state_name,industry_name,YEAR,firms_01: Total,firms_02: <5,firms_03: 5-9,firms_04: 10-19,firms_05: <20,firms_06: 20-99,firms_07: 100-499,firms_08: <500,firms_09: 500+,establishments_01: Total,establishments_02: <5,establishments_03: 5-9,establishments_04: 10-19,establishments_05: <20,establishments_06: 20-99,establishments_07: 100-499,establishments_08: <500,establishments_09: 500+,employment_01: Total,employment_02: <5,employment_03: 5-9,employment_04: 10-19,employment_05: <20,employment_06: 20-99,employment_07: 100-499,employment_08: <500,employment_09: 500+,annual_payroll_01: Total,annual_payroll_02: <5,annual_payroll_03: 5-9,annual_payroll_04: 10-19,annual_payroll_05: <20,annual_payroll_06: 20-99,annual_payroll_07: 100-499,annual_payroll_08: <500,annual_payroll_09: 500+
Alabama,Accommodation and Food Services,2010,28131,10940,5270,5430,21640,4894,743,27277,854,40615,10965,5280,5520,21765,5925,3165,30855,9760,733374,17883,35093,72753,127569,178761,101733,410314,322894,9860181000,367163000,399179000,881254000,1649856000,2300917000,1274374000,5250176000,4607200000
Alabama,Administrative and Support and Waste Management and Remediation Services,2010,17985,9740,2845,1703,14288,1662,746,16696,1289,20585,9745,2845,1740,14330,1855,990,17175,3410,587929,15953,16265,20887,56022,59130,86738,214162,347322,15029626000,598408000,476878000,611156000,1743718000,1783034000,2615762000,6403531000,8213017000
Alabama,"Agriculture, Forestry, Fishing and Hunting",2010,4069,2105,1115,550,3770,213,25,4008,61,4145,2105,1115,550,3770,220,40,4030,115,29563,4141,7138,7154,18793,6252,839,26697,1074,993727000,131235000,232818000,237834000,608057000,234954000,24858000,918546000,61095000
Alabama,"Arts, Entertainment, and Recreation",2010,5169,2890,785,580,4255,679,146,5080,89,5525,2890,785,580,4255,755,210,5220,305,86516,4091,4569,7274,17551,24601,14570,63448,12561,1623986000,125676000,84173000,105103000,332393000,407528000,270990000,1128548000,256973000
Alabama,Construction,2010,40538,24485,6695,4925,36105,3444,517,40066,472,41175,24485,6695,4930,36110,3515,575,40200,975,442935,41530,43566,66350,152985,123293,64742,349270,72136,17808020000,1277545000,1284063000,2202480000,4773525000,5154114000,2722782000,12961920000,3821452000
Alabama,Educational Services,2010,3868,1660,705,495,2860,675,160,3695,173,4175,1660,705,510,2875,730,210,3815,360,147995,742,4278,6187,13946,27659,26311,68674,74239,3984496000,63395000,53671000,105035000,241813000,560351000,683088000,1518919000,2238139000
Alabama,Finance and Insurance,2010,16091,10235,2009,850,13094,1281,561,14936,1155,35850,10285,2075,1265,13625,3345,3385,20355,15495,344209,17780,11315,9465,39957,44591,36447,128099,113307,19370081000,702246000,502251000,391704000,1724416000,1989750000,1587034000,5577210000,12727419000
Alabama,Health Care and Social Assistance,2010,40744,16410,10560,6644,33614,4563,1393,39570,1174,51190,16445,10625,6925,33995,6010,4725,44730,6460,1177911,33261,69870,86737,192219,167438,203200,565279,605714,47618473000,1893311000,2981006000,3765455000,8656168000,7649238000,6966229000,23343736000,23898473000
Alabama,Information,2010,3932,1630,565,425,2620,487,240,3347,585,7935,1630,575,430,2635,595,405,3635,4300,167814,2083,2875,4642,10099,13457,11831,47542,111193,8786123000,102961000,116287000,195284000,432581000,639486000,638186000,2044451000,5700429000
Alabama,Management of Companies and Enterprises,2010,2263,100,45,65,210,451,673,1334,929,2820,105,45,65,215,455,730,1400,1420,80074,0,0,39,512,4576,14281,19495,60579,6106680000,270000,985000,1257000,72372000,246298000,799475000,1134505000,4970626000
Alabama,Manufacturing,2010,20312,6880,3200,2685,12765,3506,1613,17884,2428,22010,6880,3200,2700,12780,3555,1900,18235,3775,1037421,10203,17064,30014,63420,125264,136515,361808,585000,46376583000,397396000,562780000,1008416000,2144478000,4802689000,5341449000,13624298000,28408789000
Alabama,"Mining, Quarrying, and Oil and Gas Extraction",2010,1015,370,95,120,585,150,75,810,205,1255,370,95,120,585,155,95,835,420,35445,152,460,1303,2299,5645,4518,13255,20358,2331132000,24206000,21421000,48471000,100277000,284877000,291493000,727081000,1545330000
Alabama,Other,2010,201,193,6,2,201,0,0,201,0,201,193,6,2,201,0,0,201,0,248,186,35,0,248,0,0,248,0,3623000,3112000,318000,0,3623000,0,0,3623000,0
Alabama,Other Services (except Public Administration),2010,51451,31360,10660,5360,47380,3142,424,50946,505,55465,31385,10770,5560,47715,4085,750,52550,2915,397235,59226,68551,70132,201578,106825,29788,348515,29376,8696022000,1256771000,1328141000,1421634000,4034772000,2189460000,635979000,7189179000,1185130000
Alabama,"Professional, Scientific, and Technical Services",2010,42656,28285,6075,3615,37975,2590,891,41456,1200,46930,28290,6090,3685,38065,3175,1280,42520,4410,467961,44414,38840,46013,133169,87885,62771,290006,164221,29090529000,1816436000,1609123000,2177166000,5646568000,5379537000,4817834000,16213121000,12267817000
Alabama,Real Estate and Rental and Leasing,2010,15140,11000,1668,859,13527,743,381,14651,489,20025,11020,1760,995,13775,1345,1075,16195,3830,118879,16387,10483,10313,39039,19839,20700,81808,33658,3784660000,509442000,297135000,300609000,1131605000,739682000,660437000,2586579000,1141888000
Alabama,Retail Trade,2010,57867,32999,11351,6118,50468,4389,1053,55910,1957,92420,33185,11670,6935,51790,7560,4250,63600,28820,1016540,56443,71502,77513,210469,138478,83063,446049,528336,23925581000,1346092000,1637254000,1952766000,4976581000,4052588000,2257419000,11533042000,11345429000
Alabama,Total,2010,75518,41651,13720,8790,64161,7081,1921,73163,2355,99251,41744,13893,9305,64942,9668,5362,79972,19279,1568111,77287,90189,116954,284430,260709,223163,768302,799809,57448016000,2376758000,2623846000,3577009000,8577613000,8989585000,8063381000,25630579000,31817437000
Alabama,Transportation and Warehousing,2010,12197,6825,1455,1133,9413,1182,537,11132,1065,14370,6825,1455,1170,9450,1345,685,11480,2890,250461,10471,8679,14188,34938,35938,33302,107939,120045,10250732000,350473000,267367000,462155000,1116156000,1225370000,1234629000,3681758000,5450938000
Alabama,Utilities,2010,544,150,140,30,320,100,25,445,99,2085,150,140,30,320,200,75,595,1490,34680,349,849,98,1519,5228,2720,9569,502,2537678000,6499000,29504000,10706000,46709000,308317000,169600000,527948000,22776000
Alabama,Wholesale Trade,2010,21623,9310,3447,2629,15386,2732,1299,19417,2206,26675,9335,3510,2805,15650,3515,2265,21430,5245,344177,14199,20571,30052,69723,76348,52274,213960,116594,16980139000,686856000,911354000,1427407000,3131249000,3438335000,2610454000,9737577000,6671972000
Alaska,Accommodation and Food Services,2010,8607,4245,1786,1189,7220,1024,196,8440,167,9965,4255,1790,1225,7270,1255,730,9255,710,130681,5693,11422,15663,33060,36422,24216,94696,32037,2954454000,220707000,204321000,267816000,704228000,700810000,490731000,1909294000,996962000
Alaska,Administrative and Support and Waste Management and Remediation Services,2010,4741,2740,730,463,3933,303,145,4381,360,5335,2740,735,475,3950,365,290,4605,730,96649,3253,4301,5123,13827,6856,7026,32850,58529,4590745000,160294000,168518000,213617000,568469000,266915000,262960000,1504989000,2902131000
Alaska,"Agriculture, Forestry, Fishing and Hunting",2010,1915,1780,65,30,1875,15,15,1905,10,1925,1780,65,30,1875,15,20,1910,15,5598,1038,190,203,1828,0,0,1897,0,252233000,91045000,6328000,6138000,130060000,0,0,212263000,0
Alaska,"Arts, Entertainment, and Recreation",2010,2585,1770,355,220,2345,205,15,2565,20,2740,1770,370,260,2400,210,15,2625,115,19703,769,1479,1433,5866,6239,0,12307,0,390784000,90876000,42362000,38920000,204501000,93327000,0,332454000,0
Alaska,Construction,2010,12083,8415,1700,1097,11212,596,89,11897,186,12305,8415,1700,1100,11215,640,110,11965,340,90194,9951,10149,13451,36533,17883,5264,64294,23237,7560985000,815850000,706053000,952329000,2539010000,1612616000,461618000,4914605000,2339962000
Alaska,Educational Services,2010,1135,560,265,120,945,115,45,1105,30,1280,560,265,125,950,120,170,1240,40,13345,563,1321,1523,4037,3125,2094,12749,0,340065000,20136000,37151000,34741000,101913000,71952000,68488000,326170000,0
Alaska,Finance and Insurance,2010,2179,1175,305,165,1645,116,95,1856,323,3925,1175,310,180,1665,235,400,2300,1625,35025,318,1471,1349,4797,2501,0,12472,15626,2095609000,89599000,69289000,80020000,274712000,124654000,150660000,810600000,1037683000
Alaska,Health Care and Social Assistance,2010,9596,4620,2165,1325,8110,851,374,9335,261,11110,4620,2175,1355,8150,1120,890,10160,950,210736,7142,13499,16154,38727,30862,46265,121036,72688,10373649000,516542000,698970000,1042086000,2318880000,1477817000,1586546000,5556867000,4131145000
Alaska,Information,2010,1081,465,140,138,743,116,73,932,149,1925,470,145,155,770,200,220,1190,735,31325,455,273,1054,2171,2394,985,5911,7018,1901027000,27118000,20190000,35943000,92669000,122123000,48367000,460059000,1328180000
Alaska,Management of Companies and Enterprises,2010,531,50,15,26,91,105,130,326,205,710,50,15,30,95,105,150,350,360,31724,0,0,0,0,903,0,0,25617,3330699000,3637000,0,0,1043000,34153000,0,5326000,2959155000
Alaska,Manufacturing,2010,2288,1215,425,245,1885,195,25,2105,183,2625,1220,425,245,1890,210,40,2140,485,53003,673,1442,1294,5856,3916,3375,14640,37695,2115897000,74227000,133868000,101139000,372316000,176747000,107620000,726390000,1340473000
Alaska,"Mining, Quarrying, and Oil and Gas Extraction",2010,630,315,50,45,410,45,55,510,120,780,315,50,50,415,45,65,525,255,42997,0,31,0,217,464,4165,7246,34955,4507640000,38055000,13627000,10312000,69514000,46489000,495749000,883962000,3428265000
Alaska,Other,2010,38,36,1,1,38,0,0,38,0,38,36,1,1,38,0,0,38,0,0,0,0,0,0,0,0,0,0,954000,711000,0,0,954000,0,0,954000,0
Alaska,Other Services (except Public Administration),2010,8346,5135,1823,832,7790,315,90,8195,151,8865,5140,1835,895,7870,390,280,8540,325,47553,8835,11192,9932,31949,8450,2690,44813,1302,1513679000,281422000,328062000,316548000,970259000,305903000,65089000,1403311000,48787000
Alaska,"Professional, Scientific, and Technical Services",2010,8672,5640,1000,790,7430,507,185,8122,550,9830,5645,1000,835,7480,665,235,8380,1450,81740,7576,6283,9021,24979,12778,4918,46571,25044,5316701000,474909000,377833000,631871000,1534982000,966143000,378577000,3095053000,2135547000
Alaska,Real Estate and Rental and Leasing,2010,3635,2660,400,200,3260,167,63,3490,145,4105,2665,400,230,3295,295,215,3805,300,23654,3755,2307,1886,8708,3435,2112,16419,2958,915321000,151646000,92566000,66462000,328701000,145259000,72934000,658302000,209004000
Alaska,Retail Trade,2010,9719,4866,1919,1355,8140,857,208,9205,514,12575,4910,2005,1530,8445,1290,525,10260,2315,153776,5675,10229,15014,35599,21079,9613,77435,42839,4414854000,253263000,322265000,441172000,1071685000,715420000,346169000,2356326000,1308504000
Alaska,Total,2010,16462,9920,2776,1744,14440,1142,311,15893,569,19985,9949,2821,1904,14674,1624,1054,17352,2633,254734,15123,18265,23324,56712,40422,38240,135374,119360,12821494000,743636000,735069000,1018588000,2497293000,1806390000,1636105000,5939788000,6881706000
Alaska,Transportation and Warehousing,2010,4288,2665,423,344,3432,244,214,3890,398,5565,2670,430,390,3490,375,485,4350,1215,77338,1905,1260,2672,6989,5138,9945,27412,31441,4758394000,190010000,82109000,126053000,449545000,326034000,437190000,1480286000,1895610000
Alaska,Utilities,2010,282,90,50,42,182,50,45,277,5,455,90,55,85,230,75,135,440,15,8886,121,202,320,739,1658,5834,8486,0,695227000,6048000,7195000,19897000,34523000,132925000,470143000,659149000,0
Alaska,Wholesale Trade,2010,2820,1065,330,275,1670,388,194,2252,568,3715,1075,330,320,1725,510,295,2530,1185,34892,561,1230,1805,5534,5735,3431,19922,11659,2165090000,75563000,62803000,103675000,330819000,325311000,150772000,1018633000,890852000
Arizona,Accommodation and Food Services,2010,39092,13354,7830,7733,28917,7823,1192,37932,1160,57190,13375,7855,7895,29125,9290,4910,43325,13865,1178510,22432,51195,104334,179827,292576,174195,650467,526273,18967340000,548465000,628721000,1293163000,2481355000,4183252000,2549084000,9245470000,9678447000
Arizona,Administrative and Support and Waste Management and Remediation Services,2010,35865,21320,5165,3210,29695,3114,1240,34049,1816,41095,21330,5205,3285,29820,3320,1585,34725,6370,1003354,29921,33251,41077,108238,113066,158417,389009,599438,34153258000,977534000,926298000,1143096000,3083232000,3153604000,4392192000,10982472000,22576484000
Arizona,"Agriculture, Forestry, Fishing and Hunting",2010,925,660,130,50,840,50,20,910,15,940,660,130,50,840,65,20,925,15,5985,768,0,0,2170,1609,1272,5415,0,186967000,35540000,14953000,3476000,79576000,54314000,23884000,177097000,0
Arizona,"Arts, Entertainment, and Recreation",2010,7445,4185,995,670,5850,942,409,7201,244,8475,4185,1005,685,5875,975,710,7560,915,184438,2917,4899,8071,17344,35473,54844,117150,57446,5822188000,270670000,116577000,174770000,585135000,656817000,2660839000,4041039000,1346609000
Arizona,Construction,2010,59762,38045,9411,6077,53533,4750,864,59147,615,60455,38050,9420,6095,53565,4805,1035,59405,1050,603315,56488,60934,80388,200798,172478,91636,476331,73259,25962175000,1883535000,1975261000,2711301000,6577939000,7083279000,3929255000,17957714000,5915690000
Arizona,Educational Services,2010,8298,3830,1195,1205,6230,1395,361,7986,312,9535,3835,1195,1210,6240,1500,645,8385,1150,281045,4627,7645,15655,29301,54094,44472,134728,142829,10549652000,186262000,176370000,327642000,697439000,1604477000,1450057000,3900817000,6396594000
Arizona,Finance and Insurance,2010,25210,17958,2500,923,21381,1019,812,23212,1998,47260,17980,2610,1045,21635,1550,2255,25440,21820,604808,27601,14317,10716,54027,28365,39740,127081,456385,35860043000,1152605000,660745000,627030000,2512027000,1733009000,2324181000,6783768000,28496114000
Arizona,Health Care and Social Assistance,2010,66091,36670,13530,7464,57664,5038,1795,64497,1594,82000,36720,13685,7740,58145,6895,5610,70650,11350,1531876,56476,87094,95284,242844,186907,259809,703720,789378,70063604000,3737101000,3873732000,4049524000,11693611000,8199086000,10312312000,30541440000,38454652000
Arizona,Information,2010,6319,3205,785,510,4500,616,302,5418,901,10300,3205,790,515,4510,720,400,5630,4670,195429,3402,4144,6256,15201,19721,19416,59217,130971,14780189000,257964000,199102000,325435000,804692000,1121485000,1250870000,3552867000,8119280000
Arizona,Management of Companies and Enterprises,2010,2976,236,50,65,351,455,817,1623,1353,4460,240,50,65,355,460,885,1700,2760,214450,343,168,29,1073,5253,24395,30721,182946,16524850000,33187000,17304000,25384000,79912000,271833000,1681645000,2034335000,14403967000
Arizona,Manufacturing,2010,20745,8895,3490,2690,15075,3092,1041,19208,1537,21780,8895,3490,2690,15075,3195,1185,19455,2325,605246,12047,18141,29234,67968,94851,58497,258553,303951,34269662000,492301000,662317000,1052261000,2446377000,4054352000,2473772000,10607615000,21756702000
Arizona,"Mining, Quarrying, and Oil and Gas Extraction",2010,884,390,120,105,615,115,41,771,113,1215,390,120,105,615,135,65,815,400,28461,216,446,646,2180,2547,573,7158,20875,1769398000,40165000,21972000,23440000,125378000,121076000,112996000,400539000,1326189000
Arizona,Other,2010,204,198,3,3,204,0,0,204,0,204,198,3,3,204,0,0,204,0,0,0,0,33,0,0,0,0,0,3979000,3678000,217000,84000,3979000,0,0,3979000,0
Arizona,Other Services (except Public Administration),2010,47474,29189,9025,4895,43109,2947,776,46832,642,53305,29230,9120,5050,43400,3815,2490,49705,3600,405008,49960,58776,62460,174633,100257,59954,342847,42748,10394471000,1351769000,1376177000,1528213000,4273656000,2441969000,1608744000,8566364000,1364775000
Arizona,"Professional, Scientific, and Technical Services",2010,75363,55500,8185,5039,68724,3366,1321,73411,1952,81315,55510,8215,5125,68850,3925,2110,74885,6430,632703,67846,50655,63224,190241,106162,79306,382643,218482,38159080000,3762806000,2419006000,3193078000,9458576000,6497410000,4793914000,21087457000,15987370000
Arizona,Real Estate and Rental and Leasing,2010,31708,25035,2632,1518,29185,1127,583,30895,813,39765,25085,2750,1690,29525,1830,1545,32900,6865,203251,27622,16071,17834,65815,32048,22254,125693,66226,7810433000,1105461000,521815000,588467000,2226350000,1186556000,1126115000,4750103000,2968844000
Arizona,Retail Trade,2010,51469,29133,9695,5239,44067,3629,1337,49033,2436,89965,29275,10055,6020,45350,5995,4565,55910,34055,1465904,42166,52114,52197,152502,107439,103006,374816,988683,35669175000,1180818000,1298159000,1560780000,3969609000,3400993000,3881747000,11921112000,22418058000
Arizona,Total,2010,102175,61994,16049,10185,88228,8434,2570,99232,2943,131849,62101,16281,10633,89015,10659,6659,106333,25516,2065224,97639,105358,135068,338065,305709,282220,925994,1139230,84030312000,3757658000,3338483000,4242532000,11338673000,10488845000,10724886000,32552404000,51477908000
Arizona,Transportation and Warehousing,2010,12953,6990,1740,1060,9790,1148,671,11609,1344,15325,7000,1745,1070,9815,1315,885,12015,3310,277143,7534,10148,13318,33853,29887,27349,102069,143886,10494278000,309327000,336880000,418352000,1112831000,1100314000,999996000,3336878000,6790431000
Arizona,Utilities,2010,789,435,95,70,600,40,67,707,82,1325,435,100,70,605,95,175,875,450,5935,437,488,688,1978,899,4707,10781,49,377390000,22197000,17453000,41586000,82166000,84416000,505035000,700431000,4374000
Arizona,Wholesale Trade,2010,27585,14077,3790,2601,20468,2959,1569,24996,2589,32520,14115,3850,2745,20710,3410,2220,26340,6180,448167,20636,21968,27637,73935,73162,51317,218053,212877,26600451000,1071915000,987504000,1343794000,3486059000,3493727000,2712042000,10506312000,15601401000
Arkansas,Accommodation and Food Services,2010,20418,7170,3740,4108,15018,4195,624,19837,581,26450,7200,3780,4185,15165,4815,2410,22390,4060,451652,11268,24805,55548,92865,145089,73882,315517,135997,5673053000,228174000,284461000,645604000,1163243000,1713722000,879592000,3832078000,1839055000
Arkansas,Administrative and Support and Waste Management and Remediation Services,2010,11274,6565,1665,1075,9305,932,307,10544,730,12630,6565,1670,1115,9350,1065,510,10925,1705,243290,8492,10557,13040,34719,30443,26266,102991,125628,6095878000,286991000,304764000,333597000,963910000,814883000,539402000,2519827000,3129724000
Arkansas,"Agriculture, Forestry, Fishing and Hunting",2010,3228,1855,755,335,2945,190,40,3175,53,3365,1855,755,335,2945,210,45,3200,165,21626,3137,4788,4157,12654,5398,0,20177,787,708799000,131214000,178431000,138734000,457693000,139196000,10965000,637909000,46324000
Arkansas,"Arts, Entertainment, and Recreation",2010,3954,2355,615,405,3375,422,87,3884,70,4045,2355,615,415,3385,460,115,3960,85,42829,1773,3876,4898,12935,14055,7049,37112,2178,773420000,108474000,51098000,64130000,232219000,261044000,136895000,670961000,41115000
Arkansas,Construction,2010,27428,17505,4550,3045,25100,1875,259,27234,194,27695,17505,4550,3045,25100,1920,345,27365,330,213521,28289,29725,40385,99613,63508,29855,197582,7758,7960224000,844523000,871497000,1337788000,3068945000,2464048000,1391687000,7085275000,451056000
Arkansas,Educational Services,2010,2550,1245,370,280,1895,405,145,2445,105,2835,1245,370,280,1895,425,350,2670,165,74460,1542,2317,3103,7257,16366,16036,42764,25726,1477538000,48435000,38275000,50958000,142985000,355676000,509088000,1036963000,402322000
Arkansas,Finance and Insurance,2010,12027,8280,1370,480,10130,712,380,11222,805,21865,8290,1395,615,10300,2060,2580,14940,6925,168348,13366,8168,5957,28888,24402,27997,87204,78065,8695742000,448197000,334098000,232984000,1044302000,1092706000,1104919000,3565213000,4819177000
Arkansas,Health Care and Social Assistance,2010,29540,13730,6580,3925,24235,2933,1434,28602,938,37195,13730,6600,4025,24355,4140,4345,32840,4355,850131,23328,42428,49151,117594,123733,180018,425987,414696,30973806000,1424699000,1541027000,1876729000,4870282000,3915838000,5071704000,14181655000,16536889000
Arkansas,Information,2010,2621,1090,380,290,1760,345,100,2205,416,5260,1090,380,290,1760,455,160,2375,2885,102349,842,2101,3039,6617,9968,2166,21120,52194,5291823000,39706000,56812000,83932000,200167000,438575000,66139000,866677000,2650685000
Arkansas,Management of Companies and Enterprises,2010,1537,115,25,55,195,275,466,936,601,5690,115,25,55,195,280,510,985,4705,180800,96,0,367,660,2693,9136,12755,167947,15285155000,9711000,0,18109000,46685000,137834000,516425000,707190000,14570270000
Arkansas,Manufacturing,2010,12668,4475,2210,1595,8280,1875,882,11037,1631,13870,4475,2210,1600,8285,2045,1120,11450,2420,677191,6007,10983,16653,37333,57704,58963,190638,426485,26217857000,208006000,362385000,546835000,1217384000,2090103000,2249258000,6733447000,16684364000
Arkansas,"Mining, Quarrying, and Oil and Gas Extraction",2010,1803,800,210,205,1215,225,98,1538,265,2015,800,210,205,1215,230,125,1570,445,43798,683,1053,2297,5683,6696,6675,20211,23592,2784418000,60088000,52091000,123652000,254101000,319388000,426701000,1053826000,1731185000
Arkansas,Other,2010,115,110,3,1,114,1,0,115,0,115,110,3,1,114,1,0,115,0,0,0,20,0,0,0,0,0,0,2165000,1871000,127000,0,2059000,0,0,2165000,0
Arkansas,Other Services (except Public Administration),2010,31765,20440,6047,2960,29447,1791,208,31446,319,33280,20475,6090,3050,29615,2300,435,32350,930,210688,37519,38359,37348,115371,59479,12209,193710,13069,4507990000,780020000,770536000,759538000,2324783000,1140528000,315838000,3970113000,431827000
Arkansas,"Professional, Scientific, and Technical Services",2010,26753,19065,3751,1843,24659,1020,373,26052,701,28795,19070,3780,1910,24760,1335,840,26935,1860,163596,27472,22802,23043,76025,27626,16217,129530,28834,7583768000,1140464000,861255000,885217000,2958445000,1502176000,776580000,5586477000,1727694000
Arkansas,Real Estate and Rental and Leasing,2010,11744,9195,1045,538,10778,417,222,11417,327,14485,9205,1050,600,10855,915,595,12365,2120,63726,12802,6023,5872,25974,11988,4587,46682,15775,1807711000,331554000,157699000,155722000,664735000,359477000,116860000,1259753000,497872000
Arkansas,Retail Trade,2010,36762,19452,8198,4449,32099,2616,608,35323,1439,55030,19570,8355,4890,32815,4535,2510,39860,15170,536811,34296,51899,54892,144264,79658,37663,274591,243555,12661822000,772020000,1147718000,1346571000,3292750000,2384592000,953828000,6904405000,5401827000
Arkansas,Total,2010,51072,29233,8988,5611,43832,4398,1191,49421,1651,65158,29288,9070,5885,44243,6140,3802,54185,10973,965474,50583,58962,74163,183708,159731,139164,482603,482871,33735110000,1535799000,1599405000,2026282000,5161486000,4776468000,4397712000,14335666000,19399444000
Arkansas,Transportation and Warehousing,2010,10462,6160,1460,929,8549,785,324,9658,804,12060,6160,1475,950,8585,840,445,9870,2190,218738,9074,8832,10941,30459,23906,18741,76487,120670,8437326000,277936000,275119000,336492000,917264000,914863000,650925000,2648537000,4989329000
Arkansas,Utilities,2010,728,420,115,20,555,55,48,658,70,1720,420,115,20,555,135,165,855,865,31741,950,686,0,1849,2750,8646,13619,518,2247616000,23609000,19946000,6974000,53466000,146742000,547783000,764853000,189609000
Arkansas,Wholesale Trade,2010,13892,5745,1879,1740,9364,1887,896,12147,1745,16930,5765,1910,1835,9510,2530,1405,13445,3485,212724,5998,10490,19102,41490,48149,26472,130778,73932,10395137000,387600000,405477000,759613000,1636810000,2129464000,1296111000,5666125000,4323054000
California,Accommodation and Food Services,2010,284785,114890,60474,53603,228967,48068,5669,282704,2081,377315,115085,60815,54855,230755,58325,24745,313825,63490,6517210,198695,394764,714832,1308417,1793995,940284,4029339,2404225,118278360000,4298469000,5317021000,10420600000,19918825000,30807930000,16703107000,67717520000,49837607000
California,Administrative and Support and Waste Management and Remediation Services,2010,175489,105966,26976,16900,149842,16994,5007,171843,3646,205800,106090,27155,17290,150535,19095,8020,177650,28150,5362258,169252,175237,223493,572944,636812,754115,2002235,3335136,204023786000,6967282000,5666940000,7524632000,20228451000,23603420000,23890723000,67860571000,135888209000
California,"Agriculture, Forestry, Fishing and Hunting",2010,9066,5970,1230,770,7970,754,251,8975,91,9310,5970,1230,780,7980,825,355,9160,150,126627,8232,7764,9305,26335,31068,29492,89137,29064,4270837000,484225000,337070000,430881000,1260639000,1363793000,753319000,3444687000,603499000
California,"Arts, Entertainment, and Recreation",2010,94881,71025,8620,5956,85601,6713,1762,94076,805,101025,71070,8670,6030,85770,7390,2425,95585,5440,1472130,52073,54726,78281,207900,274569,278393,766582,690119,66098090000,19619670000,2637149000,2494165000,24766595000,8090942000,12479740000,46153255000,19480931000
California,Construction,2010,330655,216204,51738,33782,301724,24172,3520,329416,1239,334995,216215,51770,33865,301850,24725,4870,331445,3550,2924005,334895,339020,452743,1128150,893015,521924,2544555,344676,146609370000,12764640000,12998085000,19826860000,45589585000,45768800000,27474740000,118848095000,25390246000
California,Educational Services,2010,51683,24845,7855,7168,39868,8669,2205,50742,941,58980,24870,7895,7285,40050,10025,4025,54100,4880,1741855,39035,51467,97703,188751,341756,343803,879480,853710,61881500000,1429890000,1237830000,2191382000,4881110000,10640405000,12594832000,28159090000,33548417000
California,Finance and Insurance,2010,137797,99245,16918,7752,123915,7419,2944,134278,3519,245515,99525,17480,8715,125720,12240,14965,152925,92590,2792144,159421,107205,99520,371006,248810,336457,964105,1539587,245744513000,8484367000,6579608000,7847877000,22977392000,22731891000,30168824000,76846519000,166932737000
California,Health Care and Social Assistance,2010,430364,251796,91881,44124,387801,30000,8696,426497,3867,505785,252205,92665,46300,391170,41915,29575,462660,43125,8366952,452902,600891,576101,1637634,1158084,1242679,4042129,4246747,414682619000,25733035000,24279622000,23670468000,73682874000,44887424000,45707771000,164465766000,248888503000
California,Information,2010,71075,46821,7635,5451,59907,6340,2263,68510,2565,101435,46875,7675,5630,60180,7235,3665,71080,30355,2454814,55294,49151,71304,178164,228014,257029,672426,1618405,229770491000,9276110000,3217884000,5212923000,17757349000,18089434000,22922636000,59519980000,151462964000
California,Management of Companies and Enterprises,2010,16168,1325,460,685,2470,3279,4953,10702,5466,24755,1335,460,700,2495,3345,5440,11280,13475,1312465,1665,2124,3995,7853,37074,166804,211850,1100537,149661300000,204545000,157285000,273065000,635265000,2868982000,13178585000,16683485000,132969194000
California,Manufacturing,2010,185265,77109,33029,27500,137638,31830,8624,178092,7173,194685,77165,33065,27645,137875,32700,10555,181130,13555,5606795,131084,210650,363379,724681,1222506,1023136,3055674,2344881,323530411000,5671986000,7798384000,14303203000,28075938000,54355947000,53145011000,139025422000,169374257000
California,"Mining, Quarrying, and Oil and Gas Extraction",2010,3094,1310,405,419,2134,451,191,2776,318,4085,1310,405,445,2160,470,280,2910,1175,105754,1806,2378,5260,9961,14610,18084,44057,58462,9744264000,121581000,167645000,355862000,659771000,1008549000,1454622000,3205876000,6260373000
California,Other,2010,2340,2267,52,17,2336,4,0,2340,0,2340,2267,52,17,2336,4,0,2340,0,0,0,320,0,0,99,0,0,0,49447000,42980000,3109000,0,48070000,1377000,0,49447000,0
California,Other Services (except Public Administration),2010,310615,201447,55672,28898,286017,20056,3083,309156,1459,344125,201570,56110,30145,287825,24920,9185,321930,22195,2696308,362314,358932,379362,1107211,701237,354958,2172420,494614,77931040000,9528143000,9348384000,10437006000,29336851000,20246605000,11635048000,61383917000,15368223000
California,"Professional, Scientific, and Technical Services",2010,525055,384105,65095,36787,485987,26766,6491,519244,5811,565165,384300,65425,38045,487770,31580,11950,531300,33865,5842080,558239,423046,482947,1471076,931898,655090,3072980,2679547,443244735000,34481603000,24259370000,30334192000,89128060000,73426805000,55816806000,219091215000,221761758000
California,Real Estate and Rental and Leasing,2010,185065,141150,21557,10705,173412,7778,2278,183468,1597,233295,141565,22460,12590,176615,12870,11870,201355,31940,1320433,206552,137087,134633,478875,264658,211036,963492,303299,62843762000,8634070000,5216278000,5795327000,19660413000,12269882000,9652466000,41743525000,20074833000
California,Retail Trade,2010,345549,208006,67673,36637,312316,24229,5292,341837,3712,531325,209190,69940,41350,320480,37945,22560,380985,150340,7079587,336781,412403,457515,1208462,863637,588376,2698240,4032563,196755889000,9677411000,10448332000,12277398000,32399254000,27996544000,21255274000,83298301000,111454666000
California,Total,2010,690454,430767,114578,70439,615784,57427,11742,684953,5501,849875,431635,116119,74142,621896,73355,36877,732128,117747,12536402,705881,751207,939042,2396130,2176280,1751079,6323489,6212913,635620368000,34683509000,27310921000,35391204000,97385634000,92056922000,83765930000,273208486000,362411882000
California,Transportation and Warehousing,2010,84986,47185,13581,9296,70062,8485,2741,81288,3698,104380,47230,13665,9595,70490,9965,5500,85955,18425,2064521,71569,85516,116538,277862,271767,205431,768606,1265573,90032775000,2662492000,2988684000,4331491000,10076608000,10956844000,9202122000,30574477000,58979303000
California,Utilities,2010,2486,1420,370,215,2005,154,80,2239,247,5585,1425,390,230,2045,190,175,2410,3175,22153,2406,2339,2568,7662,4623,8717,20367,12102,1743780000,124786000,98503000,162603000,401527000,394123000,782447000,1541866000,1078017000
California,Wholesale Trade,2010,253762,143422,42513,27915,213850,25811,7671,247332,6430,290115,143845,43060,29130,216035,30995,14225,261255,28860,3954115,241364,274420,359642,883674,881067,658204,2437715,1457199,276316615000,11961420000,12995671000,18068640000,43075925000,48970695000,42640006000,135252390000,139132497000
Colorado,Accommodation and Food Services,2010,46226,16485,9205,9588,35278,8831,1020,45129,1097,61035,16495,9265,9765,35525,10505,4195,50225,10810,1097695,26268,60250,127821,214774,311132,153041,679289,405402,18449370000,704202000,798801000,1771299000,3276915000,4916396000,2455294000,10714755000,7695953000
Colorado,Administrative and Support and Waste Management and Remediation Services,2010,37065,23470,4916,3349,31735,2651,938,35324,1741,41235,23480,4930,3365,31775,2890,1210,35875,5360,964302,29496,29781,43452,105524,93420,95574,310442,648887,39641739000,1300930000,953254000,1364000000,3661180000,3157742000,3274504000,10624007000,28829579000
Colorado,"Agriculture, Forestry, Fishing and Hunting",2010,1500,1200,175,60,1435,50,0,1485,15,1500,1200,175,60,1435,50,0,1485,15,7874,1279,749,467,3225,2093,0,5694,0,248274000,49137000,36787000,17553000,114134000,71458000,0,200849000,0
Colorado,"Arts, Entertainment, and Recreation",2010,11444,7375,1445,1050,9870,997,303,11170,274,12085,7375,1445,1050,9870,1100,390,11360,725,245326,7014,9032,13030,32438,38279,40374,115527,117481,6607383000,396446000,203523000,264631000,887153000,737157000,975550000,2874381000,2392294000
Colorado,Construction,2010,83005,60595,10210,6430,77235,4294,791,82320,685,83735,60600,10220,6445,77265,4370,960,82595,1140,618005,81099,65341,85252,234594,157519,90827,489950,101036,29462650000,3020480000,2574105000,3406150000,9015965000,7525012000,4571091000,21412495000,6479697000
Colorado,Educational Services,2010,10276,6105,1285,1110,8500,1223,300,10023,253,10790,6105,1285,1125,8515,1280,455,10250,540,216605,7830,8261,14756,31848,50640,35530,121470,83519,6418870000,297330000,211258000,336261000,856178000,1382412000,1174854000,3528990000,2483918000
Colorado,Finance and Insurance,2010,30491,22375,2982,1070,26427,1270,829,28526,1965,50475,22420,3090,1225,26735,2420,3400,32555,17920,461330,29136,18420,12424,64293,38068,56566,163561,271707,31540398000,1597507000,988226000,864004000,3597177000,2565039000,3413657000,9874789000,21019862000
Colorado,Health Care and Social Assistance,2010,60926,33885,12372,6887,53144,4932,1626,59702,1224,72710,33910,12435,7140,53485,6475,4910,64870,7840,1238507,54589,81550,90357,229211,185993,236441,665309,540454,54098617000,2824731000,3342288000,3745482000,9935755000,7562898000,8881510000,26751794000,26414108000
Colorado,Information,2010,9603,5260,1090,785,7135,781,516,8432,1171,14700,5265,1090,810,7165,855,660,8680,6020,383604,3895,6176,7790,20151,24916,28251,87859,285408,29242216000,375292000,349225000,433885000,1195484000,1646766000,2309004000,5669241000,22697916000
Colorado,Management of Companies and Enterprises,2010,3402,305,65,80,450,582,919,1951,1451,4575,305,65,80,450,605,975,2030,2545,221210,320,263,451,1131,7052,26715,34955,185648,23225235000,61065000,49410000,25738000,137313000,574652000,2326455000,3044300000,19841571000
Colorado,Manufacturing,2010,23337,11385,3631,3014,18030,2922,932,21884,1453,24045,11390,3640,3025,18055,3025,1030,22110,1935,475550,14177,19724,33949,76960,91499,46396,257055,172796,24651228000,632389000,776764000,1322133000,2951442000,4119582000,2498391000,11667417000,10341451000
Colorado,"Mining, Quarrying, and Oil and Gas Extraction",2010,5859,3440,715,574,4729,495,188,5412,447,6360,3440,715,580,4735,525,215,5475,885,112922,3107,3556,7037,16446,14857,14471,47655,63002,10501428000,388680000,371852000,599271000,1361885000,1245122000,1532844000,4177885000,6191348000
Colorado,Other,2010,279,258,16,4,278,1,0,279,0,279,258,16,4,278,1,0,279,0,384,212,97,0,361,0,0,384,0,5961000,4412000,1164000,197000,5773000,0,0,5961000,0
Colorado,Other Services (except Public Administration),2010,58961,37505,10923,5757,54185,3375,730,58290,671,64580,37535,10995,5945,54475,4360,1900,60735,3845,483588,64355,69487,73719,210442,116621,55025,388387,72768,13644155000,1759937000,1841295000,1899723000,5546501000,3191503000,1734260000,10671125000,2496693000
Colorado,"Professional, Scientific, and Technical Services",2010,111487,86395,10533,6236,103164,4322,1668,109154,2333,118560,86405,10605,6380,103390,5015,2105,110510,8050,865150,100716,67784,78727,262631,135332,87448,491154,361431,63940907000,5859030000,3627004000,4440859000,13975110000,9732568000,7855414000,32040537000,31581493000
Colorado,Real Estate and Rental and Leasing,2010,38510,31010,3369,1685,36064,1039,537,37640,870,45155,31060,3445,1790,36295,1655,1240,39190,5965,203886,38984,20587,21393,82378,30858,18136,135544,59354,7746791000,1374287000,689086000,736642000,2813285000,1149257000,789873000,4886425000,2658583000
Colorado,Retail Trade,2010,61324,35395,11781,6678,53854,3997,1084,58935,2389,92605,35475,12055,7390,54920,6390,4040,65350,27255,1087428,51523,68110,71380,196204,121084,59845,402415,454112,30922511000,1515094000,1776832000,2021917000,5457801000,4227939000,2192126000,12327628000,14341999000
Colorado,Total,2010,125820,81800,18100,11590,111490,8823,2499,122812,3008,151973,81876,18294,12056,112226,11260,6161,129647,22326,1955336,123115,118576,153533,395224,316989,249181,961394,993942,89244945000,4803262000,4089319000,5241964000,14134545000,12278557000,11262423000,37675525000,51569420000
Colorado,Transportation and Warehousing,2010,14531,8995,1635,1107,11737,925,586,13248,1283,16700,9005,1640,1130,11775,1000,770,13545,3155,276677,10792,10133,12991,36394,26805,15584,84457,155460,11396789000,389809000,352666000,427710000,1224772000,1160477000,670216000,3245959000,6769387000
Colorado,Utilities,2010,1079,595,140,50,785,142,45,972,107,1925,595,140,55,790,245,100,1135,790,39551,875,815,473,2312,6264,4326,13087,2319,3172992000,33112000,34913000,31041000,128628000,458802000,320818000,916343000,188565000
Colorado,Wholesale Trade,2010,30355,16000,4108,2800,22908,2886,1654,27448,2907,35700,16030,4155,2900,23085,3530,2250,28865,6835,424364,22657,24439,31851,84463,77815,42789,225050,171287,25942959000,1173662000,1187673000,1636007000,4106092000,4260651000,2566344000,11677763000,12722986000
Connecticut,Accommodation and Food Services,2010,33157,14525,6580,5708,26813,5298,433,32544,613,40020,14535,6595,5785,26915,5995,1655,34565,5455,607035,25042,43607,77157,145926,186067,55962,392218,213412,11603832000,578597000,648865000,1239177000,2472405000,3256942000,916908000,6724662000,4856694000
Connecticut,Administrative and Support and Waste Management and Remediation Services,2010,23898,15290,3325,2000,20615,1617,604,22836,1062,26205,15290,3345,2025,20660,1735,745,23140,3065,394807,20601,19945,24230,67289,53355,63526,195772,188914,15549706000,1106027000,838476000,985363000,3005604000,2400104000,1674748000,7555494000,7826088000
Connecticut,"Agriculture, Forestry, Fishing and Hunting",2010,390,285,80,15,380,10,0,390,0,390,285,80,15,380,10,0,390,0,1297,0,92,0,992,0,0,1297,0,47261000,12360000,8618000,0,29906000,0,0,47261000,0
Connecticut,"Arts, Entertainment, and Recreation",2010,7525,4037,1080,974,6091,1107,181,7379,146,8035,4040,1080,985,6105,1155,320,7580,455,116512,4614,6450,12259,24570,45634,21005,99732,14502,3186282000,411402000,190453000,324896000,950989000,1278815000,326658000,2692770000,330543000
Connecticut,Construction,2010,40764,29405,5535,3210,38150,2067,319,40536,228,40935,29410,5540,3215,38165,2085,335,40585,350,251172,42089,35963,40947,121258,70451,27102,229589,11011,14593000000,2063343000,1865453000,2190220000,6147891000,4490093000,1635343000,12822960000,801593000
Connecticut,Educational Services,2010,6100,2785,1060,780,4625,943,335,5903,197,6480,2785,1060,780,4625,1005,420,6050,430,331377,4376,7082,10172,22328,38186,49308,117246,199917,13977795000,149665000,162535000,223116000,546324000,1261107000,2238632000,4309789000,9190593000
Connecticut,Finance and Insurance,2010,18677,10945,2518,1450,14913,1404,738,17055,1622,31695,10950,2610,1560,15120,2175,2405,19700,11995,514512,17368,15782,16227,51360,44561,58441,161064,343917,71914429000,1454742000,1589428000,2523766000,5624136000,7649583000,8475677000,22182925000,47585247000
Connecticut,Health Care and Social Assistance,2010,38793,16170,8756,5863,30789,4625,2176,37590,1203,51285,16205,8895,6330,31430,6795,6205,44430,6855,1306834,32974,57635,76005,167531,175991,310530,664317,621618,58765875000,1504871000,2583550000,3590902000,7692114000,8161380000,11351418000,27498941000,30726744000
Connecticut,Information,2010,5014,2225,610,550,3385,650,248,4283,731,8245,2235,610,550,3395,710,325,4430,3815,163954,2432,3151,6198,14039,21095,17820,58368,103057,11376673000,249688000,190274000,277022000,791057000,1275800000,1064538000,3363454000,7233872000
Connecticut,Management of Companies and Enterprises,2010,2504,175,80,120,375,355,576,1306,1198,3585,175,80,120,375,360,625,1360,2225,192475,0,410,720,1395,4620,20304,26695,165776,22512945000,26365000,69797000,61200000,160715000,313880000,1584310000,2122435000,20390140000
Connecticut,Manufacturing,2010,21680,8095,3840,3236,15171,4020,1217,20408,1272,22365,8095,3840,3255,15190,4120,1335,20645,1720,567222,11845,21642,37624,75721,137998,103898,357031,175252,32866191000,613780000,957992000,1871902000,3623377000,7353328000,5930411000,18656966000,12052287000
Connecticut,"Mining, Quarrying, and Oil and Gas Extraction",2010,257,125,35,35,195,25,5,225,32,355,125,35,35,195,35,5,235,120,3490,12,0,400,761,461,0,1583,1351,304150000,8019000,6338000,19394000,36749000,35853000,0,115803000,132726000
Connecticut,Other,2010,147,141,2,4,147,0,0,147,0,147,141,2,4,147,0,0,147,0,179,119,0,45,179,0,0,179,0,3318000,2913000,0,136000,3318000,0,0,3318000,0
Connecticut,Other Services (except Public Administration),2010,43515,26500,9495,4421,40416,2301,347,43064,451,46455,26540,9570,4575,40685,2680,735,44100,2355,298960,50033,60931,57280,170322,73176,16646,268920,17862,8981267000,1391074000,1673714000,1570751000,4666195000,2142744000,738381000,7918425000,645335000
Connecticut,"Professional, Scientific, and Technical Services",2010,44433,29590,6310,3835,39735,2559,702,42996,1437,47385,29615,6335,3885,39835,2825,905,43565,3820,471649,43707,39634,47523,135160,81348,36601,265855,192212,37455109000,2593643000,2406807000,3114560000,8208283000,6895125000,3151180000,19328845000,16591760000
Connecticut,Real Estate and Rental and Leasing,2010,12399,8790,1585,728,11103,576,287,11966,433,16160,8840,1635,760,11235,780,1295,13310,2850,96374,14532,9793,8479,33647,16542,8291,65156,22525,4952200000,645871000,478466000,442614000,1593726000,920519000,521840000,3270981000,1612045000
Connecticut,Retail Trade,2010,45039,25324,8550,4695,38569,3554,910,43033,2006,64700,25430,8715,5030,39175,4700,2520,46395,18305,861930,36804,50626,50154,147140,99063,51406,312900,353827,24395121000,1326537000,1468411000,1773256000,4642622000,4360474000,2067755000,11478145000,8513645000
Connecticut,Total,2010,72747,41488,12637,8073,62198,6672,1776,70646,2101,89234,41557,12784,8394,62735,8131,4347,75213,14021,1436992,71851,83181,106755,261787,242301,209547,713635,723357,79918588000,3146198000,3382136000,4651163000,11179497000,12079689000,10682318000,33941504000,45977084000
Connecticut,Transportation and Warehousing,2010,6805,3160,960,779,4899,803,335,6037,768,8205,3165,960,815,4940,865,445,6250,1955,188200,3699,5472,9014,20122,21317,10252,64707,95119,7759898000,239684000,247648000,501999000,1019778000,1203359000,465673000,3027319000,4337079000
Connecticut,Utilities,2010,362,85,35,30,150,55,35,240,122,845,85,35,30,150,55,90,295,550,5343,0,0,288,219,1072,4637,6456,214,2924852000,0,0,14853000,56629000,75945000,338742000,561167000,15186000
Connecticut,Wholesale Trade,2010,19553,9270,2866,2142,14278,2369,1032,17679,1874,22090,9275,2890,2200,14365,2570,1370,18305,3785,335196,11343,15754,24418,57450,67982,42571,189699,122294,24551472000,1011795000,1108013000,1717284000,3955566000,4604365000,3127850000,12782797000,10213780000
Delaware,Accommodation and Food Services,2010,7811,3285,1195,1365,5845,1382,229,7456,355,9550,3290,1205,1380,5875,1515,770,8160,1390,157225,4457,7941,17974,30445,50273,25960,108381,48402,2690214000,181504000,126785000,271585000,587353000,793193000,349273000,1747084000,937035000
Delaware,Administrative and Support and Waste Management and Remediation Services,2010,6322,3480,890,615,4985,490,225,5700,622,6760,3485,890,615,4990,515,235,5740,1020,117824,4509,4832,6524,17911,13079,20564,57259,47213,4402025000,203261000,164518000,197266000,710966000,398543000,535343000,1853883000,2073579000
Delaware,"Agriculture, Forestry, Fishing and Hunting",2010,215,165,25,15,205,5,0,210,5,215,165,25,15,205,5,0,210,5,725,34,0,0,440,0,0,510,0,22827000,3743000,0,0,17005000,0,0,17107000,0
Delaware,"Arts, Entertainment, and Recreation",2010,1930,1115,268,205,1588,225,55,1868,62,2050,1115,270,205,1590,260,65,1915,135,29689,873,1040,2321,5167,6457,2670,18587,6198,704398000,51055000,35782000,40878000,157155000,145376000,71643000,490443000,165997000
Delaware,Construction,2010,11803,7715,1875,1135,10725,814,145,11684,119,11875,7715,1880,1135,10730,835,150,11715,160,92239,10890,11213,14318,38522,28265,12569,85632,3431,4406072000,399301000,463271000,597328000,1489860000,1568157000,698052000,4026288000,251455000
Delaware,Educational Services,2010,1323,565,218,150,933,230,75,1238,85,1375,565,220,155,940,245,75,1260,115,29603,564,904,1764,3880,10229,9659,23818,2334,1082173000,20998000,25923000,37573000,91185000,253919000,420629000,808466000,89685000
Delaware,Finance and Insurance,2010,6078,3355,603,280,4238,338,328,4904,1174,10050,3380,615,330,4325,545,560,5430,4620,175909,3832,3451,2233,11281,6410,5899,27904,140666,12845099000,205058000,165000000,130743000,561977000,638008000,425853000,1920819000,10786630000
Delaware,Health Care and Social Assistance,2010,9377,3355,2165,1726,7246,1152,448,8846,531,12425,3360,2175,1805,7340,1535,1525,10400,2025,284223,5519,13441,22321,43012,37768,39249,129328,146717,13182641000,313335000,663778000,1011673000,2010931000,1877907000,1522867000,5641965000,7425660000
Delaware,Information,2010,1236,595,125,103,823,125,35,983,253,2010,595,125,105,825,135,70,1030,980,36370,295,365,590,1398,2885,625,8927,19866,2056384000,43790000,17854000,45225000,148229000,142409000,36071000,467706000,1067597000
Delaware,Management of Companies and Enterprises,2010,5171,2480,85,71,2636,325,641,3602,1569,6275,2495,90,75,2660,370,760,3790,2485,67975,2862,380,268,3578,1890,3841,9767,58180,5709625000,47269000,14690000,7464000,71391000,96610000,178857000,365660000,5343965000
Delaware,Manufacturing,2010,2841,1100,405,350,1855,439,189,2483,358,3005,1100,405,360,1865,460,215,2540,465,100200,853,1215,2023,5013,9292,6752,31514,62749,5090099000,176628000,64858000,90983000,394468000,505696000,357864000,1734155000,2892583000
Delaware,"Mining, Quarrying, and Oil and Gas Extraction",2010,42,25,5,5,35,0,0,35,7,55,25,5,5,35,0,0,35,20,43,0,0,0,0,0,0,0,0,2734000,0,0,0,2080000,0,0,2080000,0
Delaware,Other,2010,43,39,2,2,43,0,0,43,0,43,39,2,2,43,0,0,43,0,61,0,0,0,61,0,0,61,0,1158000,1004000,0,0,1158000,0,0,1158000,0
Delaware,Other Services (except Public Administration),2010,10199,5990,2075,1089,9154,660,154,9968,231,10660,5990,2090,1175,9255,755,220,10230,430,69672,10544,12398,13451,38466,19293,5782,65379,3096,1851388000,292288000,326476000,320325000,977471000,459567000,142094000,1712928000,99818000
Delaware,"Professional, Scientific, and Technical Services",2010,11734,7725,1315,866,9906,853,310,11069,665,12595,7725,1320,935,9980,1025,370,11375,1220,114562,8880,7872,10699,29954,24689,14338,72490,29936,9085402000,711274000,469485000,693257000,1917130000,1785036000,1742242000,5628150000,2556028000
Delaware,Real Estate and Rental and Leasing,2010,4519,3015,405,260,3680,266,128,4074,445,5460,3015,415,275,3705,390,320,4415,1045,28368,3655,2265,2401,9633,5721,3625,20868,4063,1301917000,171066000,90529000,87077000,372246000,224001000,118778000,763462000,277209000
Delaware,Retail Trade,2010,12889,6649,2180,1279,10108,892,395,11395,1494,18270,6665,2210,1460,10335,1260,725,12320,5950,231399,8932,11641,12400,38016,25463,14436,84925,122179,6084933000,263236000,306568000,381702000,1026426000,953935000,577342000,2708742000,2984787000
Delaware,Total,2010,19679,10969,2940,2007,15916,1735,656,18307,1372,24290,10989,2972,2134,16095,2139,1306,19540,4750,359007,17466,19307,26684,63457,58673,46748,168878,190129,17166760000,809958000,683790000,944169000,2437917000,2403940000,1992479000,6834336000,10332424000
Delaware,Transportation and Warehousing,2010,3072,1715,428,229,2372,278,95,2745,327,3260,1715,430,230,2375,295,100,2770,490,38780,1322,1878,2029,6329,6929,1928,21793,15061,1571830000,72580000,50811000,62192000,217999000,225612000,64861000,681413000,562430000
Delaware,Utilities,2010,135,60,10,5,75,5,15,95,40,230,60,20,5,85,5,20,110,120,5732,0,0,0,0,0,0,0,0,586780000,2234000,0,0,6762000,0,0,2797000,0
Delaware,Wholesale Trade,2010,4633,2290,455,378,3123,487,285,3895,738,5115,2290,460,395,3145,545,350,4040,1075,62125,2613,1675,3204,9436,7242,4610,27032,27384,4621284000,176677000,115269000,159363000,528766000,338524000,248182000,1404851000,2616313000
District of Columbia,Accommodation and Food Services,2010,8572,3115,1535,1235,5885,1845,365,8095,477,11320,3115,1540,1260,5915,1905,670,8490,2830,275105,5436,9828,16033,31502,68248,28430,129167,131054,7210586000,165457000,203313000,317222000,689840000,1538918000,619963000,2895815000,3845969000
District of Columbia,Administrative and Support and Waste Management and Remediation Services,2010,4032,1585,410,385,2380,575,493,3448,584,5735,1590,415,395,2400,585,590,3575,2160,165319,1625,2046,3611,8453,21538,50304,82889,67832,6523057000,155827000,164684000,272594000,653986000,882300000,1654862000,3276951000,2682932000
District of Columbia,"Agriculture, Forestry, Fishing and Hunting",2010,10,5,5,0,10,0,0,10,0,10,5,5,0,10,0,0,10,0,0,0,0,0,0,0,0,0,0,0,0,0,0,0,0,0,0,0
District of Columbia,"Arts, Entertainment, and Recreation",2010,1387,770,190,130,1090,150,60,1300,87,1545,770,190,130,1090,155,115,1360,185,31184,484,821,886,2524,4258,8041,19464,6695,1559986000,50094000,61823000,31801000,160362000,184730000,242229000,659270000,499161000
District of Columbia,Construction,2010,2065,1050,340,260,1650,255,80,1985,80,2105,1050,340,260,1650,255,80,1985,120,28579,1264,1838,2748,6982,7624,5796,22268,0,1873717000,99198000,108053000,188060000,427693000,507036000,327340000,1389516000,0
District of Columbia,Educational Services,2010,2369,780,325,335,1440,440,311,2191,178,2645,780,325,345,1450,520,390,2360,285,246716,1052,1590,3280,5763,19651,37000,67205,179327,10878243000,73550000,95440000,174242000,357313000,876138000,1679858000,3033298000,7841578000
District of Columbia,Finance and Insurance,2010,2926,940,305,215,1460,422,224,2106,820,5125,940,305,225,1470,540,380,2390,2735,56212,516,1592,2515,4520,7799,2142,19010,34627,7400211000,100549000,175718000,326941000,647390000,830079000,261227000,2023497000,5337706000
District of Columbia,Health Care and Social Assistance,2010,8847,4100,1635,1022,6757,1155,515,8427,420,10710,4100,1640,1125,6865,1455,1045,9365,1345,318938,6713,10399,12223,30645,38831,60044,131704,174870,16654560000,500804000,615018000,621398000,1808637000,1526195000,2073292000,5591730000,10416896000
District of Columbia,Information,2010,2552,915,240,210,1365,335,164,1864,688,3630,915,240,210,1365,340,175,1880,1750,95036,540,822,1804,3856,6824,6149,23797,55746,9233857000,99474000,69680000,161695000,380420000,572455000,492630000,1935077000,6426926000
District of Columbia,Management of Companies and Enterprises,2010,806,40,25,15,80,65,155,300,506,950,40,25,15,80,65,155,300,650,51924,0,0,52,0,884,3387,4615,8906,4591095000,0,0,6780000,0,65357000,311808000,414937000,4109823000
District of Columbia,Manufacturing,2010,435,230,70,65,365,40,5,410,25,445,230,70,65,365,45,5,415,30,5054,236,240,390,1010,1035,0,2402,1005,204025000,12913000,11477000,16866000,43053000,31499000,0,91934000,44309000
District of Columbia,"Mining, Quarrying, and Oil and Gas Extraction",2010,20,10,0,0,10,0,0,10,10,20,10,0,0,10,0,0,10,10,0,0,0,0,0,0,0,0,0,0,0,0,0,0,0,0,0,0
District of Columbia,Other,2010,84,79,1,3,83,1,0,84,0,84,79,1,3,83,1,0,84,0,121,57,0,33,95,0,0,121,0,1863000,1425000,0,78000,1505000,0,0,1863000,0
District of Columbia,Other Services (except Public Administration),2010,17989,7910,3466,2446,13822,2794,1054,17670,319,20425,7910,3490,2490,13890,2980,1395,18265,2160,347065,12613,21603,30457,68256,96794,109478,275106,49296,23511767000,959824000,1267849000,1895897000,4137908000,6900191000,8199619000,19355572000,3089158000
District of Columbia,"Professional, Scientific, and Technical Services",2010,21004,11095,2873,1940,15908,2012,1150,19070,1934,24775,11100,2875,1945,15920,2080,1265,19265,5510,445033,14267,17149,21939,54122,58422,61538,180756,257095,50522069000,2166217000,1963455000,2413965000,6556394000,6503562000,6058061000,19874926000,30491312000
District of Columbia,Real Estate and Rental and Leasing,2010,3608,1980,470,280,2730,327,253,3310,298,5640,1995,500,285,2780,540,510,3830,1810,42831,2601,2633,2687,8984,7955,8693,26150,13049,3247762000,192261000,154887000,152498000,501292000,513015000,610894000,1686460000,1223514000
District of Columbia,Retail Trade,2010,7104,3945,1100,578,5623,427,228,6278,826,8810,3960,1110,600,5670,530,385,6585,2225,87666,6227,4947,4551,16838,6277,1321,30804,46711,2731771000,212531000,146568000,124572000,555994000,225166000,30686000,950082000,1445460000
District of Columbia,Total,2010,16913,7972,2661,1854,12487,2166,959,15612,1301,21502,7981,2683,1908,12572,2450,1470,16492,5010,463076,14191,17417,23912,55520,74786,86817,217123,245953,30987176000,1074242000,1085490000,1461066000,3620798000,4504550000,5112407000,13237755000,17749421000
District of Columbia,Transportation and Warehousing,2010,804,315,85,20,420,95,80,595,209,910,315,85,20,420,105,90,615,295,16695,84,249,34,405,734,616,5263,9500,624228000,32538000,23944000,525000,58949000,36938000,25128000,236918000,264988000
District of Columbia,Utilities,2010,170,5,0,5,10,0,5,15,155,225,5,0,5,10,0,5,15,210,0,0,0,0,0,0,0,0,0,0,0,0,0,0,0,0,0,0
District of Columbia,Wholesale Trade,2010,1689,675,250,145,1070,135,90,1295,394,2065,680,255,150,1085,145,95,1325,740,19803,566,966,1098,3212,1636,57,7161,9399,1648253000,46634000,69679000,62304000,212218000,84412000,1917000,479641000,835302000
Florida,Accommodation and Food Services,2010,132200,59765,24333,21470,105568,21692,2997,130257,1943,177715,59905,24490,21845,106240,23955,9935,140130,37585,3635467,98112,160178,288499,547069,812272,474964,1836767,1798031,61573853000,2265867000,2104585000,3920230000,8293997000,12249027000,7615305000,28188858000,33370384000
Florida,Administrative and Support and Waste Management and Remediation Services,2010,143387,103628,15935,9977,129540,7805,2747,140092,3295,160310,103725,16010,10130,129865,8535,4530,142930,17380,5835564,140036,102672,132568,388457,292003,366338,1068228,4728994,204376573000,5286193000,3021861000,3843893000,12124452000,8999288000,10353661000,31929346000,172119478000
Florida,"Agriculture, Forestry, Fishing and Hunting",2010,4794,3140,675,445,4260,352,121,4733,61,4920,3140,675,445,4260,420,140,4820,100,61872,3124,4190,5404,14854,12342,15393,43319,181,1633314000,146286000,142739000,169536000,477878000,343079000,316489000,1163595000,417779000
Florida,"Arts, Entertainment, and Recreation",2010,35015,23205,3875,2765,29845,3448,1120,34413,602,37310,23205,3885,2780,29870,3635,1480,34985,2325,784210,28009,24718,36289,94684,149102,159130,410494,355559,21936059000,1326405000,577108000,732016000,2663046000,3185676000,7393188000,13669551000,7660754000
Florida,Construction,2010,222257,163570,26755,17513,207838,11570,1850,221258,999,225205,163580,26770,17580,207930,12100,2415,222445,2760,1489990,217163,176525,234600,643470,418875,240071,1313295,163502,58271975000,6462210000,5566975000,7975305000,20004490000,17092328000,10565798000,48076895000,9543429000
Florida,Educational Services,2010,26006,15008,3305,2645,20958,3491,963,25412,594,28985,15025,3315,2700,21040,3990,1370,26400,2585,718260,18545,21335,35707,78740,140466,139059,364630,351060,24107561000,641046000,486835000,777407000,1909655000,3946086000,4510684000,10556250000,13457034000
Florida,Finance and Insurance,2010,88436,64731,10564,4632,79927,3716,1884,85527,2909,156525,64905,10790,5155,80850,6620,7865,95335,61190,1642187,82704,64598,57243,216821,121367,152914,507449,1098409,100818545000,4431937000,3207590000,2896939000,10613526000,7750551000,9642079000,28745058000,70700047000
Florida,Health Care and Social Assistance,2010,228092,130420,49974,25319,205713,14784,4664,225161,2931,271205,130680,50240,26190,207110,20105,14835,242050,29155,4746347,219443,326342,332296,886049,546330,684439,2126510,2586164,207301745000,11977229000,13919233000,13831938000,39732724000,24541339000,25659323000,90329340000,115729803000
Florida,Information,2010,23866,15850,2509,1670,20029,1640,730,22399,1467,39030,15885,2515,1720,20120,1850,1335,23305,15725,757690,18453,15848,21257,58037,57048,43852,162676,589878,46159102000,1127171000,691642000,921754000,2779988000,3194096000,2365348000,8735772000,37197832000
Florida,Management of Companies and Enterprises,2010,7887,1170,230,265,1665,1371,1945,4981,2906,12870,1175,230,270,1675,1410,2070,5155,7715,664770,1634,1170,2023,4885,18330,58285,81500,583270,49588820000,617940000,63785000,137397000,819220000,1324155000,4358445000,6501820000,43087000000
Florida,Manufacturing,2010,59886,32115,9005,7106,48226,6603,2277,57106,2780,63080,32120,9010,7115,48245,6805,2550,57600,5480,1264386,48711,54474,84044,199324,227624,180620,670591,524704,59607251000,1770203000,1738268000,3066834000,6867187000,9244814000,7837784000,26152144000,30035795000
Florida,"Mining, Quarrying, and Oil and Gas Extraction",2010,1080,560,140,105,805,130,32,967,113,1320,560,140,105,805,150,65,1020,300,18684,338,264,1021,2024,3541,0,7112,1766,1058179000,33641000,26108000,53871000,118446000,137248000,8142000,310638000,525564000
Florida,Other,2010,661,633,20,8,661,0,0,661,0,661,633,20,8,661,0,0,661,0,720,0,119,0,720,0,0,720,0,13748000,11861000,1719000,0,13748000,0,0,13748000,0
Florida,Other Services (except Public Administration),2010,201634,140920,31166,16717,188803,10276,1438,200517,1117,217820,140965,31315,17020,189300,12340,4220,205860,11960,1457199,233035,201458,220540,660972,363878,139953,1170579,266401,35830160000,5546975000,4684015000,4980403000,15227495000,8997889000,3394878000,27735965000,7688763000
Florida,"Professional, Scientific, and Technical Services",2010,324134,255998,32466,18405,306869,10841,3109,320819,3315,345280,256140,32655,18890,307685,13295,6030,327010,18270,2089088,344586,207878,236449,797493,351828,232913,1395488,656555,121835285000,17260965000,9925550000,11768095000,38973550000,21916097000,15259891000,76284410000,44648736000
Florida,Real Estate and Rental and Leasing,2010,115609,95959,9610,4655,110224,2727,1354,114305,1304,141060,96145,9990,5230,111365,4010,5360,120735,20325,710643,122064,60136,57858,242864,81561,88717,415548,266718,26071402000,4162487000,2020315000,1839129000,8033066000,3133276000,3239677000,14526063000,10879418000
Florida,Retail Trade,2010,224173,156384,34158,17088,207630,10428,2742,220800,3373,353135,156845,35100,19270,211215,16715,9770,237700,115435,4162985,223015,201668,206307,649331,348001,238913,1246243,1979358,106781486000,6258409000,5097451000,5312840000,16747108000,11737648000,8888764000,37714299000,50180767000
Florida,Total,2010,400840,278363,55655,32785,366803,23856,5856,396515,4325,491150,278782,56263,34228,369273,30086,16593,415952,75198,6626558,429770,362466,433591,1225827,877638,736626,2840091,3786467,252973227000,15516579000,11984958000,14002915000,41504452000,31329079000,28413157000,101246688000,151726539000
Florida,Transportation and Warehousing,2010,54563,38150,5865,3530,47545,3054,1508,52107,2456,62690,38170,5890,3645,47705,3385,2180,53270,9420,985768,46368,36739,44202,134634,93339,88468,332227,602146,40722160000,1791570000,1261139000,1452102000,4532956000,3524765000,3559601000,12096186000,28197465000
Florida,Utilities,2010,1486,785,230,84,1099,129,102,1330,156,2925,785,230,110,1125,215,335,1675,1250,131696,1268,989,811,3687,4890,16849,28159,100180,10270344000,47894000,54064000,35876000,157405000,269878000,1121669000,1681558000,8386399000
Florida,Wholesale Trade,2010,132201,87594,17794,10400,115788,8922,3411,128121,4080,151060,87790,17965,10900,116655,10895,6480,134030,17030,1372608,135229,113073,130236,381315,265304,185266,861772,468346,69466750000,5863689000,4953719000,5619301000,16464826000,13004680000,9213571000,39448861000,28491130000
Georgia,Accommodation and Food Services,2010,66321,25750,12370,12626,50746,12691,1539,64976,1345,92835,25780,12440,12820,51040,14485,6675,72200,20635,1717045,42758,81708,172303,296833,465868,235869,1001235,715336,25499275000,948430000,999290000,2106716000,4057935000,6275888000,3180553000,13547560000,11939211000
Georgia,Administrative and Support and Waste Management and Remediation Services,2010,50484,31835,6285,4425,42545,3969,1668,48182,2302,58835,31840,6305,4475,42620,4160,2485,49265,9570,1523241,44109,39895,57734,145161,144723,201210,504884,971961,45620655000,1695602000,1280397000,1860456000,4873692000,4729280000,6195994000,16132847000,27744380000
Georgia,"Agriculture, Forestry, Fishing and Hunting",2010,4705,2495,1050,660,4205,406,45,4656,49,4820,2500,1050,660,4210,420,80,4710,110,37863,3768,6948,8495,20121,12482,0,36078,599,1310591000,151573000,238384000,280531000,678213000,437146000,18695000,1219066000,26169000
Georgia,"Arts, Entertainment, and Recreation",2010,12618,7735,1570,1440,10745,1310,297,12352,266,13480,7745,1570,1450,10765,1420,420,12605,875,202842,8678,9513,18415,37230,49454,38137,130294,45386,6271305000,405852000,188950000,346983000,973200000,901026000,940697000,2959412000,2695438000
Georgia,Construction,2010,86225,57770,12595,8324,78689,5811,999,85499,726,87410,57800,12595,8340,78735,5880,1340,85955,1455,749715,89588,83040,110815,284595,213158,121937,631420,104175,31782740000,2924190000,2817372000,4097695000,9839725000,9293953000,5727944000,25120500000,5937293000
Georgia,Educational Services,2010,12093,6480,1775,1390,9645,1623,465,11733,360,13540,6485,1785,1475,9745,2030,525,12300,1240,386894,8832,11545,18493,39187,67778,73946,186129,198132,13685220000,267159000,226202000,349505000,852635000,1743797000,2435874000,5146265000,8530155000
Georgia,Finance and Insurance,2010,38531,25632,4894,2027,32553,2417,1300,36270,2261,73325,25705,5095,2580,33380,5310,5245,43935,29390,776253,37808,29048,23723,93807,80019,88538,275327,373919,53508826000,1722045000,1398518000,1429531000,4560466000,4313691000,5544692000,14862325000,37534487000
Georgia,Health Care and Social Assistance,2010,90174,43790,20962,12355,77107,9041,1965,88113,2061,110190,43845,21100,12860,77805,11435,6380,95620,14570,2183267,73063,137152,165685,378391,331261,276676,992439,1124913,91788682000,3997512000,5731757000,6876666000,16642800000,13520660000,9682877000,40068062000,49346451000
Georgia,Information,2010,11085,5885,1205,955,8045,1151,493,9689,1396,20320,5890,1205,1025,8120,1285,825,10230,10090,561271,7290,6952,11682,26935,38662,42855,113084,445262,39413292000,412802000,326727000,553176000,1329880000,2471106000,2991357000,6933084000,32572470000
Georgia,Management of Companies and Enterprises,2010,5527,475,115,160,750,771,1387,2908,2619,8185,475,115,160,750,785,1450,2985,5200,557620,0,476,1270,2145,8610,41138,52435,504979,50937695000,226996000,37020000,80215000,384121000,495025000,2526020000,3405340000,47532355000
Georgia,Manufacturing,2010,34897,13390,5470,4739,23599,5074,2566,31239,3658,38415,13390,5470,4785,23645,5470,3050,32165,6250,1534660,20218,32249,55901,116912,178953,193712,534741,895069,66598472000,808563000,1105186000,2053995000,4219155000,7136352000,8103130000,21249133000,41351001000
Georgia,"Mining, Quarrying, and Oil and Gas Extraction",2010,613,165,170,50,385,95,35,515,98,990,165,170,50,385,105,55,545,445,22712,72,854,481,1889,2099,0,7598,10131,1198464000,9211000,32271000,16428000,69605000,91028000,0,385917000,530417000
Georgia,Other,2010,358,348,8,2,358,0,0,358,0,358,348,8,2,358,0,0,358,0,327,0,47,0,327,0,0,327,0,6750000,6163000,563000,0,6750000,0,0,6750000,0
Georgia,Other Services (except Public Administration),2010,95733,61260,17745,9038,88043,5879,960,94882,851,102340,61290,17790,9270,88350,7115,1650,97115,5225,767550,108337,113989,117415,343024,207450,76247,637162,111610,20013336000,2569804000,2582483000,2685971000,7856925000,4966506000,2284837000,15376271000,3921944000
Georgia,"Professional, Scientific, and Technical Services",2010,130919,98695,13270,8240,120205,5887,2067,128159,2760,139515,98715,13310,8490,120515,6540,2855,129910,9605,1142131,106364,86239,104946,326545,191858,136765,665223,453956,72978867000,6702077000,4209621000,5289461000,16239220000,12218167000,8362749000,37234498000,34734286000
Georgia,Real Estate and Rental and Leasing,2010,39353,30627,3550,1791,35968,1493,810,38271,1082,53135,30715,3710,2025,36450,2300,3115,41865,11270,262923,38727,21833,20605,82117,43067,40406,171369,85389,11364038000,1311180000,731380000,728330000,2804844000,1884297000,1867294000,6777337000,4471983000
Georgia,Retail Trade,2010,107506,68689,18804,9550,97043,6038,1631,104712,2794,168600,68970,19260,10500,98730,9010,5695,113435,55165,1923131,117433,118996,120951,366347,201344,110635,697438,1110165,45835300000,2769500000,2710187000,3055040000,8534269000,6803825000,3655596000,19343368000,25127681000
Georgia,Total,2010,170245,105062,26471,17016,148549,13933,3907,166389,3856,217099,105237,26778,17805,149820,17384,9726,176930,40169,3315274,169135,173288,225953,568376,501443,414115,1483934,1831340,137538790000,6027455000,5564596000,7296347000,18888398000,17923283000,16329389000,53141070000,84397720000
Georgia,Transportation and Warehousing,2010,24117,14060,2540,1875,18475,1958,1344,21777,2340,29155,14085,2545,1930,18560,2145,1850,22555,6600,680195,15756,16029,23435,61056,52596,57525,180451,477554,28636587000,696303000,554081000,776439000,2053127000,1906610000,2279019000,6405828000,21361204000
Georgia,Utilities,2010,641,200,50,25,275,145,112,532,109,2990,200,50,25,275,220,345,840,2150,107841,332,134,122,932,6787,20409,28173,0,7793397000,11040000,3649000,10146000,42035000,386507000,1344659000,1780116000,6405000
Georgia,Wholesale Trade,2010,56168,28777,8169,5879,42825,5876,3216,51917,4251,65625,28850,8285,6095,43230,6805,4590,54625,11000,908560,42534,50746,70378,168939,161186,141528,496913,386412,53782220000,2193675000,2396862000,3362867000,8044707000,8386913000,7954097000,25310070000,27445970000
Hawaii,Accommodation and Food Services,2010,13674,4908,2673,2681,10262,2641,370,13273,401,17415,4920,2680,2715,10315,3105,1140,14560,2855,446762,9030,17064,36091,62721,103432,59201,225245,215490,10782730000,240359000,242788000,494622000,973874000,1929517000,1274816000,4203800000,6524335000
Hawaii,Administrative and Support and Waste Management and Remediation Services,2010,7968,4265,1230,850,6345,825,322,7492,476,9260,4265,1240,870,6375,995,630,8000,1260,202265,6367,6803,10011,25257,26715,39362,99507,69296,5660770000,211093000,208257000,243021000,689464000,862303000,933700000,2679098000,1963624000
Hawaii,"Agriculture, Forestry, Fishing and Hunting",2010,205,165,5,10,180,20,5,205,0,205,165,5,10,180,20,5,205,0,1191,0,0,0,0,598,0,1191,0,19713000,4092000,0,0,8816000,9968000,0,19713000,0
Hawaii,"Arts, Entertainment, and Recreation",2010,2294,1090,310,285,1685,395,124,2204,90,2470,1090,315,290,1695,430,195,2320,150,46432,416,1524,3013,6227,14780,13140,35224,4439,1103111000,70259000,41393000,68349000,210517000,304537000,332832000,915832000,97033000
Hawaii,Construction,2010,13535,7970,2360,1620,11950,1214,192,13356,179,13690,7970,2360,1620,11950,1265,240,13455,235,135495,11587,14759,20414,48976,41956,19970,117791,9832,7713240000,494726000,676911000,969407000,2163025000,2477986000,1367003000,6502211000,830980000
Hawaii,Educational Services,2010,2395,985,420,345,1750,440,105,2295,100,2610,985,420,350,1755,485,205,2445,165,97363,1300,2331,4166,8447,17004,13711,39997,53972,3183535000,37342000,43094000,79028000,186490000,417479000,522845000,1155614000,1909616000
Hawaii,Finance and Insurance,2010,4163,2376,395,295,3066,303,193,3562,601,7250,2385,415,335,3135,590,685,4410,2840,90212,3411,1798,3000,9763,8843,10491,31568,44129,5124443000,178537000,116511000,159116000,471973000,455264000,662543000,1748817000,3214747000
Hawaii,Health Care and Social Assistance,2010,14556,7625,3692,1476,12793,989,418,14200,356,17540,7625,3710,1570,12905,1570,1255,15730,1810,307432,13607,23230,17449,55744,38325,60910,163823,134330,14114055000,806839000,1029593000,771790000,2606693000,1427677000,2089993000,6460807000,7049746000
Hawaii,Information,2010,1643,760,230,155,1145,160,40,1345,298,2715,770,230,170,1170,195,90,1455,1260,43320,707,873,1061,3487,3388,305,9516,32696,2306243000,42180000,55163000,40531000,148837000,155342000,14909000,412721000,1822119000
Hawaii,Management of Companies and Enterprises,2010,941,10,25,55,90,225,260,575,366,1175,10,25,55,90,225,285,600,575,27500,0,84,283,396,2043,6703,9142,18167,1887545000,0,2475000,15865000,19325000,119901000,374900000,515465000,1359918000
Hawaii,Manufacturing,2010,4062,1975,725,655,3355,459,116,3930,132,4220,1975,725,665,3365,495,160,4020,200,49673,1651,3166,6484,13498,9024,4270,42785,4509,1606354000,81284000,81460000,188068000,403108000,293283000,134427000,1302225000,218790000
Hawaii,"Mining, Quarrying, and Oil and Gas Extraction",2010,41,5,10,5,20,5,5,30,11,45,5,10,5,20,5,5,30,15,479,0,0,0,0,0,0,0,0,38780000,0,0,0,1456000,0,0,0,0
Hawaii,Other,2010,56,54,1,1,56,0,0,56,0,56,54,1,1,56,0,0,56,0,0,0,0,0,0,0,0,0,0,1010000,976000,0,0,1010000,0,0,1010000,0
Hawaii,Other Services (except Public Administration),2010,15713,10350,2435,1415,14200,1065,226,15491,222,17690,10390,2435,1450,14275,1430,775,16480,1210,124337,17653,14949,16134,50708,33751,11672,102906,6567,3386352000,508724000,431780000,451324000,1417196000,969181000,349275000,2992154000,179999000
Hawaii,"Professional, Scientific, and Technical Services",2010,15059,9875,2040,1245,13160,860,358,14378,681,16710,9875,2055,1295,13225,985,435,14645,2065,121560,13052,12644,14382,39913,25757,14738,89042,27546,6470479000,771705000,623668000,809542000,2243053000,1682830000,798009000,4893211000,1372859000
Hawaii,Real Estate and Rental and Leasing,2010,8014,5670,993,503,7166,360,209,7735,279,9660,5710,1040,550,7300,630,370,8300,1360,59241,8218,5077,5039,20069,8142,6350,37261,9065,2522993000,354760000,210059000,215621000,786021000,349054000,257886000,1526368000,503307000
Hawaii,Retail Trade,2010,15067,7610,3019,1692,12321,1226,428,13975,1092,23470,7630,3140,1925,12695,2400,2005,17100,6370,301827,9883,14834,18361,45237,30428,26085,111147,143436,7949053000,342641000,398594000,433355000,1221066000,911294000,861390000,3294368000,4001458000
Hawaii,Total,2010,25383,14184,4460,2884,21528,2340,600,24468,915,31939,14225,4531,3052,21808,3306,1923,27037,4902,478838,25090,29235,38426,92751,88624,77569,258944,219894,17541821000,917383000,951645000,1180764000,3049792000,3010148000,2742202000,8802142000,8739679000
Hawaii,Transportation and Warehousing,2010,3483,1380,530,405,2315,476,280,3071,412,4280,1385,530,420,2335,535,555,3425,855,110566,1945,2362,4274,9455,13024,15659,43969,47995,4368533000,66922000,85337000,116194000,303255000,477173000,552074000,1469316000,2254007000
Hawaii,Utilities,2010,120,35,5,15,55,10,20,85,35,265,35,5,15,55,55,55,165,100,6658,9,0,0,159,0,0,1244,0,546589000,5190000,0,0,14395000,0,0,99583000,6138000
Hawaii,Wholesale Trade,2010,7714,3645,1265,907,5817,868,318,7003,711,8745,3665,1310,945,5920,1115,525,7560,1185,90451,4746,6181,9257,23734,20208,11097,66308,18253,3963456000,219596000,264615000,362093000,916500000,863774000,481468000,2662886000,1092859000
Idaho,Accommodation and Food Services,2010,14312,5475,2940,2968,11383,2209,368,13960,352,17560,5495,2955,3025,11475,2850,1275,15600,1960,251646,8458,19690,39372,68065,70321,37436,176002,76838,3339808000,161434000,207196000,417076000,789805000,912084000,451635000,2162456000,1159044000
Idaho,Administrative and Support and Waste Management and Remediation Services,2010,10060,6575,1300,850,8725,620,220,9565,495,10730,6580,1300,865,8745,695,265,9705,1025,163720,8266,7564,10177,27336,16934,19721,67308,75547,3816187000,277380000,172336000,231869000,732035000,448192000,402519000,1711298000,1956036000
Idaho,"Agriculture, Forestry, Fishing and Hunting",2010,2310,1705,290,160,2155,95,40,2290,20,2320,1705,290,160,2155,95,50,2300,20,15817,1825,1681,2193,6081,2072,2715,15462,355,504311000,101657000,67952000,76882000,249767000,123724000,49107000,485911000,18400000
Idaho,"Arts, Entertainment, and Recreation",2010,3577,2315,385,410,3110,347,60,3517,60,3685,2320,385,420,3125,370,95,3590,95,41360,2532,2209,4693,9042,11553,6138,30372,4997,627144000,85032000,37551000,63620000,199048000,192906000,93411000,514317000,56821000
Idaho,Construction,2010,31636,23635,4200,2370,30205,1164,135,31504,132,31790,23635,4200,2385,30220,1210,160,31590,200,148855,32410,26857,30316,92042,39033,5880,144160,1975,5175834000,924562000,783018000,920081000,2641837000,1663129000,327975000,4949089000,114768000
Idaho,Educational Services,2010,1909,940,310,255,1505,290,30,1825,84,2010,940,310,255,1505,300,90,1895,115,50011,820,1599,2745,6566,9982,1064,18151,31270,1039402000,34022000,30448000,48663000,123538000,234560000,26709000,401638000,623245000
Idaho,Finance and Insurance,2010,7876,5310,830,373,6513,305,288,7106,770,14265,5320,865,450,6635,615,1525,8775,5490,102476,7428,4379,3972,17534,4197,15503,44632,50988,4632381000,269010000,181767000,154961000,671067000,207599000,777149000,1863239000,2636318000
Idaho,Health Care and Social Assistance,2010,21092,10528,4615,2760,17903,1994,663,20560,532,23705,10585,4660,2815,18060,2620,1745,22425,1280,396926,17376,29747,35058,84112,76450,79842,245809,143680,14083773000,879046000,971492000,1215124000,3102313000,2439585000,2104788000,7742442000,6107562000
Idaho,Information,2010,2281,1045,285,265,1595,266,82,1943,338,3510,1050,285,270,1605,380,115,2100,1410,59834,1053,997,2468,5483,6464,2369,19061,38972,2539424000,55633000,36478000,75100000,189110000,284906000,113470000,773432000,1663749000
Idaho,Management of Companies and Enterprises,2010,869,65,15,45,125,157,270,552,317,1180,65,20,45,130,165,275,570,610,42579,0,0,0,58,1732,4928,7022,35557,3456411000,14955000,0,0,30875000,88836000,308525000,428680000,2937360000
Idaho,Manufacturing,2010,8470,3950,1500,975,6425,1216,345,7986,484,8785,3950,1505,975,6430,1250,410,8090,695,202672,4449,6962,8520,24930,34182,14954,96387,83014,9229082000,170791000,229846000,293674000,801653000,1275994000,563470000,3360603000,4120755000
Idaho,"Mining, Quarrying, and Oil and Gas Extraction",2010,531,260,55,90,405,45,39,489,42,580,260,55,90,405,55,50,510,70,9352,117,268,943,1582,827,576,3781,2466,635506000,17991000,11827000,43435000,85167000,45881000,39719000,300272000,182416000
Idaho,Other,2010,80,77,3,0,80,0,0,80,0,80,77,3,0,80,0,0,80,0,0,0,0,0,0,0,0,0,0,940000,852000,0,0,940000,0,0,940000,0
Idaho,Other Services (except Public Administration),2010,15502,10305,2735,1452,14492,629,160,15281,221,16445,10305,2745,1560,14610,945,290,15845,600,91699,16459,17052,17229,53943,16181,6128,80311,4664,2020526000,419775000,391343000,359610000,1188568000,353885000,153815000,1751860000,160140000
Idaho,"Professional, Scientific, and Technical Services",2010,19867,14155,2430,1570,18155,787,278,19220,647,21160,14160,2450,1620,18230,1025,365,19620,1540,139510,19286,14997,18754,55802,22682,9038,93258,41811,6734868000,745164000,567432000,728250000,2066036000,1145405000,420490000,3806761000,2907737000
Idaho,Real Estate and Rental and Leasing,2010,9235,7535,786,383,8704,183,138,9025,210,10510,7555,810,440,8805,395,405,9605,905,32961,7802,4129,4181,19850,2354,4533,29451,3032,891884000,260724000,108010000,102920000,479082000,82826000,118032000,740122000,113158000
Idaho,Retail Trade,2010,20694,10275,4020,2828,17123,1799,509,19431,1263,29550,10305,4100,3120,17525,2730,2495,22750,6800,356671,14407,24597,33329,78646,50910,28245,170159,161155,8618875000,394988000,513902000,776048000,1723014000,1414537000,736441000,4177042000,4085924000
Idaho,Total,2010,36660,22619,5717,3813,32149,2628,718,35495,1165,43450,22659,5776,4003,32438,3571,2158,38167,5283,487875,36135,37371,50121,123627,90161,67712,281500,206375,16235999000,1062260000,978521000,1303758000,3344539000,2747910000,2028416000,8120865000,8115134000
Idaho,Transportation and Warehousing,2010,7344,4755,915,560,6230,527,204,6961,383,8010,4755,920,565,6240,595,280,7115,895,73151,6253,4656,5966,18369,14739,10455,46134,16895,2430790000,182072000,152293000,175741000,550258000,475811000,338925000,1461841000,715132000
Idaho,Utilities,2010,571,325,50,55,430,55,5,490,81,960,325,50,55,430,90,30,550,410,13159,453,293,563,1479,1742,0,3495,89,1022005000,9234000,6864000,20857000,43004000,119131000,0,172586000,75747000
Idaho,Wholesale Trade,2010,8201,3600,945,840,5385,1106,566,7057,1144,10095,3600,960,900,5460,1470,870,7800,2295,107905,3720,4730,7649,19246,27458,13360,73036,29622,4873367000,200056000,188670000,328280000,769829000,1058914000,585421000,2785710000,1753394000
Illinois,Accommodation and Food Services,2010,102674,43540,19818,17988,81346,17893,1956,101195,1479,134395,43620,19885,18210,81715,20175,6685,108575,25820,2271455,77117,131180,241214,452909,656485,288723,1398809,864472,37451920000,1537758000,1686445000,3125510000,6345879000,9695208000,4774808000,20841885000,16544811000
Illinois,Administrative and Support and Waste Management and Remediation Services,2010,72984,47272,8885,5809,61966,6156,2287,70409,2575,82675,47285,8910,5870,62065,6650,3010,71725,10950,2219540,60720,55691,76806,196978,230058,304889,748776,1446683,66500105000,3024766000,2214961000,2789456000,8145345000,8793702000,9036543000,26642003000,38671334000
Illinois,"Agriculture, Forestry, Fishing and Hunting",2010,1505,1155,210,50,1415,25,30,1470,35,1635,1155,210,50,1415,30,75,1520,115,7992,1533,1143,498,3308,288,1476,5523,0,364032000,46262000,44752000,17561000,116476000,9052000,71658000,225731000,0
Illinois,"Arts, Entertainment, and Recreation",2010,20789,12325,2835,2285,17445,2430,559,20434,355,22250,12330,2845,2315,17490,2510,880,20880,1370,375075,16222,17760,30251,64732,92436,80054,242841,114645,11497962000,660584000,383366000,571172000,1667685000,2140453000,4209157000,8202112000,2513884000
Illinois,Construction,2010,144997,107500,18479,10400,136379,6793,1149,144321,676,145875,107500,18500,10405,136405,6920,1340,144665,1210,940105,148983,121217,137705,407641,242958,156936,819504,107654,55955815000,6395245000,5660006000,7281735000,19334738000,16231697000,10758494000,47014455000,8063978000
Illinois,Educational Services,2010,17369,8490,2305,2050,12845,3226,725,16796,573,19185,8500,2315,2140,12955,3490,1005,17450,1735,759657,11383,14896,28038,55148,132776,92555,288212,468898,27507838000,456037000,316209000,582532000,1358470000,3438803000,3279206000,8265045000,19118082000
Illinois,Finance and Insurance,2010,66228,44233,8114,3877,56224,4796,2142,63162,3066,113025,44305,8285,4470,57060,8615,8680,74355,38670,1495702,72889,49303,48270,171390,164350,197544,548875,939506,130836223000,3483738000,2694747000,3403018000,9644747000,12762089000,16265477000,39316184000,90494497000
Illinois,Health Care and Social Assistance,2010,131083,66834,27252,16641,110727,12841,4872,128440,2643,161520,67035,27530,17665,112230,17050,13910,143190,18330,3704003,117485,179298,222189,524451,498021,701970,1733198,1938301,158377800000,6269984000,8029743000,10476157000,24840626000,20459875000,22674675000,68301957000,89006700000
Illinois,Information,2010,15337,7775,1973,1395,11143,1664,882,13689,1648,27675,7785,2000,1405,11190,1890,1235,14315,13360,602736,7764,10136,17508,33329,57131,63934,170403,429090,40675582000,591733000,553973000,819097000,2021670000,3699430000,3961314000,10008273000,30588325000
Illinois,Management of Companies and Enterprises,2010,7505,510,145,261,916,1357,1985,4258,3247,10960,510,145,270,925,1385,2140,4450,6510,814625,516,25,1278,2333,14967,67445,85350,729275,88845065000,72440000,1623000,85888000,219250000,1097125000,4984875000,6301250000,82543815000
Illinois,Manufacturing,2010,67316,24097,10825,10302,45224,12967,4465,62656,4660,71050,24115,10835,10370,45320,13535,5145,64000,7050,2499725,36260,64779,132010,246396,498585,472169,1283184,1065981,128356644000,1728337000,2592437000,5489024000,10095846000,23513700000,23703205000,59839346000,60491279000
Illinois,"Mining, Quarrying, and Oil and Gas Extraction",2010,2410,1351,340,257,1948,224,94,2266,144,2800,1355,340,270,1965,295,190,2450,350,38556,2311,2184,3104,7892,5801,3907,19566,14142,2514755000,90949000,103225000,129036000,343937000,369812000,291180000,1114935000,1089611000
Illinois,Other,2010,381,365,12,3,380,1,0,381,0,381,365,12,3,380,1,0,381,0,416,0,70,32,0,0,0,416,0,7702000,6810000,465000,46000,7321000,0,0,7702000,0
Illinois,Other Services (except Public Administration),2010,147465,89672,30363,15650,135685,9274,1468,146427,1038,159015,89790,30735,16380,136905,11265,3235,151405,7610,1205785,164531,196217,204551,566857,312274,130694,1019607,165824,36004924000,4013777000,4767040000,5096976000,13883068000,8977006000,5516008000,28663813000,7011068000
Illinois,"Professional, Scientific, and Technical Services",2010,182545,134147,20872,12489,167508,9038,2763,179309,3236,193275,134235,21020,12780,168035,10595,3625,182255,11020,1743418,161006,131602,160920,476247,291771,226987,1001256,701996,133849046000,12182908000,7165034000,9435746000,28836350000,21162610000,17651407000,67984601000,64365670000
Illinois,Real Estate and Rental and Leasing,2010,48708,35761,5839,2798,44398,2303,878,47579,1129,61125,35840,6005,3050,44895,3560,2395,50850,10275,371976,44001,36387,34630,122216,72875,53013,254490,93935,17624940000,1880642000,1379138000,1446922000,4732170000,3342895000,2704116000,11064996000,5355987000
Illinois,Retail Trade,2010,127334,73304,24326,13456,111086,10485,2640,124211,3123,203350,73570,24835,14805,113210,15395,10875,139480,63870,2903936,115452,146746,160037,424566,368332,179934,1043879,1621473,72379549000,3093241000,3578972000,4271336000,11038517000,12315197000,6159463000,30359739000,39745392000
Illinois,Total,2010,253612,155697,39988,25532,221217,22233,5799,249249,4363,314171,155956,40460,26724,223140,28028,14819,265987,48184,4980011,247263,261969,340209,849441,823544,715710,2388695,2591316,235718368000,10241376000,9434860000,12730094000,32406330000,34562872000,32739429000,99708631000,136009737000
Illinois,Transportation and Warehousing,2010,54109,36970,5419,3786,46175,3553,1741,51469,2640,60755,36975,5430,3830,46235,3850,2285,52370,8385,1055202,34444,34288,46947,126759,104018,98305,347996,602335,45574748000,1586331000,1242551000,1766971000,4646917000,4353337000,4423636000,13876112000,27544055000
Illinois,Utilities,2010,884,295,125,80,500,180,40,720,164,2415,295,125,85,505,300,70,875,1540,71796,327,745,455,1763,7400,3018,14018,10441,6819575000,20467000,29923000,45636000,107970000,494250000,280587000,961230000,1122994000
Illinois,Wholesale Trade,2010,81791,41675,12147,8848,62670,10178,4219,77067,4724,95970,41755,12290,9235,63280,12625,7315,83220,12750,1482102,64135,77143,111309,257876,314901,242609,829798,602074,95004231000,3624148000,4225372000,6107819000,14022755000,18132562000,14565766000,47209311000,44685045000
Indiana,Accommodation and Food Services,2010,45876,16500,8975,9228,34703,8681,1313,44697,1179,63590,16525,9015,9345,34885,10100,5105,50090,13500,1222370,27477,59854,126889,214945,321564,176626,715284,506004,16659315000,532344000,648645000,1411469000,2594890000,3970503000,2096439000,8696515000,7946164000
Indiana,Administrative and Support and Waste Management and Remediation Services,2010,31203,18530,4693,3030,26253,2645,896,29794,1409,35705,18540,4715,3060,26315,2945,1295,30555,5150,745725,25174,29657,38723,95654,91127,99304,300259,418942,22040082000,909456000,789417000,1023261000,2763459000,2880184000,2521079000,8550324000,12754141000
Indiana,"Agriculture, Forestry, Fishing and Hunting",2010,1186,925,125,55,1105,20,36,1161,25,1280,925,125,55,1105,20,55,1180,100,7468,367,677,245,2699,129,0,6009,0,300519000,33300000,19076000,19828000,75923000,9128000,0,203433000,0
Indiana,"Arts, Entertainment, and Recreation",2010,10296,5710,1555,1365,8630,1229,245,10104,192,10700,5710,1570,1390,8670,1320,370,10360,340,156682,6757,9365,18020,36547,44015,19864,111792,29128,4038874000,286626000,174012000,289488000,777732000,814462000,312844000,2395699000,610860000
Indiana,Construction,2010,68134,45250,11360,6369,62979,3949,745,67673,461,68780,45255,11360,6375,62990,4035,905,67930,850,555380,71264,73386,84733,231366,139044,83867,463945,75047,27560830000,2517440000,2625995000,3299213000,8455475000,7196830000,4818013000,21028460000,5304924000
Indiana,Educational Services,2010,7280,3500,1185,890,5575,1147,258,6980,300,7990,3500,1215,915,5630,1295,380,7305,685,309914,4985,7487,11414,24233,43580,30993,103393,203599,8108025000,143247000,163988000,183458000,498613000,1008159000,813395000,2428242000,5562244000
Indiana,Finance and Insurance,2010,24800,16584,3080,1201,20865,1432,939,23236,1564,48870,16605,3185,1520,21310,3175,4680,29165,19705,466677,28425,18715,14416,62572,45969,80850,195448,268149,26128889000,1103297000,801467000,661538000,2617239000,2075966000,3899770000,8904190000,16920158000
Indiana,Health Care and Social Assistance,2010,53856,23725,12485,7535,43745,5767,2581,52093,1763,75365,23815,12615,7990,44420,8130,7845,60395,14970,1918271,42665,83021,97263,228542,221653,395563,854021,1059178,74506371000,1908701000,3165593000,4105751000,9192490000,9070265000,12719756000,31285057000,43126195000
Indiana,Information,2010,5379,2450,691,565,3706,691,273,4670,709,11485,2450,695,580,3725,875,570,5170,6315,202035,3157,3929,7317,14988,20712,18714,62057,136129,9643103000,158476000,138449000,245533000,573261000,814731000,939515000,2670979000,7009138000
Indiana,Management of Companies and Enterprises,2010,3217,140,45,110,295,555,1027,1877,1340,4365,140,45,110,295,560,1110,1965,2400,260600,0,10,595,940,6280,26742,33962,224538,23720910000,21819000,2794000,23560000,48394000,340363000,1613951000,2002708000,21631643000
Indiana,Manufacturing,2010,37935,11489,6140,5898,23527,7419,3194,34140,3795,41110,11495,6140,5935,23570,7810,3860,35240,5870,1979058,17518,35891,71927,135116,274177,312400,777680,1103167,96870811000,837747000,1237888000,2733017000,5135520000,11526083000,12991699000,31607014000,60389261000
Indiana,"Mining, Quarrying, and Oil and Gas Extraction",2010,946,350,100,152,602,142,77,821,125,1525,360,100,155,615,245,160,1020,505,29469,436,312,1287,2242,3610,7081,15304,11450,1876802000,29386000,10569000,69774000,121605000,200379000,504956000,960565000,731202000
Indiana,Other,2010,190,181,7,2,190,0,0,190,0,190,181,7,2,190,0,0,190,0,0,0,39,0,0,0,0,0,0,3377000,3095000,182000,0,3377000,0,0,3377000,0
Indiana,Other Services (except Public Administration),2010,75991,45357,16215,8399,69971,4578,783,75332,659,82610,45390,16385,8780,70555,6425,2045,79025,3585,622161,86373,103453,109780,302260,151511,55476,518628,66887,14373915000,1873428000,2150094000,2277721000,6310455000,3551727000,1390092000,11433503000,2149881000
Indiana,"Professional, Scientific, and Technical Services",2010,59897,40685,8461,5043,54189,3370,933,58492,1405,64560,40695,8500,5205,54400,4010,1500,59910,4650,497847,62453,54113,63677,182634,104067,53019,345661,137864,26195586000,2388409000,2128780000,2674403000,7214003000,5518754000,3440869000,16471158000,9138641000
Indiana,Real Estate and Rental and Leasing,2010,21867,16125,2360,1333,19818,913,518,21249,618,28765,16180,2470,1505,20155,1865,1850,23870,4895,160597,22908,14902,16274,55754,25578,25618,111189,40962,5195880000,684513000,428930000,446198000,1580095000,896728000,839203000,3431396000,1611679000
Indiana,Retail Trade,2010,65352,33775,13911,7978,55664,5787,1490,62941,2411,110380,33925,14260,9015,57200,9975,6570,73745,36635,1535073,53120,78533,99632,233524,192310,111251,570401,865583,34829471000,1378889000,1903968000,2350061000,5652117000,5775244000,3319081000,14884082000,18547224000
Indiana,Total,2010,110961,61802,19838,12977,94617,10525,2908,108050,2911,145019,61913,20084,13684,95681,14064,8544,118289,26730,2400382,106325,130136,173432,409893,387148,359509,1156550,1243832,90398935000,3406665000,3716266000,5059557000,12182488000,13192646000,13044095000,38419229000,51979706000
Indiana,Transportation and Warehousing,2010,22066,12260,2954,2361,17575,1932,833,20340,1726,25080,12275,2965,2400,17640,2110,1070,20820,4260,510038,14466,18730,30346,69628,63517,57252,194091,252786,18801781000,661620000,639775000,1017187000,2341926000,2469022000,2062737000,6986683000,9596582000
Indiana,Utilities,2010,969,295,210,95,600,205,30,835,134,3130,295,210,110,615,245,90,950,2180,71235,636,705,136,2953,8229,0,13682,44153,6097882000,22823000,43520000,35174000,109842000,511718000,222447000,858866000,4121944000
Indiana,Wholesale Trade,2010,31976,14520,4753,3736,23009,4295,1954,29258,2718,38855,14580,4815,3965,23360,5180,3260,31800,7055,526280,19934,29228,44995,100244,118301,77416,313339,194584,25845718000,1018607000,1255166000,1969394000,4307147000,5596681000,3780375000,14138616000,10966479000
Iowa,Accommodation and Food Services,2010,27904,10810,5178,5438,21426,5100,705,27231,673,34590,10815,5185,5520,21520,6115,2445,30080,4510,547985,16950,34729,74836,127819,178053,75168,382025,163519,7000500000,318544000,330914000,741301000,1396980000,1970005000,878391000,4256498000,2736507000
Iowa,Administrative and Support and Waste Management and Remediation Services,2010,15799,9795,2220,1435,13450,1012,469,14931,868,17905,9800,2235,1470,13505,1190,765,15460,2445,301013,13100,13591,17976,46877,32731,54820,143031,148009,8344562000,459773000,366554000,525000000,1373281000,968045000,1339725000,3997106000,4129581000
Iowa,"Agriculture, Forestry, Fishing and Hunting",2010,1235,950,110,65,1125,55,45,1225,10,1430,950,110,65,1125,110,135,1370,60,8329,660,556,520,2280,1549,1306,6112,0,400539000,40923000,33850000,18891000,102974000,63741000,60736000,260642000,0
Iowa,"Arts, Entertainment, and Recreation",2010,7054,4225,1095,825,6145,640,155,6940,114,7285,4225,1100,835,6160,670,205,7035,250,96286,5146,6706,10796,24064,23241,14692,65793,20392,1730598000,160820000,110751000,152689000,438125000,331225000,187489000,1106761000,420416000
Iowa,Construction,2010,42526,29544,6415,3764,39723,2212,400,42335,191,43045,29545,6415,3790,39750,2365,575,42690,355,276415,45037,41575,48571,137351,78336,42469,263540,8579,12917350000,1690532000,1548125000,2049846000,5307950000,4148067000,2457858000,12109520000,682994000
Iowa,Educational Services,2010,3207,1425,510,415,2350,493,195,3038,169,3735,1430,510,430,2370,550,455,3375,360,189834,1899,3191,5403,10939,18352,29908,63362,125706,4593382000,49415000,51794000,75576000,185408000,367107000,785298000,1470796000,3064274000
Iowa,Finance and Insurance,2010,18377,11720,2333,1249,15302,1345,626,17273,1104,30455,11740,2390,1725,15855,3780,3325,22960,7495,448516,18840,13797,15680,50919,45841,59896,162039,227872,25989062000,666310000,552231000,686523000,1916326000,2126805000,2983882000,7411639000,15005971000
Iowa,Health Care and Social Assistance,2010,28949,12680,5385,3843,21908,4040,1908,27856,1093,40055,12730,5405,4035,22170,5980,6030,34180,5875,1035421,23398,34434,50853,109683,167349,272550,557639,434175,36123188000,1086457000,1291896000,2084863000,4481768000,5112640000,8093847000,17836174000,18172867000
Iowa,Information,2010,4556,1800,745,733,3278,553,243,4074,482,7925,1800,750,765,3315,850,595,4760,3165,158991,2403,4218,9195,17376,16405,14830,51860,105297,6904682000,85765000,144476000,259639000,516226000,684143000,609028000,1910071000,4915216000
Iowa,Management of Companies and Enterprises,2010,1978,60,40,120,220,421,683,1324,654,2365,60,40,125,225,425,755,1405,960,87210,13,147,300,592,4434,21325,26430,60567,6210850000,549000,13254000,13867000,32945000,234205000,1296895000,1564045000,4636084000
Iowa,Manufacturing,2010,16083,5485,2590,2004,10079,2854,1424,14357,1726,17980,5485,2605,2020,10110,3110,1995,15215,2765,800340,6942,13683,21367,48356,96695,124121,299935,444334,36542660000,320308000,464983000,776806000,1686410000,4067256000,5203122000,12134326000,21358981000
Iowa,"Mining, Quarrying, and Oil and Gas Extraction",2010,325,115,35,35,185,76,36,297,28,880,115,35,35,185,215,175,575,305,8032,23,207,378,816,2894,2221,6091,0,433636000,13297000,7489000,17394000,41135000,155540000,132207000,330977000,0
Iowa,Other,2010,145,138,5,1,144,1,0,145,0,145,138,5,1,144,1,0,145,0,0,0,0,0,0,0,0,0,0,1873000,1445000,0,0,1715000,0,0,1873000,0
Iowa,Other Services (except Public Administration),2010,42897,27885,8615,3980,40480,1737,336,42553,344,45650,27985,8895,4270,41150,2350,705,44205,1445,261262,52119,54679,50831,159704,54623,14306,238994,14878,5745263000,1049949000,1065965000,1016144000,3144533000,1315856000,330009000,5014634000,464875000
Iowa,"Professional, Scientific, and Technical Services",2010,29090,19350,4500,2390,26240,1642,406,28288,802,31215,19355,4515,2500,26370,2150,625,29145,2070,228273,28126,28023,29074,88910,50786,20196,168124,49143,11557088000,1120727000,1022294000,1152513000,3344347000,2848079000,1151522000,7643058000,3210012000
Iowa,Real Estate and Rental and Leasing,2010,11060,8398,1038,525,9961,465,272,10698,362,13590,8405,1045,605,10055,1115,565,11735,1855,63749,11183,6018,5415,23864,12056,5708,44578,12063,2319333000,319238000,154392000,141062000,640436000,440429000,254781000,1401666000,482541000
Iowa,Retail Trade,2010,40174,19526,8440,6000,33966,3545,1006,38517,1657,61715,19575,8560,6520,34655,5760,3625,44040,17675,827549,32081,50236,73799,165175,106120,54483,343140,359060,17976931000,751232000,1141151000,1674310000,3597971000,3093709000,1639708000,8661334000,7253357000
Iowa,Total,2010,63402,36381,10704,7285,54370,5688,1575,61633,1769,80801,36445,10849,7781,55075,8483,5473,69031,11770,1253095,61980,69948,96772,228700,211393,203366,643459,609636,44904616000,1832032000,1884639000,2744488000,6461159000,6920886000,7191421000,20573466000,24331150000
Iowa,Transportation and Warehousing,2010,16090,10535,1875,1365,13775,1078,420,15273,817,18100,10535,1885,1370,13790,1300,630,15720,2380,261163,11693,11546,17055,44685,32318,23977,104989,151136,9407660000,455106000,341927000,513967000,1340920000,1149380000,1003731000,3616778000,5629537000
Iowa,Utilities,2010,441,50,50,70,170,157,22,349,92,1355,50,50,70,170,315,50,535,820,1307,0,153,944,1384,6224,0,8337,0,60656000,1542000,12027000,47065000,63327000,357442000,0,474359000,0
Iowa,Wholesale Trade,2010,17661,6915,2434,2586,11935,2789,1306,16030,1631,24005,6935,2490,2750,12175,4060,3710,19945,4060,316800,10415,14892,30568,58601,79741,69963,221997,81481,14563992000,457193000,576295000,1316458000,2417418000,3621624000,3247955000,9789579000,4223512000
Kansas,Accommodation and Food Services,2010,21551,7845,3857,4163,15865,4224,631,20720,831,29490,7855,3870,4205,15930,4805,2090,22825,6665,510187,12244,25759,56613,95363,146650,67984,310983,197960,6428146000,237249000,254425000,568400000,1066936000,1728655000,842560000,3649371000,2772871000
Kansas,Administrative and Support and Waste Management and Remediation Services,2010,15864,9385,2265,1460,13110,1298,461,14869,995,17470,9385,2280,1490,13155,1390,585,15130,2340,347022,12502,14490,17223,46872,45936,41919,147335,182048,10408041000,491597000,374111000,522542000,1430844000,1392696000,1004680000,4139813000,5721504000
Kansas,"Agriculture, Forestry, Fishing and Hunting",2010,960,730,135,55,920,30,5,955,5,960,730,135,55,920,30,5,955,5,3380,705,775,684,2540,739,0,3356,0,113274000,36539000,28975000,26618000,96799000,12682000,0,112449000,0
Kansas,"Arts, Entertainment, and Recreation",2010,4920,2730,798,595,4123,592,105,4820,100,5090,2730,800,600,4130,660,120,4910,180,68573,2250,4607,7464,16170,21624,14529,55514,10726,1157151000,92480000,77655000,115921000,293549000,367988000,269616000,975331000,142151000
Kansas,Construction,2010,34987,23135,5560,3333,32028,2312,353,34693,294,35320,23135,5575,3340,32050,2345,380,34775,545,280745,38354,35717,44319,120216,86704,35739,249265,28003,12767775000,1247418000,1214216000,1702897000,4230725000,4501587000,1803472000,10719105000,1920528000
Kansas,Educational Services,2010,3246,1470,530,370,2370,555,168,3093,153,3500,1475,530,370,2375,585,270,3230,270,96538,1450,3018,4633,10531,22369,28580,64377,27949,2397277000,55944000,58835000,75032000,221327000,514257000,651016000,1538770000,708733000
Kansas,Finance and Insurance,2010,18378,11870,2033,1242,15145,1369,500,17014,1364,29360,11890,2130,1635,15655,3415,2135,21205,8155,280592,19860,11976,15736,48532,45307,40903,140113,137305,15636353000,712473000,515526000,736300000,1984061000,2252472000,2141819000,6682755000,8466656000
Kansas,Health Care and Social Assistance,2010,29476,12951,6030,3939,22920,3855,1705,28480,996,38755,12990,6065,4135,23190,5110,4750,33050,5705,928048,22623,39216,50949,116020,149535,247523,518936,377908,34238144000,1035176000,1487898000,2089126000,4655917000,5899097000,7133269000,17861756000,15483032000
Kansas,Information,2010,3709,1465,460,411,2336,510,236,3082,627,7185,1465,460,425,2350,650,645,3645,3540,193376,1720,2324,4376,9772,12992,14618,44450,144265,12255219000,75281000,78794000,184075000,355440000,693373000,543080000,1782140000,10342100000
Kansas,Management of Companies and Enterprises,2010,2240,170,45,90,305,426,620,1351,889,2835,170,45,90,305,440,660,1405,1430,124175,0,96,344,615,4220,18640,23520,100619,10015240000,0,7157000,20123000,48211000,274955000,1054985000,1383530000,8625817000
Kansas,Manufacturing,2010,13738,4520,2305,1871,8696,2535,1074,12305,1433,14775,4520,2305,1900,8725,2750,1290,12765,2010,687300,5663,12177,19585,42402,84442,89887,244896,395152,32506035000,222627000,421569000,738540000,1497190000,3406443000,3943486000,9868845000,20587381000
Kansas,"Mining, Quarrying, and Oil and Gas Extraction",2010,4735,2780,700,569,4049,386,90,4525,210,5045,2780,705,595,4080,490,105,4675,370,44795,4786,4509,7213,16612,11962,1594,34410,8808,2372707000,207910000,189172000,331022000,729391000,611225000,115727000,1626417000,644166000
Kansas,Other,2010,153,150,3,0,153,0,0,153,0,153,150,3,0,153,0,0,153,0,138,0,20,0,138,0,0,138,0,2215000,1952000,263000,0,2215000,0,0,2215000,0
Kansas,Other Services (except Public Administration),2010,37811,24400,7204,3417,35021,2020,446,37487,324,39990,24420,7270,3545,35235,2455,1020,38710,1280,257417,43805,44864,42200,135342,65407,28744,239711,14754,5817915000,910785000,944665000,912552000,2801213000,1503502000,675972000,5361266000,383509000
Kansas,"Professional, Scientific, and Technical Services",2010,33317,22598,4440,2719,29757,1755,729,32241,1076,35860,22600,4460,2815,29875,2025,1125,33025,2835,289883,31114,27763,34275,94285,53057,47023,203646,65354,15153296000,1400787000,1089340000,1472826000,4000900000,2801825000,2585404000,9593178000,4504754000
Kansas,Real Estate and Rental and Leasing,2010,12090,8968,1240,691,10899,476,251,11626,464,15250,8980,1285,780,11045,830,1075,12950,2300,76968,12549,7504,7624,29172,10476,10670,52431,16152,2435970000,413119000,232523000,212092000,885759000,383832000,326335000,1634008000,597521000
Kansas,Retail Trade,2010,37679,18893,8209,4652,31754,3272,929,35955,1724,53635,18950,8365,4980,32295,4685,2835,39815,13820,659692,33614,52177,55012,144472,96234,59147,311597,316945,15046892000,754755000,1079141000,1286070000,3147940000,2872288000,1722771000,7927893000,6640717000
Kansas,Total,2010,59170,33675,9908,6443,50026,5538,1609,57173,1997,74301,33727,10037,6812,50576,7545,4490,62611,11690,1127160,58346,64995,85363,208704,200461,185458,594623,532537,42686303000,1797931000,1849340000,2584912000,6232183000,7005547000,6454732000,19692462000,22993841000
Kansas,Transportation and Warehousing,2010,11081,6635,1420,936,8991,796,367,10154,927,13075,6635,1420,960,9015,865,655,10535,2540,197388,9362,8602,10885,31554,21595,14663,74725,115720,7322360000,307521000,260464000,388762000,991952000,782865000,643091000,2623966000,4438313000
Kansas,Utilities,2010,387,90,40,35,165,100,40,305,82,985,90,40,35,165,155,250,570,415,30695,78,118,496,944,4027,1110,8881,14979,2411450000,1401000,5815000,26864000,45150000,252805000,255965000,572627000,1288452000
Kansas,Wholesale Trade,2010,16960,7062,2369,1986,11417,2622,1167,15206,1754,22160,7085,2430,2105,11620,4040,2455,18115,4045,293101,9889,13746,22449,48705,68994,39823,176023,104770,14889638000,547608000,657331000,1062410000,2364281000,3191929000,2082599000,8441941000,5862860000
Kentucky,Accommodation and Food Services,2010,26861,9135,4565,5460,19160,5654,1016,25830,1031,37585,9165,4595,5530,19290,6575,3755,29620,7965,752734,14520,30941,74242,119989,207354,125582,455854,296292,10156740000,298060000,356823000,883154000,1540800000,2511088000,1569819000,5660805000,4486915000
Kentucky,Administrative and Support and Waste Management and Remediation Services,2010,16922,9825,2450,1580,13855,1385,581,15821,1101,20055,9830,2450,1595,13875,1440,780,16095,3960,407048,14006,14898,20036,51314,46675,56109,163279,224625,10193262000,456776000,416987000,622107000,1529928000,1376317000,1318003000,4430241000,5305914000
Kentucky,"Agriculture, Forestry, Fishing and Hunting",2010,1195,820,200,80,1100,40,40,1180,15,1210,820,200,80,1100,40,55,1195,15,9193,1285,1243,1010,3776,1461,3841,9111,0,305244000,33029000,31250000,25922000,93830000,41759000,163164000,300855000,1045000
Kentucky,"Arts, Entertainment, and Recreation",2010,6112,3120,1085,855,5060,804,113,5977,135,6370,3125,1095,870,5090,865,180,6135,235,80655,4457,6898,10662,23285,29612,7900,66687,10659,1697892000,154856000,124359000,192568000,495199000,574511000,144567000,1362061000,180875000
Kentucky,Construction,2010,38424,24290,6380,4145,34815,2896,462,38173,251,38850,24290,6380,4160,34830,3000,540,38370,480,321335,36709,41332,54865,136884,104692,47662,297235,11551,13401345000,1252725000,1327855000,1892570000,4473150000,4992186000,2434960000,12185270000,615109000
Kentucky,Educational Services,2010,3708,1600,576,593,2769,540,238,3547,161,4370,1600,580,600,2780,590,445,3815,555,139158,2230,3561,7319,13959,18035,39295,74375,55240,3359486000,67104000,62218000,110393000,256603000,410425000,1014566000,1750501000,1297943000
Kentucky,Finance and Insurance,2010,15564,9460,2232,965,12657,1191,477,14325,1239,31965,9490,2325,1265,13080,3255,3245,19580,12385,318904,17539,12864,11894,43491,40821,39831,128315,178673,16744422000,601881000,512252000,513014000,1647121000,1792290000,1608705000,5266846000,11106626000
Kentucky,Health Care and Social Assistance,2010,41250,17920,9625,6424,33969,4324,1589,39882,1368,54800,17955,9675,6715,34345,5805,4565,44715,10085,1205766,34240,62776,84103,183718,151528,194406,550439,649143,46929240000,1589927000,2283971000,3165229000,7090190000,6547841000,5656598000,19648299000,27116669000
Kentucky,Information,2010,4031,1700,555,440,2695,507,227,3429,602,7435,1700,560,445,2705,685,390,3780,3655,119164,2569,3227,5046,12159,16715,7230,40253,81019,5972568000,91625000,104712000,145404000,362475000,657970000,321749000,1488677000,4342408000
Kentucky,Management of Companies and Enterprises,2010,2219,160,45,70,275,361,640,1276,943,3195,160,45,70,275,370,705,1350,1845,126930,0,0,419,747,3310,13785,18050,108880,10197875000,16699000,6648000,25051000,53094000,196453000,862410000,1115940000,9081935000
Kentucky,Manufacturing,2010,17301,5235,2660,2415,10310,3045,1500,14855,2446,18890,5240,2660,2425,10325,3360,1840,15525,3365,908286,7749,13401,27675,55452,99817,126864,324086,517207,40335592000,266372000,466084000,938697000,1818742000,3888544000,5228102000,12577455000,24812510000
Kentucky,"Mining, Quarrying, and Oil and Gas Extraction",2010,2585,1025,310,375,1710,472,184,2366,219,3200,1055,310,375,1740,500,300,2540,660,105536,1233,1563,4284,8231,16876,15274,42631,59518,6831765000,111997000,68329000,212343000,394413000,915951000,947062000,2380925000,4177978000
Kentucky,Other,2010,717,708,7,1,716,1,0,717,0,717,708,7,1,716,1,0,717,0,431,354,40,0,404,0,0,431,0,8559000,8216000,218000,0,8460000,0,0,8559000,0
Kentucky,Other Services (except Public Administration),2010,44423,28490,8276,4327,41093,2374,453,43920,503,47890,28500,8350,4505,41355,3200,1000,45555,2335,326337,51730,52566,56521,163913,76993,20304,270870,31004,7484114000,1099534000,1091471000,1135267000,3362770000,1920576000,491982000,5957655000,931348000
Kentucky,"Professional, Scientific, and Technical Services",2010,37755,25385,5630,3085,34100,1926,646,36672,1083,40660,25395,5640,3145,34180,2355,955,37490,3170,324652,38196,35853,39418,115245,61357,37280,221845,88325,14680022000,1494723000,1309622000,1589500000,4413141000,3049749000,1744660000,9536472000,4864731000
Kentucky,Real Estate and Rental and Leasing,2010,14268,10418,1550,848,12816,533,354,13703,565,18020,10425,1630,940,12995,935,855,14785,3235,86320,13217,9557,10129,37014,13982,7049,62781,19967,2751334000,447681000,266018000,324172000,1044323000,488124000,199831000,1907334000,781497000
Kentucky,Retail Trade,2010,49922,26028,10380,6471,42879,4245,904,48028,1894,77895,26120,10540,7165,43825,6435,3530,53790,24105,995553,44194,66581,81203,196826,132882,54185,402424,469166,23886562000,1062171000,1443446000,1880690000,4393410000,3955871000,1456320000,10032635000,11320946000
Kentucky,Total,2010,69572,38523,12136,8266,58925,6518,1805,67248,2324,90771,38587,12273,8693,59553,8724,5152,73429,17342,1456790,67970,79618,110715,258303,233557,204792,696652,760138,52246863000,2014025000,2204949000,3111758000,7330732000,7801930000,6806201000,21938863000,30308000000
Kentucky,Transportation and Warehousing,2010,12489,6740,1625,1280,9645,1043,517,11205,1284,14755,6740,1635,1295,9670,1135,615,11420,3335,304966,9481,9797,15872,36647,30795,18732,90667,201128,11977612000,322858000,294631000,440758000,1106973000,1106250000,741980000,3109191000,8250390000
Kentucky,Utilities,2010,470,145,55,50,250,85,55,390,80,1705,145,55,50,250,170,240,660,1045,41110,278,282,568,1241,4594,5824,12417,18015,3299909000,9945000,8307000,18180000,40470000,275316000,334393000,683987000,1621930000
Kentucky,Wholesale Trade,2010,17891,7625,2560,2132,12317,2417,1093,15827,2064,21420,7640,2605,2230,12475,2900,1765,17140,4280,319401,11413,14446,24043,54160,60592,48535,179674,126596,16315231000,522215000,588883000,974486000,2207312000,2751996000,2411954000,7974955000,7505908000
Louisiana,Accommodation and Food Services,2010,32439,11665,6165,6225,24055,6752,796,31603,836,43285,11665,6195,6345,24205,7510,2980,34695,8590,888349,18312,40890,85485,145859,245977,114117,509127,373454,14306775000,426015000,521397000,1023625000,1976044000,3547551000,1868862000,7430306000,6768892000
Louisiana,Administrative and Support and Waste Management and Remediation Services,2010,19927,10785,3130,2045,15960,2128,725,18813,1114,22685,10805,3150,2075,16030,2370,1130,19530,3155,502546,16835,19734,26499,64891,80954,86630,239798,255448,15085072000,623295000,589504000,854278000,2088365000,2892203000,2221105000,7495577000,7239675000
Louisiana,"Agriculture, Forestry, Fishing and Hunting",2010,3001,1576,745,425,2746,190,30,2966,35,3050,1580,745,425,2750,190,65,3005,45,18264,2222,4663,5124,12482,4538,173,17880,63,757270000,101900000,164284000,168102000,448944000,195235000,8568000,703994000,13985000
Louisiana,"Arts, Entertainment, and Recreation",2010,6511,3635,1055,737,5427,805,142,6374,137,6950,3635,1055,785,5475,960,235,6670,280,103653,4767,6458,8718,21398,29338,9697,69620,34754,2743534000,157072000,136026000,137108000,456216000,542779000,170863000,1556073000,897270000
Louisiana,Construction,2010,41699,24270,7335,5115,36720,3712,707,41139,560,42205,24270,7340,5120,36730,3725,840,41295,910,657780,40752,47079,68317,159360,141133,79863,400650,220146,30921405000,1390895000,1533971000,2578039000,5515695000,6322056000,4638103000,17276605000,12000377000
Louisiana,Educational Services,2010,4926,2025,685,550,3260,1190,305,4755,171,5365,2025,690,550,3265,1290,450,5005,360,175353,3074,4152,7473,15893,55305,39683,113934,53398,5813108000,101121000,87403000,135934000,345007000,1490672000,1247377000,3176123000,2397452000
Louisiana,Finance and Insurance,2010,19733,12165,3365,1235,16765,1292,589,18646,1087,37785,12190,3475,1520,17185,4280,4165,25630,12155,310058,18927,20721,15177,56209,50771,54748,171297,130748,16910760000,885934000,860998000,670321000,2435718000,2507016000,2596427000,7790735000,8694333000
Louisiana,Health Care and Social Assistance,2010,49881,21884,11735,7033,40652,6068,2015,48735,1146,59510,21915,11765,7270,40950,7630,4540,53120,6390,1370855,40489,77826,91821,211495,252131,295800,772716,578169,49663550000,2304420000,2894114000,3183540000,8393771000,7460721000,8190791000,24576309000,24104923000
Louisiana,Information,2010,3227,1355,455,350,2160,438,161,2759,468,6965,1355,465,355,2175,525,330,3030,3935,108325,1669,2228,4394,9786,12099,5175,33792,73334,5554890000,90424000,87719000,149934000,349232000,519979000,328637000,1400883000,3693367000
Louisiana,Management of Companies and Enterprises,2010,2376,155,65,110,330,505,705,1540,836,3060,155,65,110,330,510,740,1580,1480,91950,0,256,108,196,5649,22669,30145,61421,9112180000,24162000,13090000,41484000,77582000,332205000,1496113000,1913570000,7169596000
Louisiana,Manufacturing,2010,14968,5465,2565,2181,10211,2448,862,13521,1447,16285,5465,2565,2185,10215,2615,1195,14025,2260,515890,7748,13156,25033,51831,83694,67739,228748,257634,28041226000,364422000,487577000,1007827000,1992654000,3697614000,3401480000,10218058000,16001216000
Louisiana,"Mining, Quarrying, and Oil and Gas Extraction",2010,6393,3185,765,660,4610,836,354,5800,593,7925,3190,770,680,4640,965,495,6100,1825,246904,4918,5115,8931,19069,30277,36280,85948,160789,17796030000,392407000,258367000,526367000,1178259000,2101293000,2400584000,5704311000,12087434000
Louisiana,Other,2010,174,167,6,1,174,0,0,174,0,174,167,6,1,174,0,0,174,0,175,129,0,0,175,0,0,175,0,3665000,2718000,0,0,3665000,0,0,3665000,0
Louisiana,Other Services (except Public Administration),2010,44942,26345,9637,4835,40817,3043,519,44379,563,48130,26345,9730,5070,41145,3780,975,45900,2230,367113,49489,62121,62689,176700,108613,34450,328233,25056,9207183000,1142475000,1357798000,1476009000,3997936000,2590619000,1006572000,7803695000,1125211000
Louisiana,"Professional, Scientific, and Technical Services",2010,54308,37460,7368,4460,49288,3194,758,53240,1068,57775,37470,7385,4530,49385,3810,1130,54325,3450,437019,57818,46149,57411,164304,104160,56148,330060,97561,23596234000,2824030000,2025932000,2840799000,7701831000,6260535000,3654365000,17938358000,5385693000
Louisiana,Real Estate and Rental and Leasing,2010,17575,12391,2075,1197,15663,903,450,17016,559,22085,12400,2115,1310,15825,1525,1260,18610,3475,145395,17792,12939,14445,46848,28371,25096,104167,37244,6192316000,632136000,415730000,528972000,1595080000,1151405000,1128623000,3937275000,2117716000
Louisiana,Retail Trade,2010,54799,28878,11409,6991,47278,4817,931,53026,1773,83435,28965,11655,7670,48290,7170,3310,58770,24665,929683,52676,72319,87501,218758,169292,59993,468500,375145,22115293000,1198852000,1677993000,2165214000,5107123000,4947278000,2153536000,12617387000,8711583000
Louisiana,Total,2010,81299,44294,14891,9708,68893,8289,1986,79168,2131,103365,44350,15041,10187,69578,10906,5423,85907,17458,1599551,79395,97779,129713,306887,317154,247328,871369,728182,62265835000,2824365000,2974470000,4104523000,9903358000,10955914000,9709754000,30569026000,31696809000
Louisiana,Transportation and Warehousing,2010,15175,8155,2074,1495,11724,1563,592,13879,1296,19095,8160,2085,1535,11780,1690,845,14315,4780,311324,11724,10659,18838,44624,49610,41993,145854,141500,15881179000,534367000,463949000,753658000,1796316000,2426398000,2756101000,7445649000,7320762000
Louisiana,Utilities,2010,1133,625,225,65,915,75,43,1033,100,2685,625,225,65,915,125,165,1205,1480,4212,1286,1379,669,3452,2541,5106,12644,211,309612000,26680000,34256000,22861000,88280000,113052000,277036000,529521000,9333000
Louisiana,Wholesale Trade,2010,21660,8669,3670,3132,15471,3026,1243,19740,1920,27680,8700,3700,3330,15730,3860,2265,21855,5825,357474,13898,22296,38562,80061,88821,46743,231622,118908,18087948000,694861000,1029853000,1782331000,3565661000,4231839000,2273638000,10761821000,7145260000
Maine,Accommodation and Food Services,2010,17588,8735,3138,2900,14773,2269,244,17286,302,19800,8740,3155,2935,14830,2650,1040,18520,1280,228018,9716,21298,39451,70907,78940,35274,186456,39820,4082198000,533945000,425930000,641069000,1604595000,1335266000,488441000,3462640000,588682000
Maine,Administrative and Support and Waste Management and Remediation Services,2010,9156,6030,1180,685,7895,645,184,8724,432,9770,6035,1180,700,7915,730,355,9000,770,106877,8346,6826,8079,24934,20659,17958,71607,28869,2913334000,287191000,200542000,229071000,745849000,573192000,347317000,1892670000,808642000
Maine,"Agriculture, Forestry, Fishing and Hunting",2010,3870,3035,365,255,3655,180,25,3860,10,3915,3035,365,255,3655,195,45,3895,20,16782,139,2231,3237,8175,5401,362,16532,0,643039000,114439000,65888000,108902000,290857000,209068000,22825000,622444000,0
Maine,"Arts, Entertainment, and Recreation",2010,4287,2930,590,355,3875,275,87,4237,50,4380,2930,595,355,3880,295,150,4325,55,34977,3007,3261,4150,11722,9735,6421,31409,2017,712880000,153266000,97063000,101447000,375909000,161050000,65141000,651968000,36620000
Maine,Construction,2010,25032,19445,2915,1590,23950,869,107,24926,106,25115,19445,2915,1595,23955,895,125,24975,140,113841,26417,18625,20230,66820,26237,5701,106052,2484,4853905000,999111000,667134000,787278000,2478918000,1273261000,326775000,4364758000,148405000
Maine,Educational Services,2010,2275,1165,335,315,1815,270,100,2185,90,2375,1165,335,315,1815,300,130,2245,130,72903,1334,2088,3715,7392,11012,12134,32595,38951,2050198000,51278000,39877000,93091000,191143000,307866000,392276000,964925000,1048165000
Maine,Finance and Insurance,2010,4764,2490,625,350,3465,474,236,4175,589,9670,2490,640,455,3585,1165,1615,6365,3305,128956,3805,3426,4048,11834,16279,22059,52570,64843,7139649000,152155000,161579000,193765000,530932000,794602000,1040350000,2471773000,4129014000
Maine,Health Care and Social Assistance,2010,16497,7770,3383,1787,12940,1759,1064,15763,734,23930,7775,3425,1850,13050,2745,4400,20195,3735,528710,12896,22010,22884,59544,71034,127117,262128,254284,20385117000,504251000,848833000,857398000,2265038000,2192282000,4197176000,8730989000,11242052000
Maine,Information,2010,2547,1265,385,220,1870,276,115,2261,286,3595,1265,385,220,1870,360,230,2460,1135,42050,1591,1600,2501,6900,8625,4200,25238,15786,2128850000,51660000,64089000,61909000,202513000,371441000,148521000,959408000,701194000
Maine,Management of Companies and Enterprises,2010,846,55,10,50,115,130,346,591,255,1030,55,10,55,120,130,360,610,420,40538,0,0,135,203,1737,8773,10783,29753,2804677000,0,0,9665000,19532000,70992000,414776000,509797000,2294679000
Maine,Manufacturing,2010,7860,3475,1295,999,5769,1193,402,7364,496,8150,3475,1300,1000,5775,1245,470,7490,660,191799,3610,6290,8366,21800,35626,26191,103410,62689,8725114000,161871000,212314000,299220000,780618000,1476988000,1198499000,4157941000,3379961000
Maine,"Mining, Quarrying, and Oil and Gas Extraction",2010,116,80,10,0,90,10,0,100,16,120,80,10,0,90,10,0,100,20,258,73,0,0,133,0,0,253,0,18307000,4963000,0,0,7093000,0,0,14673000,0
Maine,Other,2010,52,50,1,1,52,0,0,52,0,52,50,1,1,52,0,0,52,0,0,0,0,0,0,0,0,0,0,615000,560000,0,0,615000,0,0,615000,0
Maine,Other Services (except Public Administration),2010,17324,11885,3285,1190,16360,622,142,17124,200,18100,11895,3335,1215,16445,930,295,17670,430,88196,21717,20213,13868,58613,16479,4761,83594,2127,2180804000,521601000,486297000,342044000,1381905000,471594000,121921000,2040171000,72414000
Maine,"Professional, Scientific, and Technical Services",2010,16713,11450,2393,1240,15083,816,213,16112,601,17580,11450,2425,1275,15150,990,265,16405,1175,112792,14511,15360,14861,47862,24405,8528,84545,23998,5980442000,681734000,667828000,707933000,2095170000,1400502000,578707000,4270661000,1625788000
Maine,Real Estate and Rental and Leasing,2010,7067,5590,625,325,6540,218,90,6848,219,7980,5610,625,395,6630,290,130,7050,930,32122,7503,3704,3316,15370,4495,3882,25231,3793,1050869000,235671000,136000000,119648000,506244000,165920000,128593000,837932000,138088000
Maine,Retail Trade,2010,23785,12294,4746,3266,20306,1827,483,22616,1169,32565,12345,4805,3565,20715,2650,1695,25060,7505,343064,17606,27079,36062,87021,52453,32548,183121,78735,8352896000,516673000,639071000,877180000,2068371000,1468338000,1116153000,4944335000,2073519000
Maine,Total,2010,33773,21008,5353,3311,29672,2447,649,32768,1005,40571,21039,5411,3497,29947,3359,2449,35755,4816,480932,32798,35233,43895,111926,88885,81649,282460,198472,17278644000,1095704000,1046920000,1283837000,3426461000,2899998000,2850380000,9176839000,8101805000
Maine,Transportation and Warehousing,2010,5561,3550,625,504,4679,369,138,5186,375,6085,3555,625,525,4705,430,190,5325,760,55512,3683,3035,5099,13904,11072,3312,32316,11921,2140027000,166316000,99169000,147855000,453607000,383539000,117926000,1056772000,587226000
Maine,Utilities,2010,256,115,10,20,145,20,30,195,61,480,115,10,30,155,30,80,265,215,5954,203,0,138,452,447,1662,3032,138,526706000,10063000,0,7194000,24619000,25127000,111621000,196319000,18618000
Maine,Wholesale Trade,2010,7024,3475,905,696,5076,673,423,6172,852,7955,3485,910,740,5135,755,670,6560,1395,76928,4522,4042,6236,16544,12811,12502,49967,16766,3668238000,203926000,178115000,277908000,739097000,584683000,610366000,2251259000,1066287000
Maryland,Accommodation and Food Services,2010,42885,18415,8078,6906,33399,7593,912,41904,981,54930,18415,8130,6945,33490,8375,2665,44530,10400,954351,32987,52964,92576,179134,282009,109480,572841,379063,16412773000,855110000,803678000,1373296000,3034434000,4694324000,1681923000,9484710000,6919489000
Maryland,Administrative and Support and Waste Management and Remediation Services,2010,35317,19810,5065,3818,28693,3820,1277,33790,1527,39865,19830,5085,3855,28770,3940,1525,34235,5630,849616,28699,32281,49940,112811,140437,146988,408292,419785,30951470000,1270785000,1140713000,1858706000,4315351000,5120047000,4893895000,14609672000,15668300000
Maryland,"Agriculture, Forestry, Fishing and Hunting",2010,978,795,100,40,935,25,0,960,18,990,795,100,40,935,25,0,960,30,4068,1062,470,486,2137,164,0,2361,630,140104000,30337000,13716000,15805000,64463000,4405000,0,86177000,21436000
Maryland,"Arts, Entertainment, and Recreation",2010,9452,5293,1297,1170,7760,1165,274,9199,253,10185,5295,1300,1235,7830,1225,405,9460,725,166257,6956,7591,15589,31254,43892,34492,111719,29957,4391428000,322311000,215954000,309172000,854055000,905782000,883893000,2840909000,425760000
Maryland,Construction,2010,71950,46230,10780,7650,64660,5673,1048,71381,569,72580,46230,10780,7655,64665,5725,1160,71550,1030,707595,71675,70334,102390,245695,212631,140792,608385,92123,37155730000,2812320000,2895901000,4646977000,10365650000,11357685000,8240739000,30291085000,6447493000
Maryland,Educational Services,2010,9251,4295,1380,1200,6875,1475,578,8928,323,9920,4295,1380,1260,6935,1640,670,9245,675,385530,5169,8751,16187,32203,60969,79096,178048,201323,15623302000,224484000,230389000,331712000,796696000,1835361000,2939152000,5762323000,9538745000
Maryland,Finance and Insurance,2010,21500,13115,3190,1428,17733,1429,729,19891,1609,38810,13140,3240,1550,17930,2890,2450,23270,15540,489444,22955,19883,17208,60991,48481,52518,171125,274854,38536096000,1177818000,1176146000,1273027000,3666472000,3556845000,4056051000,12048490000,23345867000
Maryland,Health Care and Social Assistance,2010,61739,30271,13905,7718,51894,6043,2178,60115,1624,77755,30370,14050,8245,52665,8880,7305,68850,8905,1637168,57117,90459,100336,249756,221178,293965,775155,835189,72038775000,2821049000,4031405000,4596130000,11508616000,9893576000,10105885000,31858459000,39230250000
Maryland,Information,2010,6898,3320,830,638,4788,790,425,6003,895,12085,3325,830,645,4800,875,555,6230,5855,265660,2950,4468,7765,17273,25233,23831,75072,174031,20019326000,276710000,281054000,448055000,1043932000,1593728000,1980946000,5135433000,13198042000
Maryland,Management of Companies and Enterprises,2010,3053,125,30,165,320,611,845,1776,1277,5570,125,30,165,320,625,950,1895,3675,248379,132,137,861,1257,8616,30078,39951,208428,22561515000,12386000,8707000,72365000,93747000,593939000,1779407000,2467093000,20094422000
Maryland,Manufacturing,2010,15303,6125,2565,2089,10779,2468,814,14061,1242,15955,6125,2580,2095,10800,2575,975,14350,1605,437675,7654,12861,22745,50481,77387,52720,213579,187284,25582063000,387392000,530546000,997148000,2153760000,3595007000,2584330000,9989894000,13266677000
Maryland,"Mining, Quarrying, and Oil and Gas Extraction",2010,296,95,50,15,160,65,20,245,51,365,95,50,15,160,65,40,265,100,5662,53,224,0,342,1625,0,1723,2078,317776000,6084000,14353000,0,25015000,77407000,0,160023000,119129000
Maryland,Other,2010,252,242,6,4,252,0,0,252,0,252,242,6,4,252,0,0,252,0,0,0,35,44,0,0,0,0,0,4543000,4082000,375000,86000,4543000,0,0,4543000,0
Maryland,Other Services (except Public Administration),2010,62670,36925,12494,7257,56676,4679,716,62071,599,66985,36955,12550,7485,56990,5435,1295,63720,3265,535814,68930,80259,95618,246767,164965,57617,475740,45165,17490692000,2010895000,2185902000,2733972000,6956479000,5346159000,2581615000,15161888000,1833606000
Maryland,"Professional, Scientific, and Technical Services",2010,89159,60628,10648,7316,78592,6452,1964,87008,2151,98065,60730,10665,7460,78855,7005,2455,88315,9750,1163337,87951,68346,95010,254507,228281,168222,662260,473873,87833650000,5470717000,4163170000,5902282000,15559544000,17347812000,13925383000,47522580000,39448472000
Maryland,Real Estate and Rental and Leasing,2010,22261,15753,2325,1380,19458,1414,608,21480,781,29760,15775,2375,1545,19695,2095,2330,24120,5640,207428,19838,14639,16902,53902,40536,40005,138062,57965,10500068000,963771000,560379000,763793000,2273726000,2204303000,2469099000,7217439000,3101659000
Maryland,Retail Trade,2010,58717,31867,11851,6877,50595,4300,1429,56324,2393,91780,32010,12155,7435,51600,6230,4500,62330,29450,1311261,50767,72798,81688,207229,141467,102982,478614,737066,34356485000,1580824000,1844345000,2242288000,5715549000,4733182000,3987626000,14983538000,18397870000
Maryland,Total,2010,108246,62757,18092,11856,92705,10218,2657,105580,2666,134579,62871,18266,12339,93476,12573,6411,112460,22119,2075507,105462,118089,157474,381025,378073,312589,1071687,1003820,97807214000,4356824000,4406259000,6081566000,14844649000,16405663000,14880891000,46131203000,51676011000
Maryland,Transportation and Warehousing,2010,14880,7990,2210,1363,11563,1447,586,13596,1284,16535,7990,2210,1370,11570,1575,700,13845,2690,293298,9868,13246,15359,41755,43735,21846,115222,123273,11927876000,403968000,421803000,495567000,1386755000,1589789000,932850000,4105466000,5581981000
Maryland,Utilities,2010,315,95,20,25,140,15,30,185,130,695,95,20,25,140,15,80,235,460,51287,0,52,0,447,0,0,496,46482,5484776000,1706000,2946000,2304000,13716000,0,0,47200000,5124588000
Maryland,Wholesale Trade,2010,24651,11545,3747,2600,17892,3193,1326,22411,2240,28805,11550,3770,2650,17970,3670,1995,23635,5170,424720,15002,21584,30544,73410,97819,64512,253894,153819,26337015000,940568000,1173750000,1759955000,3982182000,5592334000,3900559000,14201454000,11248341000
Massachusetts,Accommodation and Food Services,2010,64735,28289,12928,11020,52237,10583,1004,63824,911,82185,28345,12950,11170,52465,12065,3775,68305,13880,1259936,49103,84718,150054,284217,374650,144121,804930,455314,24064746000,1540469000,1345484000,2371385000,5264010000,6611037000,2678739000,14607291000,9449243000
Massachusetts,Administrative and Support and Waste Management and Remediation Services,2010,43678,28590,5435,3463,37488,3299,1276,42063,1615,48650,28605,5455,3500,37560,3475,1535,42570,6080,955065,34939,34238,44904,116954,127111,155203,411160,510495,37127224000,2292094000,1502444000,1951723000,5809024000,5069131000,5606311000,16942916000,19255360000
Massachusetts,"Agriculture, Forestry, Fishing and Hunting",2010,1780,1420,210,120,1750,20,5,1775,5,1780,1420,210,120,1750,20,5,1775,5,5078,242,986,1111,4487,109,0,4890,0,152510000,57287000,19846000,23107000,114832000,6308000,0,149162000,0
Massachusetts,"Arts, Entertainment, and Recreation",2010,14199,7675,2270,1695,11640,1919,407,13966,233,15250,7675,2285,1710,11670,2130,710,14510,740,245114,10201,14413,21882,48182,70315,51329,174769,52815,8658261000,612884000,444832000,669870000,1749594000,1546759000,1659367000,5355227000,1157251000
Massachusetts,Construction,2010,83950,61399,11455,6270,79124,3855,543,83522,428,84220,61400,11455,6275,79130,3900,590,83620,600,509025,90675,73580,81929,248554,136251,63151,454900,36190,31049389000,4461490000,3844672000,4541806000,12878380000,9696623000,4465602000,27474040000,2883807000
Massachusetts,Educational Services,2010,12373,5490,1975,1485,8950,2031,887,11868,505,13345,5490,1975,1580,9045,2105,1220,12370,975,961381,7950,12778,19784,41487,80144,137798,262337,696297,37788841000,361076000,332261000,493613000,1191896000,2539552000,5201848000,9035941000,28718150000
Massachusetts,Finance and Insurance,2010,27070,14825,4105,2334,21264,2428,1384,25076,1994,47185,14870,4300,2725,21895,4115,5260,31270,15915,978604,24252,25475,29957,81704,81657,124802,295517,631396,102677369000,2075387000,2169725000,2757891000,7019198000,8559594000,9765920000,25743670000,75352026000
Massachusetts,Health Care and Social Assistance,2010,65848,28855,14310,9610,52775,7332,3436,63543,2305,90510,28945,14400,10035,53380,10110,10945,74435,16075,2815562,54613,93728,127006,277948,273749,485307,1046333,1627586,131416043000,2946990000,4281443000,6059137000,13323047000,12723169000,17640385000,43977905000,85960263000
Massachusetts,Information,2010,10713,4765,1510,1165,7440,1398,600,9438,1275,17460,4770,1525,1170,7465,1440,720,9625,7835,475222,5998,8829,11219,31443,48911,51206,135044,333826,41675412000,478980000,519612000,924894000,1985955000,4040420000,5255145000,11578419000,29605862000
Massachusetts,Management of Companies and Enterprises,2010,3980,305,85,115,505,611,1078,2194,1786,5705,305,85,115,505,620,1120,2245,3460,424649,0,47,667,1381,7354,37936,46768,377881,46127756000,100029000,28080000,70325000,199074000,857218000,2786095000,3842387000,42285369000
Massachusetts,Manufacturing,2010,33440,11790,6030,5307,23127,6431,1836,31394,2046,34535,11795,6035,5350,23180,6585,2050,31815,2720,1055160,17279,34257,65103,128394,227509,167383,579872,398981,64774222000,971795000,1589583000,3030822000,5919322000,11852277000,10147297000,30837931000,29094890000
Massachusetts,"Mining, Quarrying, and Oil and Gas Extraction",2010,373,135,60,85,280,49,17,346,27,430,135,60,85,280,65,50,395,35,3694,124,162,839,1677,555,0,3488,0,245190000,13335000,9557000,58883000,92374000,39571000,0,209409000,0
Massachusetts,Other,2010,473,449,17,6,472,1,0,473,0,473,449,17,6,472,1,0,473,0,630,426,109,74,609,0,0,630,0,13900000,10131000,2577000,924000,13632000,0,0,13900000,0
Massachusetts,Other Services (except Public Administration),2010,77700,47855,16160,8391,72406,3974,698,77078,622,84735,47915,16280,8815,73010,4865,1770,79645,5090,581995,90030,104166,107666,306988,131756,54111,505761,62619,17211370000,2680899000,2797759000,2795083000,8301708000,4025756000,1965703000,14510208000,1948059000
Massachusetts,"Professional, Scientific, and Technical Services",2010,100990,69135,13162,7834,90131,6126,2011,98268,2722,106670,69160,13205,7970,90335,6555,2455,99345,7325,1236946,93384,84545,101969,294657,205810,188705,696542,525350,113759475000,6621005000,5288417000,7151644000,19164564000,19033123000,17770120000,56490155000,56847459000
Massachusetts,Real Estate and Rental and Leasing,2010,24525,17654,3050,1505,22209,1157,498,23864,661,31830,17780,3240,1630,22650,1770,1520,25940,5890,197595,25167,18811,18709,63459,34614,39416,143197,44513,11068518000,1248376000,862110000,925186000,3054010000,1802794000,2138882000,7105160000,3764901000
Massachusetts,Retail Trade,2010,81970,47929,15934,8624,72487,5666,1426,79579,2391,122060,48280,16415,9325,74020,8260,5315,87595,34465,1508780,76913,96509,99606,269403,168430,98252,566933,694466,44752286000,2460894000,2602878000,3059546000,8217250000,6796969000,3914598000,19965698000,16972867000
Massachusetts,Total,2010,137406,80749,23277,14871,118897,12237,3298,134432,2974,169790,80938,23567,15492,119997,15013,8500,143510,26280,2928545,136019,152059,198182,486260,449872,421238,1357370,1571175,158404256000,6347711000,6154497000,8353810000,20856018000,21964050000,21973561000,64793629000,93610627000
Massachusetts,Transportation and Warehousing,2010,15683,8553,1950,1534,12037,1667,822,14526,1157,17825,8560,1950,1550,12060,1775,985,14820,3005,370525,11293,11957,19868,44898,57003,54642,161692,156083,14506930000,532963000,423355000,675993000,1659191000,2011388000,1768359000,5700649000,6512128000
Massachusetts,Utilities,2010,474,180,45,25,250,30,52,332,142,1405,180,45,25,250,30,95,375,1030,53614,133,150,210,760,1423,3923,7504,45859,6311522000,12918000,10109000,12286000,47482000,124626000,656686000,1031044000,5277625000
Massachusetts,Wholesale Trade,2010,35964,16780,5849,4138,26767,4633,1788,33188,2776,40805,16815,5880,4280,26975,5175,2380,34530,6275,645101,24602,35603,52392,117870,148165,93109,381793,233083,49965158000,1814716000,2217026000,3376178000,7501967000,10011263000,8005748000,26575270000,21885557000
Michigan,Accommodation and Food Services,2010,75079,29405,14832,14796,59033,13727,1181,73941,1138,97245,29440,14885,15000,59325,16100,5385,80810,16435,1619070,45364,99785,201128,347565,493565,183580,1026652,589162,22446065000,1040840000,1098773000,2294583000,4437695000,6375531000,2293896000,13139797000,9274714000
Michigan,Administrative and Support and Waste Management and Remediation Services,2010,50207,31170,6275,4194,41639,4792,2090,48521,1686,56890,31190,6305,4295,41790,5170,2495,49455,7435,1341156,38999,39682,55108,133933,191565,315310,652712,635198,40547088000,1829112000,1323390000,1717485000,4909241000,6884942000,9859001000,21950118000,17115432000
Michigan,"Agriculture, Forestry, Fishing and Hunting",2010,2584,1870,345,175,2390,129,35,2554,30,2590,1870,345,175,2390,130,35,2555,35,14629,2847,1930,2030,7284,2986,1442,13914,636,518816000,92115000,64071000,58264000,225051000,99426000,52332000,461666000,51150000
Michigan,"Arts, Entertainment, and Recreation",2010,16864,10170,2200,2157,14527,1801,310,16638,226,17600,10185,2220,2180,14585,1945,475,17005,595,241917,11542,14030,27955,56594,66930,38559,168156,47969,7423137000,603089000,317759000,552922000,1514740000,1372170000,2341530000,5666577000,1343041000
Michigan,Construction,2010,93745,70659,11300,6845,88804,3916,640,93360,385,94475,70660,11300,6880,88840,3985,890,93715,760,537245,93036,73345,90456,259640,133441,75816,475100,58541,28339160000,4321560000,3160645000,4157764000,11641085000,7819907000,4311781000,23961480000,4123348000
Michigan,Educational Services,2010,9855,4877,1530,1260,7667,1434,414,9515,340,11015,4880,1530,1325,7735,1615,785,10135,880,356916,7006,9869,16593,34459,58037,61171,156763,199659,9154660000,207289000,183654000,312858000,716236000,1448256000,1840271000,4067594000,5062359000
Michigan,Finance and Insurance,2010,34917,22893,4795,2336,30024,2365,910,33299,1618,68345,22920,4920,2805,30645,5290,5070,41005,27340,735892,40424,30009,28969,101794,87512,96069,293194,342033,43679251000,1642240000,1395171000,1576701000,4637657000,4599189000,5093307000,14687601000,28800670000
Michigan,Health Care and Social Assistance,2010,104422,47678,26569,14741,88988,10314,3196,102498,1924,130985,47785,26820,15265,89870,14895,11535,116300,14685,2812326,89005,177105,193622,463401,388780,477935,1340234,1465717,119290865000,4175831000,7323743000,8643267000,20144857000,16554466000,15762310000,52635494000,66283067000
Michigan,Information,2010,8576,4095,1212,938,6245,883,377,7505,1071,17255,4095,1220,965,6280,1135,690,8105,9150,328113,5617,7356,11583,26004,28361,25529,86880,232506,19512990000,246011000,273021000,488106000,1032468000,1335835000,1132247000,3918491000,15519707000
Michigan,Management of Companies and Enterprises,2010,5365,355,150,275,780,1046,1552,3378,1987,7415,355,160,275,790,1065,1660,3515,3900,485365,0,432,1730,2556,13420,48485,64465,420601,49038470000,38821000,45250000,163420000,247640000,750580000,2889025000,3887525000,45132032000
Michigan,Manufacturing,2010,58245,21577,9973,8849,40399,10803,3796,54998,3247,61890,21600,9985,8900,40485,11375,4900,56760,5130,2138902,33510,60331,112208,218836,401209,405568,1081916,976787,116062023000,1685387000,2510091000,5004411000,9535743000,19624013000,20336488000,52485038000,58901415000
Michigan,"Mining, Quarrying, and Oil and Gas Extraction",2010,1688,890,245,184,1319,166,55,1540,148,1845,895,255,185,1335,185,55,1575,270,20886,682,1240,2424,5345,4435,0,12871,6450,1412313000,88351000,74646000,178821000,348544000,291087000,69651000,788102000,614140000
Michigan,Other,2010,826,785,32,7,824,2,0,826,0,826,785,32,7,824,2,0,826,0,0,0,203,74,0,0,0,0,0,12137000,9306000,958000,939000,11203000,0,0,12137000,0
Michigan,Other Services (except Public Administration),2010,106947,65236,23557,10814,99607,5805,864,106276,671,114885,65295,23805,11505,100605,7600,2035,110240,4645,762270,123438,151946,139938,419419,188669,69712,693141,40990,18988629000,2786073000,3279169000,2992788000,9068397000,5011368000,2131844000,16573544000,1521027000
Michigan,"Professional, Scientific, and Technical Services",2010,100744,69721,13093,8150,90964,5632,1793,98389,2355,109235,69770,13210,8350,91330,6790,3005,101125,8110,1159629,99017,84552,105584,290282,189922,170879,662209,465337,76177424000,4972819000,4243214000,5533018000,14815112000,12056702000,9875436000,37032246000,36935005000
Michigan,Real Estate and Rental and Leasing,2010,29588,21546,3713,1779,27038,1364,560,28962,626,37765,21625,3900,2005,27530,2265,1510,31305,6460,231489,30961,22824,21520,77800,41224,39295,160171,57824,8097328000,1026715000,709726000,751739000,2508010000,1578265000,1260215000,5457450000,2201730000
Michigan,Retail Trade,2010,115771,69356,22395,11903,103654,7965,1701,113320,2451,175085,69640,22925,13330,105895,12885,7710,126490,48595,2187574,116841,140144,136367,407516,281152,152317,887295,1168804,51048349000,2833417000,3095129000,3745623000,9800044000,8740843000,4057768000,23145764000,26655621000
Michigan,Total,2010,174345,102961,30375,19206,152542,15217,3601,171360,2985,219119,103163,30804,20272,154239,20283,10755,185277,33842,3288456,169882,199646,256983,626511,570071,503239,1699821,1588635,138809653000,6186312000,6446942000,8661808000,21295062000,21654553000,19900409000,62850024000,75959629000
Michigan,Transportation and Warehousing,2010,23178,14295,2770,2013,19078,1929,839,21846,1332,27410,14325,2790,2090,19205,2170,1215,22590,4820,403884,16423,16756,25199,60604,61391,48130,181487,178662,17658034000,711475000,608687000,914267000,2289779000,2446512000,2064306000,7156563000,7961351000
Michigan,Utilities,2010,528,200,45,30,275,50,44,369,159,1980,200,45,60,305,65,150,520,1460,8487,18,154,0,828,2235,3982,7863,8154,5177973000,14026000,12614000,0,44497000,144782000,455373000,752875000,1231088000
Michigan,Wholesale Trade,2010,48543,25097,7098,5428,37623,5424,2357,45404,3139,57555,25160,7240,5735,38135,6740,4175,49050,8505,768179,35371,43456,67748,156155,163895,127733,464743,276391,45658220000,2080473000,2234073000,3589833000,7960876000,9067407000,6983648000,24740023000,19376674000
Minnesota,Accommodation and Food Services,2010,42267,14544,7403,9239,31186,9110,1053,41349,918,55825,14555,7420,9360,31335,10440,3420,45195,10630,1050750,20772,49207,128804,201183,329430,136664,669611,371091,15760035000,582207000,529625000,1345452000,2460157000,4397347000,1897455000,8805293000,6880588000
Minnesota,Administrative and Support and Waste Management and Remediation Services,2010,31447,20240,4020,2815,27075,2291,877,30243,1204,34875,20245,4060,2895,27200,2600,1120,30920,3955,650299,25969,24820,36458,90709,88295,105641,293154,329941,22599798000,1168796000,816719000,1171033000,3187061000,2881079000,2623029000,9061209000,12424835000
Minnesota,"Agriculture, Forestry, Fishing and Hunting",2010,2290,1465,465,185,2115,110,25,2250,40,2340,1465,465,185,2115,120,35,2270,70,11729,1764,2624,2124,7377,2982,178,11003,443,403851000,73845000,91814000,54382000,227200000,122233000,7054000,373328000,22214000
Minnesota,"Arts, Entertainment, and Recreation",2010,12763,7900,1917,1330,11147,1173,235,12555,208,13395,7900,1950,1340,11190,1225,320,12735,660,203723,8261,11932,16453,38961,39307,35175,123559,45620,6015991000,362498000,246515000,262174000,892641000,691912000,1180114000,3408376000,1068173000
Minnesota,Construction,2010,81217,62645,9460,5368,77473,2851,548,80872,345,81840,62645,9460,5375,77480,2975,670,81125,715,467125,79868,61051,70822,215484,99311,67840,389870,52362,26453510000,3745515000,2833848000,3420670000,10037422000,6207910000,4596646000,21238640000,3470764000
Minnesota,Educational Services,2010,8387,3845,1065,1230,6140,1655,310,8105,282,9185,3850,1070,1230,6150,1780,445,8375,810,345638,5233,6927,16701,28497,67556,48823,152187,185839,9064630000,198657000,133273000,332338000,672291000,1659208000,1390078000,3863591000,4999429000
Minnesota,Finance and Insurance,2010,30616,20675,3397,1980,26052,2053,830,28935,1681,46905,20745,3525,2385,26655,4510,3370,34535,12370,692754,30010,20077,24658,79079,70728,58330,215373,439077,51263741000,1421604000,962854000,1447889000,3933155000,4278161000,3392350000,11967755000,37442729000
Minnesota,Health Care and Social Assistance,2010,50201,22448,9428,6823,38699,6689,3195,48583,1618,73410,22510,9520,7140,39170,9740,11220,60130,13280,2146267,35059,62299,92420,194630,272703,498290,975518,1154815,82358145000,1615397000,2329636000,3207927000,7195488000,9314412000,13550152000,30275996000,51287469000
Minnesota,Information,2010,8266,3934,1168,870,5972,970,398,7340,926,12840,3945,1175,890,6010,1300,880,8190,4650,291973,3282,7248,10823,25454,33471,29937,101099,174206,18623503000,247881000,260635000,526665000,1050801000,1690249000,2360779000,5230790000,12203406000
Minnesota,Management of Companies and Enterprises,2010,3984,270,130,115,515,690,1180,2385,1599,5695,270,135,115,520,695,1250,2465,3230,500635,366,467,611,1379,8670,38285,48530,452085,55720055000,41750000,31577000,28039000,104925000,683220000,2543795000,3331940000,52376883000
Minnesota,Manufacturing,2010,34689,13645,5705,4525,23875,6201,2237,32313,2376,36885,13645,5705,4560,23910,6490,2855,33255,3630,1327913,20185,32306,55343,116178,226421,246262,638803,575874,68476261000,870520000,1262500000,2356389000,4713991000,10756299000,12316138000,30092455000,32324281000
Minnesota,"Mining, Quarrying, and Oil and Gas Extraction",2010,641,365,55,90,510,40,16,566,75,735,365,55,90,510,45,20,575,160,24613,415,0,797,1555,681,594,4138,20436,2212645000,45051000,15941000,58793000,138800000,37373000,35256000,272037000,1871702000
Minnesota,Other,2010,243,225,13,5,243,0,0,243,0,243,225,13,5,243,0,0,243,0,0,0,79,0,0,0,0,0,0,4511000,3420000,992000,0,4511000,0,0,4511000,0
Minnesota,Other Services (except Public Administration),2010,70240,41375,14396,8480,64251,4744,704,69699,541,75815,41460,14575,8835,64870,6115,1805,72790,3025,580829,75350,92638,112567,283021,159068,63235,508905,48060,14350262000,1759995000,1939931000,2257857000,5994479000,3671547000,1734591000,11526345000,2251687000
Minnesota,"Professional, Scientific, and Technical Services",2010,78204,57305,8477,5502,71284,3906,1219,76409,1795,82195,57325,8535,5740,71600,4520,1640,77760,4435,654110,61868,54960,69829,198877,128428,93119,428400,200182,40673130000,3688330000,2757126000,3470647000,9967676000,8771009000,6907340000,25943110000,14286395000
Minnesota,Real Estate and Rental and Leasing,2010,25003,19265,2350,1226,22841,1036,525,24402,601,30965,19295,2410,1415,23120,1820,1830,26770,4195,173726,23081,14332,14631,54188,34555,38262,127860,32198,6461917000,826344000,494675000,475254000,1796328000,1218653000,1134072000,4139065000,2102824000
Minnesota,Retail Trade,2010,65319,32665,13671,9093,55429,6020,1561,63010,2309,97735,32900,13895,9920,56715,9175,5500,71390,26345,1359603,55769,87228,114551,262991,204823,118548,603604,624275,32527729000,1429483000,1793940000,2586179000,5847227000,5643757000,3390222000,15238916000,15756480000
Minnesota,Total,2010,117687,70768,18013,12857,101638,10735,2786,115159,2528,145464,70906,18241,13500,102647,14184,8124,124955,20509,2357971,108531,118904,173088,400523,403973,376181,1180677,1177294,105548294000,4055171000,3797510000,5417966000,13270647000,14783298000,14638572000,42692517000,62855777000
Minnesota,Transportation and Warehousing,2010,20576,12630,2390,1782,16802,1841,756,19399,1177,22745,12630,2405,1800,16835,2025,995,19855,2890,314639,8867,14571,22847,55545,59660,53982,174145,132001,11609731000,576383000,516058000,701062000,1828839000,1848490000,1889983000,5655537000,5737273000
Minnesota,Utilities,2010,589,105,40,70,215,160,65,440,149,1475,105,40,70,215,210,120,545,930,16782,8,66,939,1361,5740,5218,12729,464,1418173000,3866000,8290000,60389000,81725000,375271000,388215000,873123000,39097000
Minnesota,Wholesale Trade,2010,35066,17501,4660,3989,26150,4339,1869,32358,2708,41245,17550,4740,4130,26420,5135,3125,34680,6565,618077,24767,28616,46163,105335,135698,89275,351254,220312,42032436000,1436236000,1573196000,2778888000,5873288000,7944056000,5022221000,19656947000,17765324000
Mississippi,Accommodation and Food Services,2010,17886,6370,3535,3508,13413,3301,451,17165,721,24780,6380,3535,3570,13485,3745,1630,18860,5920,565298,10206,23783,46964,81421,112922,57083,253566,309063,9021126000,212029000,267188000,538504000,1022053000,1358012000,667596000,3097884000,5869547000
Mississippi,Administrative and Support and Waste Management and Remediation Services,2010,9917,5595,1550,935,8080,801,333,9214,703,11240,5595,1555,945,8095,885,440,9420,1820,223090,8473,9194,11888,31241,30358,29663,99875,103508,5526741000,275341000,239942000,287133000,844644000,688099000,644508000,2430204000,2567711000
Mississippi,"Agriculture, Forestry, Fishing and Hunting",2010,3378,1795,885,455,3135,180,20,3335,43,3440,1795,885,455,3135,185,35,3355,85,21437,3123,5694,5558,14925,4878,0,20147,439,752246000,118309000,168916000,180916000,482366000,161000000,5641000,675411000,28891000
Mississippi,"Arts, Entertainment, and Recreation",2010,3265,1920,500,410,2830,335,50,3215,50,3340,1920,505,410,2835,355,80,3270,70,35345,2544,2914,4921,11328,11548,5507,30860,0,612795000,85522000,46279000,70196000,215736000,189557000,68937000,513539000,0
Mississippi,Construction,2010,21727,13520,3610,2430,19560,1705,245,21510,217,21945,13520,3610,2435,19565,1720,275,21560,385,219701,21174,23074,31719,79370,62546,31276,177431,19895,8164805000,632290000,690802000,1022779000,2356965000,2564633000,1410784000,6461456000,834997000
Mississippi,Educational Services,2010,2371,915,366,275,1556,545,140,2241,130,2910,915,370,275,1560,560,280,2400,510,90985,1141,2159,3247,7509,24048,16412,48176,42731,1939926000,36460000,43043000,59283000,147104000,510406000,412500000,1072919000,865199000
Mississippi,Finance and Insurance,2010,11789,7920,1345,660,9925,666,370,10961,828,23580,7945,1405,1060,10410,2275,2855,15540,8040,165458,15124,8138,7816,32321,22833,27094,83503,39608,7642791000,485517000,314318000,326265000,1156891000,987386000,1110902000,3317168000,4241947000
Mississippi,Health Care and Social Assistance,2010,24537,10655,5975,3765,20395,2422,959,23776,761,30460,10655,5990,3885,20530,3180,2540,26250,4210,756924,19962,38584,48209,109166,88755,125140,327209,389149,30227802000,1023018000,1447073000,1893501000,4390629000,3375387000,4051197000,11936023000,17675108000
Mississippi,Information,2010,1967,670,420,230,1320,191,105,1616,351,4590,670,420,275,1365,285,160,1810,2780,43659,820,2237,2188,6294,4665,2083,17124,3429,1855352000,37047000,62024000,61541000,187723000,163020000,124112000,603249000,650700000
Mississippi,Management of Companies and Enterprises,2010,1280,65,20,40,125,256,420,801,479,1605,65,20,40,125,260,450,835,770,39563,88,0,113,239,2493,11370,13962,25659,2639868000,10336000,47000,3123000,14432000,112521000,647100000,763414000,1846996000
Mississippi,Manufacturing,2010,10699,3425,1645,1386,6456,1829,957,9242,1457,11780,3425,1645,1390,6460,1865,1195,9520,2260,541470,4029,7851,14674,31039,58998,75049,191905,303900,20152342000,163061000,240467000,461740000,979624000,2038291000,2373246000,6190365000,12211127000
Mississippi,"Mining, Quarrying, and Oil and Gas Extraction",2010,1612,905,145,159,1209,160,70,1439,173,1700,905,145,160,1210,165,85,1460,240,23103,624,338,1497,3248,4306,4531,14880,6690,1482984000,54589000,39542000,76662000,175064000,398576000,241218000,829468000,649472000
Mississippi,Other,2010,119,113,3,3,119,0,0,119,0,119,113,3,3,119,0,0,119,0,157,0,0,31,157,0,0,157,0,2304000,2074000,127000,103000,2304000,0,0,2304000,0
Mississippi,Other Services (except Public Administration),2010,30929,19490,6520,2880,28890,1485,269,30644,285,32420,19495,6570,3015,29080,1845,540,31465,955,194525,38167,41197,35343,117988,46749,10892,183938,5464,4076030000,753246000,775868000,744448000,2313174000,949120000,244545000,3746720000,201722000
Mississippi,"Professional, Scientific, and Technical Services",2010,21647,14580,3210,1770,19560,1082,380,21022,625,23755,14585,3230,1800,19615,1550,605,21770,1985,155233,23433,19919,21842,68021,32783,22499,125240,24894,6905845000,838484000,731102000,846192000,2472174000,1586524000,1163141000,5315699000,1499660000
Mississippi,Real Estate and Rental and Leasing,2010,9608,7362,948,425,8735,326,232,9293,315,12130,7365,980,490,8835,400,705,9940,2190,49984,10379,5482,4120,23153,7255,4475,37920,7626,1565553000,285297000,140202000,137736000,582136000,248011000,216895000,1156786000,304589000
Mississippi,Retail Trade,2010,38567,21392,7734,4446,33572,2850,599,37021,1546,58720,21455,7905,4810,34170,4295,3000,41465,17255,594719,38202,49487,55496,147212,91154,42299,289521,288728,13269189000,825613000,1065300000,1325849000,3237069000,2599358000,982454000,6981665000,6054525000
Mississippi,Total,2010,45813,25587,8337,5199,39123,3952,1119,44194,1619,59300,25619,8434,5506,39559,5314,3349,48222,11078,882181,47085,54461,68897,170443,143279,123274,436996,445185,28606573000,1302085000,1429437000,1901847000,4633369000,4355538000,3945163000,12934070000,15672503000
Mississippi,Transportation and Warehousing,2010,9038,4770,1330,895,6995,801,312,8108,930,10385,4770,1330,895,6995,890,390,8275,2110,158963,7015,7854,10439,26638,23251,13648,68661,65929,5784377000,229279000,241595000,346857000,852319000,793321000,423688000,2340701000,2644493000
Mississippi,Utilities,2010,1836,1180,350,60,1590,105,60,1755,81,2980,1185,350,70,1605,200,210,2015,965,43738,2839,2109,610,5669,5578,8838,20502,0,3091923000,55017000,56854000,22637000,143281000,285529000,500491000,943302000,0
Mississippi,Wholesale Trade,2010,11677,4875,1685,1439,7999,1503,787,10289,1388,14145,4885,1705,1535,8125,1910,1270,11305,2840,161685,6381,8922,15854,35925,35302,30151,113492,42263,7014857000,298906000,357576000,638964000,1356833000,1463615000,1291489000,4551791000,2183978000
Missouri,Accommodation and Food Services,2010,44919,17154,7335,8581,33070,9332,1256,43658,1261,61565,17190,7370,8690,33250,10730,4625,48605,12960,1154280,27134,48991,118813,195656,337877,163432,699145,452393,16659345000,567873000,556873000,1392474000,2519895000,4407197000,2235937000,9200290000,7441962000
Missouri,Administrative and Support and Waste Management and Remediation Services,2010,32802,20657,4630,2758,28045,2463,863,31371,1431,36375,20670,4635,2770,28075,2670,1070,31815,4560,711768,27336,27882,35595,97766,82550,95997,290131,389209,20335049000,924190000,850071000,1037481000,2845568000,2543335000,2628461000,8203237000,11527870000
Missouri,"Agriculture, Forestry, Fishing and Hunting",2010,1205,890,140,75,1105,50,20,1175,30,1225,890,140,75,1105,55,20,1180,45,6244,930,713,641,3174,1298,512,5691,0,182799000,35771000,17934000,16500000,78029000,32489000,11628000,141489000,0
Missouri,"Arts, Entertainment, and Recreation",2010,9928,5652,1350,1332,8334,1102,249,9685,243,10555,5660,1350,1365,8375,1215,315,9905,650,194965,7301,8593,17266,34402,38448,24976,104972,80192,6611777000,268034000,145443000,309022000,736544000,717769000,2407160000,3986557000,1615483000
Missouri,Construction,2010,68597,46364,10828,6182,63374,4058,696,68128,469,69230,46370,10835,6195,63400,4205,865,68470,760,534693,72409,69687,82625,227140,140110,73515,448725,72339,25650405000,2396011000,2440717000,3369420000,8207670000,7632256000,4114092000,20258825000,4476216000
Missouri,Educational Services,2010,6867,3010,935,930,4875,1310,388,6573,294,7545,3015,935,935,4885,1405,500,6790,755,356703,3846,6030,11700,23678,55807,65286,146107,208411,12515741000,126785000,109843000,230970000,475592000,1333194000,1819762000,3658436000,8782293000
Missouri,Finance and Insurance,2010,29062,19525,3132,1610,24267,2092,871,27230,1832,54240,19545,3240,1935,24720,5345,4615,34680,19560,586181,32521,18707,19677,72599,68566,80259,231128,348166,34535931000,1217318000,779114000,937335000,2989067000,3223652000,4106443000,10804582000,23424095000
Missouri,Health Care and Social Assistance,2010,61438,29930,12175,8075,50180,6921,2586,59687,1751,80665,29985,12240,8380,50605,8975,8145,67725,12940,1903137,49222,79416,105387,235115,287756,352729,888007,1003792,72710779000,2216507000,3152503000,4277628000,9647675000,9634343000,10271403000,29748812000,42498633000
Missouri,Information,2010,6372,2835,904,755,4494,766,285,5545,827,12685,2835,915,785,4535,960,490,5985,6700,280598,3729,5065,9198,20282,19768,18613,63968,206113,16317478000,179921000,196291000,365605000,767712000,1031265000,791677000,2768164000,13499789000
Missouri,Management of Companies and Enterprises,2010,4115,240,55,175,470,847,1206,2523,1592,6015,240,55,175,470,870,1290,2630,3385,354550,290,189,102,1118,9175,31129,41605,312945,31613785000,22583000,12540000,38477000,75107000,561855000,1945245000,2582435000,29031350000
Missouri,Manufacturing,2010,29122,11186,4880,4412,20478,4584,1711,26773,2349,31110,11195,4885,4445,20525,4950,2075,27550,3560,1027300,18281,28381,51163,107338,153183,134346,446717,507915,45913675000,630654000,937177000,1900683000,3695023000,6318947000,5978754000,18178673000,24570198000
Missouri,"Mining, Quarrying, and Oil and Gas Extraction",2010,805,280,160,95,535,122,69,726,79,1305,280,160,95,535,280,205,1020,285,13964,191,1052,1081,2541,2869,3630,9955,1514,736140000,21462000,41182000,56191000,118204000,163507000,177840000,485990000,82440000
Missouri,Other,2010,5417,5384,15,18,5417,0,0,5417,0,5417,5384,15,18,5417,0,0,5417,0,0,0,82,201,0,0,0,0,0,30803000,29792000,482000,529000,30803000,0,0,30803000,0
Missouri,Other Services (except Public Administration),2010,72865,45840,13917,7335,67092,4348,768,72208,657,78380,45855,14055,7690,67600,5465,2080,75145,3235,565436,85628,88682,94996,271980,149269,52353,486423,53164,13519266000,1869782000,1937851000,2025368000,5862528000,3535770000,1349913000,11109172000,1701169000
Missouri,"Professional, Scientific, and Technical Services",2010,62096,41805,8810,5015,55630,3571,1176,60377,1719,66830,41840,8835,5165,55840,4275,1535,61650,5180,694152,63836,54362,64881,185165,115506,76184,387295,260327,40949335000,2674131000,2334420000,2969939000,8042623000,7009983000,4659923000,20031425000,17787738000
Missouri,Real Estate and Rental and Leasing,2010,24378,18267,2450,1260,21977,1079,590,23646,732,30705,18300,2530,1410,22240,1610,1565,25415,5290,172255,26715,14902,15714,59038,31258,30453,125357,43142,5977438000,754529000,506800000,464128000,1740891000,1162235000,1004676000,4088243000,1722768000
Missouri,Retail Trade,2010,68126,36213,13256,8706,58175,6072,1455,65702,2424,108995,36325,13665,9640,59630,9835,6320,75785,33210,1370825,62487,82117,110017,257791,197542,100535,576949,707041,32208966000,1409172000,1818288000,2634854000,5895251000,6132138000,2924085000,15316863000,16003465000
Missouri,Total,2010,117832,70882,18419,12565,101866,10468,2704,115038,2794,149903,70986,18654,13208,102848,14077,8026,124951,24952,2292551,117460,120245,167392,405097,388455,316757,1110309,1182242,88576663000,3459620000,3594020000,5095852000,12149492000,13222345000,11577796000,36949633000,51627030000
Missouri,Transportation and Warehousing,2010,20486,12565,2410,1884,16859,1528,683,19070,1416,23520,12570,2420,1895,16885,1655,945,19485,4035,373683,18662,15150,23401,59807,48308,41512,157190,184796,13624720000,568539000,504364000,731604000,1844338000,1636517000,1476268000,5163396000,7238716000
Missouri,Utilities,2010,548,135,50,40,225,180,49,454,94,1785,135,50,40,225,285,245,755,1030,75129,0,267,395,1021,9185,4741,15611,41658,6231003000,6837000,11352000,18888000,43004000,577825000,308668000,957743000,3653236000
Missouri,Wholesale Trade,2010,33181,15071,4808,4060,23939,4524,1961,30424,2757,39700,15110,4880,4265,24255,5600,3225,33080,6620,588798,22816,28274,49317,107173,128379,91348,341021,228388,28372352000,1113956000,1340124000,2167082000,4705636000,6689912000,4364619000,16312885000,11236338000
Montana,Accommodation and Food Services,2010,15262,5765,3306,3125,12196,2580,256,15032,230,16955,5770,3330,3175,12275,2980,710,15965,990,221518,8894,21918,42466,73833,89781,27436,192353,18908,3088612000,228703000,263721000,488702000,986640000,1215412000,389340000,2616725000,385961000
Montana,Administrative and Support and Waste Management and Remediation Services,2010,7915,5420,1080,630,7130,347,125,7602,313,8360,5425,1090,635,7150,420,170,7740,620,74576,7073,6619,6438,22466,10747,6777,48071,4292,1952004000,235584000,171889000,170442000,601139000,226317000,213894000,1184714000,110200000
Montana,"Agriculture, Forestry, Fishing and Hunting",2010,1826,1475,210,85,1770,25,11,1806,20,1860,1475,210,85,1770,25,30,1825,35,5204,1805,1093,809,4205,640,0,5219,0,168094000,57162000,34074000,19314000,119781000,25201000,0,153106000,785000
Montana,"Arts, Entertainment, and Recreation",2010,5172,3055,935,675,4665,382,70,5117,55,5750,3055,945,695,4695,450,80,5225,525,49583,3158,6085,8767,19231,13305,8435,42540,0,754436000,112889000,103307000,119647000,338247000,189282000,77798000,627715000,0
Montana,Construction,2010,25453,20055,3075,1435,24565,635,117,25317,136,25555,20055,3075,1435,24565,635,145,25345,210,109424,27545,18925,18088,67294,19428,9333,100698,2546,4445612000,922218000,647039000,672586000,2295945000,1107854000,457982000,4066191000,168553000
Montana,Educational Services,2010,1655,955,245,190,1390,170,55,1615,40,1710,955,245,190,1390,170,95,1655,55,26144,199,863,2288,4919,6168,2145,18001,5047,573190000,32259000,20338000,35152000,98482000,123493000,54975000,392419000,97317000
Montana,Finance and Insurance,2010,6403,4195,730,363,5288,394,168,5850,553,10120,4195,740,445,5380,1075,695,7150,2970,77183,6248,3957,3964,14584,12942,9426,40637,19538,3665544000,231812000,153392000,155645000,556242000,486820000,436224000,1596968000,1382503000
Montana,Health Care and Social Assistance,2010,14588,7565,3090,1675,12330,1170,683,14183,405,16905,7570,3100,1740,12410,1405,1785,15600,1305,318419,12608,19974,20484,55860,46120,84623,190406,112032,11488255000,497801000,682344000,712763000,1925977000,1414154000,2640385000,6063366000,4790195000
Montana,Information,2010,1954,960,260,265,1485,133,103,1721,233,2875,960,260,270,1490,185,405,2080,795,42651,327,1170,3120,5868,2816,8835,22277,18312,1630744000,48748000,28561000,94678000,238873000,110056000,383211000,896619000,685819000
Montana,Management of Companies and Enterprises,2010,575,60,10,40,110,125,130,365,210,650,60,10,40,110,130,130,370,280,13651,0,0,0,27,450,3737,4411,9197,895885000,4114000,0,5659000,11469000,16843000,241347000,270775000,622083000
Montana,Manufacturing,2010,5937,3185,1005,765,4955,582,164,5701,236,6050,3185,1005,765,4955,625,180,5760,290,61595,3432,4161,6201,17153,12687,6039,44743,8669,2509356000,133497000,135412000,198120000,545198000,459694000,239028000,1511247000,628087000
Montana,"Mining, Quarrying, and Oil and Gas Extraction",2010,1618,925,165,164,1254,130,75,1459,159,1700,925,165,165,1255,130,95,1480,220,16922,830,614,1628,3364,2553,2191,11533,2774,1245025000,66040000,43601000,98734000,233882000,167537000,179731000,757425000,552077000
Montana,Other,2010,71,71,0,0,71,0,0,71,0,71,71,0,0,71,0,0,71,0,0,0,0,0,0,0,0,0,0,711000,711000,0,0,711000,0,0,711000,0
Montana,Other Services (except Public Administration),2010,14824,9845,2875,1302,14022,571,85,14678,146,15465,9845,2880,1320,14045,800,125,14970,495,75170,17095,17583,15033,52008,14074,1584,71745,1545,1701002000,391238000,394052000,324406000,1131696000,373567000,54757000,1618616000,42438000
Montana,"Professional, Scientific, and Technical Services",2010,16915,12540,1995,1132,15667,635,153,16455,460,17725,12545,1995,1180,15720,860,345,16925,800,84601,16441,12051,13942,45141,15684,5991,73509,8534,3700114000,647656000,470768000,581536000,1727591000,840998000,347903000,3155910000,496017000
Montana,Real Estate and Rental and Leasing,2010,7740,6365,640,358,7363,175,50,7588,152,8505,6380,650,465,7495,355,95,7945,560,27220,7227,3303,4053,15897,4276,321,22516,2466,700196000,201561000,79098000,91610000,386049000,122487000,7026000,561154000,86701000
Montana,Retail Trade,2010,19248,10025,4052,2453,16530,1583,340,18453,795,24695,10050,4145,2705,16900,2245,1195,20340,4355,258951,14726,23766,30068,75700,45558,17462,148254,92974,6144532000,411606000,536600000,710900000,1695903000,1265274000,509149000,3688211000,2155329000
Montana,Total,2010,31358,19918,5018,3111,28047,2031,485,30563,795,36011,19936,5062,3286,28284,2774,1441,32499,3512,338405,31432,32846,41268,105546,71631,54377,231554,106851,10716100000,938669000,845689000,1047088000,2831446000,2040157000,1777112000,6648715000,4067385000
Montana,Transportation and Warehousing,2010,5704,3860,630,420,4910,321,180,5411,293,6545,3870,630,430,4930,335,275,5540,1005,51938,3726,3176,4190,12693,9042,6781,32913,9480,1671839000,145428000,106924000,143057000,419290000,313638000,185650000,1018989000,401478000
Montana,Utilities,2010,408,190,30,30,250,95,20,365,43,1000,190,30,35,255,130,40,425,575,13963,214,156,382,844,2611,0,4843,3738,1087783000,7773000,4443000,21387000,36522000,176283000,0,303066000,320636000
Montana,Wholesale Trade,2010,5957,2815,790,598,4203,672,337,5212,745,7275,2815,805,655,4275,915,610,5800,1475,61121,3220,4017,6221,15226,16219,7292,44805,14522,2656991000,149199000,168441000,236129000,611349000,630836000,311837000,1787610000,725216000
Nebraska,Accommodation and Food Services,2010,16722,6269,3178,3263,12710,3024,440,16174,548,21215,6290,3190,3290,12770,3530,1810,18110,3105,336886,9910,21177,43900,75468,105259,51370,233090,103284,4132540000,181325000,193396000,434308000,812050000,1240124000,634353000,2703965000,1421749000
Nebraska,Administrative and Support and Waste Management and Remediation Services,2010,11725,7370,1575,1085,10030,705,285,11020,705,13100,7370,1575,1095,10040,800,385,11225,1875,225836,9664,8853,13187,33267,19482,28242,91430,109267,6794351000,337414000,244689000,327226000,945094000,588947000,662335000,2468069000,3460324000
Nebraska,"Agriculture, Forestry, Fishing and Hunting",2010,835,640,70,50,760,30,20,810,25,875,640,70,50,760,30,30,820,55,4926,697,301,532,1755,478,188,2861,1955,225855000,38658000,12567000,13475000,67832000,20390000,7788000,112121000,109650000
Nebraska,"Arts, Entertainment, and Recreation",2010,4079,2395,625,440,3460,440,70,3970,109,4275,2395,625,455,3475,475,80,4030,245,53289,2754,3882,5366,12817,14798,6478,36825,13513,862814000,97370000,60522000,83983000,264263000,243633000,113298000,664495000,141058000
Nebraska,Construction,2010,28781,19745,4412,2680,26837,1442,295,28574,207,29050,19745,4435,2685,26865,1475,370,28710,340,196595,29174,26758,34833,94341,51250,24466,178016,9078,8235085000,982690000,971273000,1271229000,3241367000,2486825000,1138505000,7104556000,560107000
Nebraska,Educational Services,2010,2383,1015,365,365,1745,450,105,2300,83,2620,1015,365,365,1745,510,245,2500,120,91625,1244,2275,4467,8621,18916,15611,44352,18926,2455565000,30395000,24727000,72002000,133944000,370648000,393007000,930928000,609988000
Nebraska,Finance and Insurance,2010,12862,8409,1484,845,10738,837,336,11911,951,20990,8425,1555,1055,11035,2200,1425,14660,6330,260686,12279,8847,9846,30870,26875,20706,85792,166663,14682267000,441874000,368731000,446338000,1278597000,1340301000,999506000,3780157000,10387361000
Nebraska,Health Care and Social Assistance,2010,20840,9853,4010,2756,16619,2567,977,20163,677,25945,9905,4025,2855,16785,3485,2545,22815,3130,589113,13833,25783,35860,79701,100379,122819,311057,242206,22612758000,822332000,1001175000,1404076000,3254936000,3890741000,3949712000,11297281000,9882287000
Nebraska,Information,2010,2914,1178,375,340,1893,395,166,2454,460,4670,1180,380,350,1910,490,260,2660,2010,76539,1206,1766,3618,8283,12293,4924,32082,41961,4408634000,51229000,69572000,130868000,260710000,582806000,243883000,1345211000,2248889000
Nebraska,Management of Companies and Enterprises,2010,1445,120,50,80,250,280,381,911,534,1775,120,50,80,250,285,410,945,830,77320,0,32,358,42,2715,10662,14108,62629,5882460000,9041000,7997000,20870000,39340000,137850000,1091182000,1273710000,4608750000
Nebraska,Manufacturing,2010,8582,3310,1335,1117,5762,1329,648,7739,843,9225,3310,1335,1130,5775,1450,735,7960,1265,382254,4160,5842,10238,23491,41233,46392,130804,208892,15636745000,164758000,204189000,375309000,839291000,1697155000,1826189000,5077979000,8488393000
Nebraska,"Mining, Quarrying, and Oil and Gas Extraction",2010,547,320,75,60,455,37,15,507,40,605,320,75,60,455,40,15,510,95,3269,92,88,697,1644,364,0,2603,285,215248000,19992000,17123000,31866000,75476000,28661000,0,138608000,16263000
Nebraska,Other,2010,88,86,2,0,88,0,0,88,0,88,86,2,0,88,0,0,88,0,0,0,0,0,0,0,0,0,0,1112000,1079000,0,0,1112000,0,0,1112000,0
Nebraska,Other Services (except Public Administration),2010,26459,17100,4800,2452,24352,1501,339,26192,267,28465,17145,4860,2570,24575,1920,1030,27525,940,182473,28770,29352,31495,93577,50796,16494,167174,9913,4133223000,665101000,623475000,611687000,1925727000,1113723000,470494000,3674864000,303907000
Nebraska,"Professional, Scientific, and Technical Services",2010,20540,13710,2850,1690,18250,1138,318,19706,834,22045,13710,2855,1710,18275,1430,530,20235,1810,198370,18366,16057,18992,57206,35025,17006,119034,72237,10855933000,809823000,670801000,864686000,2506700000,1958207000,985730000,5825870000,4723125000
Nebraska,Real Estate and Rental and Leasing,2010,8588,6598,780,375,7753,306,214,8273,315,9895,6620,820,405,7845,450,440,8735,1160,47976,4505,4742,3483,15143,8389,9529,40043,6212,1520050000,232808000,136977000,104261000,502440000,253772000,362031000,1275925000,214605000
Nebraska,Retail Trade,2010,25734,12433,5239,3535,21207,2392,764,24363,1371,37085,12485,5360,3840,21685,3765,2425,27875,9210,460020,19934,32162,42607,99573,74603,36790,223713,201631,10479512000,488319000,649453000,920396000,2108890000,2013345000,1153106000,5603412000,4371638000
Nebraska,Total,2010,41974,24531,6762,4621,35914,3658,993,40565,1409,51886,24588,6857,4867,36312,5093,3019,44424,7462,769436,41184,44119,61415,146718,134212,110438,391368,378068,28033406000,1230500000,1209891000,1709711000,4150102000,4434071000,3894587000,12478760000,15554646000
Nebraska,Transportation and Warehousing,2010,10612,7200,1184,750,9134,582,262,9978,634,11510,7200,1185,750,9135,610,360,10105,1405,179796,8391,6508,8758,26731,17677,15871,63548,82646,6723019000,285795000,209783000,281432000,800795000,657952000,622997000,2181789000,3359178000
Nebraska,Utilities,2010,157,55,5,5,65,30,5,100,57,525,55,5,5,65,55,5,125,400,787,0,0,0,91,281,0,305,482,74933000,717000,0,0,5539000,28847000,0,37911000,58008000
Nebraska,Wholesale Trade,2010,11394,4570,1485,1452,7507,1842,816,10165,1229,15120,4580,1510,1585,7675,2465,1995,12135,2985,188490,6983,8228,15224,33064,48142,28763,122244,57600,9173427000,287323000,324155000,635849000,1348086000,2135648000,1352002000,5189637000,3464124000
Nevada,Accommodation and Food Services,2010,19885,6710,4173,3701,14584,3529,778,18891,994,28665,6730,4190,3885,14805,4290,2700,21795,6870,1442672,8312,25513,48577,86491,129421,119510,335523,1101778,39358229000,279041000,367606000,685650000,1345462000,2382348000,2400026000,6246644000,33077840000
Nevada,Administrative and Support and Waste Management and Remediation Services,2010,18551,10635,2555,1795,14985,1770,643,17398,1153,20255,10635,2560,1825,15020,1815,790,17625,2630,418515,14310,15610,22691,53849,59218,51067,171393,208596,13355193000,679620000,450393000,641772000,1802225000,1746839000,1260757000,5178871000,7186068000
Nevada,"Agriculture, Forestry, Fishing and Hunting",2010,235,195,20,20,235,0,0,235,0,235,195,20,20,235,0,0,235,0,91,0,0,33,91,0,0,91,0,21195000,8236000,0,1134000,21195000,0,0,21195000,0
Nevada,"Arts, Entertainment, and Recreation",2010,5306,3165,490,530,4185,685,232,5102,204,6120,3165,490,535,4190,775,505,5470,650,132955,1691,2662,6223,12569,28619,28670,76112,45355,3748567000,272990000,97120000,171668000,625587000,762347000,671579000,2198983000,1260285000
Nevada,Construction,2010,24643,14235,3945,2960,21140,2354,599,24093,550,25015,14235,3945,2960,21140,2405,665,24210,805,302872,20205,25328,39285,86849,84934,52852,234980,63260,14488642000,955616000,927153000,1495430000,3405420000,3841794000,2649348000,10197647000,4060662000
Nevada,Educational Services,2010,2858,1520,405,265,2190,400,105,2695,163,3090,1520,405,270,2195,410,140,2745,345,49183,1520,2419,3306,8263,13425,10911,33719,9535,1656838000,73066000,53524000,78119000,218187000,456344000,449404000,1167570000,304457000
Nevada,Finance and Insurance,2010,12619,8337,1230,514,10081,740,515,11336,1283,20205,8385,1265,555,10205,1280,1260,12745,7460,161606,10836,7227,5465,25674,14504,9792,54120,102557,8916519000,597221000,284501000,232080000,1173585000,894586000,412806000,2578690000,6072825000
Nevada,Health Care and Social Assistance,2010,27076,14618,5670,3220,23508,2183,602,26293,783,31170,14650,5675,3320,23645,2815,1675,28135,3035,490342,23650,37325,41456,103552,77906,66945,257433,204601,22945096000,1844774000,1620730000,1719897000,5204329000,3320198000,2503375000,11268758000,10451928000
Nevada,Information,2010,3950,2380,390,285,3055,270,139,3464,486,5595,2385,395,290,3070,280,185,3535,2060,66652,2064,1567,2420,8254,6263,2665,23662,44355,3835513000,161805000,88080000,123607000,436590000,399361000,168783000,1346806000,2653126000
Nevada,Management of Companies and Enterprises,2010,2463,720,65,90,875,345,438,1658,805,2885,725,70,90,885,360,510,1755,1130,63434,3,8,598,1671,2395,10869,14935,48499,5611634000,32092000,10707000,102939000,165165000,130999000,641773000,939830000,4674110000
Nevada,Manufacturing,2010,8245,3615,1345,955,5915,1218,459,7592,653,8520,3615,1345,955,5915,1235,510,7660,860,159860,3407,6794,8534,23041,28442,17702,87446,50832,7709540000,202037000,262701000,356942000,938255000,1235253000,744916000,3667914000,3184760000
Nevada,"Mining, Quarrying, and Oil and Gas Extraction",2010,1092,550,170,105,825,80,80,985,107,1170,550,170,105,825,80,80,985,185,52853,131,334,288,2696,921,5121,11092,38983,4940115000,94643000,36212000,19223000,300183000,42079000,481389000,1160011000,3736151000
Nevada,Other,2010,107,100,7,0,107,0,0,107,0,107,100,7,0,107,0,0,107,0,121,0,46,0,121,0,0,121,0,2403000,2036000,367000,0,2403000,0,0,2403000,0
Nevada,Other Services (except Public Administration),2010,18326,11560,3205,1720,16485,1098,357,17940,386,20510,11570,3255,1795,16620,1475,755,18850,1660,155154,18859,20156,17594,60653,35450,18333,124303,21785,4251546000,561957000,545064000,532774000,1684122000,984922000,495108000,3331351000,703894000
Nevada,"Professional, Scientific, and Technical Services",2010,37911,27765,4040,2475,34280,1819,685,36784,1127,40735,27780,4055,2525,34360,2035,865,37260,3475,259706,35067,24838,29680,91885,53424,27266,180144,58124,15156019000,2202509000,1322799000,1616718000,5223595000,3327078000,1581752000,10316938000,4036531000
Nevada,Real Estate and Rental and Leasing,2010,15433,11372,1625,850,13847,670,339,14856,577,19060,11405,1655,910,13970,1060,915,15945,3115,125321,14952,9941,9715,35326,16685,14242,71078,49828,4408123000,543294000,299625000,328720000,1182608000,653765000,474083000,2430138000,1873925000
Nevada,Retail Trade,2010,24332,11927,4565,2797,19289,1876,863,22028,2304,40420,12005,4695,3020,19720,2615,2220,24555,15865,584445,16829,26565,31028,77855,48409,32663,178498,360886,15634212000,551818000,728499000,769986000,2124806000,1458959000,1266487000,5225815000,9619799000
Nevada,Total,2010,47352,27757,7199,4779,39735,4081,1460,45276,2076,59207,27814,7272,4977,40063,5055,3100,48218,10989,1002956,42859,47261,62550,152670,140004,125710,418384,584572,37909682000,1982268000,1597657000,2083552000,5663477000,5117451000,4396148000,15177076000,22732606000
Nevada,Transportation and Warehousing,2010,5984,2930,545,586,4061,495,442,4998,986,6960,2935,545,605,4085,520,515,5120,1840,203334,3470,2017,5898,12185,10657,24107,53010,105089,7627783000,150881000,102158000,225771000,503988000,412881000,876008000,2042541000,3833301000
Nevada,Utilities,2010,283,100,20,15,135,60,26,221,62,600,100,20,15,135,100,70,305,295,2214,93,48,0,156,0,1131,2728,1263,201135000,5353000,1888000,0,14839000,0,99788000,218103000,129313000
Nevada,Wholesale Trade,2010,12775,5980,1562,1160,8702,1533,945,11180,1595,14290,5985,1570,1205,8760,1725,1140,11625,2665,166877,6820,7394,10440,30611,30399,20945,91053,48486,8518581000,459479000,398390000,488455000,1529579000,1599491000,949354000,4357712000,2750170000
New Hampshire,Accommodation and Food Services,2010,14508,5630,2970,2905,11505,2354,320,14179,329,17690,5640,2980,2955,11575,2720,1085,15380,2310,258250,6935,19944,38992,67415,79710,31086,179098,64979,4415531000,287501000,305326000,558901000,1162210000,1328856000,558459000,3084111000,1329569000
New Hampshire,Administrative and Support and Waste Management and Remediation Services,2010,10148,6573,1310,865,8748,637,272,9657,491,10910,6575,1320,875,8770,710,345,9825,1085,189788,7553,7551,10833,29503,19869,24851,80141,92200,7390680000,410995000,266709000,374856000,1099073000,787622000,712433000,2827658000,4006072000
New Hampshire,"Agriculture, Forestry, Fishing and Hunting",2010,695,510,125,35,670,20,0,690,5,700,510,125,35,670,25,0,695,5,2327,408,667,0,1691,240,0,2141,0,91731000,23328000,25740000,19200000,68586000,20801000,0,89387000,0
New Hampshire,"Arts, Entertainment, and Recreation",2010,3458,1955,495,360,2810,475,87,3372,86,3605,1955,495,360,2810,545,140,3495,110,58631,2349,2672,4434,10830,15915,10154,38937,16910,1275027000,389584000,77513000,103302000,591942000,344692000,101230000,1069585000,133146000
New Hampshire,Construction,2010,20203,14980,2450,1625,19055,948,125,20128,75,20295,14980,2450,1625,19055,970,175,20200,95,113438,21642,15083,20495,60314,32994,9600,110668,1002,5679787000,947242000,691528000,991101000,2691902000,2010730000,469985000,5517687000,107322000
New Hampshire,Educational Services,2010,2812,1270,495,370,2135,416,123,2674,138,3025,1270,500,375,2145,500,165,2810,215,136611,2014,2722,4690,9739,14720,14635,44699,88678,3881402000,57110000,59678000,98890000,226479000,376727000,496188000,1274351000,2528334000
New Hampshire,Finance and Insurance,2010,5371,2915,597,370,3882,442,306,4630,741,9430,2915,605,445,3965,710,1320,5995,3435,105622,4838,3490,3827,12675,10295,17753,42157,54209,6761882000,264523000,200424000,233838000,742152000,753849000,951323000,2728482000,3801763000
New Hampshire,Health Care and Social Assistance,2010,13824,5590,3365,1990,10945,1588,652,13185,639,17810,5590,3390,2035,11015,2095,1775,14885,2925,412712,10603,21364,26290,59902,55316,86053,206451,191479,18273641000,417643000,907486000,1258180000,2606912000,2260459000,2932991000,7960957000,9687115000
New Hampshire,Information,2010,2446,1005,365,244,1614,274,157,2045,401,3615,1005,365,245,1615,325,215,2155,1460,63515,936,1570,2709,5720,7355,9939,27718,23291,4846647000,81263000,111785000,144006000,409929000,486077000,509711000,1537898000,1758840000
New Hampshire,Management of Companies and Enterprises,2010,812,60,20,40,120,100,175,395,417,1085,65,20,40,125,100,190,415,670,84360,0,0,172,405,1143,3747,5430,78930,8086255000,7774000,0,4573000,50900000,84200000,257930000,393520000,7692735000
New Hampshire,Manufacturing,2010,9146,3475,1490,1267,6232,1709,444,8385,761,9470,3475,1490,1270,6235,1770,495,8500,970,265729,4255,6798,12072,27559,51819,28341,128199,107368,14800752000,201750000,337830000,553520000,1286290000,2657624000,1449592000,6362617000,6842235000
New Hampshire,"Mining, Quarrying, and Oil and Gas Extraction",2010,197,135,15,20,170,10,5,185,12,220,135,15,20,170,10,15,195,25,665,0,0,48,331,0,0,780,0,54827000,12016000,5979000,4383000,29801000,0,0,46798000,0
New Hampshire,Other,2010,71,69,2,0,71,0,0,71,0,71,69,2,0,71,0,0,71,0,67,56,0,0,67,0,0,67,0,1401000,1316000,0,0,1401000,0,0,1401000,0
New Hampshire,Other Services (except Public Administration),2010,16836,10500,3745,1450,15695,670,178,16543,293,17865,10510,3770,1465,15745,875,350,16970,895,103351,19479,23136,17212,62293,17605,6951,92839,5799,2827516000,531108000,594267000,407558000,1571360000,510135000,213089000,2479821000,225026000
New Hampshire,"Professional, Scientific, and Technical Services",2010,18641,12400,2595,1595,16590,1043,305,17938,703,19605,12400,2615,1625,16640,1210,400,18250,1355,145132,18352,15688,20206,56288,29306,15102,109529,34392,8520040000,1039661000,998742000,1192345000,3269960000,2006467000,1385292000,6921407000,1527222000
New Hampshire,Real Estate and Rental and Leasing,2010,5816,4150,725,330,5205,241,133,5579,237,6805,4180,770,360,5310,485,175,5970,835,32435,5688,4060,3154,13579,6130,1631,25532,3981,1259703000,242856000,152497000,94370000,514376000,315157000,67839000,1021921000,195162000
New Hampshire,Retail Trade,2010,20800,10030,4294,2596,16920,1930,558,19408,1392,30830,10050,4385,2860,17295,2625,1510,21430,9400,437458,14078,23188,25336,68483,49320,29210,166027,156437,10996337000,497723000,676312000,870106000,2075847000,1847540000,1249976000,5409552000,3541073000
New Hampshire,Total,2010,31025,17524,5346,3440,26310,2742,766,29818,1207,37452,17548,5406,3570,26524,3411,1857,31792,5660,562505,30068,35081,45627,110776,95742,78420,284938,277567,24223645000,1225412000,1249269000,1660277000,4134958000,3930503000,3142242000,11207703000,13015942000
New Hampshire,Transportation and Warehousing,2010,3643,2070,574,315,2959,290,115,3364,279,4055,2070,575,315,2960,320,140,3420,635,57055,2826,2867,3151,9529,6642,3301,25892,13357,2056454000,119597000,117142000,116520000,372157000,225095000,109076000,952229000,559455000
New Hampshire,Utilities,2010,237,83,20,15,118,30,25,173,64,565,85,20,15,120,30,95,245,320,12531,64,76,96,355,0,0,192,8067,1097215000,7283000,2794000,7934000,24741000,0,0,14632000,732328000
New Hampshire,Wholesale Trade,2010,8522,3985,1125,898,6008,971,540,7519,1003,9325,3985,1130,930,6045,1030,695,7770,1555,113168,5106,4807,9313,22546,23861,15344,71772,33028,7666555000,404119000,339614000,529284000,1413125000,1485550000,864988000,4331111000,2911073000
New Jersey,Accommodation and Food Services,2010,84252,46185,15045,11500,72730,9776,868,83374,878,97715,46220,15070,11635,72925,10410,2225,85560,12155,1374715,77668,99040,155456,332196,357896,111116,803040,571108,27147600000,1927108000,1539763000,2416596000,5901498000,5916912000,1898663000,13723778000,13400827000
New Jersey,Administrative and Support and Waste Management and Remediation Services,2010,59899,39370,7620,4795,51785,4648,1511,57944,1955,66150,39395,7635,4850,51880,4820,2020,58720,7430,1285421,51217,49750,63303,167124,176827,195896,545710,719483,45892318000,2877713000,2011155000,2514565000,7412774000,6675071000,6006806000,20265945000,24878694000
New Jersey,"Agriculture, Forestry, Fishing and Hunting",2010,1120,870,120,75,1065,35,10,1110,10,1120,870,120,75,1065,35,10,1110,10,5426,550,647,928,2807,724,0,4140,0,160542000,36057000,18119000,25081000,88217000,19860000,0,128360000,0
New Jersey,"Arts, Entertainment, and Recreation",2010,16043,9565,2030,1762,13357,2015,450,15822,221,17090,9580,2030,1795,13405,2035,605,16045,1045,256406,10831,12832,22946,48344,81563,63744,203817,47760,7973194000,692588000,335777000,509475000,1546801000,1892411000,3500393000,7123574000,662904000
New Jersey,Construction,2010,103768,75505,13709,8148,97362,5202,663,103227,541,104325,75505,13710,8160,97375,5245,730,103350,975,662775,111028,88908,107237,310553,182721,82614,584355,66490,39270825000,4966365000,4313090000,5783016000,15056135000,12363274000,5563037000,33444620000,4953793000
New Jersey,Educational Services,2010,15339,6995,2620,1972,11587,2725,676,14988,351,16655,7005,2620,2000,11625,2875,950,15450,1205,472815,11041,17367,25944,55427,116192,85668,268679,181409,16766910000,344442000,383307000,550267000,1282026000,3565194000,3492595000,8633367000,6964169000
New Jersey,Finance and Insurance,2010,32310,20045,4530,2231,26806,2353,1090,30249,2061,61870,20100,4665,2550,27315,3785,3830,34930,26940,951136,30760,27915,27405,89646,75716,80809,250699,698818,88787913000,1921935000,1895393000,2352188000,6233567000,6905454000,5675357000,19128007000,69597078000
New Jersey,Health Care and Social Assistance,2010,110579,54150,25543,14700,94393,11060,3195,108648,1931,131335,54235,25760,15380,95375,14325,9860,119560,11775,2620990,108842,166269,192623,471514,406423,466221,1348730,1216292,117745377000,5146038000,7214339000,9572488000,21989381000,18719557000,16035541000,56921086000,59079200000
New Jersey,Information,2010,10863,5800,1284,1040,8124,1199,500,9823,1040,19205,5800,1285,1045,8130,1295,660,10085,9120,462597,8105,7883,13104,29557,34539,36814,109301,339669,39606131000,538013000,464716000,792504000,1833966000,2578948000,2984967000,7705939000,30710003000
New Jersey,Management of Companies and Enterprises,2010,4885,380,135,140,655,745,1054,2454,2431,7080,380,135,140,655,755,1150,2560,4520,642530,0,488,850,2050,11502,37630,51182,591348,76512765000,52966000,45010000,198195000,296171000,885835000,3471455000,4653900000,71864245000
New Jersey,Manufacturing,2010,39340,15310,6698,5824,27832,7058,2175,37065,2275,40440,15315,6710,5875,27900,7220,2400,37520,2920,1112338,24107,37894,70262,143158,252351,227894,669823,365142,65918365000,1180120000,1722323000,3226520000,6509422000,12819937000,11925858000,33247568000,27647735000
New Jersey,"Mining, Quarrying, and Oil and Gas Extraction",2010,335,120,40,50,210,51,27,288,47,415,120,40,50,210,65,40,315,100,4631,74,72,514,933,1028,54,3553,1203,315718000,9053000,13205000,27534000,54156000,61153000,2968000,272915000,69438000
New Jersey,Other,2010,308,300,2,5,307,1,0,308,0,308,300,2,5,307,1,0,308,0,0,0,0,0,0,0,0,0,0,6265000,5887000,0,0,6164000,0,0,6265000,0
New Jersey,Other Services (except Public Administration),2010,110942,75355,18565,9785,103705,5673,878,110256,686,115055,75410,18655,10030,104095,6330,1590,112015,3040,724117,138004,118460,128066,387404,193977,69312,662876,49032,20382397000,3409815000,3052298000,3344672000,9826600000,5404140000,2294562000,17886615000,2010255000
New Jersey,"Professional, Scientific, and Technical Services",2010,141825,101671,17015,10136,128822,7947,2376,139145,2680,149450,101725,17055,10330,129110,8810,3010,140930,8520,1568343,148338,109696,130920,399233,269611,215716,889619,651616,120132706000,8484339000,6281019000,8388882000,23208695000,19942449000,16383573000,59742325000,58809897000
New Jersey,Real Estate and Rental and Leasing,2010,36124,25853,4817,2547,33217,1643,518,35378,746,43485,25925,4995,2895,33815,2140,1110,37065,6420,264598,42117,30917,32326,106840,53054,24402,186419,59981,12641483000,1617637000,1197015000,1286587000,4143993000,2675613000,1255960000,8155154000,4022125000
New Jersey,Retail Trade,2010,116342,76501,19172,9626,105299,6808,1606,113713,2629,162040,76720,19565,10215,106500,8950,4185,119635,42405,2106157,107226,113128,108427,331630,210724,99012,678737,1122680,59511756000,3482084000,3150972000,3259112000,10121896000,8723640000,4895325000,24160364000,29378107000
New Jersey,Total,2010,193722,121756,30637,18796,171189,15619,3727,190535,3187,228937,121924,30916,19451,172291,18194,8008,198493,30444,3367169,204829,199958,249765,654552,575657,459107,1689316,1677853,178657361000,8331055000,7796979000,10500762000,26628796000,26459482000,22017579000,75105857000,103551504000
New Jersey,Transportation and Warehousing,2010,30005,17080,3916,2665,23661,3077,1466,28204,1801,33485,17080,3935,2675,23690,3310,1975,28975,4510,688156,21527,23778,33097,82762,108135,119456,320600,269957,30430665000,955893000,972366000,1337311000,3403398000,4008175000,4539721000,12351218000,12936106000
New Jersey,Utilities,2010,451,160,40,20,220,50,22,292,159,1875,160,45,20,225,75,50,350,1525,70842,120,168,0,432,1851,870,4539,50729,7062277000,29196000,15217000,24175000,73974000,158869000,82386000,422406000,6249514000
New Jersey,Wholesale Trade,2010,68433,36540,10476,7394,54410,7977,2658,65045,3388,74355,36575,10540,7510,54625,8485,3640,66750,7605,1257336,57460,65135,95729,227409,265323,197324,704570,530778,98389716000,3566585000,3910726000,5963890000,13524543000,16574011000,12933512000,43839038000,53358982000
New Mexico,Accommodation and Food Services,2010,15077,5250,2555,3095,10900,3048,527,14475,602,20445,5250,2565,3135,10950,3730,1720,16400,4045,392671,8323,17238,43319,69583,113475,66458,250470,138326,5863884000,176994000,204061000,560021000,945863000,1659330000,993474000,3607602000,2180366000
New Mexico,Administrative and Support and Waste Management and Remediation Services,2010,8586,4790,1335,835,6960,665,201,7826,760,9460,4795,1335,850,6980,760,250,7990,1470,169889,6927,7354,9601,26136,21561,15158,69115,95171,4881991000,230407000,194283000,244023000,706342000,661881000,315342000,1978624000,2411744000
New Mexico,"Agriculture, Forestry, Fishing and Hunting",2010,481,340,85,36,461,10,5,476,5,495,340,90,45,475,10,5,490,5,2222,385,392,142,1197,0,0,1977,0,75802000,17922000,8849000,5188000,42832000,0,0,72092000,0
New Mexico,"Arts, Entertainment, and Recreation",2010,3109,1810,425,327,2562,370,70,3002,107,3270,1810,425,345,2580,430,100,3110,160,69143,1755,2088,2774,8526,12626,8829,34689,28136,1485450000,66552000,55953000,52491000,193632000,235195000,216921000,722726000,635880000
New Mexico,Construction,2010,23511,15030,3714,2385,21129,1836,346,23311,200,23690,15030,3715,2385,21130,1865,405,23400,290,206645,23752,23501,31690,80797,65386,44815,196910,5920,8077370000,721390000,726253000,1106198000,2573011000,2804791000,1918626000,7536155000,344239000
New Mexico,Educational Services,2010,2866,1415,370,440,2225,390,145,2760,106,2970,1415,370,440,2225,390,180,2795,175,49557,1757,2039,5611,10451,14962,11924,41394,3266,1374359000,67377000,45592000,125457000,251867000,398656000,405820000,1170529000,132526000
New Mexico,Finance and Insurance,2010,7701,4830,905,410,6145,428,323,6896,805,13920,4850,995,535,6380,1025,1570,8975,4945,113641,8058,5108,4403,19349,13423,22861,56969,40748,5568244000,297359000,216512000,167757000,710007000,649441000,1022317000,2677046000,2851517000
New Mexico,Health Care and Social Assistance,2010,20118,9520,3870,2867,16257,2265,780,19302,816,24265,9530,3895,2920,16345,2850,1810,21005,3260,546942,14818,25298,37484,80330,87303,107926,284244,250036,21590381000,698153000,1016894000,1462263000,3214797000,2860268000,3212068000,9488212000,11459854000
New Mexico,Information,2010,2487,1275,265,225,1765,213,110,2088,399,3955,1275,270,230,1775,270,260,2305,1650,60490,1276,1272,2588,5853,4769,3593,15806,36186,2485388000,69068000,41974000,85320000,212125000,215326000,144406000,613821000,1775220000
New Mexico,Management of Companies and Enterprises,2010,845,30,30,30,90,175,225,490,355,995,30,30,30,90,185,240,515,480,30330,25,0,0,0,2313,5510,8199,22085,1699535000,2505000,5496000,435000,14031000,117770000,338659000,475789000,1221909000
New Mexico,Manufacturing,2010,6843,3225,1254,950,5429,732,272,6433,410,7000,3225,1255,955,5435,770,290,6495,505,102278,3751,5209,8105,20569,15910,9782,59771,22752,4708384000,142854000,176491000,299853000,737627000,607557000,396417000,2241511000,1259544000
New Mexico,"Mining, Quarrying, and Oil and Gas Extraction",2010,2993,1365,305,385,2055,474,144,2673,320,3370,1365,305,385,2055,490,190,2735,635,66692,1220,1589,4753,9066,13858,11056,35168,31967,4967451000,134112000,84807000,280849000,504250000,868423000,953254000,2397923000,2578378000
New Mexico,Other,2010,74,71,1,1,73,1,0,74,0,74,71,1,1,73,1,0,74,0,114,0,0,0,0,0,0,114,0,1172000,961000,0,0,1062000,0,0,1172000,0
New Mexico,Other Services (except Public Administration),2010,19194,11520,3775,2170,17465,1196,217,18878,316,20345,11520,3795,2225,17540,1425,535,19500,845,133603,20649,23261,27782,74094,38054,5381,122695,4974,3211539000,508725000,562827000,597199000,1682176000,908985000,153153000,2869189000,172822000
New Mexico,"Professional, Scientific, and Technical Services",2010,22139,14995,2820,1891,19706,1076,475,21257,882,23845,14995,2840,1930,19765,1225,555,21545,2300,186975,21541,17471,23466,65159,31281,21343,122483,65662,11060084000,1009651000,798346000,1034588000,2870776000,1898241000,1463096000,6386937000,4836088000
New Mexico,Real Estate and Rental and Leasing,2010,9296,6990,1030,447,8467,330,155,8952,344,11290,7005,1065,500,8570,460,615,9645,1645,45361,9708,5760,4672,22106,7016,458,33006,9013,1634034000,299028000,183158000,158476000,652106000,268098000,70907000,1022812000,511440000
New Mexico,Retail Trade,2010,22196,11341,4190,2713,18244,1797,642,20683,1513,34065,11390,4290,2950,18630,2700,2015,23345,10720,391959,17617,23401,33456,81569,50267,30153,175796,140234,9224140000,489788000,617070000,820878000,1959788000,1576197000,1000020000,4661357000,3968199000
New Mexico,Total,2010,35655,20192,5753,4113,30058,3166,903,34127,1528,44221,20216,5837,4279,30332,4083,2327,36742,7479,600165,34810,37663,54671,127144,112330,91186,330660,269505,21318930000,1095902000,1105424000,1603347000,3804673000,3627997000,3169383000,10602053000,10716877000
New Mexico,Transportation and Warehousing,2010,5403,3110,620,440,4170,445,204,4819,584,6415,3110,620,445,4175,490,255,4920,1495,73756,2552,2939,4786,13972,13106,3934,34991,21833,2639985000,160848000,84753000,152035000,430183000,416572000,159577000,1096474000,1103725000
New Mexico,Utilities,2010,725,425,70,60,555,75,15,645,80,1155,425,70,60,555,135,25,715,440,21648,882,385,771,2161,2874,0,5988,149,1558890000,18767000,9691000,27867000,61635000,164545000,0,275960000,249902000
New Mexico,Wholesale Trade,2010,8411,3360,1245,985,5590,1036,461,7087,1324,9785,3365,1250,1025,5640,1200,615,7455,2330,96815,3857,5023,8420,22893,18000,8025,57760,35897,4487682000,238887000,228618000,348821000,991576000,731918000,325303000,2320078000,2023135000
New York,Accommodation and Food Services,2010,209041,112140,38933,29358,180431,24501,2716,207648,1393,237165,112155,39005,29580,180740,26650,7280,214670,22495,3082080,192344,254993,397084,845275,900401,427386,2174035,903179,63993680000,4472436000,4006453000,6520525000,15005716000,17912385000,9584822000,42518976000,21393003000
New York,Administrative and Support and Waste Management and Remediation Services,2010,114777,77620,13540,9082,100242,8727,3086,112055,2722,125045,77650,13575,9175,100400,9205,4015,113620,11425,2324862,102942,83665,119581,312227,343976,446309,1109626,1198662,102275620000,5125515000,3657317000,5553817000,14357252000,13986917000,14990980000,43580606000,58371652000
New York,"Agriculture, Forestry, Fishing and Hunting",2010,2910,2250,370,165,2785,90,15,2890,20,2920,2250,370,165,2785,100,15,2900,20,15298,3286,2276,1591,7729,3135,0,14061,495,484961000,92444000,60729000,61513000,219059000,118675000,0,441332000,17817000
New York,"Arts, Entertainment, and Recreation",2010,53598,37005,5850,4551,47406,4623,1021,53050,548,56890,37015,5875,4635,47525,4875,1690,54090,2800,760852,38387,37261,60155,143661,183500,154814,489283,257297,33617505000,4980257000,1927885000,2030919000,8953164000,6363447000,5694637000,21270489000,11896738000
New York,Construction,2010,225205,163435,29450,18062,210947,12043,1666,224656,549,226465,163440,29450,18090,210980,12230,1875,225085,1380,1507510,237667,191536,241502,671275,446375,247426,1370780,117942,88757715000,9698240000,8566060000,12332268000,30611580000,28591925000,17641116000,77164520000,9901714000
New York,Educational Services,2010,32892,15775,4337,3805,23917,6343,1622,31882,1010,35890,15785,4365,3925,24075,6680,2540,33295,2595,1879005,22693,27693,51953,104098,257254,263968,626250,1222956,71788380000,874075000,702309000,1397990000,2980700000,8604641000,10380925000,21977120000,48819998000
New York,Finance and Insurance,2010,81810,51560,12065,6021,69646,6260,2730,78636,3174,140485,51685,12415,6795,70895,9085,8875,88855,51630,2612862,79277,75035,74730,237856,214135,297579,766030,1831994,465621674000,7004351000,7332273000,9839320000,24310209000,40263521000,58508132000,124880171000,339206473000
New York,Health Care and Social Assistance,2010,226878,125285,44265,24569,194119,19098,8346,221563,5315,280210,125495,44615,25640,195750,25625,25200,246575,33635,6941622,220814,288875,327849,848246,735294,1352616,2942218,3980891,308471882000,11736080000,12794656000,14913661000,39484448000,32410946000,45933715000,118042497000,189853169000
New York,Information,2010,37440,22453,4514,3355,30322,3897,1211,35430,2010,55070,22465,4525,3425,30415,4375,1610,36400,18670,1307514,28327,28495,42888,101956,134107,115087,359483,929392,112836960000,2417212000,1580389000,2159172000,6232277000,9063124000,9227517000,25081820000,87186185000
New York,Management of Companies and Enterprises,2010,9426,1090,281,291,1662,1637,2530,5829,3597,14005,1095,290,320,1705,1705,2745,6155,7850,887735,8,49,1930,3748,23820,88333,116775,770783,111915060000,5114000,152845000,316456000,1534035000,2010661000,9093636000,12704350000,99178287000
New York,Manufacturing,2010,82184,37152,14037,11187,62376,13366,3554,79296,2888,84665,37160,14045,11275,62480,13705,4185,80370,4295,2067559,57912,87032,143736,304088,495608,403070,1280582,661858,103010587000,2516306000,3172708000,5510810000,11542099000,21763925000,19069513000,55232400000,42743770000
New York,"Mining, Quarrying, and Oil and Gas Extraction",2010,1320,675,205,135,1015,134,86,1235,85,1625,675,205,135,1015,160,165,1340,285,18941,1029,1124,1501,3695,2800,3648,13737,144,1240316000,59618000,57617000,79955000,227833000,201416000,197827000,880916000,209726000
New York,Other,2010,1019,997,12,9,1018,1,0,1019,0,1019,997,12,9,1018,1,0,1019,0,0,0,0,0,0,0,0,0,0,23144000,19580000,1632000,0,23139000,0,0,23144000,0
New York,Other Services (except Public Administration),2010,254158,177410,40934,21097,239441,11891,1827,253159,999,267700,177590,41255,21465,240310,14025,4035,258370,9330,1740442,305618,266422,275481,860333,414161,224155,1506365,170091,55909300000,7897442000,7469723000,8090169000,23465817000,14112722000,9617561000,47320455000,6362307000
New York,"Professional, Scientific, and Technical Services",2010,279219,204491,33165,19463,257119,14640,3842,275601,3618,294435,204595,33280,19750,257625,16235,5625,279485,14950,2828555,274294,213285,252967,763622,504662,393116,1667284,1118055,230578563000,17110450000,12517670000,16442143000,46069233000,38054071000,32375158000,116736993000,111417569000
New York,Real Estate and Rental and Leasing,2010,142834,110597,16268,8305,135170,5407,1216,141793,1041,158175,110970,16600,8980,136550,7525,4075,148150,10025,795424,141049,104897,107174,381951,178016,100603,663684,119649,40293650000,6142524000,4376362000,4868261000,15395167000,9354581000,6088493000,30896741000,9031839000
New York,Retail Trade,2010,290717,199723,46185,22625,268533,16154,2792,287479,3238,383815,200020,46810,24155,270985,21755,9510,302250,81565,4157010,273576,287895,268905,906427,533534,233404,1726509,2099877,113107317000,9002771000,8229134000,8099745000,25739134000,18909912000,8633030000,54309150000,55398013000
New York,Total,2010,444895,294493,66569,40042,401104,32425,7156,440685,4210,519504,294873,67135,41432,403440,38965,18551,460956,58548,7266189,476304,433799,533547,1443650,1214915,1079112,3737677,3528512,418437922000,20029923000,17166034000,22366086000,59562043000,59820067000,58258822000,177640932000,240796990000
New York,Transportation and Warehousing,2010,53336,33452,6751,4654,44857,4871,1724,51452,1884,59925,33495,6785,4710,44990,5420,2760,53170,6755,1104777,43045,42192,58390,150315,172186,142915,481779,607151,46126302000,1669445000,1554314000,2161008000,5419793000,6984753000,5332783000,18257980000,26902230000
New York,Utilities,2010,984,405,125,58,588,121,61,770,214,3065,405,125,60,590,175,270,1035,2030,206544,602,748,537,2019,4184,4659,12475,182796,18562121000,30667000,52305000,34460000,131955000,377931000,491574000,1162911000,16453818000
New York,Wholesale Trade,2010,152610,95295,21917,14391,131603,13590,3893,149086,3524,164875,95435,22025,14835,132295,15290,6285,153870,11005,1731600,154852,138409,185447,487640,449418,315744,1263004,384387,109522158000,7767505000,7300184000,10286214000,25357651000,27228286000,20569188000,73676950000,31535238000
North Carolina,Accommodation and Food Services,2010,68039,25390,13445,13923,52758,12504,1406,66668,1371,95600,25415,13500,14120,53035,14660,5770,73465,22135,1686408,40324,90920,188943,321190,435345,211594,970257,714261,24185140000,1001201000,1158479000,2425146000,4590376000,5832611000,2879175000,13327141000,10830627000
North Carolina,Administrative and Support and Waste Management and Remediation Services,2010,50296,30930,7645,4495,43070,3901,1413,48384,1912,57550,30965,7670,4550,43185,4410,2110,49705,7845,1110488,47044,49218,58778,158565,142424,161960,469878,617066,32750887000,1488876000,1375581000,1706335000,4594530000,4131537000,4532030000,13393631000,18805411000
North Carolina,"Agriculture, Forestry, Fishing and Hunting",2010,3773,2335,750,475,3560,115,40,3715,58,3780,2335,750,475,3560,115,45,3720,60,21676,3593,4668,5813,14679,2554,465,19761,1096,735477000,128331000,145413000,196222000,477688000,85810000,40676000,654834000,38059000
North Carolina,"Arts, Entertainment, and Recreation",2010,15985,9190,2275,1849,13314,1988,400,15702,283,16955,9195,2295,1850,13340,2220,590,16150,805,273419,12683,14531,25093,53556,78795,55122,190445,71037,7244691000,503432000,357252000,517908000,1386882000,1533952000,1494386000,4481899000,2502911000
North Carolina,Construction,2010,113469,77505,17089,10364,104958,6793,982,112733,736,115535,77505,17110,10380,104995,7015,1305,113315,2220,873145,124046,111088,137810,373100,239720,116133,738570,127636,33554995000,3598430000,3351591000,4583200000,11534475000,9414374000,5030590000,26370925000,6887731000
North Carolina,Educational Services,2010,11384,6090,1555,1355,9000,1605,456,11061,323,12105,6090,1555,1365,9010,1660,650,11320,785,434092,8158,10231,17992,37182,64944,77614,184608,239257,15535697000,259625000,192266000,335102000,791847000,1650744000,2548359000,5119050000,10044115000
North Carolina,Finance and Insurance,2010,32190,21715,4238,1798,27751,1607,905,30263,1927,66590,21785,4430,2270,28485,3770,4740,36995,29595,809513,30913,23831,21939,80957,47910,62440,197369,560946,54490138000,1637809000,1182014000,1419158000,4292486000,2800788000,3488626000,10917756000,42730474000
North Carolina,Health Care and Social Assistance,2010,88985,38030,20398,13620,72048,11919,3048,87015,1970,114440,38075,20515,14005,72595,15735,9910,98240,16200,2701065,67202,136012,181077,388084,450495,454566,1295817,1368893,105584827000,3144639000,5681545000,6787944000,15623633000,15307575000,14711189000,45741633000,59005510000
North Carolina,Information,2010,9009,4820,1080,785,6685,870,453,8008,1001,17880,4820,1085,810,6715,1200,925,8840,9040,368329,5676,6557,9804,24236,26089,32141,89681,249269,21721486000,308078000,250734000,408056000,987891000,1330245000,2012003000,4639409000,16976609000
North Carolina,Management of Companies and Enterprises,2010,5175,325,175,155,655,990,1428,3073,2102,7615,325,175,155,655,1005,1555,3215,4400,367238,442,765,900,2112,11455,40590,54295,313081,32337520000,33182000,55725000,44425000,133465000,648162000,2437443000,3227040000,29118450000
North Carolina,Manufacturing,2010,41062,15320,6470,5329,27119,7107,2765,36991,4071,44815,15325,6470,5345,27140,7380,3475,37995,6820,1866005,22812,38380,61516,133059,259127,262680,711007,1059882,80418022000,920985000,1251207000,2146579000,4551423000,9706638000,10287199000,26596886000,49350572000
North Carolina,"Mining, Quarrying, and Oil and Gas Extraction",2010,628,300,75,65,440,62,43,545,83,1055,300,75,65,440,90,80,610,445,12778,105,413,655,1546,1820,1399,5775,6727,594525000,12360000,17224000,20943000,76641000,69244000,68686000,241105000,321960000
North Carolina,Other,2010,441,417,19,5,441,0,0,441,0,441,417,19,5,441,0,0,441,0,0,0,127,57,0,0,0,0,0,8218000,6837000,1033000,348000,8218000,0,0,8218000,0
North Carolina,Other Services (except Public Administration),2010,103988,66802,20759,9539,97100,5467,710,103277,711,111670,66855,20920,9925,97700,7255,2400,107355,4315,719416,125592,133737,123344,386005,190267,60381,647824,50801,16791960000,2721766000,2878179000,2715846000,8331811000,4388337000,1585043000,14557395000,1809773000
North Carolina,"Professional, Scientific, and Technical Services",2010,104346,75275,12586,7528,95389,4972,1559,101920,2426,113465,75305,12655,7775,95735,6085,2975,104795,8670,886383,106074,81058,97264,289836,155779,91882,548855,328705,55922431000,4805440000,3563488000,4623515000,13028105000,9032640000,6528625000,29031920000,26483760000
North Carolina,Real Estate and Rental and Leasing,2010,37631,29734,3501,1547,34782,1353,676,36811,820,50240,29845,3595,1860,35300,2600,2835,40735,9505,229374,40503,21632,18340,81065,38722,40531,163653,57262,8210551000,1252916000,705242000,609761000,2583857000,1564330000,1458995000,5688002000,2478571000
North Carolina,Retail Trade,2010,103716,60962,20133,10954,92049,7412,1582,101043,2673,171695,61225,20770,12680,94675,13810,7080,115565,56130,1957805,104559,126953,124220,371137,240648,111488,756817,1021522,45502649000,2534823000,2959906000,3477095000,8989108000,7570546000,3365334000,20326335000,22499073000
North Carolina,Total,2010,168938,101077,28306,18027,147410,14579,3548,165537,3401,218104,101255,28687,19037,148979,19554,10434,178967,39137,3234595,168452,186086,239702,594240,530282,420868,1545390,1689205,125174128000,5409926000,5563476000,7209203000,18182605000,17289062000,15329063000,50800730000,74373398000
North Carolina,Transportation and Warehousing,2010,22663,13760,2673,1879,18312,1755,907,20974,1689,26710,13775,2685,1990,18450,1900,1255,21605,5105,470921,17588,15699,22756,59763,52265,39189,162055,252252,17590345000,637101000,492842000,694475000,1861483000,1860831000,1493123000,5512505000,10166942000
North Carolina,Utilities,2010,736,250,100,70,420,120,75,615,121,2360,250,100,70,420,205,195,820,1540,82862,7,581,824,1831,6636,8097,16610,32470,7329949000,10011000,15626000,31682000,58791000,379446000,575426000,1024691000,4914447000
North Carolina,Wholesale Trade,2010,47896,24744,6832,5056,36632,5360,2564,44556,3340,58255,24800,6985,5470,37255,6655,4275,48185,10070,783043,37835,41707,62129,147190,154147,123149,439438,301712,45076709000,1813666000,1985441000,2798028000,6682589000,7467198000,6818049000,21600606000,22939024000
North Dakota,Accommodation and Food Services,2010,7940,3020,1415,1300,5735,1755,310,7800,140,9165,3020,1425,1315,5760,1995,820,8575,590,159606,4606,9485,17227,31271,63136,39856,135501,14691,2040358000,87183000,85694000,187915000,363584000,759405000,580961000,1706083000,263817000
North Dakota,Administrative and Support and Waste Management and Remediation Services,2010,4206,2480,675,385,3540,257,100,3897,309,4640,2480,675,395,3550,295,195,4040,600,52145,2981,3845,3640,11705,7037,8004,31335,18853,1373584000,109984000,114195000,90933000,337735000,148480000,208670000,834246000,452676000
North Dakota,"Agriculture, Forestry, Fishing and Hunting",2010,575,445,75,25,545,20,0,565,10,585,445,75,25,545,20,0,565,20,2082,455,420,0,1139,0,0,1593,0,79827000,23304000,16750000,0,48412000,0,0,63332000,0
North Dakota,"Arts, Entertainment, and Recreation",2010,1936,1170,250,270,1690,169,57,1916,20,2105,1170,250,275,1695,235,155,2085,20,21533,797,1159,2217,4944,5593,5818,19713,0,319992000,39127000,19308000,36878000,113231000,71466000,61717000,283486000,0
North Dakota,Construction,2010,12733,8520,1795,1424,11739,810,85,12634,99,12850,8520,1795,1430,11745,850,115,12710,140,93042,11697,11251,17973,42961,28354,3415,81607,6321,4674200000,542276000,443606000,743589000,1754798000,1577067000,146102000,3797275000,517846000
North Dakota,Educational Services,2010,695,225,120,95,440,145,55,640,55,725,225,120,100,445,150,55,650,75,21400,77,665,1158,2351,6448,5604,14551,0,434608000,6987000,7147000,13984000,33349000,129884000,127498000,290925000,50048000
North Dakota,Finance and Insurance,2010,5366,3600,465,385,4450,353,148,4951,415,8575,3605,485,580,4670,1080,965,6715,1860,80539,4989,2829,4663,12648,10525,11518,37595,38590,3594039000,197380000,117363000,188048000,523595000,448520000,539906000,1706193000,1810157000
North Dakota,Health Care and Social Assistance,2010,7722,3500,1455,1035,5990,911,526,7427,295,9175,3510,1455,1085,6050,1115,1150,8315,860,267979,4920,8768,11896,26609,34912,60651,129342,115643,10109527000,203781000,318376000,440173000,988751000,928660000,1547696000,3702592000,4834447000
North Dakota,Information,2010,1138,330,165,203,698,190,72,960,178,1760,330,165,235,730,285,80,1095,665,34000,240,676,1611,3286,6039,3469,16495,12715,1616129000,10474000,22577000,55793000,98770000,310865000,153618000,631271000,636893000
North Dakota,Management of Companies and Enterprises,2010,456,30,15,25,70,115,120,305,151,490,30,15,25,70,115,125,310,180,22645,10,0,0,232,714,2002,3005,19551,1191960000,2880000,0,0,30876000,35212000,113258000,183625000,1004507000
North Dakota,Manufacturing,2010,3446,1310,555,525,2390,553,238,3181,265,3690,1310,555,525,2390,590,325,3305,385,80239,1041,2083,4543,9153,11243,10163,43502,18008,3351061000,49139000,70843000,165601000,343518000,445793000,387547000,1614929000,861981000
North Dakota,"Mining, Quarrying, and Oil and Gas Extraction",2010,1281,545,120,150,815,190,65,1070,211,1410,545,120,150,815,190,100,1105,305,38427,218,684,1788,3367,6939,3520,15697,21179,3327604000,59617000,41401000,137976000,253209000,629263000,254503000,1223714000,1982981000
North Dakota,Other,2010,38,35,3,0,38,0,0,38,0,38,35,3,0,38,0,0,38,0,0,0,22,0,0,0,0,0,0,707000,321000,386000,0,707000,0,0,707000,0
North Dakota,Other Services (except Public Administration),2010,11637,7482,2190,1141,10813,608,45,11466,171,12110,7485,2210,1160,10855,850,50,11755,355,65674,12258,13169,13268,40257,17558,233,61391,2091,1363101000,269529000,292484000,256009000,839539000,333195000,5188000,1229941000,58380000
North Dakota,"Professional, Scientific, and Technical Services",2010,7287,4870,935,660,6465,392,145,7002,285,7765,4885,935,670,6490,535,255,7280,485,54815,6820,5562,7802,21033,9789,5769,39986,10065,2573049000,301412000,223223000,344337000,888544000,544557000,387935000,1970076000,443527000
North Dakota,Real Estate and Rental and Leasing,2010,3611,2685,310,220,3215,153,96,3464,147,3990,2685,310,225,3220,220,260,3700,290,17775,2365,1819,2505,7232,2241,1524,14681,1306,586135000,112650000,50331000,84769000,262502000,68418000,44757000,474647000,59418000
North Dakota,Retail Trade,2010,12151,5185,2556,1870,9611,1324,384,11319,832,15995,5220,2615,2025,9860,1825,1080,12765,3230,211719,6712,14842,22215,49386,35716,24091,115921,66141,5049100000,232952000,363056000,565933000,1226585000,1098974000,655012000,3192356000,1329047000
North Dakota,Total,2010,18169,10163,2916,2162,15241,1735,472,17448,721,21832,10179,2949,2299,15427,2432,1377,19236,2596,294907,16694,19184,28901,64779,63048,54626,182453,112454,10543129000,532484000,549626000,855760000,1937870000,2062367000,1757779000,5758016000,4785113000
North Dakota,Transportation and Warehousing,2010,5302,3385,689,395,4469,317,184,4970,332,5875,3390,690,395,4475,360,310,5145,730,57397,4111,4019,4518,14060,9330,11118,38405,12475,2352038000,166935000,154864000,142294000,503503000,371073000,559767000,1588952000,568036000
North Dakota,Utilities,2010,194,35,10,15,60,75,10,145,49,565,35,10,20,65,115,40,220,345,3267,0,0,94,132,2840,0,4756,0,250318000,1114000,0,4742000,8828000,205355000,0,356878000,1126000
North Dakota,Wholesale Trade,2010,5479,1830,805,748,3383,916,438,4737,742,7500,1830,825,860,3515,1335,805,5655,1845,91112,2053,4387,8247,16618,22876,13450,57452,26772,4430233000,118674000,217215000,363939000,790938000,1127628000,661311000,2768958000,1454464000
Ohio,Accommodation and Food Services,2010,83141,32099,15760,16206,64065,15631,1935,81631,1510,115715,32140,15790,16530,64460,18755,9020,92235,23480,2110515,51521,104725,220334,377503,565720,286786,1232910,867125,27554885000,1017090000,1109642000,2438120000,4566878000,7070423000,3452189000,15104685000,12307793000
Ohio,Administrative and Support and Waste Management and Remediation Services,2010,57024,34275,7990,5687,47952,4997,1854,54803,2221,66805,34285,7995,5800,48080,5360,2665,56105,10700,1517964,45304,52051,74633,175410,190906,240027,614488,866535,45351020000,1975727000,1545494000,2293244000,5867389000,5703984000,5901048000,17626659000,26478806000
Ohio,"Agriculture, Forestry, Fishing and Hunting",2010,1225,865,180,70,1115,60,20,1195,30,1240,865,180,70,1115,60,20,1195,45,6265,1129,792,596,3101,1717,0,5596,731,180110000,31938000,29725000,18562000,87545000,51599000,0,154099000,28977000
Ohio,"Arts, Entertainment, and Recreation",2010,18021,10075,2940,2090,15105,2128,463,17696,325,19300,10090,2950,2125,15165,2270,745,18180,1120,288667,13595,18788,26506,61132,81626,61100,206586,74533,9094437000,554636000,420742000,453795000,1486135000,1564634000,3161665000,6258229000,2630804000
Ohio,Construction,2010,101704,68880,15105,10210,94195,6057,857,101109,595,103100,68880,15110,10240,94230,6355,1150,101735,1365,806680,104367,98525,135638,339690,216284,108545,673773,118321,40550330000,4165970000,4022105000,5896894000,14098635000,11760995000,6000340000,32340496000,7419336000
Ohio,Educational Services,2010,12889,5370,1995,1642,9007,2761,643,12411,478,14680,5385,2005,1690,9080,3090,970,13140,1540,537006,8847,13020,21786,44297,113396,93116,253567,281256,14867595000,260134000,232736000,413895000,911062000,2871162000,2806330000,6671865000,8127860000
Ohio,Finance and Insurance,2010,43351,28525,6193,2889,37607,2687,929,41223,2128,87790,28580,6475,3620,38675,6020,4335,49030,38760,1214894,49720,38792,36437,127638,94026,81747,308059,898149,73129945000,1888501000,1746920000,1899647000,5567732000,5080760000,3998602000,14818450000,57804621000
Ohio,Health Care and Social Assistance,2010,104446,42045,25239,15537,82821,13763,5058,101642,2804,140470,42250,25490,16545,84285,19270,15150,118705,21765,3942506,84008,166054,206699,458330,542030,748504,1753847,2176861,154591238000,3654677000,6515313000,8464421000,18650898000,20327501000,21306958000,60353570000,93885279000
Ohio,Information,2010,9108,3920,1365,1068,6353,1275,410,8038,1070,20275,3925,1370,1090,6385,1455,1015,8855,11420,420098,4837,7642,13135,28477,42404,35548,112972,289122,25975166000,273697000,321646000,556872000,1196756000,2133169000,1700313000,5364489000,19660223000
Ohio,Management of Companies and Enterprises,2010,6754,370,140,305,815,1260,1963,4038,2716,11310,375,140,305,820,1265,2040,4125,7185,718715,0,476,1834,2873,13815,58990,75690,642979,61624530000,138304000,49050000,162340000,349694000,766495000,4363840000,5480215000,56140864000
Ohio,Manufacturing,2010,68458,22225,11754,10723,44702,13670,4916,63288,5170,73645,22235,11755,10820,44810,14370,6225,65405,8240,2896743,36813,71138,137241,258509,503697,531802,1362548,1374185,146388873000,1529304000,2613767000,5496691000,9924834000,22259440000,25011751000,60048141000,77379434000
Ohio,"Mining, Quarrying, and Oil and Gas Extraction",2010,3086,1565,615,377,2557,256,115,2928,158,3765,1570,620,380,2570,325,240,3135,630,44759,2627,3814,4513,11570,7857,4125,27058,16081,2481674000,101713000,161560000,210388000,486538000,391207000,204168000,1237696000,1136878000
Ohio,Other,2010,351,340,8,3,351,0,0,351,0,351,340,8,3,351,0,0,351,0,357,0,0,41,357,0,0,357,0,6312000,5418000,474000,420000,6312000,0,0,6312000,0
Ohio,Other Services (except Public Administration),2010,125445,72893,28470,14124,115487,7775,1187,124449,996,141700,72985,28860,14890,116735,10160,3280,130175,11525,1026289,142786,184570,184254,515009,257287,101373,881867,100426,24306041000,3059623000,3726829000,3800120000,10602616000,6157789000,2710261000,19690531000,3735625000
Ohio,"Professional, Scientific, and Technical Services",2010,111078,73898,15883,9715,99496,7078,2069,108643,2435,121470,73950,15925,10075,99950,8380,3310,111640,9830,1134083,115847,104210,126408,348029,236936,164921,756716,359584,66671005000,4810800000,4516014000,6012494000,15381630000,13818330000,10673240000,40088495000,26157695000
Ohio,Real Estate and Rental and Leasing,2010,34766,24587,4468,2236,31291,1768,814,33873,893,49085,24640,4660,2695,31995,2940,3685,38620,10465,294251,39217,26971,27882,96057,50040,39160,192105,83268,10787025000,1175989000,849347000,945496000,2989616000,1811508000,1604329000,6642665000,3561282000
Ohio,Retail Trade,2010,107945,58264,22437,12855,93556,9355,2192,105103,2842,185175,58505,23075,14320,95900,15230,8850,119980,65195,2666546,86935,134668,154699,398373,324451,186509,945086,1603441,62823526000,2288569000,3020666000,3915239000,9190250000,9701947000,5574747000,24919897000,36331788000
Ohio,Total,2010,190184,104791,34681,23033,162505,19292,4689,186486,3698,253491,105025,35174,24447,164646,25730,14127,204503,48988,4352481,182546,228383,308697,719626,725065,630097,2074788,2277693,174515811000,6037354000,6983836000,9854154000,22875344000,25736248000,23392176000,72003768000,102512043000
Ohio,Transportation and Warehousing,2010,28745,15505,3845,3201,22551,2795,1157,26503,2242,35145,15520,3880,3285,22685,3320,1645,27650,7495,716983,21900,23468,40618,88874,90912,66024,252041,376516,28523503000,789828000,813928000,1363818000,3011581000,3434272000,2439210000,8998633000,16346294000
Ohio,Utilities,2010,836,265,113,75,453,205,55,713,123,3480,265,115,80,460,285,115,860,2620,13095,66,471,637,2021,6537,0,12232,0,841768000,16069000,21363000,44506000,107553000,448688000,0,891731000,0
Ohio,Wholesale Trade,2010,57971,26890,9267,7212,43369,7552,3242,54163,3808,71550,26980,9435,7660,44075,9740,6175,59990,11560,1045574,43079,58341,91500,198688,230392,190004,638322,385585,56624837000,2228326000,2843826000,4304299000,9434472000,11813924000,9649141000,31292507000,24572830000
Oklahoma,Accommodation and Food Services,2010,25623,9695,4685,4743,19123,5050,658,24831,792,35655,9710,4695,4795,19200,6055,2630,27885,7770,654029,16401,30826,64241,111466,186205,86804,390210,254224,8599785000,355799000,325878000,699374000,1384770000,2303906000,1080175000,4856157000,3619394000
Oklahoma,Administrative and Support and Waste Management and Remediation Services,2010,19883,11950,3000,1775,16725,1503,550,18778,1105,21975,11960,3010,1810,16780,1640,875,19295,2680,432662,18401,18471,21595,59870,55118,63001,190882,226286,13091626000,571102000,504301000,581483000,1702869000,1686408000,1538530000,5319974000,7388885000
Oklahoma,"Agriculture, Forestry, Fishing and Hunting",2010,726,485,110,80,675,20,11,706,20,735,485,110,80,675,20,20,715,20,4091,433,512,849,2275,314,0,3826,0,140214000,20957000,16609000,31196000,72505000,10732000,0,124700000,0
Oklahoma,"Arts, Entertainment, and Recreation",2010,5034,2815,755,575,4145,590,202,4937,97,5370,2820,755,585,4160,635,275,5070,300,128311,3567,4275,6661,15911,23673,28332,72755,1174,3102309000,114465000,79885000,117947000,342386000,426339000,702232000,1611973000,27099000
Oklahoma,Construction,2010,40127,25610,6690,4515,36815,2640,338,39793,334,40430,25610,6690,4515,36815,2670,400,39885,545,316175,41773,42905,59098,146375,95332,37242,284225,26945,13552130000,1319037000,1330447000,2049981000,4728660000,4120794000,1694600000,10749375000,2561873000
Oklahoma,Educational Services,2010,3266,1555,500,415,2470,460,173,3103,163,3490,1555,500,420,2475,480,240,3195,295,94971,1544,2978,3831,9877,15710,18467,47456,43263,2373767000,51883000,60020000,75616000,199087000,386074000,483840000,1174902000,1089910000
Oklahoma,Finance and Insurance,2010,19952,13795,2215,1069,17079,1330,504,18913,1039,33285,13805,2305,1490,17600,3240,2840,23680,9605,291328,23036,12808,12618,50453,48411,47791,153009,124584,14023894000,814871000,495109000,591476000,1982943000,2181179000,2041241000,6568850000,7152732000
Oklahoma,Health Care and Social Assistance,2010,42109,20690,9345,4855,34890,4686,1458,41034,1075,52935,20730,9370,4935,35035,6080,4645,45760,7175,1042154,35584,59892,63049,160683,199014,194123,560628,460360,38919860000,2019362000,2405501000,2209972000,6661504000,5974930000,6027149000,18732663000,19534880000
Oklahoma,Information,2010,4077,1800,575,574,2949,419,182,3550,527,7715,1800,575,620,2995,495,470,3960,3755,146530,2187,3170,6892,13658,11661,7448,40487,94219,6621341000,97673000,108426000,271163000,490870000,557645000,333832000,1646629000,4367409000
Oklahoma,Management of Companies and Enterprises,2010,2222,160,65,95,320,430,661,1411,811,2770,165,65,95,325,430,710,1465,1305,136368,0,12,536,16,3456,15750,20257,116111,11551947000,28242000,460000,29368000,65228000,220960000,1102260000,1398068000,10153879000
Oklahoma,Manufacturing,2010,16938,6475,2899,2519,11893,2566,949,15408,1530,18125,6475,2900,2520,11895,2715,1140,15750,2375,521873,8783,15002,28293,57859,79472,75500,243273,236914,23690900000,344744000,539213000,1031885000,2062828000,3399936000,3499438000,10069760000,11835732000
Oklahoma,"Mining, Quarrying, and Oil and Gas Extraction",2010,12709,8125,1759,1119,11003,905,304,12212,497,14125,8130,1760,1120,11010,950,455,12415,1710,203974,7687,11337,14980,39675,31218,21675,93740,109684,16474710000,596526000,597510000,772920000,1975901000,1935825000,1482667000,5463984000,10991393000
Oklahoma,Other,2010,149,138,9,1,148,1,0,149,0,149,138,9,1,148,1,0,149,0,0,0,0,0,0,0,0,0,0,2355000,1613000,618000,0,2246000,0,0,2355000,0
Oklahoma,Other Services (except Public Administration),2010,41827,26386,8035,4153,38574,2430,412,41416,411,44340,26425,8110,4290,38825,3015,1120,42960,1380,306462,48265,51691,54442,156036,83820,34868,284692,11393,6715865000,1000299000,1091046000,1139370000,3249606000,1801476000,816190000,6107659000,402004000
Oklahoma,"Professional, Scientific, and Technical Services",2010,43663,31030,6010,3080,40120,1951,616,42687,976,46630,31050,6045,3185,40280,2265,840,43385,3245,311495,47132,37852,39165,127838,61699,48036,242049,61128,16454667000,1916250000,1512402000,1733581000,5234143000,3493111000,3097216000,12055903000,4179379000
Oklahoma,Real Estate and Rental and Leasing,2010,15904,12086,1617,816,14519,644,233,15396,508,19390,12115,1650,1015,14780,1045,530,16355,3035,104153,13991,9870,10353,38398,17526,9129,70157,28682,3790593000,504138000,311965000,295344000,1121640000,626474000,328875000,2255590000,1430103000
Oklahoma,Retail Trade,2010,42792,22753,8906,5321,36980,3329,809,41118,1674,64820,22880,9145,5825,37850,5035,3155,46040,18780,733795,40429,55558,67352,167192,103526,49381,342292,349694,16995695000,951706000,1210241000,1597148000,3798015000,3338379000,1425874000,8880993000,7545185000
Oklahoma,Total,2010,71972,42203,12257,7745,62205,6175,1575,69955,2017,90050,42285,12395,8159,62839,8175,4611,75625,14425,1241168,72950,80193,102997,256140,231185,186048,673373,567795,46094301000,2377908000,2363810000,3068283000,7810001000,7630173000,6699590000,22139764000,23954537000
Oklahoma,Transportation and Warehousing,2010,11067,6490,1309,980,8779,809,414,10002,1065,12980,6490,1315,990,8795,910,630,10335,2645,174764,7385,7285,11420,30319,24923,17351,75934,78415,7351664000,315359000,236032000,397213000,966086000,982138000,732908000,2802209000,3488962000
Oklahoma,Utilities,2010,690,265,90,20,375,135,60,570,120,1765,265,90,20,375,185,180,740,1025,35957,205,515,260,1211,7567,0,14136,3199,2895985000,19061000,21974000,11880000,49618000,422383000,0,934575000,232402000
Oklahoma,Wholesale Trade,2010,18672,8235,2776,2322,13333,2319,1188,16840,1832,22970,8265,2840,2480,13585,3005,1900,18490,4480,278730,11852,15551,28008,59915,59044,44552,178245,84740,13643535000,627336000,725144000,1239643000,2678256000,2735358000,2109802000,7941933000,4879765000
Oregon,Accommodation and Food Services,2010,41353,14758,9740,9341,33839,6108,807,40754,599,51595,14790,9790,9610,34190,7920,3480,45590,6005,718765,21460,64689,125839,214253,200956,102056,525568,188586,11475415000,495715000,797099000,1693647000,3004135000,3197848000,1578096000,7818580000,3625119000
Oregon,Administrative and Support and Waste Management and Remediation Services,2010,23535,14670,3397,2072,20139,1844,557,22540,995,26245,14670,3415,2125,20210,2060,885,23155,3090,381545,22593,21209,26576,73123,61972,62483,207684,151001,11292693000,635170000,549132000,711383000,1909545000,2017341000,1596006000,5701485000,5196445000
Oregon,"Agriculture, Forestry, Fishing and Hunting",2010,6136,4050,660,710,5420,575,95,6090,46,6280,4060,660,710,5430,620,140,6190,90,57708,5376,4203,9429,19343,20427,6933,52337,3589,1904273000,216202000,154481000,317933000,698905000,685599000,173498000,1714276000,165943000
Oregon,"Arts, Entertainment, and Recreation",2010,7735,4435,1210,850,6495,954,147,7596,139,8195,4435,1220,850,6505,1105,210,7820,375,111939,3956,7240,11183,23934,35046,10168,83461,18902,2426192000,190001000,144568000,194715000,539305000,582393000,334922000,1855505000,337054000
Oregon,Construction,2010,58447,43110,7504,4513,55127,2514,407,58048,399,58985,43110,7505,4520,55135,2685,485,58305,680,334530,63506,48831,58554,173890,86046,33929,303586,23348,15392085000,1960805000,1634440000,2189430000,5784855000,4578546000,2045343000,13008924000,1718222000
Oregon,Educational Services,2010,6382,3190,1010,800,5000,930,250,6180,202,6955,3190,1015,815,5020,1030,595,6645,310,201414,4346,6302,10188,21758,36511,33534,92603,105838,5707696000,120249000,123931000,188435000,452347000,812548000,882246000,2157659000,3437328000
Oregon,Finance and Insurance,2010,16978,11585,1877,784,14246,868,611,15725,1253,29900,11600,1970,930,14500,1740,2355,18595,11305,289124,16807,11045,8022,39499,27766,28887,103276,175661,18000453000,689490000,488142000,516642000,1747593000,1624208000,1849567000,5360986000,12221362000
Oregon,Health Care and Social Assistance,2010,48442,26350,10230,5272,41852,3998,1564,47414,1028,61000,26380,10295,5455,42130,5780,5535,53445,7555,1034442,44615,66501,69248,180334,154956,173413,525139,476229,45781728000,1966073000,2604475000,2680938000,7292615000,5830563000,5950340000,19410382000,25054804000
Oregon,Information,2010,6395,3305,936,656,4897,555,291,5743,652,9885,3315,955,690,4960,580,640,6180,3705,161938,3851,4593,6544,18076,17991,18601,62733,87595,9208361000,185466000,228614000,346973000,776125000,1081823000,1138532000,3204396000,5668762000
Oregon,Management of Companies and Enterprises,2010,2505,140,55,95,290,560,747,1597,908,3180,140,55,95,290,560,810,1660,1520,186085,0,215,396,841,5640,20252,26903,159182,17272856000,13083000,22815000,18908000,57253000,329790000,1191540000,1585747000,15687109000
Oregon,Manufacturing,2010,25074,10950,4286,3385,18621,3635,1270,23526,1548,26405,10950,4290,3420,18660,3855,1515,24030,2375,659507,15583,23904,38370,86327,118504,96008,348234,243087,31470914000,572102000,834132000,1409859000,3022972000,4937295000,4393757000,14360337000,13760573000
Oregon,"Mining, Quarrying, and Oil and Gas Extraction",2010,575,290,80,75,445,70,10,525,50,700,290,80,75,445,75,10,530,170,6595,229,493,809,1828,162,0,3695,674,318202000,20128000,19736000,30674000,74852000,18608000,0,153661000,46204000
Oregon,Other,2010,286,277,5,4,286,0,0,286,0,286,277,5,4,286,0,0,286,0,318,0,0,0,318,0,0,318,0,3905000,3228000,0,0,3905000,0,0,3905000,0
Oregon,Other Services (except Public Administration),2010,43059,27155,8577,4307,40039,2254,350,42643,416,47195,27180,8625,4530,40335,3105,2225,45665,1530,303676,47691,55050,55243,161464,75017,22697,267446,21847,7696290000,1172145000,1241934000,1292456000,3730808000,1883891000,635941000,6580999000,691841000
Oregon,"Professional, Scientific, and Technical Services",2010,55389,40030,6580,4021,50631,2554,851,54036,1353,58190,40050,6595,4135,50780,2815,1150,54745,3445,456973,54541,41943,48239,153621,76772,41835,280404,124153,22209191000,2574216000,1786869000,2432863000,6824412000,4671564000,2535889000,14407250000,6839150000
Oregon,Real Estate and Rental and Leasing,2010,22818,17762,2285,1055,21102,822,371,22295,523,28010,17820,2395,1190,21405,1260,1890,24555,3455,132594,25431,14335,12283,54154,25038,16274,96612,26449,4213071000,688589000,430734000,336628000,1479705000,739378000,519413000,2921487000,998947000
Oregon,Retail Trade,2010,47120,24527,9800,6006,40333,3741,1122,45196,1924,69175,24660,9975,6805,41440,6295,4590,52325,16850,889741,38658,61262,74510,176105,121613,76417,394798,439846,22825694000,980938000,1347294000,1735290000,4103648000,3480894000,2386355000,10277938000,11529524000
Oregon,Total,2010,87996,53341,14559,9457,77357,6804,1756,85917,2079,107397,53431,14722,9959,78112,9217,5901,93230,14167,1351164,88672,95896,125241,309809,245106,195378,750293,600871,54367614000,2750942000,2770704000,3708892000,9230538000,8702174000,7489613000,25422325000,28945289000
Oregon,Transportation and Warehousing,2010,12709,7372,1590,1095,10057,1093,487,11637,1072,14680,7380,1610,1135,10125,1210,690,12025,2655,226908,8376,9323,13369,35173,31444,18049,92631,98853,9186953000,332578000,341874000,412514000,1119060000,1278477000,804250000,3398812000,4515928000
Oregon,Utilities,2010,632,365,30,25,420,105,25,550,82,1455,365,30,25,420,165,40,625,830,33300,641,0,297,1206,4267,0,5801,18159,2780342000,14585000,0,18637000,40374000,357718000,1574000,419851000,1547966000
Oregon,Wholesale Trade,2010,23179,11357,3054,2527,16938,2627,1394,20959,2220,27525,11385,3105,2660,17150,3225,2260,22635,4890,348232,16473,16978,28990,68255,69323,49061,206967,124218,20420215000,789138000,826372000,1433400000,3124474000,3415776000,2694689000,10225606000,9924938000
Pennsylvania,Accommodation and Food Services,2010,110163,51463,21721,17580,90764,16191,1941,108896,1267,138415,51530,21785,17775,91090,18240,6310,115640,22775,2103832,88995,143794,237644,471427,582939,274838,1330640,769919,31400635000,1642270000,1714164000,2745791000,6109305000,7878956000,3758446000,17762025000,13591071000
Pennsylvania,Administrative and Support and Waste Management and Remediation Services,2010,64705,39350,9200,6429,54979,5342,2060,62381,2324,74045,39370,9220,6535,55125,5830,3285,64240,9805,1362991,54804,59850,86241,203532,201292,265962,678503,668921,42314886000,2406855000,1917461000,2745661000,7089183000,6825019000,6644075000,20847031000,21000482000
Pennsylvania,"Agriculture, Forestry, Fishing and Hunting",2010,2435,1880,280,150,2310,75,25,2410,25,2435,1880,280,150,2310,75,25,2410,25,14815,2990,1167,939,6427,2264,820,11171,0,384126000,79707000,41760000,32176000,169846000,76645000,30545000,339736000,17287000
Pennsylvania,"Arts, Entertainment, and Recreation",2010,21265,11610,3275,2547,17432,2845,615,20892,373,22540,11615,3280,2600,17495,3090,845,21430,1110,425864,15628,20365,33205,71412,113600,84059,273789,134390,12120501000,607763000,445076000,864150000,2015316000,2170445000,2070948000,7048008000,4772994000
Pennsylvania,Construction,2010,132874,90420,19615,12818,122853,7987,1306,132146,728,134175,90425,19615,12840,122880,8190,1590,132660,1515,1104725,142089,127809,171755,442075,286740,173042,908645,177885,58181990000,5352835000,5156495000,7704455000,18213785000,16609175000,9981754000,45237520000,12231546000
Pennsylvania,Educational Services,2010,15541,6345,2165,1980,10490,3476,884,14850,691,17485,6345,2165,2075,10585,3865,1390,15840,1645,1223560,8614,14316,26791,51414,150702,138529,344920,873786,45380270000,363100000,310693000,606409000,1290430000,4313680000,4792917000,10487650000,34854627000
Pennsylvania,Finance and Insurance,2010,47133,29593,7494,3266,40353,3013,1404,44770,2363,89335,29660,7775,3815,41250,5735,6945,53930,35405,1300722,53939,45731,41045,142459,100715,122969,377464,883302,89029287000,2444979000,2494603000,2576799000,7559229000,7270070000,7554261000,22830419000,65801749000
Pennsylvania,Health Care and Social Assistance,2010,126746,55358,28312,18463,102133,15219,5584,122936,3810,179900,55585,28620,19555,103760,22355,20780,146895,33005,4640105,111055,186376,247047,544868,575270,854679,1978698,2658782,187553689000,4436605000,7074932000,10143682000,21723684000,22715481000,27650533000,72175097000,115294198000
Pennsylvania,Information,2010,12749,5650,2045,1610,9305,1585,620,11510,1239,25050,5650,2050,1690,9390,1940,1090,12420,12630,553102,8779,12840,19103,43399,53613,49087,153461,396335,36670736000,371906000,494003000,818488000,1724341000,2689419000,3129337000,7888967000,28596147000
Pennsylvania,Management of Companies and Enterprises,2010,6998,345,165,270,780,1213,2089,4082,2916,10915,350,165,280,795,1240,2275,4310,6605,708760,0,572,1847,3115,15846,69394,88355,620315,66868000000,52809000,146072000,132084000,367483000,1174938000,5168905000,6711326000,60151975000
Pennsylvania,Manufacturing,2010,66495,22178,11378,10409,43965,13241,4519,61725,4770,70835,22180,11385,10460,44025,13850,5560,63435,7400,2593788,36986,69841,132908,251403,488084,476675,1274136,1193620,129178942000,1501978000,2487053000,5266357000,9539255000,21656360000,22506968000,56187272000,66912363000
Pennsylvania,"Mining, Quarrying, and Oil and Gas Extraction",2010,4240,2000,650,500,3150,570,201,3921,319,5330,2000,650,500,3150,665,355,4170,1160,112787,2673,3678,6345,14020,19320,15788,50035,61345,8322091000,171008000,189735000,300327000,673116000,1166082000,1158852000,3044011000,5215515000
Pennsylvania,Other,2010,359,340,13,6,359,0,0,359,0,359,340,13,6,359,0,0,359,0,0,0,0,67,0,0,0,0,0,7501000,5902000,1496000,103000,7501000,0,0,7501000,0
Pennsylvania,Other Services (except Public Administration),2010,165633,103330,34436,16737,154503,8973,1287,164763,870,177205,103395,34690,17255,155340,10950,3785,170075,7130,1200906,201399,220437,218056,641297,309144,117009,1074586,90395,28905610000,4288310000,4562416000,4577717000,13442355000,7648060000,3723130000,24908515000,3067325000
Pennsylvania,"Professional, Scientific, and Technical Services",2010,136765,91669,18375,12033,122077,9162,2471,133710,3055,148460,91735,18480,12380,122595,11170,3845,137610,10850,1543355,138696,118473,157635,422548,308657,213608,952097,563875,104130435000,6872417000,6207677000,8861307000,21971780000,20545255000,14935705000,57645147000,44603408000
Pennsylvania,Real Estate and Rental and Leasing,2010,34604,23203,5054,2489,30746,2016,832,33594,1010,46210,23280,5295,2885,31460,3015,2955,37430,8780,315921,33379,32495,31686,102711,63479,42857,215738,81959,12911539000,1299117000,1141917000,1184194000,3630849000,2925181000,1839222000,8577025000,4032128000
Pennsylvania,Retail Trade,2010,137209,75638,26923,16367,118928,12197,2915,134040,3169,222150,75860,27630,18135,121625,17900,10930,150455,71695,3055402,117521,156616,192216,480939,427763,285985,1216570,1518076,72436861000,3109333000,3748516000,4983320000,11980112000,13484736000,7814586000,33879269000,36180436000
Pennsylvania,Total,2010,231192,131847,41063,26933,199843,22119,5292,227254,3938,297023,132066,41561,28281,201908,28437,15897,246242,50781,4976193,231401,269441,360841,861683,827944,729406,2419033,2557160,211638083000,7810577000,8571430000,12280858000,28662865000,31681937000,28826299000,89171101000,122466982000
Pennsylvania,Transportation and Warehousing,2010,33193,17585,4359,3814,25758,3866,1333,30957,2236,39535,17600,4370,3870,25840,4280,1760,31880,7655,888487,25951,27202,49117,104670,134089,106118,348610,442310,31917410000,938943000,858988000,1537596000,3390496000,4167976000,3253796000,10973981000,17258900000
Pennsylvania,Utilities,2010,981,360,115,70,545,132,55,732,249,3915,360,120,70,550,195,135,880,3035,154380,369,342,530,1426,5261,2029,10532,136698,14651852000,26355000,11698000,36674000,94161000,363667000,148712000,680390000,13645877000
Pennsylvania,Wholesale Trade,2010,63256,29777,10065,8121,47963,7954,3388,59305,3951,75385,29810,10165,8505,48480,9600,5625,63705,11680,1165622,48918,61227,101424,220452,248840,204735,696462,448995,70942249000,2645555000,3267210000,5268631000,11289432000,13352786000,10667943000,36283430000,34296756000
Rhode Island,Accommodation and Food Services,2010,12671,5405,2375,2305,10085,2051,177,12313,358,14725,5405,2380,2355,10140,2310,480,12930,1795,205012,7780,15912,31680,55583,70613,21872,148592,56367,3420091000,259710000,211816000,438650000,914759000,1136898000,397171000,2467296000,952188000
Rhode Island,Administrative and Support and Waste Management and Remediation Services,2010,8050,5475,800,495,6770,550,218,7538,512,8430,5475,805,495,6775,570,230,7575,855,99497,4910,4437,5191,16263,17553,25086,63606,30939,2975233000,377852000,169280000,179126000,758614000,554780000,516056000,1942556000,857965000
Rhode Island,"Agriculture, Forestry, Fishing and Hunting",2010,220,195,10,10,215,5,0,220,0,220,195,10,10,215,5,0,220,0,104,115,0,0,148,0,0,104,0,13614000,7584000,0,0,7564000,0,0,13614000,0
Rhode Island,"Arts, Entertainment, and Recreation",2010,2509,1350,410,310,2070,309,65,2444,65,2715,1350,410,310,2070,315,170,2555,160,35530,1429,2300,3359,8247,9316,4886,24475,939,886300000,84671000,81675000,86526000,290011000,226563000,107434000,690824000,11348000
Rhode Island,Construction,2010,15432,11805,1840,1080,14725,555,90,15370,62,15455,11805,1840,1080,14725,560,90,15375,80,79373,14006,10768,13686,41685,17369,8532,75083,0,4258802000,692755000,481629000,715582000,1944721000,993533000,495648000,3862754000,6689000
Rhode Island,Educational Services,2010,1901,945,230,165,1340,340,106,1786,115,2015,945,235,170,1350,375,125,1850,165,127145,697,1225,1942,4831,12765,10338,29222,91444,4355178000,42994000,23366000,54442000,136903000,397331000,391720000,956577000,3174415000
Rhode Island,Finance and Insurance,2010,4415,2430,595,250,3275,298,177,3750,665,7025,2430,595,270,3295,430,580,4305,2720,82248,3146,3441,2168,8560,5714,10257,30323,46682,7109866000,196378000,195096000,186704000,610974000,417362000,597726000,1981734000,4093808000
Rhode Island,Health Care and Social Assistance,2010,12682,5200,2970,1760,9930,1394,810,12134,548,16340,5215,2990,1815,10020,1920,2585,14525,1815,413604,8989,18779,22695,53338,55270,106608,220623,177853,16942920000,432035000,820532000,959897000,2236362000,2258227000,3600784000,8361685000,8226723000
Rhode Island,Information,2010,1309,515,220,115,850,160,60,1070,239,2075,515,220,115,850,210,75,1135,940,33580,327,1257,823,2443,5002,1310,11574,14587,1908708000,28983000,55473000,30191000,142897000,239036000,44455000,541648000,963429000
Rhode Island,Management of Companies and Enterprises,2010,631,40,25,25,90,70,186,346,285,860,40,25,25,90,70,205,365,495,44340,0,7,137,26,951,6052,7700,36640,4731820000,0,4773000,7857000,16350000,54617000,372686000,458555000,4273265000
Rhode Island,Manufacturing,2010,7657,3080,1379,1125,5584,1396,357,7337,320,7770,3080,1380,1145,5605,1425,390,7420,350,167463,3559,6659,11457,25055,42049,20621,114478,27889,8170801000,189570000,259652000,438308000,998420000,1844362000,912956000,5000002000,1847803000
Rhode Island,"Mining, Quarrying, and Oil and Gas Extraction",2010,105,60,15,15,90,5,0,95,10,110,60,15,15,90,5,0,95,15,422,0,63,114,240,0,0,315,0,31042000,3319000,2400000,7440000,20661000,0,0,26245000,0
Rhode Island,Other,2010,44,44,0,0,44,0,0,44,0,44,44,0,0,44,0,0,44,0,0,0,0,0,0,0,0,0,0,723000,723000,0,0,723000,0,0,723000,0
Rhode Island,Other Services (except Public Administration),2010,13742,9025,2550,1211,12786,656,85,13527,215,14345,9030,2565,1225,12820,830,90,13740,605,83198,15754,15615,13220,46540,19085,2054,75810,5504,2298199000,444040000,392541000,387632000,1243917000,612328000,73846000,2135079000,119660000
Rhode Island,"Professional, Scientific, and Technical Services",2010,14486,10045,1895,1053,12993,670,273,13936,550,15135,10045,1900,1055,13000,720,295,14015,1120,110964,13517,10826,11311,39780,17729,13586,77739,28882,7240785000,703905000,594557000,733555000,2068571000,1164771000,879489000,4409300000,2692689000
Rhode Island,Real Estate and Rental and Leasing,2010,4437,3150,470,263,3883,230,109,4222,215,5335,3165,505,350,4020,285,260,4565,770,26103,4446,2547,2649,10552,5781,2022,19394,3964,1047711000,177516000,108340000,101579000,390860000,221796000,69502000,732592000,239525000
Rhode Island,Retail Trade,2010,14791,8585,2488,1422,12495,801,320,13616,1175,19430,8615,2570,1525,12710,915,730,14355,5075,218960,11068,13673,16814,45837,18592,7125,78541,79275,5742776000,361179000,379395000,454908000,1242934000,699030000,370159000,2487160000,2074064000
Rhode Island,Total,2010,24556,14475,3932,2483,20890,2068,579,23537,1019,28521,14491,3975,2566,21032,2433,1340,24805,3716,399000,23742,25756,33176,82674,73938,64407,221019,177981,16831981000,899602000,883741000,1162005000,2945348000,2805828000,2546801000,8297977000,8534004000
Rhode Island,Transportation and Warehousing,2010,2984,1850,335,225,2410,241,80,2731,253,3200,1850,335,225,2410,255,90,2755,445,33582,1421,1412,1751,5592,5284,1522,15949,8434,1355183000,82575000,55092000,71140000,238000000,195243000,63862000,629916000,407773000
Rhode Island,Utilities,2010,62,20,0,5,25,10,0,35,27,155,20,0,5,25,10,0,35,120,2272,0,0,0,0,0,0,159,0,198410000,0,0,0,3118000,0,0,11613000,191404000
Rhode Island,Wholesale Trade,2010,6668,2990,1090,630,4710,870,298,5878,790,7045,2995,1095,640,4730,955,305,5990,1055,84609,3972,5713,5697,18314,19387,7168,55565,19442,4870537000,222395000,314852000,332612000,1002671000,1102160000,455432000,3131739000,1245386000
South Carolina,Accommodation and Food Services,2010,35590,13183,6440,7126,26749,6789,1086,34624,966,47660,13225,6490,7210,26925,7670,3880,38475,9185,872372,21040,43646,97033,161896,251398,144423,559177,312669,12416768000,449569000,535874000,1223912000,2214912000,3553582000,1870516000,7656523000,4754335000
South Carolina,Administrative and Support and Waste Management and Remediation Services,2010,24119,14355,3635,2230,20220,1967,712,22899,1220,27035,14360,3635,2260,20255,2110,925,23290,3745,607691,22867,23514,27542,77143,69866,99348,250612,341354,16800976000,703552000,616342000,777396000,2123405000,1973280000,2219509000,6481163000,10085275000
South Carolina,"Agriculture, Forestry, Fishing and Hunting",2010,2585,1290,660,400,2350,160,35,2545,40,2605,1290,660,400,2350,170,35,2555,50,18870,2173,3976,4835,11442,4305,851,18468,371,683636000,74632000,134142000,164281000,389904000,147685000,21183000,598559000,27420000
South Carolina,"Arts, Entertainment, and Recreation",2010,7106,3805,1000,800,5605,1143,233,6981,125,7730,3810,1000,850,5660,1240,485,7385,345,112007,5194,5935,9759,22253,43563,24744,96064,13203,2049703000,158026000,108645000,178216000,460178000,779626000,419803000,1751132000,210536000
South Carolina,Construction,2010,47803,31375,7770,4845,43990,3046,365,47401,402,48440,31380,7770,4865,44015,3100,500,47615,825,406085,50623,50709,63514,166105,105758,35115,312050,35900,16540866000,1427225000,1535461000,2029333000,4994495000,4107467000,1432471000,10680245000,2027076000
South Carolina,Educational Services,2010,4930,2530,640,625,3795,785,155,4735,195,5285,2530,640,630,3800,835,230,4865,420,149987,3957,3773,8172,16545,29990,26983,74724,72588,3412623000,101242000,72229000,124362000,307029000,680546000,749746000,1756060000,1591105000
South Carolina,Finance and Insurance,2010,16463,10298,2422,1066,13786,869,553,15208,1255,36660,10375,2635,1405,14415,2485,3700,20600,16060,316952,15888,14565,13086,45959,26438,38406,116735,187659,16308493000,660805000,546521000,553082000,1798990000,1244040000,1837841000,5135613000,10819494000
South Carolina,Health Care and Social Assistance,2010,38412,16775,9210,5645,31630,4432,1163,37225,1187,48620,16805,9280,5860,31945,5450,3450,40845,7775,1076878,30186,60821,74301,167853,167259,152729,494793,568088,43904718000,1498562000,2381911000,2874688000,6765079000,6719037000,4650398000,18294610000,25545889000
South Carolina,Information,2010,3511,1660,395,290,2345,375,194,2914,597,6965,1660,395,310,2365,440,365,3170,3795,140397,2081,1784,2573,7147,9790,10433,31929,102961,7221103000,88806000,71521000,71929000,280665000,483774000,571637000,1479055000,5699434000
South Carolina,Management of Companies and Enterprises,2010,2115,160,30,70,260,310,645,1215,900,3120,160,30,75,265,310,700,1275,1845,119200,175,0,350,583,2863,16299,19808,99023,9376550000,17838000,8178000,14070000,41488000,163281000,961850000,1166130000,8157326000
South Carolina,Manufacturing,2010,18334,6600,2635,2465,11700,2795,1389,15884,2450,19830,6605,2635,2465,11705,2990,1625,16320,3510,880726,9000,14454,27164,56664,92847,110240,301609,509784,39051310000,373603000,478855000,1024776000,2043804000,3723777000,4766533000,11992350000,24137263000
South Carolina,"Mining, Quarrying, and Oil and Gas Extraction",2010,318,130,35,50,215,50,10,275,43,425,130,35,50,215,50,10,275,150,4459,100,40,472,885,1056,0,2237,2213,245968000,6683000,13861000,15533000,38548000,53261000,0,111926000,116496000
South Carolina,Other,2010,222,213,7,2,222,0,0,222,0,222,213,7,2,222,0,0,222,0,271,195,0,0,271,0,0,271,0,3718000,3143000,0,0,3718000,0,0,3718000,0
South Carolina,Other Services (except Public Administration),2010,52323,31910,11093,5185,48188,3154,466,51808,515,55570,31920,11145,5305,48370,4020,1100,53490,2080,383015,59829,70417,67275,201207,109543,32102,348603,27741,8534594000,1291873000,1448457000,1413579000,4174858000,2347739000,859798000,7504134000,904549000
South Carolina,"Professional, Scientific, and Technical Services",2010,44851,31525,6037,3300,40862,1925,787,43574,1277,48505,31530,6055,3425,41010,2410,1290,44710,3795,390435,45393,37646,41364,128374,57349,42572,242075,135961,20881375000,1969999000,1534502000,1819672000,5342016000,3572924000,2853218000,12093953000,8306243000
South Carolina,Real Estate and Rental and Leasing,2010,18325,13920,1713,962,16595,706,407,17708,617,23615,13995,1790,1080,16865,1265,945,19075,4540,124730,19333,10416,11259,43000,21464,19021,85685,30486,4059142000,607093000,338108000,357310000,1325905000,662048000,635641000,2707435000,1183573000
South Carolina,Retail Trade,2010,54113,31992,10378,5323,47693,3465,863,52021,2092,88540,32115,10710,5895,48720,6020,3395,58135,30405,1003786,53628,62569,59459,185269,105538,47822,345649,589728,22476933000,1318440000,1401888000,1631616000,4540984000,3385310000,1416872000,9509490000,12611380000
South Carolina,Total,2010,78883,45521,13673,8645,67839,6842,1849,76530,2353,102045,45636,13869,9080,68585,8894,5115,82594,19451,1502853,78795,89481,115460,283736,246292,197733,727761,775092,52547532000,2365929000,2515450000,3257791000,8139170000,7732361000,6451557000,22323088000,30224444000
South Carolina,Transportation and Warehousing,2010,10456,5652,1270,837,7759,859,652,9270,1186,12370,5660,1280,865,7805,925,840,9570,2800,221982,7214,6900,8707,24860,21613,27082,78827,134406,7916053000,265128000,231816000,302864000,836626000,708415000,952526000,2602776000,5018688000
South Carolina,Utilities,2010,430,120,65,40,225,100,55,380,50,1645,120,65,40,225,145,170,540,1105,54117,119,353,0,1091,4560,7088,12790,41267,4019108000,5432000,13263000,17545000,36240000,241671000,396145000,676039000,3341521000
South Carolina,Wholesale Trade,2010,20083,9393,3028,2253,14674,2363,1140,18177,1906,24495,9445,3060,2400,14905,2835,1930,19670,4825,288814,13220,17647,25225,60574,56030,34027,169745,93695,14417429000,659253000,831821000,1097493000,2700800000,2742490000,1719911000,7711931000,5586162000
South Dakota,Accommodation and Food Services,2010,10293,3945,1785,2133,7863,1862,356,10081,212,11795,3945,1815,2195,7955,2145,880,10980,815,187758,5503,11922,29539,47571,63798,41350,152938,34094,2563237000,140701000,119896000,330256000,598606000,801474000,614265000,2028192000,534631000
South Dakota,Administrative and Support and Waste Management and Remediation Services,2010,5097,3275,730,410,4415,273,125,4813,284,5365,3275,730,425,4430,320,165,4915,450,49552,3547,4305,4184,13428,7889,7313,32239,11103,1306567000,144172000,114055000,81280000,365468000,214463000,142059000,875315000,275318000
South Dakota,"Agriculture, Forestry, Fishing and Hunting",2010,630,490,65,45,600,15,10,625,5,630,490,65,45,600,15,10,625,5,2386,547,218,458,1404,0,0,2341,0,81581000,19893000,8990000,15101000,47606000,0,0,80851000,0
South Dakota,"Arts, Entertainment, and Recreation",2010,3167,1845,565,385,2795,253,89,3137,30,3330,1845,565,390,2800,300,195,3295,35,30247,2028,3000,4452,10514,6806,4706,27592,190,484861000,74712000,49593000,80767000,212613000,115219000,54884000,467831000,5171000
South Dakota,Construction,2010,15681,11055,2290,1555,14900,580,141,15621,60,15790,11055,2290,1560,14905,580,205,15690,100,88947,16742,14535,19213,52738,19098,9417,86127,1388,3646484000,627834000,499847000,772437000,1919303000,948664000,483353000,3443319000,95664000
South Dakota,Educational Services,2010,1050,480,135,115,730,175,95,1000,50,1095,480,135,115,730,175,110,1015,80,37251,538,781,1191,3005,7675,14039,26857,10310,851047000,13710000,13408000,18852000,53298000,152331000,380283000,634673000,213321000
South Dakota,Finance and Insurance,2010,6006,3812,657,438,4907,388,182,5477,529,9565,3815,695,600,5110,855,1010,6975,2590,111518,5976,3570,5055,14916,10877,11982,38562,63214,5514993000,219607000,150694000,191993000,583159000,453389000,580592000,1669406000,2985255000
South Dakota,Health Care and Social Assistance,2010,9203,4120,1865,1280,7265,1093,554,8912,291,11550,4135,1880,1330,7345,1750,1565,10660,890,298816,6032,12018,16383,36285,40814,68246,150450,145360,11517858000,292067000,385441000,635701000,1341351000,1369463000,2245985000,5055520000,6425795000
South Dakota,Information,2010,1390,545,215,185,945,186,77,1208,182,2095,545,225,190,960,310,300,1570,525,32319,810,1053,1338,3641,5999,2706,17830,7320,1316259000,22594000,25713000,42721000,107513000,192654000,108586000,661246000,268027000
South Dakota,Management of Companies and Enterprises,2010,663,10,31,15,56,140,245,441,222,745,10,35,15,60,140,255,455,290,26439,0,152,48,209,950,5147,6550,19726,2241354000,0,5047000,2136000,8101000,59051000,347151000,427135000,1804643000
South Dakota,Manufacturing,2010,4719,1815,800,645,3260,722,347,4329,390,5035,1815,800,650,3265,760,480,4505,530,139139,2237,3462,5051,13249,20518,17855,68516,55665,5510521000,83099000,109277000,191773000,434061000,830865000,683302000,2542553000,2217504000
South Dakota,"Mining, Quarrying, and Oil and Gas Extraction",2010,300,160,35,20,215,22,34,271,29,335,160,35,20,215,25,55,295,40,3215,182,26,172,572,0,937,2329,649,197255000,10030000,5898000,19451000,43291000,0,77156000,142082000,29950000
South Dakota,Other,2010,59,57,2,0,59,0,0,59,0,59,57,2,0,59,0,0,59,0,0,0,0,0,0,0,0,0,0,755000,742000,0,0,755000,0,0,755000,0
South Dakota,Other Services (except Public Administration),2010,13056,8540,2500,1265,12305,542,104,12951,105,13535,8540,2515,1295,12350,740,160,13250,285,73714,14723,15188,14755,47686,15290,790,66360,552,1465867000,313220000,326678000,273987000,956154000,333911000,21038000,1376704000,39830000
South Dakota,"Professional, Scientific, and Technical Services",2010,8619,5710,1250,810,7770,415,126,8311,308,9045,5710,1280,835,7825,525,170,8520,525,52089,8158,7647,9478,27692,10538,2991,44215,6308,2113746000,305381000,282144000,332295000,960625000,508531000,170349000,1768424000,299559000
South Dakota,Real Estate and Rental and Leasing,2010,4073,3095,348,265,3708,130,85,3923,150,4570,3095,350,305,3750,180,300,4230,340,17420,2218,1836,2847,9400,2003,2163,15107,1906,471133000,100775000,46461000,69857000,234355000,57486000,55605000,383049000,71395000
South Dakota,Retail Trade,2010,15435,7049,3183,2436,12668,1397,494,14559,876,19865,7075,3215,2570,12860,1970,1715,16545,3320,216068,10563,18601,28928,63043,40163,24037,138817,64696,4793992000,287689000,407902000,613251000,1350146000,1099019000,569972000,3228518000,1286126000
South Dakota,Total,2010,21637,12332,3578,2619,18529,1807,551,20887,750,25622,12344,3625,2759,18728,2525,1709,22962,2660,329163,20695,23448,34572,78715,64232,60910,203857,125306,10843236000,600926000,606322000,907434000,2114682000,1916803000,1939260000,5970745000,4872491000
South Dakota,Transportation and Warehousing,2010,5262,3465,700,455,4620,299,126,5045,217,5670,3465,700,465,4630,340,175,5145,525,43407,4540,3790,5250,14634,8599,2124,29773,11199,1494477000,146744000,120414000,150045000,434692000,316134000,77044000,946852000,441019000
South Dakota,Utilities,2010,335,40,45,75,160,100,15,275,60,770,40,45,75,160,170,55,385,385,10145,0,286,1085,1468,2916,681,5707,0,632445000,2747000,11233000,50940000,66248000,171907000,46905000,324956000,0
South Dakota,Wholesale Trade,2010,5477,1935,735,674,3344,979,428,4751,726,7030,1940,740,715,3395,1325,740,5460,1570,80481,2524,3397,6951,14370,24809,11623,58069,16858,3563134000,114018000,156304000,259803000,584971000,951037000,564482000,2351959000,977297000
Tennessee,Accommodation and Food Services,2010,39809,14450,7407,7699,29556,7927,1095,38578,1231,58445,14465,7450,7940,29855,9265,4575,43695,14750,1147410,22673,49673,104850,178135,280569,145570,605057,540607,16453900000,518440000,628170000,1311718000,2459325000,3915300000,1880014000,8264114000,8155017000
Tennessee,Administrative and Support and Waste Management and Remediation Services,2010,26835,14795,3790,3060,21645,2527,950,25122,1713,32385,14825,3805,3095,21725,2660,1390,25775,6610,898195,23155,23034,39905,87842,95752,108519,303978,577716,26657502000,903381000,699352000,1298572000,2964603000,3281136000,3264116000,9739506000,16177687000
Tennessee,"Agriculture, Forestry, Fishing and Hunting",2010,1165,795,220,80,1095,35,20,1150,15,1180,795,225,80,1100,35,20,1155,25,6169,1105,1358,848,3549,870,0,5800,0,207095000,42115000,40931000,24886000,113329000,31032000,0,195733000,0
Tennessee,"Arts, Entertainment, and Recreation",2010,10861,6135,1850,1327,9312,1083,232,10627,234,11410,6135,1855,1335,9325,1225,290,10840,570,144692,7301,11062,17226,39373,39282,20198,105242,32379,5356442000,467730000,400706000,667237000,1545443000,1248909000,879322000,4196716000,679335000
Tennessee,Construction,2010,49278,30315,7750,6019,44084,4074,661,48819,459,50125,30315,7750,6020,44085,4145,840,49070,1055,490955,49765,50873,80323,181815,149852,83116,421185,59524,20484520000,1617465000,1695989000,2803131000,6144465000,6840316000,3751289000,16913075000,3249339000
Tennessee,Educational Services,2010,5599,2425,845,735,4005,840,443,5288,311,5950,2425,845,775,4045,850,525,5420,530,284862,3810,5697,9352,18354,32490,72139,131984,147570,8720511000,147050000,112755000,221972000,499160000,865803000,2223275000,3816461000,4755792000
Tennessee,Finance and Insurance,2010,23378,14793,2853,1362,19008,1676,948,21632,1746,49585,14860,3045,1895,19800,4540,5255,29595,19990,540101,23462,17190,16021,60260,59884,75834,204962,311405,33961609000,1102704000,824658000,844340000,2864093000,3875594000,3980223000,11623484000,21845682000
Tennessee,Health Care and Social Assistance,2010,55904,24433,13828,8093,46354,5737,2110,54201,1703,74345,24480,13905,8435,46820,7555,6570,60945,13400,1839114,48634,90469,105196,246554,214625,307649,777956,1033725,78312355000,2236616000,3552231000,4409989000,10202656000,9822340000,11446326000,31676266000,45960446000
Tennessee,Information,2010,6997,3490,950,761,5201,670,310,6181,816,12105,3490,960,800,5250,770,605,6625,5480,211925,4597,5420,7319,20040,20745,14722,64321,141000,10476548000,260424000,202989000,305431000,829367000,885966000,638919000,2859632000,7356619000
Tennessee,Management of Companies and Enterprises,2010,3699,135,55,110,300,637,1066,2003,1696,6710,135,55,115,305,645,1085,2035,4675,356110,8,148,47,0,5945,27724,34910,321164,32934880000,25020000,13235000,3012000,74105000,557940000,1957098000,2603890000,30328513000
Tennessee,Manufacturing,2010,27776,9750,4470,3745,17965,4594,2143,24702,3074,29805,9750,4480,3755,17985,4795,2610,25390,4415,1256727,14544,24922,45091,92546,155391,169183,464792,714111,55843958000,590562000,838951000,1601067000,3190270000,6174484000,6978093000,18278591000,33976508000
Tennessee,"Mining, Quarrying, and Oil and Gas Extraction",2010,658,220,85,95,400,101,56,557,101,1085,220,85,95,400,110,145,655,430,10671,153,383,701,1357,2026,3310,7984,382,721267000,7287000,12837000,43996000,77863000,100582000,145383000,411481000,20356000
Tennessee,Other,2010,217,211,2,3,216,1,0,217,0,217,211,2,3,216,1,0,217,0,0,0,0,0,0,0,0,0,0,3836000,3587000,0,0,3819000,0,0,3836000,0
Tennessee,Other Services (except Public Administration),2010,65436,40080,12975,6808,59863,4329,630,64822,614,70545,40100,13015,7125,60240,5660,1320,67220,3325,543990,74955,82511,88553,250501,157477,53214,467159,54678,13116996000,1653950000,1774899000,1967543000,5417729000,3650085000,1237903000,10408035000,2164678000
Tennessee,"Professional, Scientific, and Technical Services",2010,50265,32787,7255,4710,44752,3002,1075,48829,1436,55195,32805,7290,4835,44930,3625,1575,50130,5065,503840,53672,46032,60299,161936,92354,70733,332194,156840,26965673000,2267151000,2023413000,2836326000,7171407000,5414689000,3901139000,16762852000,9651223000
Tennessee,Real Estate and Rental and Leasing,2010,19310,13317,2467,1353,17137,878,559,18574,736,27640,13360,2535,1535,17430,1535,2265,21230,6410,158406,20202,15370,15846,53102,23149,21930,108085,50250,5609609000,643440000,483716000,559619000,1723691000,811377000,823072000,3616494000,1955007000
Tennessee,Retail Trade,2010,70877,40780,13496,7674,61950,5216,1295,68461,2416,114065,40905,13790,8630,63325,7515,5280,76120,37945,1345928,70248,86602,97495,255622,168392,89856,531103,749990,32354394000,1639071000,1994896000,2523724000,6180346000,5668834000,2830057000,14968859000,16379479000
Tennessee,Total,2010,97976,53940,17338,11628,82906,9384,2710,95000,2976,131582,54038,17555,12322,83915,12249,7700,103864,27718,2264032,97304,114100,155400,366804,340836,309942,1017582,1246450,87535962000,3150401000,3436508000,4946439000,11533348000,12614037000,11793977000,35941362000,51594600000
Tennessee,Transportation and Warehousing,2010,15912,8085,2122,1614,11821,1469,840,14130,1782,20805,8090,2130,1630,11850,1615,1185,14650,6155,433552,11593,13165,18467,47817,45020,54010,152496,256469,16993857000,442571000,411370000,616919000,1514736000,1685760000,2180207000,5531773000,10625721000
Tennessee,Utilities,2010,300,60,20,10,90,95,45,230,70,750,60,20,10,90,200,220,510,240,15110,44,102,0,307,5135,2480,11856,2822,914562000,1373000,1171000,0,7391000,291901000,380770000,691631000,190204000
Tennessee,Wholesale Trade,2010,28068,11917,4426,3317,19660,3767,1776,25203,2865,34695,11920,4525,3490,19935,4495,2745,27175,7520,552754,19215,27113,38833,91226,107693,78725,292805,241665,30094670000,988780000,1197897000,1968596000,4233655000,5761816000,4142249000,14741205000,14610552000
Texas,Accommodation and Food Services,2010,157364,60224,30166,29595,119985,31459,3854,155298,2066,230225,60305,30370,30130,120805,37160,17430,175395,54830,4543277,97907,200198,396966,697243,1170234,619949,2493992,2045675,68225711000,2304432000,2508575000,5057410000,9878235000,16476433000,8966426000,35360096000,32813568000
Texas,Administrative and Support and Waste Management and Remediation Services,2010,106592,59807,16335,11470,87612,11164,4104,102880,3712,126475,59850,16395,11700,87945,11995,5905,105845,20630,4121847,94842,104994,149167,353247,425961,609014,1415794,2678535,134608337000,4315589000,3626026000,5040454000,13012070000,15209466000,19229085000,47649675000,85940452000
Texas,"Agriculture, Forestry, Fishing and Hunting",2010,4970,3380,900,405,4685,190,60,4935,35,5265,3380,900,405,4685,210,295,5190,75,30489,4604,5430,5252,15716,5409,4361,26414,3981,1072393000,193118000,198087000,195223000,607243000,191457000,104726000,937533000,129074000
Texas,"Arts, Entertainment, and Recreation",2010,27500,15185,4347,3734,23266,3036,782,27084,416,30505,15195,4380,3800,23375,3235,1085,27695,2810,568739,20194,28045,50220,102417,110503,112215,336904,171506,15073307000,1272456000,606825000,940802000,2830185000,2061481000,4817247000,10057911000,3824704000
Texas,Construction,2010,191981,113040,33405,22560,169005,18157,3273,190435,1546,196605,113040,33425,22595,169060,18735,4560,192355,4250,2697710,195285,220675,305395,721355,704745,507580,1935755,756539,124467585000,7403770000,7618470000,11151255000,26173495000,31054340000,23377252000,80680215000,43551625000
Texas,Educational Services,2010,25353,12305,3970,3393,19668,4146,941,24755,598,28165,12320,3975,3430,19725,4570,1585,25880,2285,752070,18650,26370,45635,92340,172437,133625,403630,337900,24968370000,596859000,504896000,952328000,2057698000,4631877000,4361848000,11161335000,13288549000
Texas,Finance and Insurance,2010,96106,65929,12844,5659,84432,5766,2650,92848,3258,188655,66110,13300,6890,86300,12675,14675,113650,75005,2254885,110278,78803,72347,265029,211339,264285,749842,1456795,143807627000,5214190000,4074140000,4224651000,13542350000,13591189000,15034733000,42653069000,99469201000
Texas,Health Care and Social Assistance,2010,243593,118367,55957,33758,208082,25295,6806,240183,3410,295965,118525,56125,34630,209280,32370,17730,259380,36585,6393210,210035,370618,450142,1037829,984137,1084424,3107420,3223499,255842390000,14417565000,15649050000,17678870000,47778003000,35399949000,33004947000,116257785000,139162584000
Texas,Information,2010,22037,11405,3160,2234,16799,2279,1088,20166,1871,44555,11420,3190,2275,16885,2845,1925,21655,22900,1148212,14516,19625,28135,67764,76593,83060,238573,900954,77537671000,841500000,872330000,1387926000,3136432000,4536784000,5760107000,13503391000,63650576000
Texas,Management of Companies and Enterprises,2010,12745,1111,340,481,1932,2441,3399,7772,4973,20910,1115,340,495,1950,2485,3715,8150,12760,1284863,0,1655,3281,6536,31550,108829,147165,1138039,144056425000,195695000,123735000,222885000,542315000,2373555000,8606730000,11526480000,132499292000
Texas,Manufacturing,2010,89478,34586,15340,12894,62820,15242,5423,83485,5993,97965,34610,15360,12950,62920,15860,6640,85420,12545,3540118,56335,95156,164118,332970,568267,569146,1540872,1860693,187897684000,2496062000,3407660000,6341769000,12610168000,24983518000,25974257000,66003613000,114668997000
Texas,"Mining, Quarrying, and Oil and Gas Extraction",2010,31775,18414,4489,3622,26525,3465,874,30864,911,37690,18430,4500,3655,26585,3765,1525,31875,5815,812245,29253,29362,47983,106980,129735,109330,347282,464543,75630113000,2112203000,1829663000,2871999000,6821777000,9795384000,10989464000,27650936000,47956958000
Texas,Other,2010,1489,1440,35,12,1487,2,0,1489,0,1489,1440,35,12,1487,2,0,1489,0,1738,0,197,143,0,0,0,1738,0,26735000,22994000,1795000,1352000,26141000,0,0,26735000,0
Texas,Other Services (except Public Administration),2010,216869,129035,43242,24881,197158,15857,2372,215387,1482,240485,129135,43490,25985,198610,20410,5765,224785,15700,2023661,245547,281298,330561,858079,578234,242695,1686705,289883,52797675000,5777070000,6414900000,7417611000,19619780000,13477647000,6852936000,40115200000,11373962000
Texas,"Professional, Scientific, and Technical Services",2010,274007,194358,35533,21284,251175,14641,4060,269876,4131,298785,194440,35655,21865,251960,17150,7030,276140,22645,2827820,290917,228683,278509,808328,501180,380839,1700500,1086798,202182275000,16513980000,12131025000,15256815000,43964920000,34208882000,28091554000,106656270000,94313773000
Texas,Real Estate and Rental and Leasing,2010,93265,68474,11677,5691,85842,4197,1651,91690,1575,131190,68625,11925,6290,86840,7640,8615,103095,28095,824955,105639,74502,71803,252864,132109,131091,522109,265407,35455168000,3805110000,2594850000,2654697000,9062392000,5578917000,5853856000,20627120000,14312524000
Texas,Retail Trade,2010,222888,132755,43262,23944,199961,15704,3730,219395,3493,383935,133245,44575,26735,204555,26040,15725,246320,137615,5082411,227240,263693,305865,789029,548482,364258,1758445,3099461,124920631000,6095270000,6532964000,8005691000,20724288000,17373383000,13595209000,51990299000,71074222000
Texas,Total,2010,394392,228849,69039,45156,343044,37304,8781,389129,5263,522146,229251,69888,47338,346477,48576,26289,421342,100804,8785238,397331,453241,605431,1456003,1411087,1209107,4076197,4709041,386653791000,16404914000,15540822000,20557339000,52503075000,52889659000,50028757000,155421491000,231232300000
Texas,Transportation and Warehousing,2010,60754,33240,9519,6110,48869,5734,2457,57060,3694,78725,33270,9580,6270,49120,6575,4580,60275,18450,1543837,51175,60840,79487,191659,186049,171397,569121,943587,68682210000,2056116000,2126971000,2864584000,7097241000,7916102000,7667828000,23115184000,45415024000
Texas,Utilities,2010,4777,2570,885,345,3800,425,221,4446,331,9555,2575,885,355,3815,620,595,5030,4525,235372,5326,5532,4045,15436,19124,29507,64061,145375,19693664000,196602000,225334000,256120000,695569000,1142293000,2168955000,3991947000,15564546000
Texas,Wholesale Trade,2010,124352,63270,20374,15163,98807,14239,5566,118612,5740,157630,63465,20895,16175,100535,18530,12065,131130,26500,2266624,108975,131305,196268,440123,433560,355138,1248225,938163,140149764000,5631502000,6358563000,9661289000,21690030000,22916382000,19970378000,65157200000,69371673000
United States,Accommodation and Food Services,2010,2416849,1018715,477172,448387,1944274,417567,43795,2405636,11213,3219800,1020215,479400,456115,1955730,488440,199235,2643405,576395,56560610,1712953,3179114,6098898,10991155,15268225,7615235,33880090,22677848,927954935000,38834167000,41171986000,79914635000,159927220000,228299500000,117503360000,505740360000,422147700000
United States,Administrative and Support and Waste Management and Remediation Services,2010,1618157,1047695,230154,150323,1428172,131812,39101,1599085,19072,1908870,1048650,231390,153485,1433525,149750,70535,1653810,255060,44886325,1567630,1508400,2020200,5110835,5222135,6609402,16943345,27839807,1520455130000,61875035000,48043060000,65408230000,175326325000,176969160000,195106257000,547448415000,971999150000
United States,"Agriculture, Forestry, Fishing and Hunting",2010,104996,72926,16355,9021,98302,5063,1141,104506,490,108455,72945,16370,9055,98370,5645,2320,106335,2120,780275,100828,106420,118050,332945,180152,141298,656740,116588,26456755000,3939870000,3534255000,3908640000,11383770000,6593844000,4175303000,22243660000,3954058000
United States,"Arts, Entertainment, and Recreation",2010,570507,359002,75735,58916,493653,59743,12954,566350,4157,615755,359245,76215,60030,495490,65485,21305,582280,33475,10017975,420235,497020,794765,1767805,2396985,2120367,6295285,3704153,311594075000,39352100000,13555665000,17878720000,70786485000,53664465000,80875109000,206309320000,104870546000
United States,Construction,2010,3354749,2323605,487070,308314,3118989,201593,28041,3348623,6126,3413420,2323800,487375,309225,3120400,209265,41405,3371070,42350,26946355,3555385,3182965,4120705,10859055,7429205,4440885,22729145,4212082,1304797225000,129837330000,120374815000,170272935000,420485080000,379497690000,236249475000,1036232245000,268212242000
United States,Educational Services,2010,399217,197213,60210,51310,308733,67260,16626,392619,6598,450560,197395,60500,52765,310660,74840,28615,414115,36445,16367635,307876,400840,701180,1410415,2802905,2864335,7077655,9269069,551894550000,9790590000,8551340000,14848045000,33189975000,77945340000,96815840000,207951155000,343805108000
United States,Finance and Insurance,2010,1199909,856168,162997,74621,1093786,70870,22806,1187462,12447,2367475,859205,169790,91890,1120885,167475,179945,1468305,899170,29629036,1413855,1033142,979025,3506342,2797793,3486440,9796284,19688120,2360023229000,68085490000,55971780000,65328266000,189395300000,212310724000,261911472000,663957517000,1692779712000
United States,Health Care and Social Assistance,2010,3201914,1613395,716438,415958,2745791,312734,103671,3162196,39718,4064300,1616825,721960,434545,2773330,431160,341545,3546035,518265,88846825,2959834,4734382,5525023,13262291,12214668,16272436,41751910,47106621,3764262335000,152779180000,193290925000,228722414000,574808645000,479421099000,536560119000,1590813390000,2173448945000
United States,Information,2010,353694,211332,50050,37513,298895,37748,9867,346510,7184,677155,211770,50615,39285,301670,49680,29980,381330,295825,15620180,304298,331029,500864,1144644,1446035,1535224,4134130,11473901,1119903130000,22308635000,15082147000,24117885000,61514165000,86213845000,103865455000,252039650000,866493257000
United States,Management of Companies and Enterprises,2010,138346,15639,4079,6267,25985,30195,45270,101450,36896,254365,15730,4165,6425,26320,31165,50850,108335,146030,14164765,19561,18151,37910,76285,358170,1415975,1850430,12314335,1409018505000,3549090000,1624545000,2944325000,8125680000,24519710000,103490610000,136136000000,1272882505000
United States,Manufacturing,2010,1325607,551828,236193,200889,988910,233412,66263,1288585,37022,1499910,552050,236490,202420,990960,249865,102275,1343100,156810,54215986,1014821,1571352,2740257,5342743,9313672,9895803,24592662,29447694,2747217801000,39501264000,54859489000,104668656000,199408092000,405799481000,459048039000,1065773927000,1673978069000
United States,"Mining, Quarrying, and Oil and Gas Extraction",2010,104871,60109,15552,12452,88113,11496,3134,102743,2128,135460,60255,15735,12805,88795,14085,7360,110240,25220,2905312,96257,102469,166084,366435,425816,422210,1216548,1679577,230491582000,5944760000,5546876000,9360630000,20920982000,28127262000,33007880000,82120622000,147830175000
United States,Other,2010,20537,19945,407,164,20516,21,0,20537,0,20537,19945,407,164,20516,21,0,20537,0,0,0,2495,1906,0,515,0,0,0,315276000,271260000,26689000,12502000,310451000,4825000,0,315276000,0
United States,Other Services (except Public Administration),2010,3320207,2121549,646948,332486,3100983,190274,21812,3313069,7138,3627440,2123530,652655,346740,3122925,246955,79770,3449650,177790,25988050,3971905,4190505,4387795,12552080,6782848,2952964,22294325,3458486,701607180000,93494575000,97949805000,104525970000,295970350000,182293964000,97403163000,575797825000,124811769000
United States,"Professional, Scientific, and Technical Services",2010,3838693,2827656,484032,287445,3599133,186920,34097,3820150,18543,4257530,2829980,487755,298970,3616705,242100,96185,3954990,302540,39112085,4173044,3155795,3810085,11176935,6921725,5214476,23321000,15505650,2715371205000,217790150000,160253875000,208346170000,586390195000,476534170000,381792960000,1445064785000,1266544462000
United States,Real Estate and Rental and Leasing,2010,1341024,1046873,148930,74959,1270762,50169,13377,1334308,6716,1736630,1050095,154625,86010,1290730,90440,85815,1466985,269645,9486492,1542442,952757,967415,3454153,1733475,1481005,6687825,2812525,399279860000,52968085000,33282035000,35554495000,121804615000,73868225000,63685220000,259358060000,136056563000
United States,Retail Trade,2010,3340132,2012935,658628,372148,3043711,240392,41923,3326026,14106,5339920,2021425,676665,415175,3113265,390590,236635,3740490,1599430,70575034,3478199,4251184,4841615,12665506,8655589,5361865,26872850,41795837,1752538965000,88902645000,99700396000,121526732000,310133438000,272067858000,171318023000,753627706000,992351961000
United States,Total,2010,5734538,3575240,968075,617089,5160404,475125,81773,5717302,17236,7396628,3582826,982019,652662,5217507,648386,354313,6220206,1176422,111970095,5926452,6358931,8288385,20573768,18554372,15868540,54996680,56973415,4940983369000,226541056000,212039611000,283246473000,721827140000,719061251000,665644629000,2106533020000,2834450349000
United States,Transportation and Warehousing,2010,819027,522909,113537,79750,716196,68990,19281,804467,14560,1042370,523590,114590,82835,721015,85375,50065,856455,185915,20032006,771606,733809,1061396,2558655,2520784,2295801,7408788,12532711,832253580000,27176371000,24832719000,35819202000,87848692000,95159957000,90027725000,273119692000,555716431000
United States,Utilities,2010,29553,15163,4583,2446,22192,4386,1612,28190,1363,88000,15185,4670,2685,22540,7300,6460,36300,51700,3190290,29465,29000,31911,90959,197580,259947,548914,2641340,276978305000,1062221000,1125364000,1721742000,3917115000,12461540000,19452232000,35863345000,241114960000
United States,Wholesale Trade,2010,1586526,908575,260521,186450,1355546,169764,41274,1566584,19942,2073040,912515,267095,202030,1381640,242210,141265,1765115,307925,27992535,1537737,1708450,2473330,5723645,6090720,4860818,16676635,11243276,1695323740000,73820395000,81239125000,121145065000,276204585000,323127475000,271465943000,870922305000,821228159000
Utah,Accommodation and Food Services,2010,17856,6090,3248,3630,12968,3838,554,17360,496,24255,6105,3270,3695,13070,4545,1940,19555,4700,455486,8673,20959,49039,79883,136968,77648,295976,158829,6325366000,237797000,241771000,544454000,1026234000,1766593000,1041962000,3856836000,2461076000
Utah,Administrative and Support and Waste Management and Remediation Services,2010,18001,11575,2180,1543,15298,1243,558,17099,902,19540,11580,2180,1560,15320,1295,650,17265,2275,499021,13381,13035,19494,48096,40424,60961,158031,326095,15185307000,513097000,343311000,552047000,1447773000,1236296000,1695750000,4636140000,10070038000
Utah,"Agriculture, Forestry, Fishing and Hunting",2010,330,235,35,35,305,10,10,325,5,345,235,35,35,305,10,10,325,20,1176,142,124,160,622,0,0,845,0,62894000,8419000,3051000,4990000,26817000,0,0,44854000,0
Utah,"Arts, Entertainment, and Recreation",2010,4222,2620,525,365,3510,475,137,4122,100,4315,2620,525,365,3510,500,165,4175,140,86359,2516,2927,4000,10557,16648,16018,46957,30705,1766445000,104686000,56894000,65645000,247470000,282292000,240542000,815872000,503091000
Utah,Construction,2010,43906,31200,6179,3569,40948,2261,372,43581,325,44110,31205,6185,3575,40965,2285,415,43665,445,298835,46403,39048,45978,132784,82638,34214,265264,24725,12375530000,1478568000,1206746000,1625039000,4333379000,3488339000,1766932000,10242675000,1708209000
Utah,Educational Services,2010,4278,2235,640,540,3415,580,145,4140,138,4530,2235,640,540,3415,605,160,4180,350,114064,1980,3634,6836,13811,23566,14620,54755,724,2935521000,90198000,77414000,120496000,313054000,540846000,470452000,1394335000,1266594000
Utah,Finance and Insurance,2010,16061,11505,1565,655,13725,814,305,14844,1217,24620,11540,1585,745,13870,1655,1215,16740,7880,256217,13699,8789,7196,30628,25961,22857,83227,160057,12896649000,605291000,379189000,347978000,1371353000,1486277000,1258814000,4504631000,8193901000
Utah,Health Care and Social Assistance,2010,29364,15575,6560,3675,25810,2353,594,28757,607,34060,15600,6575,3805,25980,3015,1940,30935,3125,589725,19497,43599,45611,115846,92398,78130,294433,181756,22575644000,1473212000,1356090000,1358878000,4219885000,2988685000,2407878000,9902623000,7745256000
Utah,Information,2010,5048,2615,560,380,3555,600,255,4410,638,6875,2615,565,390,3570,640,345,4555,2320,152869,2382,2275,3482,9982,19412,24797,58289,73962,8577445000,154942000,119564000,158229000,460641000,1090517000,1334760000,2994099000,4606899000
Utah,Management of Companies and Enterprises,2010,1702,235,30,40,305,345,355,1005,697,2240,235,30,40,305,350,370,1025,1215,87711,0,124,0,734,5093,9122,15186,72252,7602441000,0,3402000,43002000,59972000,216395000,660517000,948094000,6612478000
Utah,Manufacturing,2010,15293,6210,2570,2295,11075,2270,687,14032,1261,15750,6210,2575,2295,11080,2310,745,14135,1615,438789,6695,14062,25111,52376,70367,40951,196210,202984,20916357000,348896000,440231000,820882000,1795450000,2752507000,1831351000,7818194000,11423425000
Utah,"Mining, Quarrying, and Oil and Gas Extraction",2010,2187,1085,299,195,1579,240,81,1900,287,2340,1085,300,195,1580,245,85,1910,430,36176,782,1613,2320,5272,6031,2424,15565,20238,2500324000,69004000,83463000,125619000,282114000,330848000,168878000,853636000,1622793000
Utah,Other,2010,80,75,4,1,80,0,0,80,0,80,75,4,1,80,0,0,80,0,96,0,23,0,96,0,0,96,0,1471000,1366000,95000,0,1471000,0,0,1471000,0
Utah,Other Services (except Public Administration),2010,20525,13030,3795,1985,18810,1143,207,20160,365,22860,13040,3845,2090,18975,1985,480,21440,1420,233108,20481,23228,23093,66670,34088,8343,118344,29223,7122066000,546865000,581247000,577247000,1750577000,783215000,292636000,3162204000,1056567000
Utah,"Professional, Scientific, and Technical Services",2010,41420,30595,4100,2640,37335,2126,807,40268,1152,43630,30595,4120,2680,37395,2445,1035,40875,2755,331781,31623,25659,32036,98041,70705,57804,237475,81784,17326185000,1639158000,1094962000,1475784000,4258102000,3901467000,3300271000,11740031000,5263718000
Utah,Real Estate and Rental and Leasing,2010,18826,15730,1228,730,17688,478,244,18410,416,21195,15750,1265,790,17805,705,415,18925,2270,94599,15830,7367,8298,34500,13809,9109,61800,19991,3048590000,538581000,217697000,270154000,1047090000,483234000,338464000,1979359000,716944000
Utah,Retail Trade,2010,29778,15118,5670,3919,24707,2669,747,28123,1655,44080,15165,5805,4295,25265,4005,2590,31860,12220,668282,21732,33128,47119,106607,88574,55986,269750,348260,16162918000,656587000,779210000,1099053000,2596191000,2291373000,1610799000,6780372000,8534210000
Utah,Total,2010,57664,35839,8409,5663,49911,4642,1255,55808,1856,68820,35885,8496,5893,50274,5912,2877,59063,9757,1021143,52988,55600,74828,183416,170226,138263,491905,529238,38022357000,1883806000,1585817000,2172817000,5642440000,5739315000,5116279000,16498034000,21524323000
Utah,Transportation and Warehousing,2010,9259,5745,825,767,7337,752,345,8434,825,10255,5745,825,775,7345,845,410,8600,1655,209327,7172,4685,8388,21908,23566,19090,69545,112182,8426368000,259362000,175311000,290892000,756937000,886338000,744755000,2510318000,4915004000
Utah,Utilities,2010,396,225,45,35,305,25,12,342,54,1090,225,45,35,305,50,45,400,690,15293,0,285,416,0,0,0,2869,9832,1250186000,7102000,12829000,16411000,37751000,0,0,170445000,822635000
Utah,Wholesale Trade,2010,15454,7250,2060,1509,10819,1854,962,13635,1819,17610,7265,2090,1555,10910,2070,1370,14350,3260,247288,9630,11465,16476,40730,44531,29644,130547,92375,12172356000,448845000,491311000,775480000,1798486000,2239848000,1552498000,6360312000,5024702000
Vermont,Accommodation and Food Services,2010,8524,3575,1535,1775,6885,1278,158,8321,203,9480,3575,1555,1800,6930,1505,295,8730,750,142542,4687,10252,24743,40417,40638,15916,97612,41858,2334988000,148059000,131138000,336701000,623441000,677998000,261131000,1571678000,616738000
Vermont,Administrative and Support and Waste Management and Remediation Services,2010,5208,3690,590,320,4600,275,55,4930,278,5405,3690,590,320,4600,320,65,4985,420,36297,4379,3097,2632,11649,6413,0,23457,9507,1044594000,192723000,99582000,65603000,398294000,196361000,3215000,705662000,210468000
Vermont,"Agriculture, Forestry, Fishing and Hunting",2010,635,550,50,25,625,5,5,635,0,635,550,50,25,625,5,5,635,0,1543,588,236,107,1318,0,0,1543,0,49728000,20548000,6094000,3053000,36672000,0,0,49728000,0
Vermont,"Arts, Entertainment, and Recreation",2010,2134,1380,310,220,1910,160,39,2109,25,2180,1380,310,225,1915,170,65,2150,30,33473,1477,1490,2444,6241,4117,5517,18525,5984,553290000,87844000,43158000,69095000,214565000,77173000,68224000,410604000,56900000
Vermont,Construction,2010,13903,10865,1555,945,13365,415,83,13863,40,13920,10865,1555,950,13370,420,90,13880,40,61870,14012,9227,10670,36795,10705,6284,58868,22,2781260000,645070000,430249000,477744000,1598227000,612339000,282858000,2637023000,1477000
Vermont,Educational Services,2010,1693,825,240,213,1278,235,115,1628,65,1785,825,240,225,1290,255,170,1715,70,70007,897,1316,2256,5365,8342,21881,37772,31950,1921671000,43969000,35671000,43922000,145601000,229831000,654749000,1072851000,839373000
Vermont,Finance and Insurance,2010,2683,1425,290,205,1920,164,137,2221,462,4830,1435,295,290,2020,465,730,3215,1615,43494,1956,1589,2207,6540,4359,7965,22470,16050,2718060000,114639000,83996000,147174000,369438000,279449000,449786000,1335861000,1285615000
Vermont,Health Care and Social Assistance,2010,8863,4125,1865,1195,7185,1010,374,8569,294,10690,4140,1870,1210,7220,1385,1065,9670,1020,250234,7127,11493,13993,34664,37287,42318,118806,111956,8620361000,321857000,427716000,467077000,1241262000,1153689000,1377588000,3845308000,4013145000
Vermont,Information,2010,1830,800,350,195,1345,225,67,1637,193,2420,800,350,200,1350,305,110,1765,655,21070,1018,1552,2090,5200,5662,1513,16384,2874,884321000,40760000,51561000,66766000,190722000,297070000,52915000,653491000,234768000
Vermont,Management of Companies and Enterprises,2010,370,20,20,25,65,70,95,230,140,405,20,20,25,65,70,105,240,165,13325,0,64,110,196,142,4193,5330,7964,845105000,1450000,8868000,4915000,17450000,9050000,184973000,260030000,584194000
Vermont,Manufacturing,2010,4742,2185,750,518,3453,730,322,4505,237,4930,2185,750,525,3460,785,380,4625,305,92846,2300,2597,4265,12089,18116,10526,60230,20767,4434762000,101996000,100084000,145697000,424057000,806356000,553110000,2683061000,1197134000
Vermont,"Mining, Quarrying, and Oil and Gas Extraction",2010,216,140,25,5,170,25,5,200,16,240,140,25,5,170,45,5,220,20,224,154,0,0,315,564,0,193,0,11522000,10701000,5140000,0,24206000,29134000,0,9040000,0
Vermont,Other,2010,44,37,4,3,44,0,0,44,0,44,37,4,3,44,0,0,44,0,91,0,0,0,91,0,0,91,0,761000,474000,232000,0,761000,0,0,761000,0
Vermont,Other Services (except Public Administration),2010,9869,6740,1895,725,9360,311,78,9749,120,10245,6745,1925,760,9430,480,150,10060,185,44564,12248,11211,8515,33558,6074,285,43370,513,1136604000,315987000,264729000,207151000,804109000,191861000,14531000,1096986000,18230000
Vermont,"Professional, Scientific, and Technical Services",2010,10538,7320,1545,805,9670,420,105,10195,343,10880,7320,1555,810,9685,530,125,10340,540,98319,9798,9560,9694,30740,10856,5103,51842,30223,5156470000,491707000,457919000,573891000,1583966000,758214000,389492000,2956782000,1739381000
Vermont,Real Estate and Rental and Leasing,2010,3228,2390,340,210,2940,110,45,3095,133,3605,2395,380,245,3020,175,105,3300,305,14111,2494,1821,2223,7902,1815,484,12136,1191,459940000,119278000,63812000,59551000,251451000,78555000,13394000,382377000,44618000
Vermont,Retail Trade,2010,13711,6255,3039,1988,11282,1218,339,12839,872,18285,6270,3100,2155,11525,2000,1425,14950,3335,184920,8195,17451,21454,52998,29774,15026,104896,33572,4599032000,284455000,405484000,588328000,1296139000,1008448000,428763000,3031403000,675003000
Vermont,Total,2010,18596,11106,3047,1961,16114,1415,379,17908,688,21451,11119,3087,2060,16266,1961,1091,19318,2133,264099,18287,19939,26012,64238,49219,44263,157720,106379,9307917000,642415000,606979000,774417000,2023811000,1720137000,1656724000,5400672000,3907245000
Vermont,Transportation and Warehousing,2010,2235,1320,290,145,1755,233,80,2068,167,2480,1320,290,145,1755,250,120,2125,355,25856,1528,1450,1164,5002,4343,799,14349,4328,928791000,60718000,46995000,45529000,170156000,170694000,31821000,522598000,163115000
Vermont,Utilities,2010,132,40,10,10,60,15,23,98,34,295,40,10,10,60,20,80,160,135,8293,20,0,0,117,297,2081,2695,0,712151000,1524000,0,0,7253000,19695000,177464000,245304000,0
Vermont,Wholesale Trade,2010,3940,1713,545,355,2613,515,288,3416,524,4325,1715,545,360,2620,620,365,3605,720,48754,1733,2227,3175,8671,10664,7904,36381,7497,2359931000,99543000,113194000,122183000,406462000,483991000,441647000,1738585000,462438000
Virginia,Accommodation and Food Services,2010,58805,22795,11883,11472,46150,9930,1304,57384,1421,81095,22815,11930,11635,46380,11225,5415,63020,18075,1503523,38636,78087,155114,272508,349172,186562,810238,691345,23674835000,919142000,1126361000,2139473000,4190925000,5377063000,2556753000,12143000000,11500913000
Virginia,Administrative and Support and Waste Management and Remediation Services,2010,44295,25540,6457,4500,36497,4204,1608,42309,1986,51310,25565,6475,4530,36570,4735,2370,43675,7635,1156237,38620,42056,59536,142577,152547,201301,502217,642976,44702601000,1292887000,1312779000,1871249000,4500275000,5308619000,6434406000,16439629000,28006671000
Virginia,"Agriculture, Forestry, Fishing and Hunting",2010,3325,2395,570,225,3190,70,30,3290,35,3340,2395,570,225,3190,70,45,3305,35,16808,3291,3143,2479,10028,411,264,13167,1285,706682000,114796000,107420000,70904000,302604000,60939000,8612000,424482000,94806000
Virginia,"Arts, Entertainment, and Recreation",2010,12735,7525,1625,1355,10505,1595,362,12462,273,13695,7525,1625,1360,10510,1680,515,12705,990,218171,9475,9995,17754,39202,60780,43068,148527,61013,5142076000,379666000,220220000,330594000,969702000,1084767000,1114327000,3537085000,1170213000
Virginia,Construction,2010,102422,68285,15845,9675,93805,6851,1115,101771,651,103895,68295,15845,9675,93815,7070,1430,102315,1580,870460,110737,103898,130028,345395,249325,148914,746555,107193,39763320000,3624280000,3626142000,5099363000,12353375000,11792325000,7232755000,31477195000,7324796000
Virginia,Educational Services,2010,11738,5877,1710,1463,9050,1822,492,11364,374,12810,5885,1725,1505,9115,1960,640,11715,1095,352710,9034,10885,19430,39837,72427,79173,194462,148266,11092679000,284459000,257865000,406726000,963381000,2031343000,3016421000,6169896000,4718761000
Virginia,Finance and Insurance,2010,28685,18978,3778,1515,24271,1668,940,26879,1806,56975,19035,4000,1855,24890,3430,4895,33215,23760,702882,31553,22516,18241,73182,52959,68163,207857,468833,48695449000,1415663000,1166992000,1243011000,3867079000,3713355000,3993858000,12157828000,33343716000
Virginia,Health Care and Social Assistance,2010,71011,31608,16908,10346,58862,8360,1996,69218,1793,90505,31715,17130,10965,59810,11445,6510,77765,12740,1931723,57907,111546,137160,310953,317080,302671,938117,952168,84016487000,2910801000,4850770000,6108585000,13873157000,13296140000,11009026000,38506672000,44302158000
Virginia,Information,2010,9939,4690,1190,1070,6950,1176,626,8752,1187,19095,4705,1195,1075,6975,1345,940,9260,9835,436962,5880,6234,11759,25284,37339,47655,118852,286868,34169860000,395238000,359517000,697779000,1491456000,2509691000,4156766000,8593222000,25881983000
Virginia,Management of Companies and Enterprises,2010,4077,245,75,150,470,630,1236,2336,1741,5960,245,75,150,470,640,1345,2455,3505,276935,267,303,817,1346,7528,34376,43416,232308,25914210000,40660000,25180000,69447000,146740000,524220000,2389850000,3060810000,22566201000
Virginia,Manufacturing,2010,24801,9625,4310,3250,17185,3827,1543,22555,2246,26565,9625,4310,3270,17205,4070,1810,23085,3480,966162,14027,25543,38152,84688,130297,121971,375755,503666,45934945000,582498000,852187000,1376712000,3002369000,5275740000,5306676000,15265440000,27786104000
Virginia,"Mining, Quarrying, and Oil and Gas Extraction",2010,1013,275,120,145,540,198,115,853,160,1475,275,120,145,540,225,190,955,520,43068,117,702,1618,3033,6745,4445,17352,23976,2807276000,23696000,43310000,99898000,197495000,341327000,237617000,900212000,1845829000
Virginia,Other,2010,378,364,9,4,377,1,0,378,0,378,364,9,4,377,1,0,378,0,0,0,0,0,0,0,0,0,0,6632000,5423000,0,0,6612000,0,0,6632000,0
Virginia,Other Services (except Public Administration),2010,98178,59735,19872,10524,90131,6366,928,97425,753,106270,59790,19990,10970,90750,7755,2525,101030,5240,812287,113286,129195,139778,382739,222813,78407,694796,89476,26328847000,2831374000,3229621000,3939241000,10007500000,7702770000,4008867000,21926692000,3022165000
Virginia,"Professional, Scientific, and Technical Services",2010,124070,84879,14491,9677,109047,8777,3113,120937,3133,144795,84905,14530,9825,109260,10410,4640,124310,20485,2049822,106842,92986,126707,341611,311259,353132,1018340,1000853,168121313000,7768198000,5605296000,8102403000,21535233000,24024540000,28191776000,74139017000,91867834000
Virginia,Real Estate and Rental and Leasing,2010,32289,24094,3119,1862,29075,1484,778,31337,952,44030,24155,3215,2150,29520,2945,3170,35635,8395,262116,34583,19317,22987,79153,40970,46898,172737,74254,11167429000,1281619000,730841000,834629000,2876741000,1937654000,2001492000,7044230000,3781431000
Virginia,Retail Trade,2010,82102,45069,16373,9988,71430,6010,1851,79291,2811,138735,45250,16835,11130,73215,9120,6300,88635,50100,1864513,73559,100292,120727,300775,190485,121780,656652,1093195,47483348000,1938478000,2405976000,3089974000,7462139000,6363690000,4696330000,18890754000,27398334000
Virginia,Total,2010,149271,87986,24925,16378,129289,13246,3456,145991,3280,193042,88124,25236,17164,130524,16942,9458,156924,36118,2998278,148595,163449,218238,530282,483452,423734,1437468,1560810,139058799000,5559099000,5606108000,7729380000,18894587000,20188849000,19757475000,58840911000,80217888000
Virginia,Transportation and Warehousing,2010,20498,11895,2520,1859,16274,1790,860,18924,1574,23895,11895,2530,1890,16315,1985,1215,19515,4380,431599,15897,15184,21424,56398,54805,44965,161282,225501,17843053000,567106000,519557000,733341000,1877825000,2115670000,1734803000,5886591000,9877576000
Virginia,Utilities,2010,493,175,25,5,205,67,70,342,151,1800,175,25,5,205,70,210,485,1315,37185,39,0,0,415,1854,6879,9279,5582,3714500000,23498000,4505000,0,28861000,105687000,521575000,655789000,3347573000
Virginia,Wholesale Trade,2010,29610,14520,3930,3316,21766,3635,1698,27099,2511,37075,14550,4010,3440,22000,4525,3125,29650,7425,498143,21609,23514,40211,90499,104315,81626,293267,186324,28828275000,1214136000,1274955000,1966921000,4544836000,5412258000,4446563000,14927284000,13042464000
Washington,Accommodation and Food Services,2010,64230,26330,14375,12484,53189,9013,1184,63386,844,80195,26385,14475,12805,53665,10985,4575,69225,10970,1118112,35275,92379,164938,300976,296892,156883,754546,342180,19736565000,915063000,1249044000,2445301000,4584840000,5197197000,2861158000,12738069000,6947946000
Washington,Administrative and Support and Waste Management and Remediation Services,2010,39712,25420,5908,3535,34863,2670,804,38337,1375,44060,25420,5970,3605,34995,2930,1140,39065,4995,608289,37264,36513,46268,124259,94597,84534,314529,286035,23795333000,1260839000,1092237000,1421797000,3806815000,3323867000,2754848000,10298723000,13063013000
Washington,"Agriculture, Forestry, Fishing and Hunting",2010,6866,5080,640,515,6235,404,150,6789,77,6970,5080,640,515,6235,425,180,6840,130,58585,4563,3809,6303,13903,14772,17767,50049,3768,2425429000,325050000,165695000,240504000,740711000,602556000,629314000,2029846000,245952000
Washington,"Arts, Entertainment, and Recreation",2010,12618,7100,1820,1325,10245,1613,531,12389,229,13480,7100,1820,1335,10255,1685,885,12825,655,299716,7416,11035,17143,38124,65715,81552,187461,95672,7930749000,341015000,243276000,326848000,975122000,1183764000,1948608000,4175378000,2594990000
Washington,Construction,2010,104306,74945,13668,9077,97690,5207,840,103737,569,105135,74955,13675,9085,97715,5415,1030,104160,975,704820,112529,87405,120135,321195,183726,112583,620821,64094,35931270000,3843025000,3374480000,4774315000,11991820000,10218464000,6918882000,29233672000,5386536000
Washington,Educational Services,2010,11425,6065,1785,1475,9325,1501,335,11161,264,12090,6065,1800,1490,9355,1695,460,11510,580,253799,8589,11895,19977,40957,57168,39872,141491,109738,6514395000,298328000,225638000,418109000,949523000,1502867000,1189608000,3757135000,2664337000
Washington,Finance and Insurance,2010,25936,17500,3055,1433,21988,1334,914,24236,1700,51085,17560,3160,1610,22330,2785,4225,29340,21745,459403,27872,18465,16238,65500,42430,69682,183401,264998,31418715000,1299279000,938255000,1114527000,3429972000,2959341000,3948457000,10562649000,20342057000
Washington,Health Care and Social Assistance,2010,80241,41310,18385,10059,69754,6615,2347,78716,1525,95890,41350,18470,10365,70185,9270,6625,86080,9810,1845764,69910,120401,130204,323691,244670,339847,913059,903011,83493169000,2864736000,4446705000,5076272000,12487758000,9344388000,12848590000,34841258000,47797449000
Washington,Information,2010,9934,4840,1327,1075,7242,1107,514,8863,1071,15995,4840,1340,1085,7265,1270,630,9165,6830,530937,4643,6099,13339,25745,33716,34128,111615,209083,58808302000,344918000,375368000,683138000,1505840000,2093807000,2476396000,7703953000,18802048000
Washington,Management of Companies and Enterprises,2010,3853,355,115,155,625,760,1083,2468,1385,5085,355,115,155,625,770,1175,2570,2515,422944,402,533,828,1850,8830,29767,40004,383052,39798553000,54975000,41483000,71006000,170396000,576815000,2676504000,3389241000,36423472000
Washington,Manufacturing,2010,33804,15175,5445,4683,25303,4877,1684,31864,1940,35250,15180,5450,4700,25330,5040,2005,32375,2875,897603,22344,30900,55604,118139,169420,153418,484017,294517,46826233000,914959000,1181722000,2247736000,4615149000,7564562000,7831054000,22015873000,17625898000
Washington,"Mining, Quarrying, and Oil and Gas Extraction",2010,745,330,140,70,540,62,56,658,87,930,330,140,80,550,80,105,735,195,11753,352,715,694,1948,1414,1376,6151,4002,766764000,35993000,34318000,31767000,109704000,88423000,97296000,378913000,278501000
Washington,Other,2010,450,438,9,3,450,0,0,450,0,450,438,9,3,450,0,0,450,0,0,0,66,39,0,0,0,0,0,8273000,7004000,965000,304000,8273000,0,0,8273000,0
Washington,Other Services (except Public Administration),2010,74804,47502,14056,7866,69424,4091,726,74241,563,81775,47520,14150,8215,69885,5505,2080,77470,4305,540353,81674,89213,100183,275650,129897,53853,473608,40066,14744905000,2102140000,2189873000,2472273000,6778832000,3615034000,1614867000,12246479000,1444978000
Washington,"Professional, Scientific, and Technical Services",2010,94098,67195,11065,7332,85592,4806,1600,91998,2100,100310,67195,11110,7530,85835,5370,2465,93670,6640,796692,92179,71427,94262,262422,154820,117161,544262,228660,56050918000,5037480000,3725120000,5263349000,14092046000,11940659000,8321106000,34892880000,19419967000
Washington,Real Estate and Rental and Leasing,2010,37148,28582,3935,2072,34589,1269,594,36452,696,47565,28660,4095,2400,35155,2285,2425,39865,7700,232604,41816,24288,25491,91420,34875,32781,168906,51783,8800732000,1280682000,770435000,883729000,2955033000,1376168000,1463333000,5963971000,2235251000
Washington,Retail Trade,2010,73397,39359,15015,9031,63405,6306,1503,71214,2183,108850,39515,15350,9950,64815,9795,5545,80155,28695,1476223,61463,90152,113510,275367,213755,109045,614822,751556,40630853000,1685475000,2257253000,2912902000,6861520000,6996340000,3778388000,18261402000,21317049000
Washington,Total,2010,144377,88179,23786,15608,127573,11078,2978,141629,2748,175914,88303,24064,16337,128704,14622,8194,151520,24394,2326731,144087,155702,206510,506299,397494,345815,1249608,1077123,111398501000,5045030000,5024239000,6925728000,16994997000,15883699000,15551182000,48429878000,62968623000
Washington,Transportation and Warehousing,2010,20872,11690,2682,2060,16432,1794,1042,19268,1604,24235,11690,2725,2125,16540,2100,1635,20275,3960,359976,15117,16616,24915,59674,50875,36652,161582,181587,15962792000,640391000,616819000,895783000,2232767000,2030633000,1799184000,6319980000,8690478000
Washington,Utilities,2010,968,575,140,70,785,67,33,885,83,1510,575,145,70,790,115,80,985,525,27587,1150,786,734,2840,0,0,4557,0,2282303000,25307000,21606000,36097000,96120000,174502000,0,239150000,0
Washington,Wholesale Trade,2010,38590,19510,5568,4234,29312,4358,2095,35765,2825,46910,19550,5645,4550,29745,5590,3705,39040,7870,596714,29491,33636,50768,116201,126994,103784,363200,205647,36334150000,1596075000,1710027000,2572394000,5996404000,6825863000,6154879000,19457502000,15604180000
West Virginia,Accommodation and Food Services,2010,13625,5300,2600,2593,10493,2150,537,13180,445,18410,5305,2610,2675,10590,2780,2085,15455,2955,296876,9051,16649,35697,61894,73512,58634,195194,95027,3927350000,137409000,191358000,417343000,751295000,942829000,712450000,2429980000,1337351000
West Virginia,Administrative and Support and Waste Management and Remediation Services,2010,6578,3566,975,685,5226,585,192,6003,575,7335,3570,975,690,5235,645,245,6125,1210,142767,3986,5401,7232,18734,18454,22797,67992,57533,3973316000,149173000,151857000,232208000,547322000,572437000,662957000,1960516000,1483765000
West Virginia,"Agriculture, Forestry, Fishing and Hunting",2010,1190,955,155,50,1160,10,10,1180,10,1195,955,155,50,1160,10,10,1180,15,4135,1698,972,609,3295,0,0,3927,0,87425000,38688000,19560000,13831000,77375000,0,0,81755000,0
West Virginia,"Arts, Entertainment, and Recreation",2010,3244,1765,605,470,2840,276,54,3170,74,3445,1765,620,490,2875,390,65,3330,115,53215,2266,3544,5716,12692,8452,5147,28971,23164,1100381000,66288000,57762000,108491000,241152000,136208000,45513000,451758000,619645000
West Virginia,Construction,2010,18179,12180,2710,1910,16800,999,225,18024,155,18295,12180,2710,1910,16800,1020,270,18090,205,128091,18616,17011,24174,62663,32882,15102,120507,5521,5381080000,565451000,533380000,838899000,1967793000,1649607000,790908000,4845676000,463345000
West Virginia,Educational Services,2010,1338,630,200,160,990,223,75,1288,50,1410,630,200,160,990,240,110,1340,70,32095,999,1001,1693,4264,5733,13990,27642,3760,923756000,27775000,20879000,30176000,87545000,106142000,416564000,678664000,97918000
West Virginia,Finance and Insurance,2010,5867,3448,830,395,4673,441,162,5276,591,10715,3450,865,530,4845,1195,740,6780,3935,87642,6462,4884,4685,16402,14751,10181,44556,18661,3519044000,198965000,170206000,174390000,559982000,577435000,339743000,1557408000,1849967000
West Virginia,Health Care and Social Assistance,2010,17755,6765,4465,2693,13923,2151,1008,17082,673,24525,6765,4470,2785,14020,3105,3000,20125,4400,608426,13818,28438,34068,77997,82194,123348,292795,303458,22517734000,530411000,962012000,1250623000,2765985000,2733694000,3327072000,9051766000,13049293000
West Virginia,Information,2010,1348,445,225,175,845,172,69,1086,262,3735,445,225,175,845,245,125,1215,2520,48996,524,1025,1210,4169,4134,865,11798,31812,2190816000,17682000,31732000,36708000,99331000,137173000,40917000,374024000,1695154000
West Virginia,Management of Companies and Enterprises,2010,816,45,10,20,75,200,240,515,301,1050,45,10,20,75,200,245,520,530,26010,0,0,0,240,2342,4681,7430,18543,1554195000,3957000,0,0,10210000,103660000,343213000,463485000,1089149000
West Virginia,Manufacturing,2010,6071,1995,1000,865,3860,1115,432,5407,664,6495,1995,1005,865,3865,1215,555,5635,860,182346,2583,4843,8559,18230,30717,20717,82299,85329,8970481000,95946000,155472000,263456000,578270000,1141943000,935769000,3141958000,4944550000
West Virginia,"Mining, Quarrying, and Oil and Gas Extraction",2010,2603,1065,455,295,1815,356,196,2367,236,3355,1065,465,295,1825,375,230,2430,925,149802,927,2693,2635,5617,13268,23434,48810,100230,10427032000,91194000,108230000,214857000,418774000,825954000,1546765000,3011666000,7351851000
West Virginia,Other,2010,42,40,2,0,42,0,0,42,0,42,40,2,0,42,0,0,42,0,54,44,0,0,54,0,0,54,0,807000,643000,0,0,807000,0,0,807000,0
West Virginia,Other Services (except Public Administration),2010,21550,13755,4295,2126,20176,914,189,21279,271,22975,13770,4335,2210,20315,1235,285,21835,1140,127691,24253,26693,27055,80005,26238,4042,116675,4358,2728895000,480966000,483587000,519218000,1500681000,616209000,110862000,2400820000,272873000
West Virginia,"Professional, Scientific, and Technical Services",2010,13437,8100,2155,1335,11590,869,335,12794,643,14970,8110,2165,1385,11660,1120,590,13370,1600,119937,13469,13476,16620,45033,29865,12867,92118,22121,5166364000,468827000,482829000,622796000,1603737000,1479945000,587363000,3790353000,1257023000
West Virginia,Real Estate and Rental and Leasing,2010,5915,4260,730,360,5350,197,93,5640,275,7200,4275,770,395,5440,325,285,6050,1150,29975,6736,4337,3519,15971,2874,288,22071,6580,891086000,191550000,117181000,110786000,438754000,82118000,15453000,625178000,241840000
West Virginia,Retail Trade,2010,20142,9511,4154,2838,16503,1954,474,18931,1211,32785,9540,4245,3135,16920,2945,1720,21585,11200,357021,14702,24834,31230,77161,55801,26433,169305,154981,7845029000,342327000,496275000,791649000,1687342000,1638489000,602476000,4079460000,3591217000
West Virginia,Total,2010,29609,15873,5457,3655,24985,2665,777,28427,1182,38676,15897,5527,3854,25278,3756,2281,31315,7361,560450,29516,35528,48598,113642,95295,88764,297701,262749,19323797000,770713000,901979000,1293601000,2966293000,3034640000,2843793000,8844726000,10479071000
West Virginia,Transportation and Warehousing,2010,5476,3074,785,605,4464,469,132,5065,411,6245,3075,785,610,4470,485,165,5120,1125,62658,4943,4535,6892,17232,12654,3777,34392,11113,2282634000,155095000,136929000,221444000,529418000,448619000,129662000,1162669000,498826000
West Virginia,Utilities,2010,315,115,35,40,190,30,25,245,70,1270,115,35,40,190,80,120,390,880,27109,261,92,44,903,681,31,1992,21238,1999243000,5706000,2418000,856000,21389000,25917000,2434000,89907000,1640017000
West Virginia,Wholesale Trade,2010,6328,2225,966,785,3976,911,383,5270,1058,7760,2230,980,850,4060,1170,560,5790,1970,88026,3197,5245,8123,18856,18783,10969,56424,22293,4064492000,155473000,182358000,305853000,703203000,790641000,505518000,2286492000,1356615000
Wisconsin,Accommodation and Food Services,2010,58746,24020,11197,11115,46332,10540,1009,57881,865,70650,24085,11260,11230,46575,12165,3620,62360,8290,1091400,40328,73198,150167,264748,369683,135003,770167,237007,13575015000,765105000,787486000,1526834000,3080455000,4360506000,1699833000,9149138000,4271337000
Wisconsin,Administrative and Support and Waste Management and Remediation Services,2010,28894,17920,4045,2705,24670,2263,756,27689,1205,33580,17925,4045,2735,24705,2580,1215,28500,5080,612627,24378,24589,33981,85330,82252,98088,273740,308032,17093250000,907281000,770286000,1042450000,2766029000,2325915000,2209382000,7571244000,8412808000
Wisconsin,"Agriculture, Forestry, Fishing and Hunting",2010,2475,1925,325,120,2370,50,35,2455,20,2500,1925,325,120,2370,50,50,2470,30,14131,2737,1424,884,6399,523,294,11301,0,532146000,80638000,62895000,35956000,189048000,16027000,11463000,415496000,0
Wisconsin,"Arts, Entertainment, and Recreation",2010,13126,7602,1960,1540,11102,1573,272,12947,179,13580,7610,1970,1555,11135,1725,335,13195,385,198083,10189,12387,19696,44844,55240,37868,143223,36888,3876777000,386668000,272827000,322275000,1007380000,908842000,530093000,2635377000,663395000
Wisconsin,Construction,2010,70810,51505,9765,5633,66903,3098,492,70493,317,71625,51510,9765,5685,66960,3315,660,70935,690,443895,76167,62691,74327,215605,103971,56944,391985,45607,23858235000,3185375000,2695726000,3556438000,9447320000,6290767000,3624082000,20281285000,3141470000
Wisconsin,Educational Services,2010,7028,2920,1130,1040,5090,1445,185,6720,308,7545,2920,1130,1070,5120,1550,245,6915,630,270021,3029,7100,13829,25690,54802,22571,105305,159951,8017983000,109563000,127519000,232655000,477687000,1248042000,623002000,2370804000,5515910000
Wisconsin,Finance and Insurance,2010,24458,15780,2832,1478,20090,2082,835,23007,1451,46905,15805,2885,1765,20455,5135,4485,30075,16830,700222,26611,16957,18340,62665,72784,85737,226010,459554,41627046000,1086249000,737751000,847041000,2725005000,3442966000,4497559000,10838589000,30675363000
Wisconsin,Health Care and Social Assistance,2010,51103,21900,11050,7511,40461,6410,2414,49285,1818,72430,21960,11210,7935,41105,9650,7360,58115,14315,1909020,39854,72791,100849,215998,245394,347778,815387,1069900,77530003000,2081920000,2811125000,3757713000,8658922000,9338064000,9737794000,27920174000,48992385000
Wisconsin,Information,2010,5557,2150,840,712,3702,802,293,4797,760,11995,2150,840,750,3740,1080,665,5485,6510,262310,3146,4561,9108,18347,26096,21893,69307,160350,13758281000,148132000,196165000,341656000,709773000,1140099000,935253000,2972594000,9231562000
Wisconsin,Management of Companies and Enterprises,2010,3506,250,70,140,460,675,1108,2243,1263,5065,250,70,145,465,685,1175,2325,2740,311615,67,280,659,1276,7235,34069,43000,268494,26135355000,34225000,20644000,46294000,106785000,375080000,2092841000,2589350000,23537793000
Wisconsin,Manufacturing,2010,41580,13341,6490,6510,26341,8613,3479,38433,3147,45165,13350,6490,6545,26385,9155,4460,40000,5165,1944744,21086,39158,79737,147994,330545,397277,930256,896094,93933093000,907749000,1406294000,3162132000,5698309000,14640612000,18396188000,40980388000,47412420000
Wisconsin,"Mining, Quarrying, and Oil and Gas Extraction",2010,645,300,100,80,480,80,32,592,53,760,300,100,90,490,100,80,670,90,10685,158,595,1063,2107,0,0,5976,0,769033000,28201000,30920000,72469000,136633000,0,0,413588000,194377000
Wisconsin,Other,2010,344,339,5,0,344,0,0,344,0,344,339,5,0,344,0,0,344,0,0,0,0,0,0,0,0,0,0,3589000,3338000,0,0,3589000,0,0,3589000,0
Wisconsin,Other Services (except Public Administration),2010,69032,40270,15025,8057,63352,4534,610,68496,536,74115,40315,15145,8475,63935,6005,1290,71230,2885,542765,75984,96705,103466,280579,151127,39100,479351,54838,12400333000,1710975000,1987693000,2016725000,5737959000,3513485000,1111182000,10548859000,1691265000
Wisconsin,"Professional, Scientific, and Technical Services",2010,52518,34230,7705,4851,46786,3486,854,51126,1392,56580,34265,7795,5005,47065,4200,1415,52680,3900,509392,50846,48991,62348,166990,114508,64672,353239,135842,26885125000,2153683000,2124172000,2825521000,7183592000,6405352000,4186790000,18106205000,8442658000
Wisconsin,Real Estate and Rental and Leasing,2010,18392,13405,2235,1205,16845,745,415,18005,387,22700,13450,2305,1305,17060,1270,1755,20085,2615,116570,19841,13534,14348,49642,22603,13753,92804,17034,3637407000,595962000,399343000,470896000,1495934000,736846000,591696000,2951964000,597419000
Wisconsin,Retail Trade,2010,65231,31850,13615,9026,54491,6914,1632,63037,2194,97955,32010,14060,9940,56010,10530,5770,72310,25645,1389215,51787,86670,116343,265156,222875,144579,648591,659434,32117949000,1330528000,1871977000,2606616000,5853910000,6266216000,3596243000,15933141000,15481469000
Wisconsin,Total,2010,110435,61381,19156,13454,93991,11389,2627,108007,2428,139554,61503,19414,14145,95062,15421,7829,118312,21242,2320696,103742,125821,180428,409991,425831,365964,1201786,1118910,90916263000,3465340000,3703101000,5327947000,12496388000,14430510000,13664509000,40591407000,50324856000
Wisconsin,Transportation and Warehousing,2010,22962,13055,3114,2466,18635,2267,758,21660,1302,25945,13060,3120,2515,18695,2525,1115,22335,3610,457866,18079,18888,31647,72474,74751,61591,214123,234201,16891650000,695896000,643387000,1029704000,2399837000,2604916000,2115191000,7266380000,9194786000
Wisconsin,Utilities,2010,378,80,15,30,125,130,10,265,113,1585,80,15,35,130,185,20,335,1250,64398,66,0,192,487,4213,0,5389,58601,5697440000,2248000,938000,20215000,25128000,241569000,0,314132000,5375078000
Wisconsin,Wholesale Trade,2010,29101,12800,4432,3639,20871,4140,1874,26885,2216,35370,12850,4515,3825,21190,5200,3430,29820,5550,524732,19487,27164,43663,95987,125578,112900,352429,143078,27073422000,974445000,1283421000,2127799000,4468431000,6351107000,5590766000,17120493000,8430867000
Wyoming,Accommodation and Food Services,2010,7588,2805,1595,1530,5930,1188,257,7375,213,8620,2815,1600,1545,5960,1440,625,8025,595,129737,4307,10640,20990,36267,42332,28750,107634,11215,2231490000,129805000,142103000,292934000,565644000,663082000,480886000,1714661000,389464000
Wyoming,Administrative and Support and Waste Management and Remediation Services,2010,4481,3000,650,368,4018,180,45,4243,238,4735,3000,650,385,4035,200,55,4290,445,27442,3764,3533,3989,12833,3919,0,18283,7297,814695000,144601000,109596000,89888000,366182000,100441000,9474000,511014000,239076000
Wyoming,"Agriculture, Forestry, Fishing and Hunting",2010,400,340,40,15,395,0,0,395,5,400,340,40,15,395,0,0,395,5,648,366,77,0,729,0,0,729,0,22145000,12649000,5440000,4088000,20349000,0,0,20349000,0
Wyoming,"Arts, Entertainment, and Recreation",2010,2040,1360,245,240,1845,160,20,2025,15,2085,1360,245,240,1845,190,30,2065,20,17647,1504,1444,2563,6160,4784,608,13868,0,357464000,71614000,20738000,41690000,145358000,94538000,16312000,315076000,0
Wyoming,Construction,2010,13644,9460,1995,1340,12795,622,124,13541,103,13705,9460,1995,1345,12800,630,135,13565,140,88199,14684,12735,16704,46460,17646,10800,79566,5797,4070747000,570910000,476785000,728082000,1814365000,1057860000,540499000,3613207000,307574000
Wyoming,Educational Services,2010,757,400,120,105,625,60,37,722,35,800,400,120,105,625,60,75,760,40,8640,351,691,1014,2559,1904,1454,7813,0,222843000,15761000,10222000,21772000,52953000,44255000,42588000,198897000,0
Wyoming,Finance and Insurance,2010,3179,2060,320,180,2560,243,54,2857,322,5040,2065,335,220,2620,725,165,3510,1530,33603,2654,1730,1999,6598,8963,1766,19315,7632,1532167000,117666000,62909000,60469000,255769000,402348000,78416000,826933000,631259000
Wyoming,Health Care and Social Assistance,2010,8299,4133,1740,1119,6992,762,290,8044,255,9050,4135,1745,1150,7030,1010,550,8590,460,155562,6217,11033,14171,33511,25940,40551,108781,42801,6289109000,390831000,431708000,535011000,1383245000,957567000,1674244000,4220059000,1989383000
Wyoming,Information,2010,1011,340,150,125,615,192,70,877,134,1500,340,165,125,630,260,145,1035,465,17336,106,593,1079,2809,4683,2010,11814,4991,646894000,15093000,14006000,35582000,91518000,135879000,94881000,382034000,248643000
Wyoming,Management of Companies and Enterprises,2010,366,65,15,20,100,80,80,260,106,415,65,15,20,100,80,85,265,150,4224,0,0,0,233,761,931,2020,0,359560000,3724000,0,0,11615000,60628000,85129000,168723000,0
Wyoming,Manufacturing,2010,2663,1420,415,240,2075,265,117,2457,206,2740,1420,415,240,2075,285,140,2500,240,30090,1467,1278,1442,6009,4866,1506,17076,8777,1652803000,59519000,50025000,67821000,220387000,207366000,93519000,806160000,609888000
Wyoming,"Mining, Quarrying, and Oil and Gas Extraction",2010,3684,1750,630,415,2795,342,138,3275,409,4275,1750,630,415,2795,355,185,3335,940,117287,2006,3870,4934,11093,10482,6830,31425,78087,9168538000,163797000,225329000,278989000,698631000,710495000,507922000,2193681000,6401169000
Wyoming,Other,2010,58,56,0,2,58,0,0,58,0,58,56,0,2,58,0,0,58,0,67,0,0,0,67,0,0,67,0,1650000,1375000,0,0,1650000,0,0,1650000,0
Wyoming,Other Services (except Public Administration),2010,8761,5685,1760,825,8270,245,105,8620,141,9035,5685,1760,870,8315,300,120,8735,300,41794,8950,10382,9836,31752,5005,319,38722,1512,1195695000,262419000,287101000,243012000,819348000,164982000,14387000,1059951000,88670000
Wyoming,"Professional, Scientific, and Technical Services",2010,9821,7170,1230,665,9065,360,125,9550,271,10190,7175,1230,675,9080,440,185,9705,485,43237,9522,7417,6734,27032,8389,2529,40180,2012,2088257000,487537000,318522000,387612000,1223644000,428474000,131171000,1927464000,122575000
Wyoming,Real Estate and Rental and Leasing,2010,4809,3745,455,240,4440,120,55,4615,194,5420,3745,455,240,4440,240,190,4870,550,20194,4707,2646,2436,10669,1344,966,14815,4600,805555000,152243000,85745000,71858000,332246000,80199000,35756000,497102000,298055000
Wyoming,Retail Trade,2010,10614,5180,2214,1360,8754,849,342,9945,669,13630,5180,2255,1480,8915,1175,865,10955,2675,125351,7679,12164,15178,39962,22666,6923,76502,35927,3191400000,205540000,308590000,407120000,960917000,693898000,297189000,2049658000,861934000
Wyoming,Total,2010,17585,10561,2899,1876,15336,1202,371,16909,676,20231,10572,2924,1956,15452,1649,827,17928,2303,205046,17387,19052,24869,61308,40018,31594,132920,72126,8398298000,625443000,586432000,773823000,1985698000,1453118000,1280713000,4719529000,3678769000
Wyoming,Transportation and Warehousing,2010,3795,2355,540,275,3170,235,82,3487,308,4450,2355,545,280,3180,255,175,3610,840,37852,2945,2970,2250,10135,5589,2417,21033,9286,1975790000,126805000,120969000,95872000,387734000,287166000,124006000,961911000,760477000
Wyoming,Utilities,2010,242,75,5,30,110,35,20,165,77,640,75,5,40,120,60,55,235,405,11512,23,0,0,277,1328,516,2781,8727,926584000,1250000,0,17136000,19524000,85920000,33738000,184946000,750024000
Wyoming,Wholesale Trade,2010,3184,1195,395,372,1962,413,217,2592,592,4135,1215,415,380,2010,540,355,2905,1230,35271,1194,1824,3270,7245,5501,2211,18632,14417,2004129000,80710000,92688000,141506000,354524000,338733000,125145000,939667000,972250000
