state_name,industry_name,YEAR,firms_01: Total,firms_02: <5,firms_03: 5-9,firms_04: 10-19,firms_05: <20,firms_06: 20-99,firms_07: 100-499,firms_08: <500,firms_09: 500+,establishments_01: Total,establishments_02: <5,establishments_03: 5-9,establishments_04: 10-19,establishments_05: <20,establishments_06: 20-99,establishments_07: 100-499,establishments_08: <500,establishments_09: 500+,employment_01: Total,employment_02: <5,employment_03: 5-9,employment_04: 10-19,employment_05: <20,employment_06: 20-99,employment_07: 100-499,employment_08: <500,employment_09: 500+,annual_payroll_01: Total,annual_payroll_02: <5,annual_payroll_03: 5-9,annual_payroll_04: 10-19,annual_payroll_05: <20,annual_payroll_06: 20-99,annual_payroll_07: 100-499,annual_payroll_08: <500,annual_payroll_09: 500+
Alabama,Accommodation and Food Services,2011,28067,10490,5573,5223,21286,5136,790,27212,855,40895,10540,5580,5345,21465,6245,3410,31120,9775,737841,18144,36674,70741,126346,184842,111252,423158,311375,10223048000,369887000,447613000,873441000,1695433000,2391747000,1438597000,5537973000,4423300000
Alabama,Administrative and Support and Waste Management and Remediation Services,2011,17831,9635,2745,1723,14103,1682,684,16469,1362,20545,9640,2755,1745,14140,1830,900,16870,3675,652420,13825,16472,21245,55444,61973,81081,209017,426293,16320202000,536573000,466281000,627948000,1682896000,1773091000,2136023000,5895063000,10009163000
Alabama,"Agriculture, Forestry, Fishing and Hunting",2011,3919,2005,1105,470,3580,248,30,3858,61,3995,2005,1105,470,3580,255,45,3880,115,29464,3801,7102,5955,17212,6788,1113,27255,1171,1012063000,134498000,222093000,192168000,560431000,260115000,29855000,907629000,86059000
Alabama,"Arts, Entertainment, and Recreation",2011,5063,2855,730,660,4245,599,116,4960,103,5410,2855,730,665,4250,660,165,5075,335,73255,4637,4409,8509,18474,20696,11869,54603,15314,1407283000,120075000,82056000,131486000,349055000,388535000,228277000,1069333000,280192000
Alabama,Construction,2011,38221,23160,6460,4490,34110,3250,422,37782,439,38920,23160,6460,4500,34120,3325,485,37930,990,398785,39471,41050,59520,142970,119680,52751,321360,57791,16778755000,1236925000,1344830000,2161895000,4760510000,5217881000,2461259000,12711075000,3193958000
Alabama,Educational Services,2011,3893,1710,660,545,2915,630,180,3725,168,4215,1715,660,570,2945,690,210,3845,370,142188,647,3820,6928,14431,25389,29613,70623,68076,4055808000,67949000,55811000,116513000,250243000,530118000,801069000,1636819000,2268014000
Alabama,Finance and Insurance,2011,15981,10100,2024,880,13004,1274,546,14824,1157,35660,10120,2110,1190,13420,3450,3465,20335,15325,340179,18696,11604,9905,41836,44945,32790,125846,113059,20853446000,730093000,524590000,454434000,1769132000,2089629000,1649250000,5866628000,9084197000
Alabama,Health Care and Social Assistance,2011,40620,16190,10700,6704,33594,4540,1308,39442,1178,50775,16235,10755,6960,33950,6045,4190,44185,6590,1172610,32408,69547,88941,193271,168146,188297,561230,595472,48432278000,1801631000,2949454000,3817340000,8614816000,7775317000,6624338000,23249121000,24510261000
Alabama,Information,2011,3778,1565,585,365,2515,437,236,3188,590,7720,1565,620,370,2555,520,315,3390,4330,152703,2203,3103,3859,10582,12185,10209,45953,101890,7760988000,90650000,119028000,169307000,401296000,646571000,466882000,2068656000,5403051000
Alabama,Management of Companies and Enterprises,2011,2249,105,50,50,205,466,628,1299,950,2790,110,50,50,210,475,695,1380,1410,97960,165,180,209,513,4561,13730,18895,79053,8801690000,34420000,12530000,14361000,63140000,266829000,813945000,1145310000,7654904000
Alabama,Manufacturing,2011,19725,6555,3070,2555,12180,3608,1573,17361,2364,21345,6555,3070,2580,12205,3675,1830,17710,3635,1025300,8449,16976,28279,60812,125923,132195,366944,577642,46522687000,385826000,552191000,1003191000,2138426000,4982883000,5428614000,14168908000,28480589000
Alabama,"Mining, Quarrying, and Oil and Gas Extraction",2011,989,350,100,110,560,160,60,780,209,1240,350,100,110,560,165,80,805,435,37980,31,548,1152,2280,6214,2738,12718,21243,2615893000,25696000,20001000,48743000,99864000,359777000,165675000,720694000,1738923000
Alabama,Other,2011,155,149,6,0,155,0,0,155,0,155,149,6,0,155,0,0,155,0,0,0,0,0,0,0,0,0,0,3290000,2919000,371000,0,3290000,0,0,3290000,0
Alabama,Other Services (except Public Administration),2011,51191,31515,10755,4796,47066,3201,422,50689,502,55050,31640,10840,4965,47445,4140,845,52430,2620,393449,61213,69241,62647,195353,107584,30524,341617,41229,8857925000,1303467000,1361153000,1377485000,4065728000,2202626000,696922000,7216963000,1314019000
Alabama,"Professional, Scientific, and Technical Services",2011,41958,27680,6180,3550,37410,2422,903,40735,1223,46245,27685,6185,3665,37535,2980,1210,41725,4520,463619,42741,38931,44897,130280,79949,66296,282478,167559,29208980000,1805237000,1684552000,2276159000,5796586000,5053308000,5295927000,16435081000,12306649000
Alabama,Real Estate and Rental and Leasing,2011,14416,10373,1645,794,12812,757,374,13943,473,18760,10410,1735,915,13060,1425,1040,15525,3235,111678,13251,9939,9467,37002,19531,20174,79868,29208,3881613000,494458000,307895000,311685000,1133377000,713290000,654482000,2615321000,1151219000
Alabama,Retail Trade,2011,56874,32320,11401,5729,49450,4392,1042,54884,1990,91375,32415,11725,6280,50420,7680,3995,62095,29280,1024632,51669,69616,70501,200970,142097,77015,438745,546020,23914419000,1319018000,1672347000,1915809000,4945610000,4213304000,2322391000,11731828000,11531496000
Alabama,Total,2011,74131,40644,13752,8417,62813,7055,1891,71759,2372,97743,40748,13929,8854,63531,9704,5188,78423,19320,1573138,74986,90173,112156,277315,260273,219887,757475,815663,59241365000,2342593000,2666406000,3587891000,8596890000,9160066000,8193682000,25950638000,33290727000
Alabama,Transportation and Warehousing,2011,12183,6730,1590,1023,9343,1225,573,11141,1042,14335,6730,1590,1055,9375,1335,770,11480,2855,271779,10157,8899,12481,34604,37243,35944,111748,137538,11129765000,374948000,306037000,407809000,1109785000,1312539000,1420597000,3998339000,6222946000
Alabama,Utilities,2011,548,135,160,20,315,95,25,435,113,2095,135,160,20,315,195,75,585,1510,34938,300,959,132,1505,5040,2760,9339,220,2789993000,6855000,32668000,10931000,50454000,325303000,185105000,562505000,23851000
Alabama,Wholesale Trade,2011,21281,9095,3323,2659,15077,2666,1290,19033,2248,26570,9130,3385,2815,15330,3430,2215,20975,5595,342106,14440,19751,29710,69216,75163,54575,211830,113050,17469516000,697183000,915416000,1452709000,3154766000,3576925000,2768416000,10052598000,6609409000
Alaska,Accommodation and Food Services,2011,8657,4268,1708,1334,7310,969,196,8475,182,10040,4280,1710,1345,7335,1155,745,9235,805,130049,4872,10783,17298,34238,35127,24199,94122,31992,3062703000,246781000,204437000,290859000,745416000,723056000,495811000,1981890000,1022839000
Alaska,Administrative and Support and Waste Management and Remediation Services,2011,4853,2855,760,445,4060,298,127,4485,368,5460,2855,765,475,4095,345,260,4700,760,99167,822,4586,4338,13360,7667,6594,33011,54730,4782664000,183170000,175170000,155610000,548249000,329977000,256515000,1460032000,2998695000
Alaska,"Agriculture, Forestry, Fishing and Hunting",2011,1925,1770,65,40,1875,25,10,1910,15,1935,1770,65,40,1875,25,10,1910,25,6424,1015,99,176,1437,0,0,5129,259,298047000,98963000,13244000,7755000,138084000,0,0,251077000,9394000
Alaska,"Arts, Entertainment, and Recreation",2011,2605,1825,335,220,2380,190,10,2580,25,2760,1830,355,250,2435,195,10,2640,120,20475,645,1650,2383,5940,5766,0,12445,1870,415276000,97096000,50553000,53509000,221159000,93337000,0,354515000,17694000
Alaska,Construction,2011,11890,8360,1665,1085,11110,498,99,11707,183,12125,8360,1665,1095,11120,525,145,11790,335,83933,10141,10092,13306,35922,14583,6686,60358,20250,7316809000,773819000,686414000,1084002000,2628590000,1310497000,701216000,4834630000,2196911000
Alaska,Educational Services,2011,1105,550,230,155,935,90,55,1080,25,1260,550,230,160,940,95,180,1215,45,14711,828,1216,1710,4288,2711,2470,13102,1609,384476000,26548000,35707000,47789000,117240000,69595000,84026000,341422000,43054000
Alaska,Finance and Insurance,2011,2132,1100,355,125,1580,121,95,1796,336,3875,1100,360,135,1595,250,395,2240,1635,34537,1493,1797,1013,4719,2762,54,11670,15848,2178725000,85582000,90855000,65699000,274260000,138539000,156985000,807475000,1105809000
Alaska,Health Care and Social Assistance,2011,9764,4595,2390,1260,8245,827,408,9480,284,11710,4595,2395,1300,8290,1060,1010,10360,1350,206600,7224,15121,15851,39641,29197,47454,123487,67227,11217368000,516773000,764592000,1083541000,2413100000,1531752000,2013904000,6143512000,4003109000
Alaska,Information,2011,1032,455,140,118,713,106,68,887,145,1990,465,140,135,740,190,215,1145,845,32302,424,637,793,2466,2594,955,5675,9964,1990687000,34401000,20917000,34596000,100683000,130618000,45222000,457391000,1432467000
Alaska,Management of Companies and Enterprises,2011,526,30,15,25,70,116,130,316,210,720,30,15,25,70,120,150,340,380,32986,0,0,144,215,1075,0,0,25757,3502691000,3223000,0,11926000,18310000,50885000,0,8194000,3087965000
Alaska,Manufacturing,2011,2332,1245,430,240,1915,204,40,2159,173,2665,1250,430,240,1920,220,55,2195,470,55596,297,1394,1266,5010,4058,5078,16171,38779,2303661000,89902000,66834000,101072000,348947000,181103000,178207000,825119000,1467247000
Alaska,"Mining, Quarrying, and Oil and Gas Extraction",2011,642,280,80,70,430,45,55,530,112,815,280,80,75,435,45,65,545,270,44722,7,86,273,196,511,4406,8604,35018,4739901000,10850000,26746000,89261000,308511000,55436000,495317000,1188500000,3472300000
Alaska,Other,2011,24,24,0,0,24,0,0,24,0,24,24,0,0,24,0,0,24,0,0,0,0,0,0,0,0,0,0,552000,552000,0,0,552000,0,0,552000,0
Alaska,Other Services (except Public Administration),2011,8461,5250,1833,772,7855,365,85,8305,156,9055,5255,1855,815,7925,510,270,8705,350,47878,7432,11233,9288,30179,10180,1684,44597,1152,1576616000,273482000,337997000,307599000,956371000,375818000,58904000,1452217000,43746000
Alaska,"Professional, Scientific, and Technical Services",2011,8488,5500,1007,735,7242,505,177,7924,564,9600,5500,1020,765,7285,655,230,8170,1430,83987,7164,5853,8870,24437,12811,5356,46336,26723,5664666000,459490000,402870000,645014000,1565846000,1026989000,455776000,3271880000,2284139000
Alaska,Real Estate and Rental and Leasing,2011,3770,2685,470,230,3385,152,68,3605,165,4225,2690,470,265,3425,240,255,3920,305,22990,3637,2620,2560,9396,3001,1578,16794,3210,931888000,146084000,93685000,96768000,350788000,126444000,70593000,674470000,209288000
Alaska,Retail Trade,2011,9609,4777,1919,1313,8009,853,204,9066,543,12550,4820,2005,1455,8280,1310,540,10130,2420,149497,5396,10690,13688,34667,22044,7307,72129,43403,4546487000,266775000,314500000,408872000,1071365000,782581000,327543000,2419496000,1318974000
Alaska,Total,2011,16458,9896,2829,1719,14444,1104,319,15867,591,20119,9930,2883,1859,14672,1561,1103,17336,2783,254996,14881,18553,22843,56277,38807,39401,134485,120511,13394017000,780407000,761641000,1066970000,2609018000,1797223000,1862655000,6268896000,7125121000
Alaska,Transportation and Warehousing,2011,4282,2717,430,290,3437,233,218,3888,394,5540,2735,435,295,3465,380,540,4385,1155,72784,1401,1961,2130,6906,4555,12670,29599,24751,4938820000,229991000,108448000,122902000,506838000,240412000,605732000,1704240000,1636749000
Alaska,Utilities,2011,282,80,65,37,182,55,40,277,5,455,85,65,100,250,60,130,440,15,8480,45,94,372,869,1701,4023,8078,0,728570000,4307000,10653000,24207000,41316000,145899000,364810000,686934000,0
Alaska,Wholesale Trade,2011,2818,1070,340,285,1695,323,201,2219,599,3695,1080,355,325,1760,425,310,2495,1200,35565,560,1295,1666,5418,5322,3738,18674,13665,2226485000,71433000,67155000,113860000,357478000,297693000,196712000,1026010000,973138000
Arizona,Accommodation and Food Services,2011,39459,13292,7955,7550,28797,8275,1213,38285,1174,57775,13300,7985,7690,28975,9650,5280,43905,13870,1193177,21765,53229,102349,178070,303084,181942,666210,529481,20366219000,530793000,663125000,1265465000,2462053000,4433241000,2689112000,9619352000,10090960000
Arizona,Administrative and Support and Waste Management and Remediation Services,2011,35076,20615,5390,3070,29075,2959,1227,33261,1815,40055,20615,5445,3135,29195,3150,1525,33870,6185,1009709,28896,34833,39202,104967,109016,154306,381981,602377,34092313000,1000384000,967183000,1176001000,3171146000,3146366000,4489748000,11132143000,22961566000
Arizona,"Agriculture, Forestry, Fishing and Hunting",2011,930,650,135,35,820,75,15,910,20,945,650,135,35,820,90,15,925,20,6312,671,15,83,1967,2206,0,5887,0,210934000,39381000,10523000,10658000,82208000,62437000,36535000,198279000,0
Arizona,"Arts, Entertainment, and Recreation",2011,7618,4460,915,660,6035,932,424,7391,227,8670,4460,935,670,6065,955,720,7740,930,197943,4105,5074,7091,16897,36351,57347,121897,60176,6368798000,267303000,101427000,168056000,590493000,619924000,2968521000,4317892000,1566457000
Arizona,Construction,2011,56494,35771,9040,5615,50426,4656,786,55868,626,57190,35780,9050,5620,50450,4735,965,56150,1040,584960,55227,58886,74546,192211,173696,86140,459048,99234,26392185000,1881722000,1918523000,2716999000,6521070000,7213343000,4152613000,18104958000,6681598000
Arizona,Educational Services,2011,8440,3950,1245,1163,6358,1381,394,8133,307,9860,3970,1245,1180,6395,1490,615,8500,1360,375200,5186,7993,15626,29664,55509,47602,136947,235194,11323090000,228286000,181940000,369732000,787012000,1609676000,1578522000,4071241000,7068808000
Arizona,Finance and Insurance,2011,24480,17648,2350,894,20892,952,699,22543,1937,45180,17675,2395,975,21045,1350,2110,24505,20675,631653,26910,14066,10276,52402,24516,39433,123883,482323,37410413000,1167009000,660035000,699564000,2639616000,1467266000,2463349000,6974266000,29955206000
Arizona,Health Care and Social Assistance,2011,65836,36318,13865,7104,57287,5121,1820,64228,1608,81975,36380,14025,7350,57755,6960,5585,70300,11675,1564637,56153,90743,91632,240316,191021,271988,715433,811079,73614103000,3773084000,3820379000,3989132000,11714380000,8152151000,10713637000,30871529000,41509720000
Arizona,Information,2011,6194,3090,790,440,4320,666,272,5258,936,10220,3090,795,450,4335,780,395,5510,4710,238131,3528,4568,4733,14606,21310,21082,59978,130513,14072811000,225985000,191974000,251187000,680690000,1157452000,1406216000,3552164000,10159798000
Arizona,Management of Companies and Enterprises,2011,2974,241,70,55,366,475,831,1672,1302,4280,245,70,55,370,480,910,1760,2520,206175,278,0,0,911,5598,22354,28905,176904,15955235000,22362000,19141000,1412000,95628000,290685000,1455301000,1844040000,14089030000
Arizona,Manufacturing,2011,20324,8510,3460,2685,14655,2980,1149,18784,1540,21335,8510,3460,2685,14655,3065,1345,19065,2270,602383,9642,17840,29415,65111,91494,78568,271308,285620,34710426000,529584000,681394000,1125337000,2584377000,4128181000,3271525000,11274997000,21227486000
Arizona,"Mining, Quarrying, and Oil and Gas Extraction",2011,971,455,145,110,710,105,41,856,115,1270,455,145,110,710,125,65,900,370,29518,514,143,834,2572,1997,2306,8213,21365,1970350000,48421000,32279000,43761000,157685000,84795000,186075000,493319000,1481380000
Arizona,Other,2011,198,193,4,1,198,0,0,198,0,198,193,4,1,198,0,0,198,0,0,0,0,0,0,0,0,0,0,3445000,3342000,0,0,3445000,0,0,3445000,0
Arizona,Other Services (except Public Administration),2011,47637,29379,9170,4702,43251,3012,719,46982,655,53360,29425,9240,4920,43585,3870,2365,49820,3540,404744,50306,59173,60457,173798,104345,56412,343548,42202,10577608000,1394240000,1416090000,1542304000,4379502000,2578317000,1502013000,8757191000,1414949000
Arizona,"Professional, Scientific, and Technical Services",2011,74629,55000,8495,4482,67977,3403,1293,72673,1956,80865,55015,8525,4545,68085,3995,2270,74350,6515,642062,64161,53301,56241,183512,111025,79926,383830,226266,38519095000,3924557000,2678822000,3009933000,9718872000,6659413000,5015696000,21843880000,16339276000
Arizona,Real Estate and Rental and Leasing,2011,31262,24670,2722,1417,28809,1079,598,30486,776,39285,24700,2840,1535,29075,1790,1780,32645,6640,184439,29357,16508,16968,64936,29782,25584,125365,54567,7913305000,1229120000,526333000,622117000,2397406000,1187644000,1289327000,5149028000,2732841000
Arizona,Retail Trade,2011,50121,28246,9555,5029,42830,3543,1317,47690,2431,88970,28415,9825,5810,44050,5855,4530,54435,34535,1480387,43021,50862,51880,149488,108713,102387,397589,976839,36481186000,1224167000,1268522000,1492478000,3976530000,3531018000,4084018000,12289753000,22648623000
Arizona,Total,2011,100672,60853,16147,9685,86685,8480,2550,97715,2957,130305,60970,16352,10105,87427,10655,6767,104849,25456,2108561,95790,106378,128761,330929,309738,287488,928155,1180406,86533273000,3843641000,3413870000,4276083000,11533594000,10677154000,11193091000,33403839000,53129434000
Arizona,Transportation and Warehousing,2011,13155,7180,1793,960,9933,1209,699,11841,1314,15540,7195,1795,975,9965,1395,905,12265,3275,302324,7924,10119,10276,32726,33568,30314,105031,189253,11685151000,338522000,375066000,361239000,1124470000,1247503000,1127128000,3641370000,7943642000
Arizona,Utilities,2011,830,465,110,50,625,47,55,727,103,1390,465,115,50,630,105,165,900,490,30794,0,362,262,67,1446,4475,10373,1064,2702495000,22870000,23048000,12818000,76616000,102805000,339163000,696710000,103084000
Arizona,Wholesale Trade,2011,26996,13515,3650,2607,19772,2965,1563,24300,2696,32370,13540,3715,2730,19985,3435,2290,25710,6660,454629,20181,20827,25993,73217,77276,49403,212139,224225,28992263000,1033453000,1013629000,1481359000,3654984000,3666357000,2680057000,10557383000,17805293000
Arkansas,Accommodation and Food Services,2011,20591,7005,3930,4143,15078,4288,663,20029,562,26615,7025,3975,4210,15210,4870,2525,22605,4010,461827,10866,26066,56497,94331,146118,80791,324687,126798,5851440000,237941000,298208000,663796000,1204229000,1763366000,946710000,3989955000,1722033000
Arkansas,Administrative and Support and Waste Management and Remediation Services,2011,11480,6800,1615,1005,9420,992,304,10716,764,12950,6800,1620,1045,9465,1155,465,11085,1865,250675,8956,9424,12359,33402,33355,31565,107848,121657,6483473000,320590000,279200000,326571000,965530000,882033000,617546000,2631967000,3225921000
Arkansas,"Agriculture, Forestry, Fishing and Hunting",2011,3103,1685,855,310,2850,155,45,3050,53,3250,1685,855,310,2850,175,60,3085,165,21494,2745,5143,3599,12295,4091,3449,20174,403,728986000,108299000,207883000,123043000,458392000,118470000,52096000,642857000,47838000
Arkansas,"Arts, Entertainment, and Recreation",2011,4019,2480,555,425,3460,397,92,3949,70,4105,2480,555,430,3465,440,120,4025,80,42816,3227,3224,5164,12846,13737,6771,36416,2289,798569000,116081000,45115000,70871000,243237000,255489000,133835000,673407000,42597000
Arkansas,Construction,2011,26145,16665,4425,2655,23745,1915,246,25906,239,26455,16665,4425,2680,23770,1940,310,26020,435,211855,26380,28068,34892,93385,64608,23048,189289,16047,8089611000,820836000,898283000,1225094000,2963315000,2598005000,1035571000,6954298000,743044000
Arkansas,Educational Services,2011,2540,1155,455,265,1875,415,145,2435,105,2810,1155,455,265,1875,430,345,2650,160,77515,1292,2730,3399,8209,16897,17281,44719,26226,1581934000,44690000,47214000,53805000,152211000,379828000,547478000,1109289000,430624000
Arkansas,Finance and Insurance,2011,11906,8165,1445,434,10044,683,375,11102,804,21505,8165,1470,580,10215,2070,2465,14750,6755,175637,12875,8385,5230,28548,23808,28059,85843,88093,9155554000,450397000,351693000,224931000,1057591000,1085354000,1159056000,3633647000,5189798000
Arkansas,Health Care and Social Assistance,2011,29626,13900,6520,3853,24273,2978,1433,28684,942,37185,13900,6540,3960,24400,4125,4100,32625,4560,855425,22500,41899,48576,115621,127845,173782,423987,421761,31929239000,1390259000,1585146000,1879436000,4894431000,4048323000,4995245000,14294132000,17368828000
Arkansas,Information,2011,2618,1030,400,315,1745,305,125,2175,443,5085,1030,400,320,1750,410,230,2390,2695,103700,1322,2122,3494,7608,8722,4537,22530,52361,5474012000,43759000,59254000,103815000,227815000,403460000,147693000,935410000,2676689000
Arkansas,Management of Companies and Enterprises,2011,1493,70,30,55,155,280,442,877,616,5830,70,30,55,155,285,495,935,4895,196712,0,0,240,524,3059,9781,13750,182882,16257730000,4038000,1582000,9853000,31841000,153459000,559940000,753535000,15496607000
Arkansas,Manufacturing,2011,12235,4180,2120,1490,7790,1900,889,10579,1656,13445,4180,2120,1490,7790,2110,1085,10985,2460,689874,5687,11360,15303,36068,56668,56932,183826,434987,27687611000,198555000,344688000,512993000,1161089000,1995484000,2326047000,6730083000,17521430000
Arkansas,"Mining, Quarrying, and Oil and Gas Extraction",2011,1834,805,220,190,1215,255,93,1563,271,2090,805,220,190,1215,265,115,1595,495,48874,645,1217,2627,4084,8249,7659,22473,26277,3275554000,67416000,61503000,111568000,244494000,467210000,528508000,1302713000,1974281000
Arkansas,Other,2011,104,96,6,2,104,0,0,104,0,104,96,6,2,104,0,0,104,0,159,0,0,0,159,0,0,159,0,2262000,1733000,0,0,2262000,0,0,2262000,0
Arkansas,Other Services (except Public Administration),2011,31514,20195,6272,2805,29272,1706,208,31186,328,32950,20205,6305,2900,29410,2225,410,32045,905,209166,36800,39633,35219,114328,58153,13271,193186,10830,4616643000,781641000,810804000,779245000,2392516000,1110203000,337051000,4048120000,471890000
Arkansas,"Professional, Scientific, and Technical Services",2011,26575,18855,3885,1731,24471,973,393,25837,738,28500,18860,3910,1825,24595,1265,850,26710,1790,166834,25612,23469,21329,74444,27659,19794,128742,30393,7886034000,1183675000,979874000,872418000,3064604000,1398787000,906393000,5668727000,1912627000
Arkansas,Real Estate and Rental and Leasing,2011,11507,9058,1003,475,10536,431,205,11172,335,13985,9155,1015,520,10690,960,470,12120,1865,62983,12863,6133,4616,25447,11239,5172,44757,15980,1901033000,351218000,155464000,138154000,668421000,348744000,169723000,1308799000,549816000
Arkansas,Retail Trade,2011,35783,18370,8415,4331,31116,2549,621,34286,1497,54215,18470,8550,4730,31750,4190,2760,38700,15515,542622,30416,52637,51834,143013,76461,43937,275423,243918,12881268000,735897000,1192314000,1351281000,3319182000,2436164000,1111170000,7140946000,5587114000
Arkansas,Total,2011,50426,28636,9115,5364,43115,4414,1205,48734,1692,64471,28693,9198,5632,43523,6095,3747,53365,11106,980644,49146,59600,70944,179690,161475,141684,482849,497795,35312365000,1543827000,1655769000,2002297000,5201893000,4877976000,4614778000,14694647000,20617718000
Arkansas,Transportation and Warehousing,2011,10457,6150,1409,960,8519,835,289,9643,814,12170,6160,1420,975,8555,895,375,9825,2345,228530,8415,8636,10915,29609,27263,15995,76609,128232,9190797000,311650000,252979000,371895000,972418000,992903000,625152000,2686263000,5560687000
Arkansas,Utilities,2011,698,390,115,20,525,55,48,628,70,1675,390,115,20,525,135,165,825,850,31601,916,685,126,1790,2728,8579,13473,533,2391822000,22929000,19790000,7004000,52194000,148923000,597453000,814709000,50204000
Arkansas,Wholesale Trade,2011,13832,5775,1947,1580,9302,1888,875,12065,1767,17015,5785,1980,1645,9410,2530,1390,13330,3685,210918,8147,10815,16947,40293,49207,26481,130869,74390,10718278000,390134000,441079000,731109000,1647748000,2221169000,1483163000,5964205000,4380679000
California,Accommodation and Food Services,2011,288857,114372,62007,54438,230817,50154,5806,286777,2080,381935,114630,62330,55875,232835,60145,24885,317865,64070,6697540,194385,404333,723934,1322743,1866760,948118,4126558,2483230,124479060000,4642247000,5519895000,10923581000,20957344000,32801995000,17480835000,71533095000,52937361000
California,Administrative and Support and Waste Management and Remediation Services,2011,174971,106344,26624,16582,149550,16874,4930,171354,3617,204835,106460,26770,16980,150210,18880,7695,176785,28050,5431518,168362,173338,219528,568305,612369,752433,1952399,3416273,211783867000,6858947000,5707022000,7763478000,20332953000,24283490000,24272051000,69371338000,142015336000
California,"Agriculture, Forestry, Fishing and Hunting",2011,9059,5920,1315,725,7960,774,220,8954,105,9310,5920,1315,735,7970,845,315,9130,180,132276,7509,8240,9033,25981,34299,27783,89986,37527,4441910000,499570000,396202000,415125000,1320249000,1398677000,765187000,3528015000,802961000
California,"Arts, Entertainment, and Recreation",2011,96180,72425,8720,5646,86791,6801,1830,95422,758,102425,72475,8780,5820,87075,7425,2635,97135,5290,1450640,52625,56611,75511,206555,277667,293240,786460,648906,65966280000,20459738000,2740246000,2534110000,25766005000,7053916000,12786300000,46594915000,18829075000
California,Construction,2011,322582,212469,51844,30461,294774,23469,3083,321326,1256,326905,212495,51885,30540,294920,24005,4400,323325,3580,2775960,329951,340434,408332,1078633,878515,444175,2407605,339247,147803660000,13262265000,13463795000,18739845000,45465905000,47042380000,26622670000,119197465000,26976792000
California,Educational Services,2011,52574,25185,7980,7323,40488,8853,2265,51606,968,60030,25225,8020,7510,40755,10170,3930,54855,5175,1842620,39505,52395,98761,191816,362025,363086,921610,914766,65514775000,1407850000,1228085000,2352105000,4997625000,11447524000,13114039000,29676855000,35630935000
California,Finance and Insurance,2011,136156,98590,16517,7520,122627,7079,2861,132567,3589,242565,98830,16980,8475,124285,11680,13805,149770,92795,2800292,152946,104457,96935,362896,240989,323556,938635,1819161,255187529000,8486902000,6567485000,8272672000,23370322000,23117530000,30602844000,77310796000,175161082000
California,Health Care and Social Assistance,2011,433260,251357,95309,44111,390777,29844,8795,429416,3844,508360,251825,96100,46380,394305,41790,29370,465465,42895,8515150,453081,622537,576938,1661319,1160156,1281112,4103283,4330823,433908056000,26029412000,25206741000,24492136000,75746771000,45542643000,47026392000,168407503000,262101123000
California,Information,2011,71905,48058,7275,5523,60856,6304,2177,69337,2568,102870,48115,7345,5655,61115,7150,3540,71805,31065,2325516,50146,46643,66786,175572,232820,251982,668969,1623469,232052976000,8786015000,3242796000,5225422000,17332305000,19041971000,24738110000,61654781000,159405263000
California,Management of Companies and Enterprises,2011,15942,1340,395,670,2405,3178,4945,10528,5414,24015,1345,405,680,2430,3255,5415,11100,12915,1357495,1677,1700,3950,7380,37244,166010,210650,1146471,159761910000,231135000,105415000,274600000,611150000,2783040000,12398165000,15792355000,143910518000
California,Manufacturing,2011,182891,75352,33303,27068,135723,31738,8347,175808,7083,192135,75410,33350,27155,135915,32570,10020,178505,13630,5574147,128011,212117,355663,717280,1229740,997449,3032150,2418441,331840744000,5999925000,8069866000,14453175000,28998428000,55871620000,52633014000,141339523000,183780302000
California,"Mining, Quarrying, and Oil and Gas Extraction",2011,3161,1395,405,399,2199,427,194,2820,341,4145,1395,405,420,2220,445,270,2935,1210,107047,1194,1819,5026,6499,14050,18460,44438,63477,10746421000,172994000,165468000,384521000,738368000,1091130000,1626439000,3550703000,6886015000
California,Other,2011,2214,2156,48,9,2213,1,0,2214,0,2214,2156,48,9,2213,1,0,2214,0,0,0,310,102,0,0,0,0,0,45055000,40131000,3113000,1492000,44736000,0,0,45055000,0
California,Other Services (except Public Administration),2011,310129,199797,57481,27959,285237,20449,2984,308670,1459,343485,199955,57890,29150,286995,25340,8380,320715,22770,2693709,357078,370614,365471,1102502,713091,347501,2163727,482479,79679855000,9607487000,9729674000,10384818000,29687517000,21192361000,11582143000,62680507000,15529341000
California,"Professional, Scientific, and Technical Services",2011,530053,388647,66410,35337,490394,27040,6618,524052,6001,569510,388895,66735,36545,492175,31845,11830,535850,33660,6064345,559358,432936,463925,1466616,941530,685124,3116215,2676978,462175335000,36086937000,25377961000,30749155000,92219675000,77072259000,61476038000,232013815000,228930670000
California,Real Estate and Rental and Leasing,2011,184115,140230,22135,10254,172619,7648,2212,182479,1636,233080,141055,22945,12185,176185,12810,11250,200245,32835,1312914,205536,139138,130108,478492,260051,200881,946327,316046,64666264000,8944115000,5409938000,5580034000,19965878000,12393813000,10070221000,42567580000,22065236000
California,Retail Trade,2011,342044,204539,68265,35970,308774,24366,5169,338309,3735,530730,205780,70255,40660,316695,37435,23280,377410,153320,7252176,325915,414050,449592,1187348,862693,581508,2703675,4146743,203604911000,9685031000,10627710000,12865970000,32896858000,29360346000,22420494000,86054620000,112044599000
California,Total,2011,689568,429139,116492,68907,614538,57822,11639,683999,5569,849316,430130,117939,72657,620726,73361,36106,730193,119123,12698427,702508,764413,919375,2386296,2201332,1744243,6331871,6366556,663570657000,35472447000,28198202000,35746417000,99417066000,95194766000,86245991000,280857823000,382712834000
California,Transportation and Warehousing,2011,86090,48129,13835,9291,71255,8501,2654,82410,3680,106040,48165,13965,9590,71720,10025,5250,86995,19045,2110607,68686,87054,117895,282137,270234,207189,772813,1279558,94690076000,2894533000,3078337000,4424739000,10482397000,11193568000,9311281000,31527546000,60157677000
California,Utilities,2011,2510,1335,440,230,2005,184,65,2254,256,5780,1340,460,245,2045,235,150,2430,3350,23225,2571,2773,2748,8085,5322,5006,19954,14042,1890179000,95138000,154750000,175494000,434920000,469225000,462978000,1514219000,1237347000
California,Wholesale Trade,2011,250385,140125,43046,27411,210582,25851,7699,244132,6253,287355,140555,43520,28640,212715,30750,14110,257575,29780,3950485,229598,280092,354963,877665,888274,652586,2430515,1443894,295351935000,12067330000,13444483000,18130353000,43662920000,50758953000,43716502000,138433185000,154054534000
Colorado,Accommodation and Food Services,2011,46720,16280,9330,9521,35131,9486,996,45613,1107,61640,16290,9350,9730,35370,10990,4325,50685,10955,1141705,24756,60811,126672,212888,333156,156861,701746,340681,19511890000,722924000,809289000,1817770000,3341881000,5381557000,2618974000,11396670000,7996999000
Colorado,Administrative and Support and Waste Management and Remediation Services,2011,36974,23530,5090,3080,31700,2595,957,35252,1722,41305,23550,5100,3120,31770,2800,1275,35845,5460,973580,31009,31448,38749,103778,93090,109720,314176,526613,41723370000,1312527000,1088367000,1365540000,3803638000,3245295000,3882367000,11215889000,23123946000
Colorado,"Agriculture, Forestry, Fishing and Hunting",2011,1515,1200,185,60,1445,45,5,1495,20,1515,1200,185,60,1445,45,5,1495,20,8392,1233,1060,160,2948,1810,0,6177,0,251575000,53842000,33689000,12257000,124540000,57511000,0,211145000,0
Colorado,"Arts, Entertainment, and Recreation",2011,11501,7520,1450,980,9950,977,298,11225,276,12165,7520,1450,1005,9975,1075,380,11430,735,253598,7063,8670,13176,32060,37432,45609,120820,121853,6917863000,421932000,197409000,276962000,926361000,717271000,1088935000,3002425000,3053601000
Colorado,Construction,2011,78628,57700,9740,5470,72910,4314,711,77935,693,79330,57710,9740,5470,72920,4390,875,78185,1145,578075,77266,62846,71927,215768,157141,78196,456750,95660,29466440000,3022900000,2468695000,3173710000,8691545000,7727693000,4455995000,21153860000,7416439000
Colorado,Educational Services,2011,10414,6080,1375,1110,8565,1250,338,10153,261,10935,6080,1375,1125,8580,1275,520,10375,560,221512,7684,8984,14686,31058,50989,35177,123947,86715,6614170000,310961000,221871000,350112000,889059000,1474622000,1152689000,3667775000,2589125000
Colorado,Finance and Insurance,2011,29853,22110,2822,940,25872,1290,779,27941,1912,49370,22180,2910,1050,26140,2625,2830,31595,17775,435974,26687,16945,10697,61326,40947,50309,157776,253804,32570439000,1598385000,947385000,781191000,3367287000,2973222000,3434806000,10148557000,21625000000
Colorado,Health Care and Social Assistance,2011,62079,34530,12774,6797,54101,5050,1621,60772,1307,74195,34550,12855,7050,54455,6605,4670,65730,8465,1272500,54211,83900,90383,231286,191412,239266,677153,565336,56595445000,2768465000,3453280000,3829857000,10079701000,7868489000,8985858000,27244962000,28271173000
Colorado,Information,2011,9437,5060,1150,775,6985,741,482,8208,1229,14710,5065,1150,800,7015,815,680,8510,6200,390002,5314,7196,8101,22692,20894,25025,84542,286050,29772570000,368696000,351949000,519937000,1348953000,1492667000,1622905000,5317693000,24184773000
Colorado,Management of Companies and Enterprises,2011,3357,330,70,95,495,532,852,1879,1478,4415,330,70,95,495,555,905,1955,2460,224075,0,335,569,1400,6931,27320,35582,188493,25893750000,48445000,32070000,30304000,111605000,618704000,2525325000,3260195000,22619328000
Colorado,Manufacturing,2011,23351,11207,3805,2888,17900,3031,928,21859,1492,24085,11210,3810,2910,17930,3125,1025,22080,2005,494129,14569,20547,30730,74347,95798,50764,266277,190612,26624411000,673385000,782978000,1259484000,2994492000,4448563000,2786767000,12406715000,12422682000
Colorado,"Mining, Quarrying, and Oil and Gas Extraction",2011,5945,3475,704,569,4748,555,169,5472,473,6530,3475,705,575,4755,590,190,5535,995,120085,3269,4510,7284,16945,16662,13257,51274,67232,12564292000,485070000,371661000,750942000,1639733000,1496154000,1527268000,4864377000,7483196000
Colorado,Other,2011,270,257,12,0,269,1,0,270,0,270,257,12,0,269,1,0,270,0,0,0,79,0,0,0,0,0,0,4919000,4351000,512000,0,4863000,0,0,4919000,0
Colorado,Other Services (except Public Administration),2011,58955,37555,11045,5440,54040,3483,723,58246,709,64540,37595,11155,5625,54375,4410,1715,60500,4040,483094,62660,70463,70936,207729,119441,55585,390521,72393,13837655000,1779989000,1891848000,1934323000,5620724000,3355321000,1826287000,11045856000,2456356000
Colorado,"Professional, Scientific, and Technical Services",2011,111290,86495,10714,5736,102945,4332,1676,108953,2337,117975,86525,10780,5845,103150,5040,2105,110295,7680,847813,98918,68605,74379,258101,137283,80317,488469,345120,63022729000,6034535000,3895554000,4739591000,14705050000,10218932000,6602081000,32543997000,30088564000
Colorado,Real Estate and Rental and Leasing,2011,37894,30698,3258,1548,35504,1046,456,37006,888,44435,30750,3330,1655,35735,1560,1040,38335,6100,193064,28265,19815,19761,78522,31036,8364,124621,62775,7712672000,1432341000,706899000,702699000,2855695000,1239136000,410595000,4687647000,2892394000
Colorado,Retail Trade,2011,60603,34870,11918,6357,53145,3992,1092,58229,2374,91785,35015,12195,6990,54200,6245,3880,64325,27460,1099965,53683,73126,69050,197061,119772,57387,416864,483456,31578314000,1562912000,1834757000,2108053000,5616547000,4167530000,2352565000,12693944000,14528070000
Colorado,Total,2011,124709,80917,18292,10948,110157,9039,2480,121676,3033,150889,81023,18493,11379,110895,11378,5933,128206,22683,1972271,121812,119687,145601,387100,324916,250216,962232,1010039,92655142000,4916682000,4221152000,5291724000,14429558000,12869781000,11505965000,38805304000,53849838000
Colorado,Transportation and Warehousing,2011,14412,8725,1750,974,11449,993,612,13054,1358,16725,8730,1755,985,11470,1080,820,13370,3355,286316,10114,10624,10943,35726,30279,19679,89830,160900,12088527000,444231000,373826000,443959000,1296544000,1247104000,893971000,3568419000,7195498000
Colorado,Utilities,2011,1076,585,145,45,775,157,55,987,89,1960,585,145,45,775,265,110,1150,810,32992,887,801,427,2199,6646,4655,13784,2213,3377264000,22888000,28888000,25349000,82995000,568307000,359057000,1026084000,175828000
Colorado,Wholesale Trade,2011,29831,15435,4270,2668,22373,2827,1719,26919,2912,35480,15470,4345,2760,22575,3395,2315,28285,7195,445578,20587,25075,30078,81218,74976,53376,225797,194662,29628065000,1183991000,1297082000,1599210000,4206347000,4238217000,3251071000,12149170000,16032749000
Connecticut,Accommodation and Food Services,2011,33393,14350,6560,6025,26935,5411,449,32795,598,40195,14360,6580,6100,27040,6045,1845,34930,5265,585123,24233,43452,81434,149621,189726,58456,401605,186260,11488407000,667274000,649814000,1326475000,2647321000,3406271000,951509000,7075473000,4245439000
Connecticut,Administrative and Support and Waste Management and Remediation Services,2011,23376,14945,3290,1775,20010,1685,586,22281,1095,25685,14955,3300,1800,20055,1805,720,22580,3105,418875,18779,20206,22823,63256,56981,59059,193026,215178,15606549000,1222720000,857801000,937613000,3060737000,2677025000,1495854000,7948778000,7066701000
Connecticut,"Agriculture, Forestry, Fishing and Hunting",2011,355,240,90,20,350,5,0,355,0,355,240,90,20,350,5,0,355,0,1140,274,111,56,393,0,0,1140,0,40422000,10216000,9746000,1132000,29372000,0,0,40422000,0
Connecticut,"Arts, Entertainment, and Recreation",2011,7460,4060,1052,919,6031,1077,191,7299,161,7985,4060,1055,935,6050,1115,340,7505,480,114440,4308,6525,11732,23657,44724,24040,97859,14896,3207280000,413633000,211756000,317404000,960262000,1220522000,403493000,2714975000,335301000
Connecticut,Construction,2011,39383,28425,5450,2930,36805,2082,244,39131,252,39545,28435,5450,2935,36820,2105,265,39190,355,237584,41192,35322,38248,115399,73354,17665,215028,10999,14571180000,2139800000,1862793000,2229213000,6270952000,4755075000,1350402000,12820670000,994823000
Connecticut,Educational Services,2011,6195,2895,1080,815,4790,848,355,5993,202,6585,2895,1085,815,4795,870,455,6120,465,335303,4508,7066,10500,22790,35727,57323,117887,206226,14261574000,155969000,170373000,241302000,575852000,1226946000,2519645000,4421236000,9464861000
Connecticut,Finance and Insurance,2011,18359,10859,2488,1375,14722,1264,705,16691,1668,30890,10875,2585,1480,14940,1960,2390,19290,11600,553464,16197,15190,16098,49285,39760,49723,154087,375852,80694264000,1456329000,1641119000,2705955000,5876244000,6405608000,8593380000,21593538000,53584564000
Connecticut,Health Care and Social Assistance,2011,38523,15795,8846,5835,30476,4651,2201,37328,1195,51200,15840,9040,6220,31100,6830,6420,44350,6850,1324490,32376,58033,77551,169255,177455,302367,673827,633758,60720255000,1507640000,2508760000,3685572000,7728598000,8244289000,11085872000,27466503000,32625969000
Connecticut,Information,2011,4949,2155,645,490,3290,680,256,4226,723,8235,2165,645,490,3300,750,375,4425,3810,178378,2616,3857,5668,13197,21576,19290,59435,103566,12960835000,260576000,183683000,298086000,789477000,1291447000,1210419000,3493715000,7839713000
Connecticut,Management of Companies and Enterprises,2011,2427,165,95,120,380,325,521,1226,1201,3380,165,95,120,380,330,585,1295,2085,177515,196,454,61,1545,4776,18219,24540,152975,21870944000,30571000,54872000,77241000,176945000,351903000,1273356000,1802204000,20068740000
Connecticut,Manufacturing,2011,21300,7880,3820,3103,14803,4037,1205,20045,1255,21940,7880,3820,3115,14815,4130,1305,20250,1690,570924,11341,20183,34011,73361,140484,108509,359383,176574,34975650000,717667000,969486000,1726190000,3755369000,7633239000,6480640000,19756464000,12679509000
Connecticut,"Mining, Quarrying, and Oil and Gas Extraction",2011,262,145,30,35,210,15,5,230,32,370,145,30,35,210,25,5,240,130,3551,94,152,397,754,0,0,1311,1461,313775000,12584000,10173000,23294000,53404000,0,0,128841000,113408000
Connecticut,Other,2011,134,129,5,0,134,0,0,134,0,134,129,5,0,134,0,0,134,0,0,0,30,0,0,0,0,0,0,3224000,2938000,286000,0,3224000,0,0,3224000,0
Connecticut,Other Services (except Public Administration),2011,43384,26265,9812,4208,40285,2271,367,42923,461,46425,26325,9870,4340,40535,2625,775,43935,2490,301288,48721,63635,54178,169543,71609,15753,267383,18172,9067252000,1376642000,1701242000,1596621000,4702844000,2152277000,780760000,7991059000,667961000
Connecticut,"Professional, Scientific, and Technical Services",2011,43753,29205,6298,3610,39113,2476,667,42256,1497,46720,29225,6350,3655,39230,2725,865,42820,3900,497285,43925,40400,45413,133228,80855,32633,255845,221593,40245670000,2738305000,2516606000,3203928000,8519849000,6849500000,2735616000,18725229000,19977231000
Connecticut,Real Estate and Rental and Leasing,2011,12003,8545,1495,713,10753,528,280,11561,442,15440,8585,1555,790,10930,760,1170,12860,2580,94022,13997,9016,8313,32261,14817,11376,61439,26026,4985661000,616527000,436364000,430374000,1530324000,753832000,585599000,3140727000,1764871000
Connecticut,Retail Trade,2011,43807,24503,8516,4394,37413,3441,892,41746,2061,63690,24605,8685,4725,38015,4485,2590,45090,18600,871180,36890,49982,49627,140911,98778,56199,310909,365278,24842265000,1234833000,1459073000,1751301000,4482743000,4601398000,2104286000,12008973000,9022129000
Connecticut,Total,2011,71605,40623,12671,7815,61109,6608,1755,69472,2133,88040,40701,12832,8113,61646,8000,4403,74049,13991,1442620,70225,83263,103644,257132,242003,210899,710034,732586,82130924000,3231880000,3423135000,4727547000,11382562000,11973813000,10849938000,34206313000,47924611000
Connecticut,Transportation and Warehousing,2011,6721,3225,865,719,4809,828,354,5991,730,8190,3235,870,745,4850,900,455,6205,1985,190212,4443,4876,8227,18634,23952,17184,66011,80028,8182623000,255495000,225801000,471934000,1001151000,1323445000,668310000,3215751000,3791653000
Connecticut,Utilities,2011,342,65,55,30,150,50,35,235,107,785,65,55,30,150,55,90,295,490,3561,40,0,347,32,768,4145,6110,212,341474000,4527000,0,18518000,42077000,62002000,316047000,462866000,15894000
Connecticut,Wholesale Trade,2011,19147,8800,2952,2161,13913,2295,1075,17283,1864,21915,8805,2975,2215,13995,2480,1365,17840,4075,353962,13465,16694,24738,57778,65903,46850,193336,135811,26119127000,1012186000,1190591000,1726237000,4070619000,4565402000,3119690000,12913449000,11705800000
Delaware,Accommodation and Food Services,2011,8081,3310,1325,1410,6045,1466,200,7711,370,9995,3330,1330,1420,6080,1675,625,8380,1615,166055,4780,8654,18979,32804,54081,22818,110337,55457,2869453000,185188000,126384000,270796000,586920000,870271000,306239000,1782296000,1044387000
Delaware,Administrative and Support and Waste Management and Remediation Services,2011,6227,3415,935,500,4850,570,185,5605,622,6785,3420,935,500,4855,600,190,5645,1140,123748,4634,5628,5460,16394,17149,12985,50474,50493,4682845000,200742000,177009000,210107000,627668000,667652000,387737000,1894564000,2030281000
Delaware,"Agriculture, Forestry, Fishing and Hunting",2011,220,175,30,15,220,0,0,220,0,220,175,30,15,220,0,0,220,0,557,94,62,0,557,0,0,557,0,17953000,6274000,5636000,0,17953000,0,0,17953000,0
Delaware,"Arts, Entertainment, and Recreation",2011,1912,1120,245,200,1565,240,45,1850,62,2030,1120,245,200,1565,275,55,1895,135,28275,226,1295,1815,4037,7232,2339,18045,5112,739365000,127251000,23651000,52220000,231912000,184334000,68868000,582493000,107253000
Delaware,Construction,2011,10983,7120,1715,1059,9894,840,130,10864,119,11045,7120,1720,1060,9900,860,135,10895,150,89359,9855,10915,12028,35496,31254,10535,81966,3627,4422141000,390777000,434261000,551500000,1429244000,1716333000,605323000,3971658000,249586000
Delaware,Educational Services,2011,1288,520,245,133,898,215,85,1198,90,1330,520,245,135,900,230,90,1220,110,30083,137,1304,1701,3890,8699,10281,24107,5602,1083184000,18528000,28292000,35098000,87217000,216583000,378872000,727116000,318645000
Delaware,Finance and Insurance,2011,6015,3375,578,283,4236,325,323,4884,1131,10150,3675,590,315,4580,540,545,5665,4485,168778,3058,2907,2355,9711,6645,6325,27319,136945,13588215000,210349000,162518000,170460000,592346000,747237000,406764000,2088542000,11046140000
Delaware,Health Care and Social Assistance,2011,9468,3380,2215,1656,7251,1212,418,8881,587,12555,3385,2235,1725,7345,1625,1345,10315,2240,291319,6138,14162,21293,42774,40910,32785,131137,157581,13968179000,536181000,697466000,1001520000,2267263000,1971997000,1352592000,5911803000,7965220000
Delaware,Information,2011,1270,595,105,153,853,115,45,1013,257,2045,595,105,155,855,125,75,1055,990,36420,99,367,636,1926,2545,893,8902,20488,1787760000,27424000,14406000,45910000,175705000,139852000,52380000,694374000,886122000
Delaware,Management of Companies and Enterprises,2011,4602,2221,65,55,2341,296,551,3188,1414,5650,2265,65,60,2390,330,645,3365,2285,56645,2292,208,226,2805,1532,3916,8752,47893,5414812000,70575000,10276000,8499000,90538000,95760000,212570000,425845000,4989047000
Delaware,Manufacturing,2011,2829,1090,410,375,1875,449,165,2489,340,2990,1090,410,390,1890,470,185,2545,445,99731,646,1449,2323,6628,9624,6001,31439,60707,4844194000,59541000,69588000,118607000,311548000,485414000,305229000,1509652000,2806557000
Delaware,"Mining, Quarrying, and Oil and Gas Extraction",2011,67,45,5,5,55,0,0,55,12,80,45,5,5,55,0,0,55,25,68,20,0,0,68,0,0,68,0,32695000,22406000,0,0,31940000,0,0,31940000,0
Delaware,Other,2011,44,43,1,0,44,0,0,44,0,44,43,1,0,44,0,0,44,0,0,0,0,0,0,0,0,0,0,1162000,1046000,0,0,1162000,0,0,1162000,0
Delaware,Other Services (except Public Administration),2011,10076,5960,2025,1082,9067,684,105,9856,220,10520,5960,2075,1125,9160,835,105,10100,420,67207,9638,12245,13266,37509,20370,3064,62528,3333,1826637000,277682000,308342000,335434000,954892000,521085000,82664000,1688121000,97792000
Delaware,"Professional, Scientific, and Technical Services",2011,11992,7985,1245,931,10161,828,300,11289,703,12760,7990,1250,1000,10240,985,350,11575,1185,115745,7685,7633,11265,30545,24108,13492,72165,32835,9574691000,657789000,494101000,766762000,2034141000,1687743000,1724799000,5616560000,2962561000
Delaware,Real Estate and Rental and Leasing,2011,4538,3125,375,210,3710,271,143,4124,414,5415,3125,380,230,3735,395,335,4465,950,25462,3823,2078,1941,8571,4845,4508,20697,3048,1135139000,170634000,86566000,80552000,352854000,237332000,184765000,925543000,157979000
Delaware,Retail Trade,2011,12654,6500,2195,1144,9839,927,350,11116,1538,18115,6525,2210,1270,10005,1300,680,11985,6130,242385,7983,11880,10915,35077,27038,13774,83721,135987,6305019000,270131000,317859000,347505000,1028793000,1052387000,567370000,2823393000,3165988000
Delaware,Total,2011,19472,10855,2908,1940,15703,1785,607,18095,1377,24132,10947,2941,2040,15928,2223,1164,19315,4817,359602,17338,19199,25884,62421,61644,43440,167505,192097,17553103000,776762000,691851000,981163000,2449776000,2582189000,1931523000,6963488000,10589615000
Delaware,Transportation and Warehousing,2011,3062,1760,383,229,2372,283,105,2760,302,3245,1760,385,230,2375,300,110,2785,460,43448,838,1534,1707,3698,7409,2294,22681,13195,1618551000,87051000,60360000,63881000,231870000,266247000,83749000,800381000,616662000
Delaware,Utilities,2011,121,30,10,0,40,15,15,70,51,220,30,20,0,50,15,20,85,135,7155,0,0,0,0,0,0,0,0,644761000,50000,0,0,0,0,0,0,0
Delaware,Wholesale Trade,2011,4724,2390,460,348,3198,497,270,3965,759,5290,2390,465,365,3220,555,330,4105,1185,60644,2168,2145,3037,7695,8624,4432,27122,26595,4954047000,173078000,133724000,163914000,545494000,484843000,238510000,1476741000,2797364000
District of Columbia,Accommodation and Food Services,2011,8735,3085,1485,1345,5915,1975,370,8260,475,11540,3085,1485,1370,5940,2030,695,8665,2875,287706,5544,9587,17532,32748,74118,32498,139906,111723,7793015000,355348000,182839000,351027000,885535000,1662233000,690267000,3281332000,3554285000
District of Columbia,Administrative and Support and Waste Management and Remediation Services,2011,4047,1620,425,380,2425,545,518,3488,559,5670,1625,430,390,2445,565,600,3610,2060,156651,1469,1979,3813,8758,20495,55933,88906,64609,6303739000,177914000,180892000,238857000,637241000,914185000,1801983000,3485108000,2767861000
District of Columbia,"Agriculture, Forestry, Fishing and Hunting",2011,10,10,0,0,10,0,0,10,0,10,10,0,0,10,0,0,10,0,0,0,0,0,0,0,0,0,0,0,0,0,0,0,0,0,0,0
District of Columbia,"Arts, Entertainment, and Recreation",2011,1412,780,185,150,1115,130,70,1315,97,1570,780,185,150,1115,135,120,1370,200,30565,512,642,1013,3031,2878,10227,19620,5821,1228787000,49455000,64064000,53977000,189694000,151613000,327748000,706899000,296998000
District of Columbia,Construction,2011,2170,1005,435,295,1735,300,60,2095,75,2190,1005,435,295,1735,300,60,2095,95,27391,1188,2100,3019,7223,10646,3339,24248,0,1786546000,87623000,133072000,192799000,443143000,656678000,228890000,1484311000,0
District of Columbia,Educational Services,2011,2416,845,335,275,1455,455,313,2223,193,2715,845,335,285,1465,535,390,2390,325,245989,1171,1801,2806,5409,17728,35417,63994,181535,11343972000,85958000,108505000,105623000,334170000,840463000,1739842000,3023808000,8299729000
District of Columbia,Finance and Insurance,2011,2876,900,320,237,1457,400,211,2068,808,5100,900,320,255,1475,510,355,2340,2760,56301,402,1229,2488,5051,8256,1682,19099,36365,8541942000,110248000,145341000,366791000,661544000,835959000,227083000,2339420000,6147747000
District of Columbia,Health Care and Social Assistance,2011,8694,3930,1585,1122,6637,1085,543,8265,429,10320,3930,1590,1235,6755,1355,1085,9195,1125,317828,5341,9737,13427,30141,36644,63429,133351,171761,16833531000,459280000,570890000,731026000,1823026000,1420553000,2188759000,5492269000,10691823000
District of Columbia,Information,2011,2533,915,235,190,1340,325,169,1834,699,3690,915,235,190,1340,330,175,1845,1845,93987,1058,923,1452,3595,6365,9388,24700,62708,9388879000,112749000,96205000,122258000,368294000,498904000,780624000,2022023000,6812799000
District of Columbia,Management of Companies and Enterprises,2011,765,45,5,15,65,60,160,285,480,885,45,5,15,65,60,160,285,600,49802,0,0,0,0,736,3188,4178,45667,4229244000,0,0,7676000,3764000,50558000,215313000,292873000,3941437000
District of Columbia,Manufacturing,2011,485,275,75,65,415,35,10,460,25,500,275,75,65,415,40,10,465,35,3028,280,298,382,1060,977,0,2418,0,154666000,13026000,14577000,17708000,48350000,29974000,0,98799000,18856000
District of Columbia,"Mining, Quarrying, and Oil and Gas Extraction",2011,20,5,0,5,10,0,0,10,10,20,5,0,5,10,0,0,10,10,0,0,0,0,0,0,0,0,0,0,0,0,0,0,0,0,0,0
District of Columbia,Other,2011,87,83,4,0,87,0,0,87,0,87,83,4,0,87,0,0,87,0,0,0,21,0,0,0,0,0,0,1923000,1670000,253000,0,1923000,0,0,1923000,0
District of Columbia,Other Services (except Public Administration),2011,17949,7838,3403,2531,13772,2784,1049,17605,344,20365,7840,3425,2575,13840,2970,1395,18205,2160,359257,12820,21713,32079,69748,98450,111267,283616,60815,25080979000,947512000,1252659000,2135564000,4347557000,7153086000,8689690000,20364601000,3544157000
District of Columbia,"Professional, Scientific, and Technical Services",2011,21167,11160,2793,1995,15948,2077,1157,19182,1985,24985,11160,2795,2000,15955,2140,1320,19415,5570,482706,12001,16769,22695,54766,60084,68767,187792,285138,54507916000,2191040000,1822190000,2561077000,6539162000,6936127000,6966351000,21154652000,33219784000
District of Columbia,Real Estate and Rental and Leasing,2011,3581,1985,435,276,2696,348,221,3265,316,5520,2000,465,290,2755,525,500,3780,1740,46122,2663,2705,2667,8255,7394,8756,26666,14486,3328182000,207562000,162993000,180901000,582434000,462632000,619736000,1643425000,1252661000
District of Columbia,Retail Trade,2011,7058,3930,1085,518,5533,418,233,6184,874,8780,3945,1095,540,5580,500,405,6485,2295,90107,5070,5222,3914,17144,7428,3599,34003,48961,2801361000,212523000,148945000,113244000,541825000,257643000,77387000,1004180000,1468044000
District of Columbia,Total,2011,16968,7946,2629,1898,12473,2193,970,15636,1332,21545,7955,2648,1966,12569,2448,1493,16510,5035,477623,14050,17215,24724,55989,76285,91593,223867,253756,32872009000,1090444000,1055044000,1587371000,3732859000,4654070000,5521786000,13908715000,18963294000
District of Columbia,Transportation and Warehousing,2011,815,335,70,40,445,80,75,600,215,955,335,70,40,445,90,85,620,335,16856,268,247,88,959,601,650,4500,4526,618594000,21992000,26261000,6842000,65893000,21261000,25304000,206802000,290557000
District of Columbia,Utilities,2011,183,5,0,5,10,0,5,15,168,245,5,0,5,10,0,5,15,230,0,0,0,0,0,0,0,0,0,0,0,0,0,0,0,0,0,0
District of Columbia,Wholesale Trade,2011,1694,650,270,120,1040,145,100,1285,409,2230,655,275,125,1055,155,105,1315,915,17332,735,1138,907,3689,1922,0,7294,7546,1462454000,51064000,77706000,50229000,225106000,101486000,1962000,522106000,830067000
Florida,Accommodation and Food Services,2011,134411,58982,24832,22620,106434,23089,3001,132524,1887,180075,59090,24955,22950,106995,25410,10290,142695,37380,3777256,95651,163697,306167,567695,868520,477523,1914832,1783706,65818179000,2408134000,2209738000,4117872000,8738764000,13470763000,8109523000,30328489000,35465358000
Florida,Administrative and Support and Waste Management and Remediation Services,2011,143339,103000,16650,9585,129235,8026,2926,140187,3152,160170,103075,16745,9690,129510,8795,4455,142760,17410,5857137,134919,107110,128069,386855,302796,424725,1127721,4705929,219668345000,4620323000,3103894000,4052319000,11869770000,9421787000,12804952000,34263199000,184253832000
Florida,"Agriculture, Forestry, Fishing and Hunting",2011,4632,3010,660,465,4135,322,119,4576,56,4765,3010,660,465,4135,390,145,4670,95,57840,1790,3930,5590,14170,12178,13772,42586,15065,1622010000,146063000,131858000,192795000,486268000,307141000,311551000,1166013000,444318000
Florida,"Arts, Entertainment, and Recreation",2011,34914,22855,3835,2790,29480,3694,1118,34292,622,37370,22860,3845,2800,29505,3865,1540,34910,2460,821320,26223,24498,36197,92724,159892,159339,419688,385060,22962840000,1379794000,547494000,698654000,2650204000,3682984000,7248719000,13850545000,8490947000
Florida,Construction,2011,213296,155864,27122,15997,198983,11738,1596,212317,979,216045,155865,27130,16045,199040,12270,2170,213480,2565,1441940,218790,178090,212528,616244,429033,209560,1262445,169631,57969235000,6486155000,5641780000,7514600000,19643825000,17404585000,9588055000,47018795000,10394604000
Florida,Educational Services,2011,26694,15458,3255,2740,21453,3679,950,26082,612,29780,15490,3285,2750,21525,4170,1405,27100,2680,732997,20474,21656,36524,80471,145846,132467,365940,364178,25278751000,725712000,497479000,779515000,2009510000,4122435000,4355678000,10753050000,14381960000
Florida,Finance and Insurance,2011,86070,62781,10663,4212,77656,3589,1877,83122,2948,152500,62980,10885,4700,78565,6410,8085,93060,59440,1644491,79117,68189,52741,211402,118130,156757,498759,1118813,107098135000,4374625000,3218854000,2988561000,10619587000,7476352000,10150753000,28759541000,77023274000
Florida,Health Care and Social Assistance,2011,230524,130977,51194,25550,207721,15205,4638,227564,2960,275400,131345,51540,26480,209365,20585,14750,244700,30700,4841830,212248,335576,337696,896061,562209,698215,2171590,2637875,216081470000,12136121000,14211054000,14050795000,40423881000,25569718000,26870907000,92998570000,121160902000
Florida,Information,2011,23941,15910,2539,1665,20114,1577,708,22399,1542,39355,15920,2550,1700,20170,1750,1290,23210,16145,748432,16560,16034,21200,60283,54156,41890,164443,580815,46976940000,1062395000,732057000,985216000,2806310000,3056390000,2614712000,8909410000,37874012000
Florida,Management of Companies and Enterprises,2011,7795,1070,205,215,1490,1375,1992,4857,2938,12500,1070,205,220,1495,1415,2120,5030,7470,670810,9,1023,1759,4320,17767,58690,80920,589890,52643820000,195525000,181695000,125837000,503155000,1249516000,4711485000,6476495000,46167325000
Florida,Manufacturing,2011,60041,31870,9250,6951,48071,6881,2337,57289,2752,62980,31875,9250,6955,48080,7110,2600,57790,5190,1277739,44874,55034,82480,200277,237689,192130,685407,520229,61871077000,1817275000,1836796000,3129640000,7114573000,9552723000,8797551000,27756639000,30604710000
Florida,"Mining, Quarrying, and Oil and Gas Extraction",2011,1060,580,135,95,810,117,30,957,103,1270,580,135,95,810,160,40,1010,260,18075,403,505,952,2804,3209,0,6473,8031,1068735000,44611000,20512000,48244000,124902000,132427000,0,307118000,537022000
Florida,Other,2011,566,554,10,2,566,0,0,566,0,566,554,10,2,566,0,0,566,0,0,0,0,0,0,0,0,0,0,11714000,10229000,0,0,11714000,0,0,11714000,0
Florida,Other Services (except Public Administration),2011,201199,139770,32348,16037,188155,10484,1429,200068,1131,217685,139810,32460,16305,188575,12680,4400,205655,12030,1476690,232544,208628,211415,657968,372397,139368,1174836,276450,37964110000,5632945000,4914246000,5028345000,15590745000,9253794000,3480130000,28480190000,9267407000
Florida,"Professional, Scientific, and Technical Services",2011,325678,257340,33218,17505,308063,11177,3082,322322,3356,346905,257455,33390,18010,308855,14140,5370,328365,18540,2167811,319174,212671,227308,795056,368144,231139,1405588,724677,129446135000,17852180000,10644916000,11957717000,40467795000,23344142000,16000636000,80022160000,47920992000
Florida,Real Estate and Rental and Leasing,2011,115948,96047,9910,4523,110480,2862,1286,114628,1320,141370,96240,10340,5045,111625,4205,5365,121195,20175,692882,123149,61651,54831,238273,88640,74917,411068,269748,26860656000,4312317000,2097228000,1958181000,8368558000,3420982000,2991652000,14958711000,11417211000
Florida,Retail Trade,2011,224469,155182,35475,17070,207727,10674,2711,221112,3357,354775,155710,36345,19100,211155,17170,9120,237445,117330,4290283,211439,210899,201903,658210,357901,239754,1270551,2081188,110500786000,6496631000,5462452000,5492646000,17424246000,12198000000,9744386000,39868963000,51371130000
Florida,Total,2011,400058,275916,57095,32301,365312,24602,5803,395717,4341,490851,276343,57689,33630,367662,31011,16374,415047,75804,6732639,428264,371938,428207,1228409,909286,741046,2878741,3853898,265463630000,15580717000,12475924000,14271147000,42327788000,32699494000,29792391000,104819673000,160643957000
Florida,Transportation and Warehousing,2011,55846,39140,5767,3767,48674,3201,1469,53344,2502,63945,39170,5800,3845,48815,3485,2105,54405,9540,1009403,42785,35610,46343,137011,99057,87649,336291,609947,42508218000,1823044000,1250147000,1560809000,4701675000,3746704000,3584661000,12505161000,29457412000
Florida,Utilities,2011,1500,805,240,74,1119,124,97,1340,160,3570,805,240,90,1135,210,320,1665,1905,130719,833,1519,665,3758,4959,15954,27462,101265,10900324000,41738000,57709000,31776000,143417000,291246000,1063453000,1655175000,9178533000
Florida,Wholesale Trade,2011,131727,86473,18504,10423,115400,8892,3371,127663,4064,150965,86595,18635,10895,116125,10835,6300,133260,17705,1378712,109023,116878,129855,382132,269562,188133,863276,481557,72959646000,5801792000,5255797000,5979123000,17067730000,13224756000,9708386000,40829538000,30697814000
Georgia,Accommodation and Food Services,2011,66292,25404,12045,12641,50090,13319,1536,64945,1347,92880,25645,12090,12795,50530,15200,6480,72210,20670,1726559,41950,79868,172312,294855,486525,232069,1013909,712315,25964490000,964785000,1005530000,2166021000,4138850000,6663257000,3266275000,14092620000,11860636000
Georgia,Administrative and Support and Waste Management and Remediation Services,2011,49655,31055,6357,4268,41680,3974,1677,47331,2324,58290,31070,6385,4315,41770,4130,2455,48355,9935,1560165,44364,40171,54536,141916,147341,208603,514301,1011466,47320157000,1701994000,1317853000,1916405000,4969630000,4822430000,6436967000,16589208000,30327357000
Georgia,"Agriculture, Forestry, Fishing and Hunting",2011,4625,2445,1050,630,4125,406,45,4576,49,4740,2450,1050,630,4130,420,80,4630,110,35973,3470,6432,8020,18961,12006,0,34291,566,1277510000,148768000,226565000,267138000,648589000,433445000,19707000,1181475000,27384000
Georgia,"Arts, Entertainment, and Recreation",2011,12318,7520,1605,1290,10415,1327,300,12042,276,13180,7520,1605,1300,10425,1420,405,12250,930,202735,7960,10198,15978,37893,48673,35448,127917,51252,6258529000,398197000,240546000,293226000,964617000,903663000,877654000,2883139000,2838517000
Georgia,Construction,2011,80730,53325,12505,7479,73309,5772,894,79975,755,81915,53345,12505,7495,73345,5860,1225,80430,1485,729935,80054,82745,100616,265057,211700,112905,594235,109655,32228150000,2761445000,2785880000,3820435000,9367760000,9329485000,5673363000,24577350000,6649965000
Georgia,Educational Services,2011,12194,6600,1755,1300,9655,1698,465,11818,376,13710,6610,1760,1375,9745,2105,525,12375,1335,390974,8309,11281,16912,37512,70856,67565,179288,199253,14435408000,264372000,243797000,326006000,840775000,1862502000,2303243000,5069506000,9105023000
Georgia,Finance and Insurance,2011,38105,25622,4840,1777,32239,2323,1214,35776,2329,72445,25705,5055,2250,33010,5245,4715,42970,29475,794696,37571,27313,20720,84233,75203,75578,250606,392507,56239077000,1884695000,1434670000,1348997000,4716027000,4285701000,4707370000,14402569000,35980668000
Georgia,Health Care and Social Assistance,2011,90422,43690,21132,12190,77012,9453,1884,88349,2073,111260,43730,21270,12580,77580,12180,6165,95925,15335,2214703,73332,138975,162054,376859,343043,276523,1006769,1143040,94086257000,4001659000,5690210000,6778204000,16501978000,13976548000,9860321000,40607155000,50728795000
Georgia,Information,2011,10809,5670,1305,870,7845,1161,445,9451,1358,20135,5675,1305,925,7905,1310,775,9990,10145,516248,4724,7439,10358,27023,39174,37938,110503,384312,37846758000,364913000,335550000,575557000,1302523000,2485826000,2758453000,6794760000,29460599000
Georgia,Management of Companies and Enterprises,2011,5382,425,130,135,690,760,1315,2765,2617,7880,425,130,135,690,770,1360,2820,5060,572945,511,0,870,1789,8645,35370,46340,526373,54755800000,43491000,44885000,42860000,132194000,573270000,2698585000,3404060000,51335940000
Georgia,Manufacturing,2011,33942,12950,5395,4207,22552,5196,2540,30288,3654,37300,12950,5400,4270,22620,5485,2985,31090,6210,1548864,19519,31780,49920,109854,186205,198938,537635,907619,69264586000,779310000,1113660000,1793014000,3903629000,7496630000,8491714000,21723598000,42902572000
Georgia,"Mining, Quarrying, and Oil and Gas Extraction",2011,619,190,150,60,400,85,35,520,99,995,190,150,60,400,90,60,550,445,19029,196,763,633,1787,1643,0,7478,12013,1024903000,11138000,33352000,22436000,71929000,87066000,0,399372000,664160000
Georgia,Other,2011,312,299,9,3,311,1,0,312,0,312,299,9,3,311,1,0,312,0,366,0,0,0,334,0,0,366,0,5740000,4823000,0,0,5604000,0,0,5740000,0
Georgia,Other Services (except Public Administration),2011,94633,60205,18185,8445,86835,5909,1013,93757,876,101365,60240,18240,8660,87140,7215,1740,96095,5270,751729,106983,116681,110572,337519,207820,84522,636747,92368,19616985000,2530896000,2668968000,2643632000,7856765000,5067665000,2454323000,15552165000,3304428000
Georgia,"Professional, Scientific, and Technical Services",2011,130576,98665,13400,7797,119862,5894,2042,127798,2778,139020,98715,13430,7940,120085,6515,2835,129435,9585,1103882,114194,85755,101209,321988,194026,136199,661213,414800,71540902000,7065887000,4362880000,5578541000,17037659000,12595242000,8793029000,38918850000,31814248000
Georgia,Real Estate and Rental and Leasing,2011,38087,29712,3374,1583,34669,1602,775,37046,1041,51445,29805,3510,1765,35080,2515,3090,40685,10760,250081,34291,21221,18429,77333,46260,37923,171051,78572,11348619000,1346540000,708838000,699004000,2756909000,2041019000,1827268000,6985743000,4249023000
Georgia,Retail Trade,2011,105435,66982,18775,9206,94963,6002,1639,102604,2831,167190,67290,19160,10190,96640,8785,5680,111105,56085,1971709,116124,118488,107136,350411,205104,111697,695974,1160544,46893594000,2722935000,2703988000,2970357000,8455057000,6949775000,3860702000,19599634000,25410957000
Georgia,Total,2011,167589,102898,26554,16169,145621,14209,3854,163684,3905,214635,103127,26830,16871,146828,17705,9436,173969,40666,3328033,166277,173599,215107,554983,513137,410961,1479081,1848952,141481314000,6019351000,5640084000,7194179000,18853614000,18504576000,16693379000,54051569000,87429745000
Georgia,Transportation and Warehousing,2011,24531,14285,2695,1725,18705,2093,1308,22106,2425,29810,14310,2715,1750,18775,2295,1760,22830,6980,704732,15552,16236,21652,60603,57442,57338,185157,500960,30628960000,713394000,574779000,763276000,2091606000,2131087000,2245673000,6652912000,23189570000
Georgia,Utilities,2011,666,210,50,25,285,150,112,547,119,2930,210,50,25,285,225,345,855,2075,105200,339,108,132,948,6897,20325,28250,148,8601039000,14134000,3015000,7503000,37217000,401669000,1401293000,1847610000,17494000
Georgia,Wholesale Trade,2011,55317,28197,8219,5634,42050,5900,3195,51145,4172,65125,28255,8295,5880,42430,6755,4500,53685,11440,911644,42749,50519,65873,164410,167882,151752,504417,382569,55570158000,2212338000,2439745000,3333807000,8093359000,8692218000,8604484000,26272808000,28081918000
Hawaii,Accommodation and Food Services,2011,13655,4728,2783,2571,10082,2831,334,13247,408,17340,4740,2785,2610,10135,3295,1140,14570,2770,458745,8542,17668,34218,60816,113105,60578,236679,221288,11675468000,209785000,258751000,500145000,974081000,2086507000,1386263000,4463196000,7160916000
Hawaii,Administrative and Support and Waste Management and Remediation Services,2011,7733,4050,1215,765,6030,859,325,7214,519,9015,4050,1240,770,6060,980,625,7665,1350,207691,6041,7087,9394,24161,29389,31474,97136,77424,5957485000,209169000,208211000,248734000,702401000,925338000,768281000,2723185000,2270732000
Hawaii,"Agriculture, Forestry, Fishing and Hunting",2011,165,135,15,0,150,15,0,165,0,165,135,15,0,150,15,0,165,0,274,0,0,0,0,100,0,274,0,13763000,5035000,0,0,6415000,2348000,0,13763000,0
Hawaii,"Arts, Entertainment, and Recreation",2011,2268,1050,305,280,1635,392,151,2178,90,2440,1050,305,280,1635,430,225,2290,150,49156,695,1792,3140,6661,14901,15213,40789,2758,1146975000,58034000,41191000,68119000,178893000,318424000,397489000,977964000,55618000
Hawaii,Construction,2011,13061,7750,2330,1499,11579,1123,174,12876,185,13225,7750,2330,1505,11585,1175,210,12970,255,126170,11323,14296,18874,47034,36607,16687,110127,9777,7708805000,524333000,667380000,1016385000,2257088000,2294479000,1287574000,6516566000,873784000
Hawaii,Educational Services,2011,2330,955,395,320,1670,450,105,2225,105,2480,955,395,330,1680,495,155,2330,150,99798,1268,2263,3979,7783,16367,11728,37515,58674,3287250000,37433000,44484000,75620000,170747000,419741000,449075000,1075640000,2082369000
Hawaii,Finance and Insurance,2011,4097,2341,415,240,2996,288,193,3477,620,7125,2345,440,275,3060,570,690,4320,2805,88195,3247,2328,2481,7965,7751,12017,30628,53073,5282857000,186360000,129294000,132064000,479999000,374737000,761157000,1718728000,3395994000
Hawaii,Health Care and Social Assistance,2011,14595,7730,3620,1496,12846,1010,415,14271,324,17570,7740,3640,1590,12970,1610,1275,15855,1715,307365,14029,22367,17999,55066,38934,56216,162124,134096,14683559000,829102000,1028926000,838037000,2717146000,1480871000,2134138000,6662275000,7964342000
Hawaii,Information,2011,1622,745,205,165,1115,140,40,1295,327,2655,750,210,190,1150,165,90,1405,1250,40047,648,800,1191,3884,3184,300,8751,27496,2247544000,39456000,46267000,71588000,176632000,136335000,15815000,388269000,1775238000
Hawaii,Management of Companies and Enterprises,2011,961,35,25,35,95,240,255,590,371,1170,35,25,35,95,240,285,620,550,42335,0,0,23,287,2099,7091,9477,32678,2588775000,7052000,5076000,9302000,22985000,129851000,357110000,512190000,2059699000
Hawaii,Manufacturing,2011,3921,1945,680,570,3195,464,125,3784,137,4060,1945,680,575,3200,495,175,3870,190,47203,2355,2562,5138,11753,9439,4717,37643,4646,1575474000,75301000,83818000,158048000,375511000,280538000,140718000,1231397000,231899000
Hawaii,"Mining, Quarrying, and Oil and Gas Extraction",2011,36,5,10,5,20,5,5,30,6,40,5,10,5,20,5,5,30,10,392,0,0,0,0,0,0,0,0,30757000,0,0,0,0,0,0,0,0
Hawaii,Other,2011,42,40,2,0,42,0,0,42,0,42,40,2,0,42,0,0,42,0,35,22,0,0,35,0,0,35,0,789000,744000,0,0,789000,0,0,789000,0
Hawaii,Other Services (except Public Administration),2011,15349,9965,2575,1325,13865,1020,249,15134,215,17330,10045,2575,1340,13960,1355,755,16070,1260,123996,16942,15889,15339,50793,31860,14302,100600,6294,3394946000,493816000,457451000,466539000,1470093000,917010000,396418000,2974536000,193721000
Hawaii,"Professional, Scientific, and Technical Services",2011,14766,9575,2180,1095,12850,930,318,14098,668,16420,9585,2190,1145,12920,1015,435,14370,2050,124071,12775,13669,12762,39844,28570,15293,89171,30434,6879975000,749699000,662449000,720102000,2188194000,1846035000,749311000,4956684000,1817341000
Hawaii,Real Estate and Rental and Leasing,2011,7965,5700,903,501,7104,359,209,7672,293,9630,5745,935,560,7240,635,365,8240,1390,55872,9073,3924,5115,20330,8895,4808,36851,6578,2476104000,365047000,196582000,226714000,809045000,383698000,254668000,1552624000,472360000
Hawaii,Retail Trade,2011,14880,7450,3058,1564,12072,1286,393,13751,1129,23390,7475,3185,1800,12460,2430,1680,16570,6820,313434,8042,14381,15469,42346,30141,22875,108846,157243,8366917000,303940000,421576000,409099000,1186521000,935437000,852127000,3328122000,4398604000
Hawaii,Total,2011,24934,13851,4484,2679,21014,2390,599,24003,931,31472,13901,4564,2830,21295,3347,1856,26498,4974,485548,24583,29316,35492,89391,91333,75845,256569,228979,18362124000,918256000,962979000,1178464000,3059699000,3084777000,2808475000,8952951000,9409173000
Hawaii,Transportation and Warehousing,2011,3347,1310,505,330,2145,546,280,2971,376,4160,1315,505,335,2155,620,585,3360,800,112086,1664,2736,3076,9012,14642,15914,45589,51707,4522976000,76826000,75322000,90935000,284165000,513155000,607794000,1568481000,2422791000
Hawaii,Utilities,2011,130,35,15,10,60,10,15,85,45,275,35,15,10,60,55,50,165,110,6940,0,36,0,203,0,0,310,0,602215000,5248000,2120000,0,14886000,0,0,16660000,6893000
Hawaii,Wholesale Trade,2011,7565,3595,1270,770,5635,885,323,6843,722,8660,3605,1330,795,5730,1150,535,7415,1245,90524,3930,6505,7466,21256,19612,12131,65373,16830,4016897000,232895000,267464000,302637000,911366000,823482000,530490000,2698989000,998415000
Idaho,Accommodation and Food Services,2011,14179,5218,3155,2955,11328,2117,392,13837,342,17575,5240,3175,3015,11430,2770,1415,15615,1960,249617,7813,20817,39442,69023,68333,38249,177273,72987,3361664000,156504000,230624000,450198000,841960000,903617000,486748000,2249865000,1119066000
Idaho,Administrative and Support and Waste Management and Remediation Services,2011,9901,6460,1410,705,8575,560,245,9380,521,10565,6460,1415,715,8590,655,295,9540,1025,170310,7399,7901,8564,26275,14350,21368,66106,90211,4624124000,262164000,208564000,222364000,732057000,416271000,425141000,1720583000,2268372000
Idaho,"Agriculture, Forestry, Fishing and Hunting",2011,2215,1605,275,170,2050,115,30,2195,20,2225,1605,275,170,2050,115,40,2205,20,16152,1866,1681,1997,6164,3014,2066,15742,410,516029000,98058000,72480000,82553000,260424000,134464000,33980000,502464000,13565000
Idaho,"Arts, Entertainment, and Recreation",2011,3497,2245,420,380,3045,332,65,3442,55,3605,2250,420,390,3060,355,100,3515,90,43875,2420,2301,4511,10235,10480,8912,32071,5445,690984000,94772000,39146000,59704000,207918000,174054000,171539000,583864000,46705000
Idaho,Construction,2011,29021,21960,3880,1795,27635,1159,110,28904,117,29145,21960,3885,1795,27640,1210,130,28980,165,131082,29244,24650,22522,78245,37852,1833,127082,1903,5254806000,1076415000,788118000,865144000,2741701000,1748091000,193514000,5031086000,112560000
Idaho,Educational Services,2011,1989,1005,280,265,1550,315,30,1895,94,2100,1005,280,265,1550,325,90,1965,135,53424,1261,1471,3147,6319,11470,1121,19354,33566,1120011000,39012000,27846000,55355000,130005000,269778000,21009000,426570000,678215000
Idaho,Finance and Insurance,2011,7706,5200,820,340,6360,278,295,6933,773,13850,5200,855,450,6505,580,1480,8565,5285,95951,7188,4604,3401,17306,1835,13960,43501,48665,4634437000,260533000,186419000,150051000,637979000,217005000,694186000,1766676000,2637198000
Idaho,Health Care and Social Assistance,2011,21072,10515,4715,2680,17910,1973,635,20518,554,23750,10540,4750,2715,18005,2690,1675,22370,1380,397682,17968,29759,33482,83721,75125,75747,239259,91910,14381011000,849411000,974859000,1193411000,3052878000,2354622000,1982755000,7497022000,3577974000
Idaho,Information,2011,2210,1005,260,240,1505,246,107,1858,352,3250,1005,260,255,1520,310,160,1990,1260,54451,1007,1085,1947,5163,7198,2594,16761,33195,2288378000,47760000,34740000,75861000,174989000,287379000,136475000,800414000,1398877000
Idaho,Management of Companies and Enterprises,2011,850,60,20,45,125,172,250,547,303,1155,65,20,45,130,185,255,570,585,42847,2,0,0,0,1902,5663,7867,34301,3548825000,7840000,0,8489000,25095000,100789000,366651000,495150000,3007476000
Idaho,Manufacturing,2011,8328,3855,1475,1030,6360,1124,363,7847,481,8660,3855,1480,1030,6365,1160,410,7935,725,189932,4280,6832,9538,26757,32574,15735,90797,85726,8389663000,157786000,233521000,326132000,837697000,1242365000,588193000,3360877000,4373808000
Idaho,"Mining, Quarrying, and Oil and Gas Extraction",2011,550,280,75,65,420,55,33,508,42,590,280,75,65,420,65,40,525,65,8627,214,226,590,1505,889,1454,4973,2532,648131000,21745000,15616000,31448000,83233000,50727000,106824000,332546000,203099000
Idaho,Other,2011,81,78,2,1,81,0,0,81,0,81,78,2,1,81,0,0,81,0,85,0,0,0,85,0,0,85,0,1152000,1013000,0,0,1152000,0,0,1152000,0
Idaho,Other Services (except Public Administration),2011,15270,10225,2810,1232,14267,617,140,15024,246,16205,10225,2825,1330,14380,925,255,15560,645,89331,17100,17617,14852,52166,17045,5397,78167,4880,2056795000,427015000,408597000,350798000,1210742000,352333000,151134000,1761273000,185050000
Idaho,"Professional, Scientific, and Technical Services",2011,19697,14030,2650,1285,17965,827,243,19035,662,20965,14030,2675,1320,18025,1075,325,19425,1540,136971,17767,16750,15033,52241,22745,5753,86251,43555,6959606000,757852000,636378000,662013000,2078411000,1184071000,322744000,3760357000,3144693000
Idaho,Real Estate and Rental and Leasing,2011,8753,7080,838,319,8237,188,113,8538,215,9815,7085,845,425,8355,335,375,9065,750,26602,7333,4438,3244,14852,2746,4255,26451,3317,904571000,240175000,128536000,88730000,478960000,92146000,126178000,739068000,130842000
Idaho,Retail Trade,2011,20054,10045,4157,2345,16547,1801,445,18793,1261,29010,10070,4255,2625,16950,2815,2455,22220,6790,349511,14553,25840,26862,73358,50539,28173,163929,164092,8734910000,408510000,546124000,709462000,1695395000,1501692000,904505000,4292609000,4116728000
Idaho,Total,2011,35690,21983,5829,3397,31209,2574,718,34501,1189,42399,22006,5896,3591,31493,3541,2141,37175,5224,482722,34538,38219,44358,117115,89278,65640,272033,210689,16889380000,1086334000,1038417000,1260950000,3385701000,2806622000,2033280000,8225603000,8663777000
Idaho,Transportation and Warehousing,2011,7553,4990,970,475,6435,517,209,7161,392,8215,4990,975,480,6445,575,290,7310,905,77372,4819,5061,5465,17373,15224,12305,45977,17754,2643952000,225052000,184094000,192378000,630707000,492864000,395384000,1571547000,655994000
Idaho,Utilities,2011,576,345,50,50,445,50,5,500,76,975,345,50,50,445,85,30,560,415,1180,444,169,467,1340,1716,0,3224,0,107881000,9659000,9548000,19522000,47166000,121861000,0,180442000,59040000
Idaho,Wholesale Trade,2011,7977,3430,940,755,5125,1096,602,6823,1154,9935,3430,955,810,5195,1475,885,7555,2380,109356,3538,4480,6208,16336,28924,14609,70364,32635,5347469000,202546000,190145000,319112000,789055000,1209604000,660195000,2979062000,2092597000
Illinois,Accommodation and Food Services,2011,102419,42590,20143,18052,80785,18100,2024,100909,1510,134010,42645,20210,18325,81180,20365,6775,108320,25690,2284906,77044,133367,245762,457420,662299,288677,1411548,871093,38674370000,1560940000,1723535000,3271707000,6577486000,10036655000,5009591000,21636699000,16998557000
Illinois,Administrative and Support and Waste Management and Remediation Services,2011,72903,47442,8720,5670,61832,6015,2376,70223,2680,82745,47450,8755,5725,61930,6470,3085,71485,11260,2345714,58253,54748,74340,193294,227388,318170,756440,1557864,70665590000,3120058000,2225221000,2856762000,8232759000,8692843000,9542472000,27094374000,42743946000
Illinois,"Agriculture, Forestry, Fishing and Hunting",2011,1435,1095,200,45,1340,30,35,1405,30,1570,1095,200,45,1340,40,80,1460,110,8202,1362,1044,480,3010,353,1624,5621,0,387633000,43361000,50101000,12644000,111569000,18939000,91328000,244982000,0
Illinois,"Arts, Entertainment, and Recreation",2011,20852,12440,2925,2230,17595,2375,524,20494,358,22380,12465,2955,2240,17660,2490,810,20960,1420,370543,13443,18177,29672,62240,94159,72958,239334,113984,11647230000,707110000,424703000,598656000,1749804000,2209808000,3358460000,7485469000,2810960000
Illinois,Construction,2011,140923,104665,18105,9870,132640,6714,911,140265,658,141815,104675,18120,9885,132680,6830,1065,140575,1240,901525,138845,117415,130993,391673,249941,125233,774520,113845,56732735000,6376705000,5731894000,7320300000,19433445000,17122294000,10087716000,47090681000,8737298000
Illinois,Educational Services,2011,17672,8510,2500,2100,13110,3156,800,17066,606,19520,8525,2505,2155,13185,3365,1145,17695,1825,784463,10812,16513,28216,56880,129231,106690,294988,485354,29131154000,418794000,348312000,568642000,1341161000,3466755000,3745108000,8605840000,20371987000
Illinois,Finance and Insurance,2011,64609,43355,8099,3340,54794,4621,2146,61561,3048,111425,43435,8300,3875,55610,8260,8915,72785,38640,1456533,70656,50447,41531,166940,156885,183546,523843,926723,133932189000,3508173000,2800699000,3141467000,9578261000,11868439000,16849622000,38695842000,94438422000
Illinois,Health Care and Social Assistance,2011,132448,67228,27778,16834,111840,13048,4836,129724,2724,163535,67400,28035,17810,113245,17360,14365,144970,18565,3785037,113432,180262,224271,529966,511009,702437,1752180,1989945,161571492000,6404075000,8073728000,10586712000,25117176000,20689430000,22779738000,68915496000,91424416000
Illinois,Information,2011,14983,7560,1898,1306,10764,1700,884,13348,1635,26890,7570,1915,1340,10825,1910,1250,13985,12905,589627,7266,10366,15539,30636,59464,67161,170813,374708,42044318000,685946000,532899000,768178000,1971702000,3924028000,4389753000,11300462000,30602520000
Illinois,Management of Companies and Enterprises,2011,7310,430,155,205,790,1255,1966,4011,3299,10580,430,155,210,795,1275,2120,4190,6390,843015,0,561,996,2100,15215,69010,86625,756390,97626440000,64170000,45437000,93928000,210985000,1102095000,5575100000,6888180000,90738260000
Illinois,Manufacturing,2011,66378,23607,10825,9794,44226,12926,4566,61718,4660,70060,23620,10840,9850,44310,13510,5120,62940,7120,2518664,34403,65641,125587,240277,498426,484161,1296168,1098410,133019526000,1730280000,2613708000,5359125000,10000779000,23953003000,25022054000,62183258000,63389661000
Illinois,"Mining, Quarrying, and Oil and Gas Extraction",2011,2470,1436,335,262,2033,206,85,2324,146,2850,1445,335,270,2050,275,200,2525,325,38800,2209,2082,2682,7625,5205,3028,19518,13628,2687464000,104383000,123758000,169404000,416721000,302656000,256153000,1418375000,1187296000
Illinois,Other,2011,350,338,11,1,350,0,0,350,0,350,338,11,1,350,0,0,350,0,0,0,64,0,0,0,0,0,0,6877000,6250000,559000,0,6877000,0,0,6877000,0
Illinois,Other Services (except Public Administration),2011,146733,90067,30159,14567,134793,9448,1454,145695,1038,158290,90215,30480,15275,135970,11350,3680,151000,7290,1201434,164748,196168,189103,555610,323604,134363,1022840,161175,37499921000,4239308000,4892956000,5067505000,14198640000,9400186000,5766101000,29750191000,6876786000
Illinois,"Professional, Scientific, and Technical Services",2011,181933,134212,20518,11902,166632,9246,2749,178627,3306,192385,134300,20640,12220,167160,10630,3675,181465,10920,1729391,155340,130391,154270,465087,303296,222112,1005747,696569,135366032000,11360415000,7182624000,9680081000,28315517000,22739406000,18454276000,69919752000,64017559000
Illinois,Real Estate and Rental and Leasing,2011,47311,34816,5655,2636,43107,2271,854,46232,1079,59260,34885,5840,2930,43655,3585,2250,49490,9770,356934,45129,35943,32582,115985,68087,51972,243827,81325,19269069000,1917479000,1374673000,1453707000,4770615000,3367624000,2637010000,11100769000,5783979000
Illinois,Retail Trade,2011,125401,72113,24511,12859,109483,9969,2750,122202,3199,201825,72390,25140,14100,111630,14510,10505,136645,65180,2939456,111819,150714,155446,414575,354915,202865,1025747,1734538,74066718000,3132732000,3684522000,4156922000,11104442000,12126105000,7395380000,31028844000,40734996000
Illinois,Total,2011,251850,154671,39988,24727,219386,22208,5818,247412,4438,312437,154930,40481,25874,221285,27729,14925,263939,48498,5038462,245023,262088,329639,836750,829962,715009,2381721,2656741,245055769000,10368059000,9558139000,12833369000,32759567000,35403718000,33864184000,102027469000,143028300000
Illinois,Transportation and Warehousing,2011,56671,38925,5939,3696,48560,3706,1710,53976,2695,63635,38930,5950,3730,48610,4000,2215,54825,8810,1102941,20129,37223,45321,129107,112193,100635,359618,637265,49178557000,1685996000,1351493000,1786037000,4948130000,4743215000,4522030000,14681993000,30437651000
Illinois,Utilities,2011,879,315,105,80,500,175,40,715,164,2270,320,105,85,510,290,70,870,1400,72431,462,502,698,2063,6438,3837,14538,10851,7373280000,22929000,26358000,41310000,106767000,444708000,379780000,1077147000,1227063000
Illinois,Wholesale Trade,2011,80563,41092,11712,8914,61718,9926,4194,75838,4725,95390,41165,11870,9295,62330,12130,7300,81760,13630,1498434,63850,74382,111224,256460,315320,240712,829480,614880,99532841000,3659925000,4156245000,6520214000,14425725000,18634565000,15141884000,48943050000,46799674000
Indiana,Accommodation and Food Services,2011,45712,16310,8833,9190,34333,8894,1314,44541,1171,63735,16320,8875,9355,34550,10200,5315,50065,13670,1209813,26998,59487,127284,214104,330647,168680,717030,495906,16884584000,560491000,647452000,1473441000,2686885000,4090654000,2077130000,8893645000,7868234000
Indiana,Administrative and Support and Waste Management and Remediation Services,2011,30764,18193,4715,2900,25808,2541,972,29321,1443,35185,18200,4735,2925,25860,2790,1460,30110,5075,832875,23183,30306,36909,94256,88362,117373,310465,490024,23535218000,945159000,832672000,1053932000,2847793000,2902081000,2973334000,9122888000,13995005000
Indiana,"Agriculture, Forestry, Fishing and Hunting",2011,1086,795,155,50,1000,25,31,1056,30,1180,795,155,50,1000,25,50,1075,105,6061,392,769,461,2716,510,0,6284,0,228445000,29597000,20437000,15233000,73451000,17404000,0,223600000,0
Indiana,"Arts, Entertainment, and Recreation",2011,10211,5825,1505,1230,8560,1256,208,10024,187,10600,5825,1520,1245,8590,1360,300,10250,350,147702,7652,9504,16077,34590,45197,16491,107384,26223,4155605000,286411000,181449000,261379000,747676000,889198000,281027000,2410602000,556649000
Indiana,Construction,2011,65198,43320,10854,5840,60014,4068,631,64713,485,65865,43325,10860,5840,60025,4180,760,64965,900,536200,67552,70683,76231,217550,145629,68836,440500,87599,28273675000,2513469000,2663743000,3242478000,8431380000,7853309000,4280789000,21017175000,6710239000
Indiana,Educational Services,2011,7275,3400,1160,985,5545,1157,253,6955,320,7950,3400,1180,1025,5605,1285,360,7250,700,312007,4586,7366,12533,24387,44777,29601,103869,204641,8354548000,159932000,131402000,252399000,548580000,1102909000,807212000,2549132000,5723325000
Indiana,Finance and Insurance,2011,24326,16279,2978,1180,20437,1363,906,22706,1620,48180,16290,3125,1510,20925,3125,4635,28685,19495,469526,27516,16728,14374,61654,45708,80514,193800,274390,28113892000,1070436000,779051000,713941000,2587763000,2146631000,4193277000,9270466000,18591985000
Indiana,Health Care and Social Assistance,2011,53697,23620,12533,7325,43478,5929,2491,51898,1799,76005,23690,12665,7750,44105,8285,7560,59950,16055,1921497,42729,83112,96673,226105,232329,380331,843570,1069753,77503313000,2011090000,3208472000,3950973000,9201897000,9295908000,12393607000,31646130000,45509050000
Indiana,Information,2011,5343,2480,601,605,3686,626,278,4590,753,10995,2480,605,625,3710,770,585,5065,5930,200629,3035,3316,7582,15415,19165,18952,60693,137054,9884551000,139118000,119651000,281578000,567816000,769697000,827358000,2491177000,7227166000
Indiana,Management of Companies and Enterprises,2011,3179,120,60,120,300,511,1013,1824,1355,4200,120,60,120,300,520,1105,1925,2275,257805,146,221,499,916,4853,27695,33535,224090,24434880000,10028000,12836000,30880000,54241000,295371000,1743510000,2096675000,22338205000
Indiana,Manufacturing,2011,37243,10889,5975,5628,22492,7708,3197,33397,3846,40420,10890,5975,5665,22530,8160,3785,34475,5945,2078742,17725,35460,68257,129915,287342,340612,814134,1173319,103574876000,755383000,1271366000,2645289000,4905452000,12230360000,14556061000,33784296000,65503624000
Indiana,"Mining, Quarrying, and Oil and Gas Extraction",2011,961,385,105,120,610,134,87,831,130,1525,395,105,120,620,210,185,1015,510,30834,312,356,1123,2164,1859,7872,15938,11999,2101423000,29270000,18541000,65053000,123441000,145908000,602266000,1043802000,823502000
Indiana,Other,2011,171,162,5,2,169,2,0,171,0,171,162,5,2,169,2,0,171,0,285,0,0,0,220,0,0,285,0,4613000,2773000,0,0,3016000,0,0,4613000,0
Indiana,Other Services (except Public Administration),2011,75478,45247,16402,7560,69209,4831,759,74799,679,82115,45300,16570,7815,69685,6685,2135,78505,3610,615400,86477,105301,98745,292345,163375,54179,521686,75376,14805347000,1961605000,2212521000,2178299000,6368751000,3909653000,1568495000,12166673000,2320062000
Indiana,"Professional, Scientific, and Technical Services",2011,59567,40505,8386,4888,53779,3425,983,58187,1380,64180,40510,8445,4975,53930,4070,1560,59560,4620,502324,60923,54036,62418,181368,103917,58283,355198,131194,27511609000,2419953000,2140443000,2724291000,7325572000,5719387000,3528074000,16974637000,9881080000
Indiana,Real Estate and Rental and Leasing,2011,21208,15540,2365,1178,19083,1019,487,20589,619,27920,15585,2470,1265,19320,2100,1785,23205,4715,154075,18884,15069,14326,51969,29340,20754,104530,38154,5499562000,676528000,428779000,431556000,1564971000,1085430000,763799000,3487649000,1664923000
Indiana,Retail Trade,2011,63813,32750,13716,7537,54003,5827,1478,61308,2505,109575,32850,14030,8590,55470,9555,6800,71825,37750,1539410,52956,82437,95556,224380,192517,111014,564681,873479,35692762000,1384064000,1919479000,2306723000,5629217000,5961877000,3555718000,15359097000,18958047000
Indiana,Total,2011,109226,60650,19645,12326,92621,10740,2888,106249,2977,143479,60742,19897,12970,93609,14173,8531,116313,27166,2440507,104973,129269,164141,398383,398528,360206,1157117,1283390,94650570000,3495473000,3774370000,5033743000,12303586000,13807637000,13487728000,39598951000,55051619000
Indiana,Transportation and Warehousing,2011,22024,12140,3104,2089,17333,2041,868,20242,1782,25145,12145,3115,2125,17385,2195,1105,20685,4460,514296,17656,20110,26476,66618,67686,58711,197134,260701,20120290000,679288000,699364000,973767000,2387218000,2598294000,2209928000,7324930000,10638575000
Indiana,Utilities,2011,971,320,220,80,620,195,35,850,121,2835,320,220,95,635,235,105,975,1860,67352,650,1453,96,2907,7348,0,13268,41427,6005329000,24420000,50318000,33253000,116686000,491005000,175134000,896708000,4022089000
Indiana,Wholesale Trade,2011,31534,14403,4690,3536,22629,4171,1963,28763,2771,38930,14460,4750,3745,22955,5105,3065,31125,7805,535564,20754,28327,43106,97492,119609,70352,305582,211422,27671173000,1028477000,1326640000,2013988000,4414597000,5869524000,3683212000,14592590000,12520482000
Iowa,Accommodation and Food Services,2011,27666,10353,5363,5548,21264,5009,693,26966,700,34345,10370,5380,5610,21360,6015,2310,29685,4660,548192,17294,36017,75956,130008,177826,70184,378691,170702,7033464000,328705000,331269000,772818000,1438852000,2072764000,825912000,4352560000,2683334000
Iowa,Administrative and Support and Waste Management and Remediation Services,2011,15653,9770,2240,1235,13245,1077,474,14796,857,17730,9780,2250,1240,13270,1275,735,15280,2450,324645,13160,13874,15488,43749,34500,54416,142182,172801,8895563000,459818000,392930000,473708000,1350824000,1079835000,1400429000,4166972000,4559968000
Iowa,"Agriculture, Forestry, Fishing and Hunting",2011,1250,990,100,65,1155,35,50,1240,10,1425,990,100,65,1155,50,160,1365,60,8567,715,560,406,2362,1100,1549,5943,0,422403000,54238000,24271000,21581000,110099000,35540000,73734000,265594000,0
Iowa,"Arts, Entertainment, and Recreation",2011,7019,4305,1020,780,6105,620,185,6910,109,7250,4305,1035,780,6120,645,245,7010,240,101444,5281,6525,9878,22864,20944,20840,68248,19889,1761682000,161699000,110051000,148702000,434746000,324066000,304645000,1151919000,407278000
Iowa,Construction,2011,42010,29350,6515,3395,39260,2191,351,41802,208,42520,29350,6515,3425,39290,2350,475,42115,405,264670,42980,41627,44267,133345,79458,31111,250690,11996,13324580000,1775147000,1672681000,2019780000,5489780000,4292448000,1932175000,12166920000,1065010000
Iowa,Educational Services,2011,3257,1500,490,445,2435,465,178,3078,179,3790,1500,490,500,2490,515,410,3415,375,203252,120,3085,5721,11481,17201,24399,56394,144473,4859197000,65336000,54060000,77811000,210210000,369658000,645206000,1307256000,3487983000
Iowa,Finance and Insurance,2011,18164,11780,2188,1157,15125,1347,630,17102,1062,30200,11795,2260,1590,15645,3795,3480,22920,7280,442525,19232,12948,14366,48464,43956,65814,162309,214151,26443137000,699565000,531830000,653359000,1925213000,2086707000,3382668000,7659241000,14859821000
Iowa,Health Care and Social Assistance,2011,28848,12660,5305,3781,21746,4056,1943,27745,1103,40170,12670,5345,4035,22050,6080,6265,34395,5775,1032712,21683,34099,49575,107882,169554,275565,558610,430137,37410382000,1051135000,1295042000,2011448000,4404455000,5329616000,8614464000,18491799000,18767138000
Iowa,Information,2011,4521,1810,815,614,3239,527,247,4013,508,7805,1810,825,640,3275,815,625,4715,3090,149957,2559,5199,5666,16238,16139,18773,54083,94458,6729481000,93651000,171368000,229290000,527139000,717367000,703369000,2031430000,4657065000
Iowa,Management of Companies and Enterprises,2011,1942,65,40,110,215,411,678,1304,638,2260,65,40,115,220,415,745,1380,880,102815,56,142,265,469,3828,21610,26010,76600,6806475000,3558000,9761000,11988000,25572000,234580000,1297590000,1558985000,5221996000
Iowa,Manufacturing,2011,15859,5285,2540,1934,9759,2915,1412,14086,1773,17815,5290,2540,1975,9805,3135,1855,14795,3020,813463,7179,14239,20349,45941,98854,125945,301281,437305,38019586000,265786000,472258000,748076000,1625793000,4225996000,5652651000,12641470000,21035610000
Iowa,"Mining, Quarrying, and Oil and Gas Extraction",2011,315,115,30,35,180,71,36,287,28,905,115,30,35,180,210,175,565,340,9156,146,49,434,900,2507,2319,5919,1968,507986000,9683000,1945000,21320000,43873000,141436000,128184000,324522000,111246000
Iowa,Other,2011,129,127,2,0,129,0,0,129,0,129,127,2,0,129,0,0,129,0,0,0,0,0,0,0,0,0,0,2020000,1975000,0,0,2020000,0,0,2020000,0
Iowa,Other Services (except Public Administration),2011,42467,27685,8775,3590,40050,1757,328,42135,332,45160,27735,9010,3915,40660,2415,765,43840,1320,255226,52186,55394,44972,153950,56363,15076,234201,13827,5817563000,1062168000,1120135000,983893000,3198900000,1394587000,345698000,5116503000,444231000
Iowa,"Professional, Scientific, and Technical Services",2011,28859,19110,4585,2317,26012,1627,406,28045,814,31080,19115,4605,2395,26115,2130,610,28855,2225,227992,25964,28305,28606,88027,50830,23161,168152,55173,11471066000,1126270000,1069514000,1236052000,3472114000,2888619000,1280725000,7914493000,3340214000
Iowa,Real Estate and Rental and Leasing,2011,10922,8338,1013,500,9851,450,267,10568,354,13260,8355,1015,635,10005,995,535,11535,1725,64436,7726,5972,5460,20487,12454,5229,44431,12335,2337072000,318435000,174546000,149057000,664069000,486212000,254052000,1454843000,471904000
Iowa,Retail Trade,2011,39291,19280,8469,5364,33113,3540,950,37603,1688,61075,19345,8600,5875,33820,5875,3305,43000,18075,828270,31518,51812,63443,156556,106131,49373,331565,398263,18691732000,763063000,1172286000,1627984000,3596901000,3246605000,1759681000,8891574000,8058108000
Iowa,Total,2011,62669,36067,10751,6822,53640,5660,1567,60867,1802,80113,36122,10891,7331,54344,8442,5422,68208,11905,1263665,61662,70350,90582,222594,211375,203180,637149,626516,46556111000,1854062000,1968334000,2711619000,6534015000,7172468000,7561537000,21268020000,25288091000
Iowa,Transportation and Warehousing,2011,15835,10440,1870,1145,13455,1120,426,15001,834,17830,10440,1875,1155,13470,1340,620,15430,2400,262618,11814,11364,14847,42505,33116,26345,105767,151029,9431397000,456959000,383979000,490103000,1346430000,1215842000,1065780000,3738817000,5485816000
Iowa,Utilities,2011,439,55,45,75,175,152,22,349,90,1305,55,45,75,175,310,55,540,765,37336,0,0,1050,1446,6091,0,8287,19671,2854516000,3324000,9803000,53170000,67854000,352965000,0,477832000,1627009000
Iowa,Wholesale Trade,2011,17439,6870,2460,2441,11771,2677,1325,15773,1666,23995,6890,2485,2595,11970,3845,3740,19555,4440,317523,10027,14842,28088,56274,74834,72378,216862,86542,15303075000,462723000,615506000,1325457000,2474962000,3601626000,3620149000,10183286000,4568719000
Kansas,Accommodation and Food Services,2011,21675,7761,3981,4148,15890,4374,591,20855,820,29790,7795,3990,4215,16000,4980,2100,23080,6710,510561,11807,25610,57172,96274,153134,63664,314224,192604,6765662000,311496000,260493000,616731000,1195012000,1826119000,812743000,3846217000,2904206000
Kansas,Administrative and Support and Waste Management and Remediation Services,2011,15566,9190,2210,1375,12775,1260,494,14529,1037,17235,9190,2235,1425,12850,1305,630,14785,2450,340004,12722,13978,17286,45522,42293,54327,150736,162764,10405222000,464705000,385973000,517678000,1409292000,1341243000,1336183000,4299560000,5443828000
Kansas,"Agriculture, Forestry, Fishing and Hunting",2011,965,755,110,65,930,25,5,960,5,965,755,110,65,930,25,5,960,5,3280,860,673,713,2235,296,0,3200,0,116085000,39217000,23961000,31915000,99715000,6026000,0,114845000,0
Kansas,"Arts, Entertainment, and Recreation",2011,4802,2725,710,605,4040,557,105,4702,100,4985,2725,710,610,4045,610,150,4805,180,67726,3023,4034,7343,15896,21922,14219,54018,10577,1161321000,100449000,72606000,106488000,292921000,386116000,279310000,982713000,141449000
Kansas,Construction,2011,33497,22010,5550,3098,30658,2222,347,33227,270,33870,22010,5565,3105,30680,2275,375,33330,540,272075,35723,35473,40479,113775,84984,31745,238016,25078,12751775000,1235383000,1268738000,1657830000,4180810000,4432415000,1725832000,10567463000,1544881000
Kansas,Educational Services,2011,3301,1575,510,375,2460,505,168,3133,168,3555,1580,510,385,2475,530,270,3275,280,97231,2073,3203,4401,10217,19683,28347,62225,29708,2491285000,73840000,57243000,93360000,249017000,476726000,622139000,1514782000,792714000
Kansas,Finance and Insurance,2011,17916,11674,2029,1045,14748,1361,485,16594,1322,29270,11695,2140,1375,15210,3495,2325,21030,8240,269932,19657,12332,13148,46445,45791,40828,137903,126546,16534669000,716662000,564998000,636136000,1974261000,2388921000,2223899000,6968408000,9293984000
Kansas,Health Care and Social Assistance,2011,29348,13005,5968,3844,22817,3789,1690,28296,1052,39020,13030,6095,3995,23120,5000,4740,32860,6160,935061,22544,38735,48921,112689,148638,249484,515036,392264,35299833000,1043604000,1512179000,2226713000,4823258000,5870056000,7368776000,18239987000,16228832000
Kansas,Information,2011,3670,1475,455,386,2316,495,237,3048,622,7140,1475,455,400,2330,645,660,3635,3505,196663,1822,2643,4358,10155,16308,13007,45796,147749,12423770000,80459000,81424000,160745000,345762000,748778000,563416000,1848967000,10410924000
Kansas,Management of Companies and Enterprises,2011,2200,160,55,50,265,411,635,1311,889,2760,160,55,50,265,430,695,1390,1370,93330,0,0,177,26,4019,17453,22425,70854,8388095000,12853000,10118000,12065000,38380000,263560000,1130221000,1462310000,6921732000
Kansas,Manufacturing,2011,13377,4345,2255,1801,8401,2381,1162,11944,1433,14385,4345,2255,1820,8420,2585,1390,12395,1990,674490,5391,10976,19081,41155,77632,102015,246689,374215,33457497000,244875000,411359000,731715000,1601891000,3152946000,4592056000,10533264000,21095125000
Kansas,"Mining, Quarrying, and Oil and Gas Extraction",2011,4720,2755,765,455,3975,460,75,4510,210,5065,2755,770,480,4005,560,85,4650,415,46741,4473,4867,5878,15196,13470,2189,35727,9415,2655990000,203437000,219711000,287099000,713482000,739419000,121093000,1836032000,707593000
Kansas,Other,2011,126,121,3,0,124,2,0,126,0,126,121,3,0,124,2,0,126,0,0,0,0,0,0,0,0,0,0,2732000,1477000,81000,0,1558000,0,0,2732000,0
Kansas,Other Services (except Public Administration),2011,37306,24210,7164,3172,34546,2030,376,36952,354,39415,24220,7240,3285,34745,2485,985,38215,1200,250681,42780,44092,39497,130202,66329,25331,230663,13249,5860950000,920130000,960445000,929062000,2841045000,1549796000,674753000,5404415000,388278000
Kansas,"Professional, Scientific, and Technical Services",2011,33086,22488,4648,2431,29567,1745,694,32006,1080,35575,22495,4680,2520,29695,2005,1075,32775,2800,279606,30231,29293,30761,90924,54219,45534,199131,57267,15605440000,1462003000,1163235000,1461556000,4101985000,2963274000,2748748000,9996959000,4122145000
Kansas,Real Estate and Rental and Leasing,2011,11762,8703,1280,556,10539,496,263,11298,464,15010,8710,1350,620,10680,830,1070,12580,2430,75581,9128,7369,6361,26739,10536,11024,49921,18572,2653193000,383316000,252432000,217466000,876102000,374287000,332879000,1627200000,799021000
Kansas,Retail Trade,2011,36759,18245,8098,4422,30765,3237,902,34904,1855,53275,18375,8210,4735,31320,4655,2705,38680,14595,669635,31374,50440,55289,142209,93282,54224,302038,331009,15569186000,778749000,1069271000,1314898000,3203207000,2813025000,1699045000,7966637000,6971044000
Kansas,Total,2011,58114,33005,9886,6126,49017,5471,1598,56086,2028,73598,33069,10033,6452,49554,7485,4505,61544,12054,1113423,56995,64451,81081,202527,199483,186935,588945,524478,43733944000,1840957000,1898883000,2628437000,6368277000,7092950000,6847370000,20308597000,23425347000
Kansas,Transportation and Warehousing,2011,10957,6470,1435,986,8891,791,318,10000,957,12895,6470,1435,1010,8915,865,590,10370,2525,206203,8345,8680,12123,31413,22189,14995,74136,123590,7724689000,310823000,275832000,429378000,1055608000,813031000,617509000,2679363000,4749952000
Kansas,Utilities,2011,363,60,30,30,120,110,46,276,87,1150,60,30,30,120,165,260,545,605,34662,0,84,190,744,4086,1109,8637,20070,3090883000,0,3268000,21565000,34450000,270686000,272276000,591271000,1873608000
Kansas,Wholesale Trade,2011,16701,6867,2269,2020,11156,2555,1186,14897,1804,22000,6895,2315,2135,11345,3970,2415,17730,4270,293403,10419,11942,22133,48189,67464,45067,177304,103275,15790411000,564392000,630936000,1173036000,2459683000,3251032000,2325566000,8696668000,6328879000
Kentucky,Accommodation and Food Services,2011,27060,8945,4785,5560,19290,5738,1013,26041,1019,37890,8945,4840,5685,19470,6625,3590,29685,8205,751946,12894,31781,75928,121867,209020,123105,455271,288543,10371355000,339130000,369412000,943248000,1656562000,2566339000,1607884000,5850305000,4510252000
Kentucky,Administrative and Support and Waste Management and Remediation Services,2011,16870,9715,2370,1640,13725,1385,651,15761,1109,19895,9715,2375,1650,13740,1455,935,16130,3765,422195,14116,14728,20417,51267,47528,67187,174094,231958,10819832000,497406000,423439000,598770000,1564323000,1446304000,1587452000,4766146000,5707265000
Kentucky,"Agriculture, Forestry, Fishing and Hunting",2011,1065,720,175,80,975,35,40,1050,15,1080,720,175,80,975,35,55,1065,15,8487,1079,658,1085,3164,1246,3796,8285,48,301121000,32785000,22850000,31045000,87784000,39107000,168486000,297389000,880000
Kentucky,"Arts, Entertainment, and Recreation",2011,5962,3150,990,765,4905,824,103,5832,130,6225,3150,1000,800,4950,865,170,5985,240,80815,4115,5733,9679,20944,30935,5067,65172,11367,1674529000,146785000,113511000,192081000,470368000,592004000,105885000,1327025000,182192000
Kentucky,Construction,2011,36549,23130,6310,3659,33099,2717,487,36303,246,36980,23130,6315,3670,33115,2825,550,36490,490,310730,37967,40596,47449,128560,100352,46330,283535,17609,13682290000,1220418000,1348715000,1863056000,4444835000,4868310000,2596913000,12285145000,896774000
Kentucky,Educational Services,2011,3760,1701,615,505,2821,525,243,3589,171,4395,1705,615,505,2825,555,460,3840,555,140854,2054,3823,6302,12729,16414,38165,75936,59285,3450648000,64558000,68681000,94423000,255430000,379740000,1135119000,1860053000,1391141000
Kentucky,Finance and Insurance,2011,15259,9255,2357,799,12411,1147,475,14033,1226,31515,9290,2485,975,12750,3150,3470,19370,12145,302092,16396,13727,9693,41457,40147,42607,128008,168395,17618366000,618223000,555791000,460442000,1685787000,1819784000,1821649000,5581666000,11785810000
Kentucky,Health Care and Social Assistance,2011,41205,18235,9545,6175,33955,4309,1562,39826,1379,55150,18295,9605,6435,34335,5770,4500,44605,10545,1214449,33531,61461,81376,180289,155636,204335,554588,654827,48353740000,1602059000,2247140000,3080998000,6961141000,6730315000,5874048000,19977653000,28244368000
Kentucky,Information,2011,3958,1645,570,420,2635,472,207,3314,644,7535,1650,570,425,2645,645,375,3665,3870,120353,1032,3335,4786,11407,15472,4759,40134,82320,6082287000,89255000,113719000,140970000,371956000,581052000,248851000,1473598000,4546786000
Kentucky,Management of Companies and Enterprises,2011,2214,145,30,70,245,346,640,1231,983,3100,145,30,70,245,355,695,1295,1805,136585,0,0,527,741,3435,14464,18895,117659,10987035000,9353000,4515000,42255000,54874000,227300000,864955000,1156025000,9828338000
Kentucky,Manufacturing,2011,17160,5130,2800,2205,10135,3043,1511,14689,2471,18740,5130,2800,2215,10145,3385,1835,15365,3375,919571,7176,15753,23571,52716,101367,118152,316077,531398,41776507000,298044000,497270000,877173000,1836556000,4020322000,5037410000,12520140000,25778091000
Kentucky,"Mining, Quarrying, and Oil and Gas Extraction",2011,2432,890,325,375,1590,457,174,2221,211,3035,890,325,375,1590,485,320,2395,640,108596,991,1925,4815,8316,16436,12705,42301,64280,7323092000,122078000,67614000,240390000,434559000,963716000,771752000,2458796000,4667195000
Kentucky,Other,2011,601,594,6,1,601,0,0,601,0,601,594,6,1,601,0,0,601,0,616,0,32,0,616,0,0,616,0,10291000,10095000,191000,0,10291000,0,0,10291000,0
Kentucky,Other Services (except Public Administration),2011,44484,28655,8636,3787,41078,2441,460,43979,505,48000,28675,8720,3985,41380,3315,1310,46005,1995,319043,51355,55211,47670,157829,79491,18677,264632,30846,7609681000,1106827000,1159189000,1069432000,3385963000,1989951000,551233000,6109479000,992529000
Kentucky,"Professional, Scientific, and Technical Services",2011,37557,25290,5515,3090,33895,1926,646,36467,1090,40565,25300,5525,3160,33985,2330,985,37300,3265,317838,36092,34928,39820,115930,60357,38810,224670,78146,14736127000,1469044000,1335755000,1642168000,4489095000,3086365000,2213230000,9994702000,4296729000
Kentucky,Real Estate and Rental and Leasing,2011,13804,10005,1543,745,12293,595,352,13240,564,17115,10005,1630,840,12475,1020,765,14260,2855,79141,15865,9555,8345,34332,16525,4372,58990,18119,3097504000,442653000,269999000,291257000,1017884000,465019000,205883000,2117825000,882786000
Kentucky,Retail Trade,2011,48504,25097,10450,5831,41378,4227,959,46564,1940,76950,25165,10635,6390,42190,6420,3680,52290,24660,993105,33917,66540,70151,183796,133725,58271,394053,444887,24422691000,986264000,1480795000,1767490000,4261901000,4060398000,1699968000,10161492000,11832048000
Kentucky,Total,2011,68417,37753,12287,7736,57776,6475,1800,66051,2366,89770,37808,12439,8120,58367,8655,5249,72271,17499,1463173,66298,80709,102604,249611,233451,206600,689662,773511,54351979000,2039967000,2267506000,3058552000,7366025000,7901427000,7215387000,22482839000,31869140000
Kentucky,Transportation and Warehousing,2011,12437,6710,1815,1145,9670,958,497,11125,1312,14795,6715,1820,1165,9700,1040,595,11335,3460,296691,9013,11277,13316,36316,26185,20671,90482,186107,13392037000,374216000,337264000,442657000,1206077000,1013549000,888786000,3313829000,8706269000
Kentucky,Utilities,2011,460,115,80,50,245,80,55,380,80,1685,115,80,50,245,165,240,650,1035,40913,0,425,528,904,4744,5803,12222,17818,3402417000,5891000,12008000,18159000,39781000,291199000,350478000,716619000,1687826000
Kentucky,Wholesale Trade,2011,17446,7308,2592,2047,11947,2337,1077,15361,2085,21195,7330,2620,2120,12070,2835,1715,16620,4575,320859,10975,14790,23194,51585,59691,44307,168554,130742,17225639000,532920000,628387000,994281000,2299249000,2792600000,2361421000,8052728000,7669718000
Louisiana,Accommodation and Food Services,2011,33236,11650,6435,6305,24390,7198,792,32380,856,44035,11660,6520,6420,24600,8095,3105,35800,8235,912302,18539,43107,86046,149178,262643,115919,530925,376387,14818565000,474380000,535257000,1084156000,2094872000,3845765000,1883777000,7879397000,6842554000
Louisiana,Administrative and Support and Waste Management and Remediation Services,2011,19897,10835,3145,1953,15933,2165,685,18783,1114,22785,10850,3175,1970,15995,2405,990,19390,3395,503193,15876,19256,25568,63143,82450,74983,228439,256798,15923610000,627311000,565417000,775083000,1975267000,2801110000,2156002000,7243652000,7811783000
Louisiana,"Agriculture, Forestry, Fishing and Hunting",2011,2866,1401,830,395,2626,175,30,2831,35,2910,1405,830,395,2630,175,60,2865,45,19319,1932,4988,4484,12555,3963,164,18331,65,729438000,83231000,178674000,153146000,443798000,158020000,8122000,669225000,14561000
Louisiana,"Arts, Entertainment, and Recreation",2011,6496,3645,1010,747,5402,825,137,6364,132,6955,3650,1010,790,5450,980,225,6655,300,101222,5288,6278,8749,21548,29327,10330,66652,34675,2673672000,160269000,136148000,168873000,480749000,532681000,197215000,1546377000,834411000
Louisiana,Construction,2011,39920,23125,7225,4570,34920,3723,710,39353,567,40775,23125,7225,4580,34930,3740,830,39500,1275,639560,39179,47323,61654,150042,142294,95402,394785,214501,31724455000,1354106000,1575625000,2316990000,5290585000,6572181000,5381113000,17503590000,12938143000
Louisiana,Educational Services,2011,4964,1900,710,638,3248,1195,335,4778,186,5425,1905,710,640,3255,1335,460,5050,375,181278,2788,4460,8040,16121,53323,42388,114341,57091,6304029000,90823000,123949000,141348000,389246000,1522771000,1366667000,3371346000,2650767000
Louisiana,Finance and Insurance,2011,19653,12160,3400,1110,16670,1282,589,18541,1112,38145,12220,3520,1385,17125,4155,4315,25595,12550,324310,20034,20901,13908,58449,50562,58126,172066,136767,17829888000,894100000,895776000,670218000,2500804000,2489517000,2951332000,8130435000,9160200000
Louisiana,Health Care and Social Assistance,2011,49646,21980,11500,6824,40304,6149,2024,48477,1169,59625,22020,11575,7015,40610,7730,4600,52940,6685,1389615,40023,75575,89369,207485,260295,304666,783911,584455,52146465000,2282865000,2899686000,3273575000,8462833000,7696661000,9152950000,25440895000,25446278000
Louisiana,Information,2011,3289,1455,425,323,2203,455,155,2813,476,6875,1455,435,330,2220,545,320,3085,3790,106152,2013,2397,3660,9233,11021,6726,34798,68917,5773090000,94350000,80947000,163112000,355713000,523446000,338728000,1520136000,3795509000
Louisiana,Management of Companies and Enterprises,2011,2363,155,60,110,325,490,691,1506,857,3125,155,60,110,325,495,730,1550,1575,102340,0,53,107,190,5327,23301,30865,70303,10398900000,15399000,11994000,50912000,78305000,340265000,1501066000,1931890000,8343032000
Louisiana,Manufacturing,2011,14990,5490,2510,2141,10141,2573,852,13566,1424,16305,5490,2510,2155,10155,2705,1235,14095,2210,516909,7327,12872,24090,50877,85279,62205,229798,259787,30326822000,340894000,508759000,1026884000,2035749000,4021237000,3461351000,10936868000,17668648000
Louisiana,"Mining, Quarrying, and Oil and Gas Extraction",2011,6581,3260,790,625,4675,956,354,5985,596,8185,3265,795,630,4690,1095,465,6250,1935,264138,4909,4964,8220,18013,36271,41198,96438,167572,20440422000,347089000,297043000,476086000,1124910000,2572523000,2911603000,6635412000,13800134000
Louisiana,Other,2011,177,171,3,3,177,0,0,177,0,177,171,3,3,177,0,0,177,0,0,0,17,0,0,0,0,0,0,3706000,2958000,206000,0,3706000,0,0,3706000,0
Louisiana,Other Services (except Public Administration),2011,44202,25895,9662,4470,40027,3098,485,43610,592,47430,25895,9750,4710,40355,3835,1065,45255,2175,360483,48634,62378,57729,171588,110622,34213,323559,23341,9438511000,1182595000,1410848000,1420080000,4032624000,2773637000,1079113000,8127372000,1032773000
Louisiana,"Professional, Scientific, and Technical Services",2011,54242,37355,7573,4340,49268,3092,771,53131,1111,57900,37365,7595,4460,49420,3635,1130,54185,3715,437421,57723,48227,55089,162333,100865,61113,331572,95288,24490641000,2925019000,2104191000,2927711000,7991162000,6280919000,4088045000,18597163000,5542633000
Louisiana,Real Estate and Rental and Leasing,2011,17457,12235,2260,1022,15517,968,423,16908,549,21940,12245,2290,1145,15680,1615,1165,18460,3480,146391,18809,13844,12205,45477,31280,25066,105250,34590,6668234000,615100000,479502000,461785000,1577385000,1338046000,1042514000,4041509000,2185116000
Louisiana,Retail Trade,2011,54010,28203,11598,6739,46540,4749,881,52170,1840,83485,28280,11810,7415,47505,7170,2745,57420,26065,942657,47734,73504,83312,209870,170088,62388,461472,393630,23001009000,1203532000,1723785000,2197996000,5185734000,5171867000,2218327000,12876404000,9291604000
Louisiana,Total,2011,80612,43668,15053,9309,68030,8444,1977,78451,2161,103216,43735,15223,9778,68736,11065,5336,85137,18079,1617229,77712,99047,124234,300993,324465,250516,875974,741255,65771545000,2834879000,3083305000,4062857000,9981041000,11498799000,10301058000,31780898000,33990647000
Louisiana,Transportation and Warehousing,2011,14998,7900,2045,1609,11554,1553,607,13714,1284,19150,7915,2050,1650,11615,1700,835,14150,5000,315821,11085,12038,18609,45391,47880,43347,149441,138437,16479664000,552450000,477305000,796040000,1856944000,2554301000,2843481000,7699865000,7524174000
Louisiana,Utilities,2011,1116,640,230,40,910,70,38,1018,98,2590,640,235,40,915,105,160,1180,1410,4005,1406,1477,485,3450,1816,5028,11845,214,316998000,29464000,40684000,14960000,85894000,99187000,283890000,520544000,10774000
Louisiana,Wholesale Trade,2011,21309,8255,3961,2859,15075,3037,1212,19324,1985,27555,8280,4005,3035,15320,3810,2245,21375,6180,362081,13280,24334,35463,77634,90967,47591,233187,122581,19320769000,700663000,1123657000,1737517000,3610950000,4657866000,2389148000,11355576000,7715491000
Maine,Accommodation and Food Services,2011,17436,8685,3100,2798,14583,2326,245,17154,282,19545,8690,3115,2840,14645,2710,1015,18370,1175,224120,9355,20963,38148,69091,82119,27898,184306,40400,4148392000,562323000,412073000,640984000,1622740000,1382558000,479364000,3521075000,597307000
Maine,Administrative and Support and Waste Management and Remediation Services,2011,9155,6125,1165,605,7895,647,170,8712,443,9735,6130,1165,615,7910,745,240,8895,840,105847,7332,7097,7138,22967,18892,16986,67071,27340,3009708000,293778000,208762000,212747000,743860000,562817000,388178000,1928574000,756027000
Maine,"Agriculture, Forestry, Fishing and Hunting",2011,3870,3095,380,175,3650,190,20,3860,10,3915,3095,380,175,3650,205,40,3895,20,16476,2988,2405,2374,7877,5736,0,16186,0,678498000,120183000,71591000,90745000,283881000,235756000,0,653838000,0
Maine,"Arts, Entertainment, and Recreation",2011,4235,2930,540,340,3810,295,77,4182,53,4345,2930,540,345,3815,335,135,4285,60,35172,2585,2981,3623,10375,9050,6977,30968,2230,719743000,166124000,101192000,84216000,377601000,150520000,71267000,661149000,35341000
Maine,Construction,2011,24262,18820,2980,1360,23160,914,82,24156,106,24355,18820,2980,1365,23165,950,90,24205,150,113392,25487,18924,16689,62677,30233,3547,103727,3326,5069885000,979342000,713635000,744155000,2470077000,1512819000,219931000,4554629000,199997000
Maine,Educational Services,2011,2320,1160,385,275,1820,310,105,2235,85,2420,1160,385,275,1820,340,140,2300,120,75910,1385,1936,3235,7246,12554,12156,34076,40253,2242107000,80925000,39363000,81296000,209349000,363300000,390959000,1053558000,1144985000
Maine,Finance and Insurance,2011,4640,2420,605,305,3330,486,225,4041,599,9500,2425,620,380,3425,1230,1545,6200,3300,123944,3775,3257,3456,11469,17135,21875,51958,64849,7465619000,156965000,146924000,196955000,524670000,849110000,1083851000,2564409000,4495348000
Maine,Health Care and Social Assistance,2011,16342,7818,3210,1782,12810,1700,1087,15597,745,23705,7830,3245,1865,12940,2545,4365,19850,3855,526585,9960,20436,21432,55637,69171,130468,262510,253646,20790040000,498193000,798556000,934820000,2283338000,2208181000,4140627000,8735211000,11713321000
Maine,Information,2011,2506,1210,405,195,1810,271,139,2220,286,3575,1210,405,195,1810,335,285,2430,1145,51534,1491,1994,2065,6581,7807,8973,28852,11424,2235936000,61085000,70780000,52587000,209916000,319743000,300196000,1081218000,684862000
Maine,Management of Companies and Enterprises,2011,836,55,20,35,110,135,316,561,275,1025,55,20,40,115,135,325,575,450,38493,0,52,120,237,1272,7778,9358,29133,2733521000,2629000,3684000,7320000,14625000,61230000,385186000,463246000,2270013000
Maine,Manufacturing,2011,7878,3575,1295,925,5795,1183,393,7371,507,8170,3580,1295,925,5800,1255,440,7495,675,186954,3945,6119,8457,22190,34804,26378,98549,64980,8635902000,171736000,215737000,315340000,818442000,1423705000,1096006000,3945896000,3647966000
Maine,"Mining, Quarrying, and Oil and Gas Extraction",2011,126,95,5,5,105,15,0,120,6,130,95,5,5,105,15,0,120,10,20,0,0,0,20,0,0,20,0,4700000,5127000,0,0,6760000,0,0,15032000,0
Maine,Other,2011,71,68,1,2,71,0,0,71,0,71,68,1,2,71,0,0,71,0,0,0,0,0,0,0,0,0,0,1081000,913000,0,0,1081000,0,0,1081000,0
Maine,Other Services (except Public Administration),2011,17110,11760,3120,1220,16100,652,146,16898,212,18030,11780,3155,1275,16210,930,415,17555,475,89378,20847,19072,14915,56645,18304,5253,84432,2516,2263905000,524180000,460317000,362029000,1360164000,504944000,123941000,2095943000,87675000
Maine,"Professional, Scientific, and Technical Services",2011,16699,11515,2348,1195,15058,801,223,16082,617,17585,11520,2380,1230,15130,975,280,16385,1200,110281,15432,14670,14289,47005,23587,7851,81822,25208,6143681000,701174000,665799000,704829000,2129711000,1446284000,695795000,4427892000,1565921000
Maine,Real Estate and Rental and Leasing,2011,6960,5475,640,305,6420,238,80,6738,222,7680,5480,655,375,6510,340,120,6970,710,29884,6381,3561,2678,13860,4797,1670,24419,3464,1080262000,236827000,127404000,105382000,498373000,178027000,63242000,869454000,138467000
Maine,Retail Trade,2011,23142,11990,4658,3014,19662,1841,429,21932,1210,31980,12055,4755,3240,20050,2715,1590,24355,7625,345212,17208,28762,32795,84468,51963,32996,174368,81634,8456092000,511555000,633359000,857696000,2026530000,1497097000,1175392000,4995958000,2167789000
Maine,Total,2011,33325,20827,5257,3097,29181,2497,634,32312,1013,40112,20865,5320,3261,29446,3417,2387,35250,4862,479728,32426,34559,41105,108090,91658,80898,280646,199082,17764334000,1131760000,1041560000,1265365000,3438685000,3061937000,2883296000,9383918000,8380416000
Maine,Transportation and Warehousing,2011,5555,3575,615,459,4649,380,157,5186,369,6090,3580,615,480,4675,440,200,5315,775,55148,3919,2870,4676,14114,10434,4047,31953,11554,2137719000,173759000,93877000,162463000,504613000,386191000,128662000,1153496000,555951000
Maine,Utilities,2011,248,105,20,5,130,30,35,195,53,510,105,20,15,140,40,100,280,230,7812,104,0,0,108,664,0,2769,4302,543253000,9510000,2172000,0,15902000,36045000,0,188249000,319881000
Maine,Wholesale Trade,2011,6948,3435,860,621,4916,753,395,6064,884,7910,3445,860,655,4960,845,610,6415,1495,73696,3824,4066,5152,15923,14978,11440,48267,12232,3699537000,209037000,180558000,242913000,709630000,696942000,578345000,2271983000,1027567000
Maryland,Accommodation and Food Services,2011,43072,18295,7923,7101,33319,7827,976,42122,950,55180,18295,7975,7135,33405,8525,3000,44930,10250,959507,30996,52378,95915,180173,296191,122153,600625,348214,17112275000,865018000,803624000,1410806000,3093073000,4985196000,1928986000,10042390000,6451579000
Maryland,Administrative and Support and Waste Management and Remediation Services,2011,35011,19485,5160,3548,28193,3953,1231,33377,1634,39480,19500,5185,3590,28275,4085,1475,33835,5645,882160,27248,33885,46401,110826,147449,142837,409807,446858,33560275000,1182649000,1133559000,1751198000,4124456000,5379525000,4769302000,14529272000,17874144000
Maryland,"Agriculture, Forestry, Fishing and Hunting",2011,948,765,95,55,915,15,0,930,18,960,765,95,55,915,15,0,930,30,4522,757,525,522,2368,0,0,2853,636,141327000,30224000,16221000,18856000,69329000,0,0,87049000,21566000
Maryland,"Arts, Entertainment, and Recreation",2011,9326,5208,1257,1170,7635,1155,294,9084,242,10055,5220,1280,1185,7685,1210,375,9270,785,170529,5991,7607,15101,29691,42440,38825,114440,32365,4564405000,354174000,190694000,303249000,857403000,932895000,1146681000,3018552000,441073000
Maryland,Construction,2011,69261,44420,10490,6990,61900,5748,1032,68680,581,69880,44420,10490,6995,61905,5790,1160,68855,1025,682635,70118,68687,93231,234237,217903,138410,599040,64747,37074070000,2864645000,2814056000,4532477000,10220940000,11735845000,8262095000,30584390000,5134521000
Maryland,Educational Services,2011,9244,4230,1375,1225,6830,1500,581,8911,333,9960,4230,1380,1270,6880,1690,680,9250,710,397147,5325,8866,15904,30600,61530,74880,175598,211499,16146745000,223949000,251641000,361112000,860292000,1850502000,2835047000,5719805000,10070968000
Maryland,Finance and Insurance,2011,20662,12555,3095,1318,16968,1372,721,19061,1601,38675,12575,3145,1465,17185,2780,2480,22445,16230,469002,22533,19126,16066,59216,45948,53109,163907,279001,39693235000,1151029000,1167159000,1313894000,3704425000,3454204000,3945587000,11474076000,24838384000
Maryland,Health Care and Social Assistance,2011,61973,30306,13930,7863,52099,6013,2229,60341,1632,78250,30395,14115,8400,52910,8640,7595,69145,9105,1655867,56857,90991,102771,252766,221110,309517,791191,834306,75050957000,2795909000,4103184000,4825061000,11770336000,10339221000,10440200000,32958505000,41141265000
Maryland,Information,2011,6551,3100,805,558,4463,790,370,5623,928,11685,3105,805,565,4475,865,495,5835,5850,259227,3851,3419,5505,15234,26585,22294,77649,172641,19763406000,267407000,264902000,356496000,947539000,1839734000,1679516000,5534080000,12962356000
Maryland,Management of Companies and Enterprises,2011,2992,95,60,125,280,531,856,1667,1325,5400,95,60,125,280,545,905,1730,3670,245890,7,184,670,1003,7241,30532,38776,207114,22205291000,13856000,13035000,64105000,90996000,575324000,1818832000,2485152000,19720139000
Maryland,Manufacturing,2011,14835,5940,2404,2047,10391,2377,805,13573,1262,15465,5950,2415,2065,10430,2460,950,13840,1625,447148,6398,11745,22528,48448,74465,52135,200311,195114,25874198000,393739000,487992000,1016385000,2104624000,3564739000,2604364000,9671059000,13539441000
Maryland,"Mining, Quarrying, and Oil and Gas Extraction",2011,301,90,45,25,160,75,15,250,51,370,90,45,25,160,75,35,270,100,5784,69,127,149,497,2387,0,3321,1290,350844000,8967000,4892000,4199000,23054000,126463000,0,169196000,130387000
Maryland,Other,2011,213,207,4,2,213,0,0,213,0,213,207,4,2,213,0,0,213,0,0,0,0,0,0,0,0,0,0,4272000,3927000,0,0,4272000,0,0,4272000,0
Maryland,Other Services (except Public Administration),2011,62018,36440,12629,6937,56006,4729,686,61421,597,66265,36495,12695,7115,56305,5465,1275,63045,3220,543027,69604,81004,90432,242382,163687,57092,474807,52011,18551276000,2009627000,2229034000,2663671000,6923981000,5557592000,2700732000,15496022000,2176763000
Maryland,"Professional, Scientific, and Technical Services",2011,88423,59898,10976,6808,77682,6547,2019,86248,2175,97710,59930,11015,6975,77920,7055,2565,87540,10170,1207892,73546,70749,89346,250133,238667,187113,687396,497430,95391449000,5572918000,4365476000,5961990000,15920094000,18659143000,14890339000,50091566000,43829945000
Maryland,Real Estate and Rental and Leasing,2011,21319,14893,2438,1202,18533,1431,572,20536,783,28635,14920,2480,1360,18760,2075,2185,23020,5615,202266,15002,14872,14228,51375,43083,37212,134333,57471,10516679000,933688000,614176000,721546000,2307825000,2300290000,2275225000,7042890000,3082855000
Maryland,Retail Trade,2011,57796,30853,12053,6760,49666,4324,1336,55326,2470,91235,30950,12410,7270,50630,6255,3955,60840,30395,1346194,48362,75449,83333,208598,143118,95399,473458,775732,35099156000,1445431000,1905512000,2217754000,5648163000,4874993000,3797223000,14936640000,19036467000
Maryland,Total,2011,106613,61417,18063,11454,90934,10314,2656,103904,2709,133248,61516,18268,11914,91698,12568,6393,110659,22589,2104022,104067,118594,152413,375074,385371,318103,1078548,1025474,101300769000,4346789000,4467144000,6071107000,14885040000,17132816000,15104865000,47122721000,54178048000
Maryland,Transportation and Warehousing,2011,14964,8049,2205,1334,11588,1509,539,13636,1328,16680,8050,2205,1340,11595,1640,660,13895,2785,293959,9055,13219,14997,43094,46230,21532,116979,125765,12146679000,407809000,426720000,495033000,1385098000,1737395000,867784000,4236454000,5739844000
Maryland,Utilities,2011,341,120,20,15,155,20,35,210,131,710,120,20,15,155,20,85,260,450,53630,71,0,50,143,0,0,237,47930,5760528000,2011000,0,2532000,24003000,0,0,50727000,5273052000
Maryland,Wholesale Trade,2011,24163,11434,3484,2544,17462,3217,1337,22016,2147,28580,11440,3505,2610,17555,3650,2090,23295,5285,409988,12306,20170,29749,71815,99346,63024,254619,143922,26250311000,976741000,1180696000,1760934000,4016447000,5870601000,4171665000,14820357000,10616561000
Massachusetts,Accommodation and Food Services,2011,65414,28114,12878,11380,52372,11129,1059,64560,854,82935,28245,12955,11525,52725,12550,4290,69565,13370,1261205,47377,85194,155712,288935,398163,149706,839466,404293,25225786000,1564521000,1385325000,2445148000,5397685000,7089020000,2903291000,15447781000,9727841000
Massachusetts,Administrative and Support and Waste Management and Remediation Services,2011,43413,28215,5467,3406,37088,3407,1302,41797,1616,48530,28235,5485,3425,37145,3590,1480,42215,6315,1003948,33687,34930,44233,114376,132494,169803,424066,544102,39712742000,2186229000,1607535000,1957970000,5789826000,5383669000,6272502000,17639579000,21170618000
Massachusetts,"Agriculture, Forestry, Fishing and Hunting",2011,1710,1380,195,80,1655,45,5,1705,5,1710,1380,195,80,1655,45,5,1705,5,4633,790,1044,724,3286,442,0,4619,0,163225000,63454000,18087000,20297000,109116000,8009000,0,160953000,0
Massachusetts,"Arts, Entertainment, and Recreation",2011,14332,7820,2185,1742,11747,1937,397,14081,251,15390,7875,2195,1795,11865,2080,695,14640,750,247021,9829,14421,22579,48549,72246,50923,176741,53239,8562895000,651453000,460374000,700754000,1827838000,1639856000,1236255000,5389266000,1601594000
Massachusetts,Construction,2011,82119,60019,11510,5735,77264,3951,517,81732,387,82400,60020,11515,5735,77270,3990,560,81820,580,510357,88761,73884,75095,240705,150763,55358,456270,34698,32590534000,4523553000,3874926000,4553539000,13005220000,11041793000,4220903000,28775585000,2789522000
Massachusetts,Educational Services,2011,12518,5520,2080,1540,9140,2006,857,12003,515,13490,5520,2085,1640,9245,2055,1190,12490,1000,994028,8675,13455,20241,42884,83900,135284,263939,715520,39642706000,341595000,422698000,558327000,1331773000,2670678000,5117991000,9319893000,29589263000
Massachusetts,Finance and Insurance,2011,26692,14685,4065,2170,20920,2442,1279,24641,2051,46795,14730,4250,2560,21540,4370,4945,30855,15940,969528,19479,25761,26919,72344,82773,116764,286822,646864,108232606000,2061694000,2186829000,2674176000,6964175000,8741223000,9493651000,25549723000,82432245000
Massachusetts,Health Care and Social Assistance,2011,65702,28845,14519,9174,52538,7385,3430,63353,2349,90445,28910,14610,9635,53155,9990,11070,74215,16230,2861926,54878,94998,121433,274328,281189,505193,1064619,1688548,135791786000,2824865000,4382380000,5919584000,13152078000,12965910000,18116395000,44327112000,88533048000
Massachusetts,Information,2011,10662,4910,1450,1075,7435,1345,580,9360,1302,17655,4920,1450,1085,7455,1385,680,9520,8135,462417,6763,8805,10583,30305,45078,53029,135516,313283,40657118000,507543000,526874000,857494000,1947360000,4084433000,5454424000,11822700000,28122442000
Massachusetts,Management of Companies and Enterprises,2011,3951,295,125,90,510,567,1059,2136,1815,5555,295,125,90,510,580,1110,2200,3355,422578,419,610,510,1546,6998,40806,49350,373228,49275879000,87735000,43130000,57450000,188965000,531343000,3400383000,4120691000,45155188000
Massachusetts,Manufacturing,2011,32894,11705,5855,5068,22628,6399,1850,30877,2017,33910,11705,5860,5105,22670,6580,2025,31275,2635,1040692,17116,33960,62006,123481,230565,168042,574784,400893,68859319000,973726000,1594392000,3041357000,5868886000,12140358000,10457203000,31123417000,33537013000
Massachusetts,"Mining, Quarrying, and Oil and Gas Extraction",2011,363,130,70,55,255,64,17,336,27,420,130,70,55,255,80,50,385,35,3672,99,227,689,1341,829,0,3541,0,244543000,15840000,21868000,32761000,73867000,65574000,0,214908000,0
Massachusetts,Other,2011,421,402,14,2,418,3,0,421,0,421,402,14,2,418,3,0,421,0,0,0,90,0,0,110,0,0,0,13445000,10468000,1921000,0,12513000,932000,0,13445000,0
Massachusetts,Other Services (except Public Administration),2011,78190,48310,16868,7738,72916,3964,688,77568,622,85500,48380,16980,8205,73565,4785,1850,80200,5300,573112,88779,109419,100251,304605,131876,57884,501555,59116,17709730000,2790056000,3002998000,2738483000,8547252000,4168348000,1932091000,14896253000,2048229000
Massachusetts,"Professional, Scientific, and Technical Services",2011,100290,68885,13097,7184,89166,6364,1996,97526,2764,106090,68915,13175,7320,89410,6740,2435,98585,7505,1248834,91359,84601,93851,286834,212692,188116,696259,537470,120798605000,6865460000,5441427000,6811415000,19149165000,20090168000,17552809000,57258405000,62856890000
Massachusetts,Real Estate and Rental and Leasing,2011,24412,17649,3100,1380,22129,1134,498,23761,651,31580,17800,3280,1490,22570,1805,1590,25965,5615,194066,26509,19686,16142,63481,34570,39292,141383,49678,11490042000,1353489000,917222000,860326000,3151788000,1961683000,2197530000,7371534000,3931093000
Massachusetts,Retail Trade,2011,81053,47411,16024,8133,71568,5625,1443,78636,2417,121835,47775,16470,8795,73040,8115,5330,86485,35350,1536243,73069,97053,92365,274403,176586,99454,570271,713863,46314333000,2494191000,2760874000,2916352000,8294023000,7069863000,4003629000,20411218000,18386218000
Massachusetts,Total,2011,136512,80088,23475,14222,117785,12413,3290,133488,3024,169146,80311,23771,14854,118936,15128,8547,142611,26535,2960712,135509,154176,189761,479446,463178,426824,1369448,1591264,165193320000,6387670000,6355436000,8211155000,20954261000,22907600000,21980467000,65842328000,99350992000
Massachusetts,Transportation and Warehousing,2011,15467,8063,2230,1528,11821,1618,853,14292,1175,17670,8070,2230,1540,11840,1725,1025,14590,3080,368239,10231,13471,19418,45765,54492,59985,163401,188525,15481650000,509042000,499733000,692775000,1756468000,1963737000,2021800000,5915020000,8730882000
Massachusetts,Utilities,2011,479,185,35,30,250,55,42,347,132,1375,185,35,30,250,60,70,380,995,61600,22,124,273,664,2449,2460,6918,53732,6442752000,10685000,9827000,48405000,80155000,412025000,288299000,922356000,5517595000
Massachusetts,Wholesale Trade,2011,35282,16425,5769,4030,26224,4551,1786,32561,2721,40340,16455,5820,4150,26425,5100,2335,33860,6480,629402,26382,36380,49733,117091,146461,93729,380760,213440,48897062000,1787661000,2229847000,3305264000,7426947000,10007558000,7361863000,25882367000,21097850000
Michigan,Accommodation and Food Services,2011,74381,28765,14153,14741,57659,14304,1294,73257,1124,97010,28790,14210,14965,57965,16725,5860,80550,16460,1616251,44492,94648,201615,342345,513997,189117,1050136,554980,23128425000,1050115000,1068453000,2304708000,4426405000,6789655000,2462556000,13730940000,9367468000
Michigan,Administrative and Support and Waste Management and Remediation Services,2011,49295,30828,6160,4204,41192,4512,1832,47536,1759,56515,30850,6210,4290,41350,4815,2270,48435,8080,1388180,36828,39357,55409,136102,180563,285405,612124,719128,42190386000,1915017000,1291655000,1758788000,4994067000,6210535000,9570194000,21176595000,19416989000
Michigan,"Agriculture, Forestry, Fishing and Hunting",2011,2559,1775,400,195,2370,129,30,2529,30,2565,1775,400,195,2370,130,30,2530,35,15707,2475,2497,2152,7698,3301,1424,14465,675,545806000,87594000,70870000,62651000,229675000,115854000,52322000,487091000,51976000
Michigan,"Arts, Entertainment, and Recreation",2011,16371,9735,2300,2012,14047,1771,333,16151,220,17095,9760,2310,2045,14115,1895,510,16520,575,241951,10273,14253,26024,52617,61180,38009,164719,44353,7866901000,733314000,352885000,498176000,1609338000,1359322000,2621831000,5994363000,1433407000
Michigan,Construction,2011,90900,67355,12044,6345,85744,4178,561,90483,417,91690,67360,12045,6365,85770,4310,780,90860,830,548805,89331,77669,84037,254664,148616,66975,477190,65055,31378245000,4302865000,3523675000,4104869000,11934470000,9204170000,4574098000,26093115000,4762303000
Michigan,Educational Services,2011,9958,4967,1495,1315,7777,1429,394,9600,358,11135,4970,1495,1370,7835,1625,685,10145,990,363650,7116,10006,16759,34565,60185,61465,158924,204489,9423520000,212074000,179601000,339310000,740100000,1464028000,1988838000,4242959000,5172753000
Michigan,Finance and Insurance,2011,34829,22973,4825,2219,30017,2275,895,33187,1642,67875,23020,4910,2685,30615,5240,4785,40640,27235,725642,40553,29978,28030,101958,84450,94432,289532,316229,44858646000,1714601000,1451792000,1580300000,4823270000,4462286000,5095014000,14677986000,28880410000
Michigan,Health Care and Social Assistance,2011,103618,47001,25988,15033,88022,10383,3229,101634,1984,130790,47105,26200,15540,88845,14675,11655,115175,15615,2853005,86956,171237,198433,461428,395955,497350,1359393,1486910,121548710000,4315196000,6969057000,8801028000,20152072000,16964151000,16605512000,53844999000,67405742000
Michigan,Information,2011,8454,3985,1240,890,6115,906,349,7370,1084,16650,3985,1240,920,6145,1235,590,7970,8680,316187,5746,6892,9419,24722,31223,25159,86812,220124,20527892000,273943000,291844000,478059000,1067867000,1499235000,1165829000,4160053000,16274703000
Michigan,Management of Companies and Enterprises,2011,5891,310,110,215,635,1251,1861,3747,2144,7995,310,120,215,645,1275,2030,3950,4045,565590,0,450,1340,2027,19740,83395,105310,459968,53816480000,36910000,45965000,147590000,230465000,1174555000,4621770000,6026790000,47770759000
Michigan,Manufacturing,2011,58151,20640,9949,8829,39418,11406,3940,54764,3387,61670,20645,9960,8870,39475,11990,4920,56385,5285,2299068,31164,61569,113005,216782,428469,443193,1145205,1063737,125699856000,1552949000,2521700000,5181832000,9535685000,21186223000,22645268000,55922018000,64705767000
Michigan,"Mining, Quarrying, and Oil and Gas Extraction",2011,1668,865,200,204,1269,201,50,1520,148,1830,865,205,215,1285,220,65,1570,260,22423,976,1099,2600,5241,5289,3229,14665,5883,1582535000,87470000,56650000,172128000,329575000,365765000,145809000,914983000,509662000
Michigan,Other,2011,478,461,12,4,477,1,0,478,0,478,461,12,4,477,1,0,478,0,0,0,71,47,0,0,0,0,0,7034000,5454000,797000,349000,6600000,0,0,7034000,0
Michigan,Other Services (except Public Administration),2011,106254,64715,23727,10418,98860,5881,848,105589,665,114085,64795,23980,11035,99810,7630,2150,109590,4495,763079,123987,152848,131130,413925,195260,70580,695133,45695,19459017000,2896521000,3355958000,3007254000,9290146000,5214477000,2249716000,17103982000,1574196000
Michigan,"Professional, Scientific, and Technical Services",2011,99894,68993,13330,7723,90046,5682,1735,97463,2431,107985,69035,13475,7910,90420,6770,2920,100110,7875,1181331,90773,85477,100957,289992,192432,166986,655821,494116,78586908000,5199421000,4476184000,5606189000,15326709000,12451489000,10563614000,38781580000,37743684000
Michigan,Real Estate and Rental and Leasing,2011,28771,20618,3763,1837,26218,1356,574,28148,623,37460,20670,3955,2075,26700,2540,1995,31235,6225,234975,31769,22445,22193,77515,41103,38987,162156,63332,8692505000,1055200000,727188000,759944000,2569020000,1686781000,1240916000,5639608000,2631044000
Michigan,Retail Trade,2011,114596,67828,22686,11628,102142,8163,1816,112121,2475,174910,68100,23230,12915,104245,12990,8210,125445,49465,2214975,113263,144256,143911,413567,287275,163453,894869,1096312,52947588000,2852490000,3206537000,3700446000,9880783000,9222625000,5022496000,24586457000,27022250000
Michigan,Total,2011,172115,100563,30424,18899,149886,15536,3623,169045,3070,217344,100747,30832,19894,151473,20612,11022,183107,34237,3379035,166713,199739,253461,619913,587099,517344,1724356,1654679,145830792000,6316152000,6570469000,8763918000,21650539000,22791812000,21665957000,66108308000,79722484000
Michigan,Transportation and Warehousing,2011,24032,14830,2837,2138,19805,1969,892,22666,1366,28280,14840,2870,2185,19895,2185,1265,23345,4935,428292,15637,16952,26238,61735,62502,55537,194270,193814,19166785000,704733000,622694000,986686000,2342156000,2509445000,2457479000,7816335000,8790212000
Michigan,Utilities,2011,514,195,60,30,285,35,49,369,145,1890,195,60,60,315,50,155,520,1370,17643,197,200,0,674,1853,4120,7209,16376,6900730000,13269000,13090000,0,42488000,125396000,547001000,855568000,1274158000
Michigan,Wholesale Trade,2011,47684,24306,7096,5317,36719,5469,2362,44550,3134,56900,24360,7225,5595,37180,6755,4235,48170,8730,763537,31490,43035,67970,152772,170151,132807,472093,258274,48214924000,2229185000,2326632000,3724924000,8334727000,9941025000,7600660000,26829074000,19789666000
Minnesota,Accommodation and Food Services,2011,41738,14154,7514,8951,30619,9138,1039,40796,942,55450,14175,7560,9075,30810,10355,3250,44415,11035,1032646,20948,50873,122283,194120,331823,133558,663424,351998,16358415000,580357000,568306000,1361162000,2512107000,4664677000,1997294000,9203154000,6527881000
Minnesota,Administrative and Support and Waste Management and Remediation Services,2011,31639,20410,3950,2730,27090,2483,832,30405,1234,35350,20425,3970,2810,27205,2755,1070,31030,4320,699992,26584,24041,35229,89102,98674,103150,296355,378376,24487720000,1148406000,787344000,1161460000,3131069000,3393857000,3106905000,9794812000,13274779000
Minnesota,"Agriculture, Forestry, Fishing and Hunting",2011,2340,1575,390,205,2170,115,25,2310,30,2385,1575,390,205,2170,125,35,2330,55,11850,1972,2346,1997,7065,3333,174,11396,183,418083000,87452000,82024000,63574000,241047000,132241000,7248000,397515000,8366000
Minnesota,"Arts, Entertainment, and Recreation",2011,12898,8130,1865,1254,11249,1231,213,12693,205,13565,8140,1875,1260,11275,1305,275,12855,710,208934,8473,11163,13596,35094,42249,31471,118953,52085,6130027000,400594000,228399000,261928000,912217000,723459000,1087059000,3281486000,1385926000
Minnesota,Construction,2011,79498,61550,9325,4778,75653,3006,477,79136,362,80080,61555,9325,4785,75665,3125,620,79410,670,453620,77396,59185,61676,203109,110048,55173,378081,52336,28095555000,3900135000,2860450000,3425735000,10192455000,7308917000,3946314000,21836354000,4155138000
Minnesota,Educational Services,2011,8410,3850,1130,1145,6125,1700,300,8125,285,9060,3855,1135,1165,6155,1820,400,8375,685,347145,4669,7482,15197,28953,71602,44592,150533,191317,9275700000,174105000,151717000,303033000,632837000,1815328000,1378468000,3931393000,5084744000
Minnesota,Finance and Insurance,2011,29964,20150,3516,1796,25462,2065,738,28265,1699,46250,20200,3640,2190,26030,4500,3375,33905,12345,711930,28800,20711,21726,76646,71821,55278,209622,465312,54663234000,1449054000,1098169000,1364458000,4036920000,4479655000,3368370000,12165432000,39552941000
Minnesota,Health Care and Social Assistance,2011,50506,22590,9465,6602,38657,6932,3241,48830,1676,74010,22640,9555,6905,39100,9905,11105,60110,13900,2198647,35697,63277,88908,190619,283735,501201,986859,1194716,85675342000,1518751000,2341396000,3145625000,7022171000,9657799000,13888163000,30898376000,53814579000
Minnesota,Information,2011,8243,3990,1108,875,5973,925,383,7281,962,13070,3995,1115,885,5995,1265,755,8015,5055,268657,5009,6859,9754,24126,32629,37952,98721,164069,17552416000,259844000,252088000,456369000,999671000,1730832000,2473509000,5335411000,11793503000
Minnesota,Management of Companies and Enterprises,2011,3941,260,85,130,475,680,1146,2301,1640,5485,260,85,130,475,685,1220,2380,3105,515410,61,290,683,1460,7888,38115,47755,467333,57190305000,47935000,15876000,22203000,91055000,915740000,2542395000,3549190000,53595212000
Minnesota,Manufacturing,2011,34333,13345,5620,4393,23358,6311,2213,31882,2451,36485,13345,5620,4420,23385,6565,2790,32740,3745,1332556,17802,31699,50410,111188,236341,239963,640038,584513,71161187000,896337000,1255765000,2288642000,4826389000,11388198000,12624402000,31463481000,34110296000
Minnesota,"Mining, Quarrying, and Oil and Gas Extraction",2011,677,385,105,55,545,45,27,617,60,770,385,105,60,550,45,35,630,140,25834,356,531,344,1403,800,519,3444,21676,2582251000,44510000,38226000,47541000,170626000,63999000,45968000,382483000,2108598000
Minnesota,Other,2011,218,212,6,0,218,0,0,218,0,218,212,6,0,218,0,0,218,0,211,0,0,0,211,0,0,211,0,3771000,3571000,0,0,3771000,0,0,3771000,0
Minnesota,Other Services (except Public Administration),2011,70146,41602,14845,7564,64011,4929,659,69599,547,75485,41680,15015,7960,64655,6200,1780,72635,2850,566861,75273,96845,99504,274215,160396,61386,501009,39677,13546876000,1768933000,2074043000,2177836000,6048978000,3858336000,1751376000,11803229000,1426058000
Minnesota,"Professional, Scientific, and Technical Services",2011,78232,57545,8767,5067,71379,3927,1135,76441,1791,82165,57550,8815,5260,71625,4565,1525,77715,4450,668346,63779,56566,64493,195325,131965,95587,430655,211741,44655754000,3806808000,2860656000,3520858000,10245621000,9604032000,7431302000,27539900000,16678800000
Minnesota,Real Estate and Rental and Leasing,2011,24619,19120,2250,1083,22453,1049,513,24015,604,30540,19145,2280,1250,22675,1925,1775,26375,4165,167792,21492,14276,12671,51229,34872,32820,121131,32184,6894478000,824686000,498736000,459488000,1813082000,1200259000,1007104000,4050381000,2179573000
Minnesota,Retail Trade,2011,64326,32035,14016,8429,54480,5970,1553,62003,2323,96840,32165,14265,9245,55675,8940,5495,70110,26730,1367724,53053,85749,106162,252623,202080,110348,592323,655715,33330176000,1394874000,1885178000,2510868000,5836288000,5871618000,3567937000,15589736000,16241364000
Minnesota,Total,2011,116697,70169,18216,12087,100472,10921,2718,114111,2586,144606,70271,18429,12706,101406,14296,7949,123651,20955,2393746,107580,120189,161468,389237,416488,368068,1173793,1219953,110750868000,4178650000,3928210000,5351848000,13458708000,15913747000,15071465000,44443920000,66306948000
Minnesota,Transportation and Warehousing,2011,20355,12250,2435,1873,16558,1874,687,19119,1236,22555,12250,2450,1890,16590,2045,925,19560,2995,322217,12244,15065,23409,55633,61386,51232,174878,143331,12231301000,578229000,557192000,769556000,1941226000,2021223000,1887460000,5966418000,6080007000
Minnesota,Utilities,2011,604,115,40,65,220,165,65,450,154,1515,115,40,65,220,215,120,555,960,1162,2,106,940,1287,5682,5274,12810,497,100051000,5091000,7325000,63827000,84484000,375416000,389108000,879659000,46777000
Minnesota,Wholesale Trade,2011,34439,16792,4830,3838,25460,4372,1899,31731,2708,40880,16840,4875,3970,25685,5140,3195,34020,6860,595791,22414,29139,43606,101320,140676,90639,356499,200251,40598633000,1533546000,1678546000,2706516000,6223856000,8539213000,5950674000,21485474000,15764704000
Mississippi,Accommodation and Food Services,2011,18428,6485,3603,3735,13823,3406,486,17715,713,25225,6495,3615,3815,13925,3810,1680,19415,5810,572442,10175,23976,50264,85091,116134,60371,263067,306621,8946808000,251352000,273080000,579220000,1113793000,1420654000,724594000,3292282000,5623757000
Mississippi,Administrative and Support and Waste Management and Remediation Services,2011,9839,5350,1605,975,7930,816,335,9081,758,11255,5350,1610,990,7950,915,415,9280,1975,227381,9190,9518,12263,32412,30219,28019,102012,119348,5768110000,239454000,251660000,285953000,814464000,724361000,636669000,2455379000,3225882000
Mississippi,"Agriculture, Forestry, Fishing and Hunting",2011,3348,1745,955,445,3145,135,25,3305,43,3410,1745,955,445,3145,140,40,3325,85,23077,3184,6225,5381,15378,3979,0,21864,435,757379000,112422000,188569000,184811000,493521000,146477000,0,676111000,31218000
Mississippi,"Arts, Entertainment, and Recreation",2011,3200,1835,465,450,2750,345,50,3145,55,3275,1835,470,455,2760,360,80,3200,75,36143,2577,2867,5203,11747,11948,5333,30921,0,644824000,95527000,43163000,81642000,229283000,204099000,69531000,542712000,0
Mississippi,Construction,2011,20140,12095,3580,2255,17930,1755,230,19915,225,20375,12095,3580,2255,17930,1775,275,19980,395,210289,19555,23105,29860,74637,63390,31303,174423,22946,8533696000,653938000,662808000,1004643000,2334810000,2529528000,1424178000,6493350000,1438751000
Mississippi,Educational Services,2011,2456,990,375,255,1620,541,155,2316,140,2995,990,375,255,1620,560,295,2475,520,89777,935,2157,2712,7198,22305,16021,46906,41834,1969334000,36551000,45602000,48684000,136796000,483930000,422645000,1078734000,866847000
Mississippi,Finance and Insurance,2011,11556,7710,1355,615,9680,684,335,10699,857,23490,7735,1455,960,10150,2330,2940,15420,8070,164576,14016,7368,7536,30827,24057,26422,83662,39740,7797104000,488682000,302956000,313656000,1135525000,1030031000,1120314000,3391128000,4359087000
Mississippi,Health Care and Social Assistance,2011,24424,10700,6005,3665,20370,2319,948,23637,787,30410,10700,6035,3780,20515,2965,2550,26030,4380,763663,20537,39247,47287,109032,86726,122585,321855,405501,30936811000,987240000,1512334000,1888080000,4408367000,3267810000,4053601000,11886015000,18662038000
Mississippi,Information,2011,1932,700,350,250,1300,196,105,1601,331,4620,700,355,265,1320,285,190,1795,2825,55496,935,2028,2618,6199,5246,2136,17394,37117,2543102000,36327000,57687000,66968000,177734000,192579000,89681000,617860000,1853324000
Mississippi,Management of Companies and Enterprises,2011,1297,65,20,55,140,246,381,767,530,1615,65,20,55,140,250,415,805,810,40582,0,0,212,355,2036,8696,11239,29343,2864531000,137000,2941000,6665000,18655000,92092000,556421000,676410000,2188121000
Mississippi,Manufacturing,2011,10405,3215,1519,1350,6084,1958,892,8934,1471,11410,3215,1525,1365,6105,2005,1105,9215,2195,534724,3527,7186,14272,30581,64524,65886,183219,309069,20761357000,174152000,215166000,456004000,960596000,2201728000,2058897000,6046498000,12876728000
Mississippi,"Mining, Quarrying, and Oil and Gas Extraction",2011,1703,935,220,164,1319,145,72,1536,167,1830,935,220,165,1320,150,100,1570,260,24486,886,1314,1794,4554,4942,4595,15482,7761,1727683000,56881000,65244000,81564000,207859000,332843000,258726000,890040000,860818000
Mississippi,Other,2011,107,101,6,0,107,0,0,107,0,107,101,6,0,107,0,0,107,0,139,0,34,0,139,0,0,139,0,2149000,1736000,413000,0,2149000,0,0,2149000,0
Mississippi,Other Services (except Public Administration),2011,30306,19135,6410,2695,28240,1510,259,30009,297,31830,19170,6475,2780,28425,1895,585,30905,925,192369,37568,40306,31917,114743,47260,13426,182311,5366,4188028000,770662000,792692000,709664000,2291898000,1030438000,319841000,3840996000,206851000
Mississippi,"Professional, Scientific, and Technical Services",2011,21449,14445,3260,1620,19325,1160,307,20792,657,23525,14450,3280,1645,19375,1630,485,21490,2035,146708,22231,20567,19905,65259,34232,15585,117457,22292,6821020000,828241000,792119000,817088000,2491307000,1715474000,998810000,5332966000,1340410000
Mississippi,Real Estate and Rental and Leasing,2011,9527,7215,1008,415,8638,331,240,9209,318,12035,7225,1030,485,8740,520,710,9970,2065,48592,9522,5876,4250,22200,7248,5708,38558,7222,1581483000,275809000,148538000,137451000,590625000,223476000,230579000,1202701000,306535000
Mississippi,Retail Trade,2011,37381,20047,8060,4349,32456,2730,638,35824,1557,57715,20095,8250,4720,33065,4205,2555,39825,17890,605122,35530,51024,54139,143069,86000,44108,287959,284922,13600395000,761316000,1111299000,1320270000,3221688000,2629141000,1043915000,7054995000,6222652000
Mississippi,Total,2011,44969,24732,8419,5107,38258,3958,1094,43310,1659,58592,24773,8534,5398,38705,5333,3233,47271,11321,887772,45756,55036,67459,168251,144691,118856,431798,455974,29585310000,1290967000,1468076000,1892110000,4651153000,4437006000,3896903000,12985062000,16600248000
Mississippi,Transportation and Warehousing,2011,9016,4760,1310,915,6985,791,312,8088,928,10490,4760,1310,925,6995,880,385,8260,2230,157998,7179,7656,10633,27056,22452,11602,66461,73108,5887893000,237794000,235507000,356471000,869126000,736232000,442723000,2275946000,2937522000
Mississippi,Utilities,2011,1826,1160,365,60,1585,95,70,1750,76,2975,1165,365,80,1610,180,220,2010,965,43557,2757,2210,676,5775,4808,9395,20444,0,3025531000,58531000,57353000,27443000,150129000,252926000,541931000,964004000,0
Mississippi,Wholesale Trade,2011,11344,4630,1680,1444,7754,1443,698,9895,1449,13945,4635,1715,1550,7900,1810,1140,10850,3095,163677,6829,8347,16111,34884,34516,27608,109455,46004,7299678000,292157000,353559000,675510000,1386766000,1472437000,1303178000,4577051000,2434365000
Missouri,Accommodation and Food Services,2011,44562,16589,7460,8571,32620,9448,1259,43327,1235,61705,16605,7500,8675,32780,11125,4625,48530,13175,1180558,26081,50260,116736,193694,341353,169386,706623,471475,17059700000,568153000,566957000,1383648000,2525635000,4526530000,2298889000,9389960000,7651904000
Missouri,Administrative and Support and Waste Management and Remediation Services,2011,32539,20452,4620,2728,27800,2423,828,31051,1488,36265,20475,4630,2750,27855,2610,1020,31485,4780,713385,26307,28591,34028,94313,88250,89082,286033,411503,21757174000,1007394000,828289000,1056864000,2940934000,2756567000,2595453000,8475432000,12764736000
Missouri,"Agriculture, Forestry, Fishing and Hunting",2011,1235,910,140,85,1135,45,20,1200,35,1255,910,140,85,1135,50,20,1205,50,7076,1237,634,780,3264,1416,502,6056,375,206788000,40478000,22759000,23240000,93988000,27296000,11168000,154328000,35846000
Missouri,"Arts, Entertainment, and Recreation",2011,9725,5517,1450,1167,8134,1129,219,9482,243,10360,5535,1455,1200,8190,1235,285,9710,650,184473,7128,8951,15525,32667,38365,11099,95861,69105,6829471000,263309000,162415000,269539000,715901000,791437000,263642000,2267888000,1634668000
Missouri,Construction,2011,65759,44364,10682,5692,60738,3926,614,65278,481,66375,44370,10695,5710,60775,4065,785,65625,750,510625,71158,68647,75056,216170,136529,66422,428575,52939,26240505000,2454461000,2475848000,3372694000,8322925000,7684355000,4215409000,20809935000,4488035000
Missouri,Educational Services,2011,6842,2895,985,965,4845,1310,375,6530,312,7745,2895,985,985,4865,1390,485,6740,1005,368737,4779,6540,12351,24216,55548,64398,147597,213583,13724867000,126612000,117088000,233577000,489476000,1353690000,1878712000,3769702000,9796772000
Missouri,Finance and Insurance,2011,28666,19315,3072,1500,23887,2054,884,26825,1841,53930,19355,3155,1835,24345,5270,4690,34305,19625,568528,33228,18862,18348,70554,69344,74744,228666,332868,35359712000,1258701000,812115000,876926000,3014143000,3345176000,4217822000,11182612000,24229849000
Missouri,Health Care and Social Assistance,2011,63780,32140,12380,7895,52415,7029,2534,61978,1802,83630,32210,12465,8245,52920,9000,7880,69800,13830,1938705,47728,80345,103144,231405,294146,349933,881308,1033308,74785858000,2167798000,3146049000,4155063000,9486548000,10072418000,9945829000,29584180000,44726844000
Missouri,Information,2011,6331,2780,900,803,4483,707,290,5480,851,12625,2780,910,840,4530,915,505,5950,6675,280493,4408,5428,9878,20757,20478,16469,64028,210421,16353518000,160432000,205858000,369206000,760923000,947385000,681350000,2579171000,14080028000
Missouri,Management of Companies and Enterprises,2011,4120,190,80,151,421,786,1262,2469,1651,5775,190,80,155,425,805,1345,2575,3200,367275,0,30,699,1151,8055,33830,43175,323962,32921395000,38143000,2094000,42043000,136780000,484515000,2205400000,2826695000,30086289000
Missouri,Manufacturing,2011,28636,10860,4945,4133,19938,4585,1787,26310,2326,30570,10860,4950,4185,19995,4875,2155,27025,3545,1033584,16119,28373,46764,99250,154502,152368,458494,492216,48133078000,742342000,981336000,1772178000,3718940000,6529748000,7002398000,19241189000,24569521000
Missouri,"Mining, Quarrying, and Oil and Gas Extraction",2011,826,300,170,70,540,122,74,736,90,1345,300,170,70,540,295,190,1025,320,14617,273,1080,575,2459,2771,3475,9680,1513,848284000,23292000,41431000,29592000,100244000,145293000,227541000,544745000,84836000
Missouri,Other,2011,3853,3833,13,7,3853,0,0,3853,0,3853,3833,13,7,3853,0,0,3853,0,0,0,80,0,0,0,0,0,0,22544000,21916000,513000,0,22544000,0,0,22544000,0
Missouri,Other Services (except Public Administration),2011,72028,45255,14357,6611,66223,4432,702,71357,671,77610,45275,14485,7000,66760,5530,2085,74375,3235,551351,83259,91999,85632,263231,154747,42901,474719,63633,13604168000,1874482000,2017666000,1958324000,5873913000,3754643000,1252815000,11203981000,2049217000
Missouri,"Professional, Scientific, and Technical Services",2011,61104,40750,9095,4840,54685,3508,1161,59354,1750,65695,40770,9125,4985,54880,4200,1470,60550,5145,687295,61053,56698,62634,183728,115112,74876,380294,271573,43707235000,2597606000,2481220000,3120227000,8232705000,7147906000,5156120000,20774045000,20585213000
Missouri,Real Estate and Rental and Leasing,2011,23877,17872,2395,1243,21510,1045,578,23133,744,29745,17895,2480,1390,21765,1580,1585,24930,4815,166010,26674,14700,14858,56691,28611,34580,123625,35030,6214504000,752204000,484789000,442886000,1723135000,1161964000,1189559000,4271430000,1535252000
Missouri,Retail Trade,2011,66431,35217,13320,8052,56589,5854,1474,63917,2514,108185,35350,13720,8985,58055,9560,5570,73185,35000,1368418,55506,83750,100723,250123,194676,91197,556530,733434,33206136000,1426855000,1850909000,2554861000,5865016000,6263128000,3122290000,15570344000,16474430000
Missouri,Total,2011,114817,68296,18664,11920,98880,10421,2673,111974,2843,147274,68408,18903,12583,99894,13999,7809,121702,25572,2298295,113275,121910,158560,393745,390160,314171,1098076,1200219,92601836000,3492666000,3701757000,5026351000,12220774000,13612978000,11890131000,37723883000,54877953000
Missouri,Transportation and Warehousing,2011,20103,12185,2550,1781,16516,1507,665,18688,1415,23110,12185,2560,1810,16555,1610,920,19085,4025,369552,16319,15378,21825,58352,49648,39350,154183,180550,13919134000,587160000,549189000,725662000,1894088000,1731717000,1435557000,5228703000,7441485000
Missouri,Utilities,2011,548,130,65,30,225,185,44,454,94,1765,130,65,30,225,290,240,755,1010,74921,0,262,339,1009,9615,4236,14454,41512,6463452000,6364000,11953000,16423000,38594000,634615000,294789000,1001304000,3776665000
Missouri,Wholesale Trade,2011,32578,14736,4813,3737,23286,4528,1960,29774,2804,39415,14785,4880,3945,23610,5590,3190,32390,7025,592662,22222,29162,45258,102814,129919,85906,333002,243648,29865026000,1122588000,1417884000,2147938000,4806882000,6841347000,4420412000,16599655000,12490859000
Montana,Accommodation and Food Services,2011,15267,5910,3239,3110,12259,2532,268,15059,208,16940,5915,3265,3140,12320,2905,805,16030,910,217698,9017,21133,42554,73363,87887,28717,190333,14465,3120975000,224764000,251069000,534861000,1017244000,1247856000,409061000,2684040000,299514000
Montana,Administrative and Support and Waste Management and Remediation Services,2011,7990,5560,1145,550,7255,312,115,7682,308,8475,5560,1155,555,7270,385,150,7805,670,75541,5820,6907,5273,20894,10640,7776,43378,5507,1969044000,230797000,169748000,159756000,596112000,239740000,154896000,1104201000,137135000
Montana,"Agriculture, Forestry, Fishing and Hunting",2011,1746,1460,170,55,1685,30,11,1726,20,1775,1460,170,55,1685,30,30,1745,30,4255,1616,819,615,3152,855,0,4083,0,176494000,61039000,25548000,22934000,115581000,32844000,0,162133000,788000
Montana,"Arts, Entertainment, and Recreation",2011,5142,3095,930,610,4635,377,90,5102,40,5720,3100,940,630,4670,430,130,5230,490,46861,2662,5561,7586,17886,12735,10804,43010,0,733028000,131790000,95406000,109561000,350493000,186147000,112661000,668091000,0
Montana,Construction,2011,24403,19370,3105,1005,23480,689,113,24282,121,24510,19370,3105,1005,23480,695,135,24310,200,99973,24156,18828,12598,56800,21724,6635,92243,3060,4975681000,975312000,732072000,592986000,2343765000,1377180000,474631000,4476028000,201956000
Montana,Educational Services,2011,1635,875,290,175,1340,195,60,1595,40,1685,875,290,175,1340,195,100,1635,50,27637,939,1366,1959,5331,6270,5626,18300,7342,601859000,30646000,28647000,28998000,100354000,134351000,150225000,407673000,133301000
Montana,Finance and Insurance,2011,6247,4100,715,363,5178,374,153,5705,542,9830,4110,740,445,5295,1015,680,6990,2840,77760,6672,3971,3531,15580,12224,9211,39579,18702,3767995000,233836000,160002000,154924000,568519000,476439000,438468000,1654389000,1474324000
Montana,Health Care and Social Assistance,2011,14612,7570,3215,1550,12335,1170,684,14189,423,16975,7580,3225,1610,12415,1395,1850,15660,1315,319354,12666,21034,18149,53420,45270,85390,187749,111678,11806249000,510001000,705932000,687894000,1941863000,1452485000,2742193000,6224106000,4888567000
Montana,Information,2011,1979,1010,260,205,1475,133,108,1716,263,2905,1010,260,210,1480,185,415,2080,825,41651,961,1296,2322,5780,1460,7802,19789,18489,1667153000,44409000,33567000,83498000,186945000,68215000,376496000,769428000,753517000
Montana,Management of Companies and Enterprises,2011,545,45,5,35,85,115,135,335,210,595,45,5,35,85,120,135,340,255,13935,0,0,79,165,389,5332,5913,7950,947865000,3080000,0,5204000,8480000,14847000,327279000,351550000,593082000
Montana,Manufacturing,2011,5920,3225,1005,745,4975,537,194,5706,214,6050,3225,1005,745,4975,580,215,5770,280,64315,3176,4401,6543,17534,12008,8286,45520,9239,2673377000,146876000,141369000,211527000,579701000,420275000,337152000,1586882000,660764000
Montana,"Mining, Quarrying, and Oil and Gas Extraction",2011,1733,1010,185,129,1324,145,70,1539,194,1840,1010,185,130,1325,145,80,1550,290,18772,506,1204,1504,3323,3692,1788,12312,7624,1531540000,83231000,57015000,86745000,240117000,268998000,153188000,872512000,728737000
Montana,Other,2011,68,66,0,2,68,0,0,68,0,68,66,0,2,68,0,0,68,0,0,0,0,0,0,0,0,0,0,846000,722000,0,0,846000,0,0,846000,0
Montana,Other Services (except Public Administration),2011,14694,9730,2880,1307,13917,551,90,14558,136,15290,9730,2885,1325,13940,780,130,14850,440,72850,16161,17832,15957,51449,14567,1329,69614,760,1761126000,400708000,400983000,370045000,1197626000,364930000,63582000,1681370000,39335000
Montana,"Professional, Scientific, and Technical Services",2011,16967,12620,2145,952,15717,613,200,16530,437,17820,12620,2165,1000,15785,840,380,17005,815,82288,15111,12899,11438,42738,14579,6142,72081,7384,3822749000,695341000,472614000,523078000,1737080000,831776000,424167000,3321891000,455346000
Montana,Real Estate and Rental and Leasing,2011,7673,6390,615,288,7293,175,64,7532,141,8320,6405,625,350,7380,345,120,7845,475,26957,7582,3056,3328,14984,4351,1483,22692,2410,762072000,215556000,85158000,85378000,402922000,128116000,34043000,601909000,116038000
Montana,Retail Trade,2011,18647,9610,4105,2305,16020,1463,346,17829,818,24160,9665,4200,2530,16395,2085,1195,19675,4485,249923,14452,24133,25817,71567,42958,18723,145000,84143,6283679000,414241000,584930000,723388000,1750864000,1229769000,571874000,3770938000,2141328000
Montana,Total,2011,31033,19804,5098,2837,27739,1990,494,30223,810,35687,19832,5150,2988,27970,2707,1487,32164,3523,336110,30730,33327,37611,101668,69778,55046,226492,109618,11291642000,971015000,894081000,1036032000,2901128000,2107543000,1952039000,6960710000,4330932000
Montana,Transportation and Warehousing,2011,5974,4120,710,355,5185,318,155,5658,316,6805,4130,710,365,5205,335,250,5790,1015,50805,4208,4068,3817,12668,8413,6167,31479,9281,1882608000,192128000,141501000,153269000,513490000,320350000,231853000,1177806000,411836000
Montana,Utilities,2011,393,180,25,35,240,90,20,350,43,985,180,25,50,255,115,40,410,575,14014,216,64,467,901,2467,0,4803,3774,1158093000,8327000,3162000,26668000,44016000,174213000,0,312868000,345852000
Montana,Wholesale Trade,2011,5925,2840,780,533,4153,682,329,5164,761,7415,2840,795,575,4210,955,595,5760,1655,64728,2444,3683,5146,13646,16582,7669,44655,15221,2987021000,155745000,178804000,212459000,605855000,664964000,345243000,1861137000,834548000
Nebraska,Accommodation and Food Services,2011,16545,6154,3120,3193,12467,3119,400,15986,559,21220,6165,3130,3265,12560,3645,1780,17985,3235,338958,10169,20863,43008,74554,108730,47802,232176,99639,4210610000,174715000,194482000,475526000,851160000,1284057000,608016000,2764685000,1438037000
Nebraska,Administrative and Support and Waste Management and Remediation Services,2011,11674,7355,1635,970,9960,735,275,10970,704,13070,7355,1635,1010,10000,800,335,11135,1935,281490,10066,9407,11131,32651,21172,23727,85836,171742,9049211000,367186000,253135000,317482000,973560000,621542000,668194000,2562184000,6305684000
Nebraska,"Agriculture, Forestry, Fishing and Hunting",2011,790,555,115,35,705,35,20,760,30,830,555,115,35,705,35,30,770,60,5186,289,533,294,1441,559,200,2945,2130,252702000,29995000,24027000,15432000,74095000,27659000,8326000,127415000,120690000
Nebraska,"Arts, Entertainment, and Recreation",2011,4039,2455,530,385,3370,480,75,3925,114,4225,2455,530,390,3375,510,95,3980,245,55894,3055,3076,4731,11084,17683,4871,39803,13801,894965000,93425000,51836000,68124000,230798000,299109000,85810000,702492000,143953000
Nebraska,Construction,2011,28570,19770,4485,2260,26515,1602,240,28357,213,28820,19770,4490,2270,26530,1630,335,28495,325,185632,29068,28448,27643,89232,57085,19999,170865,7536,8118952000,1003576000,1033874000,1174401000,3240475000,2702730000,1079637000,7198220000,457095000
Nebraska,Educational Services,2011,2253,915,365,335,1615,460,90,2165,88,2480,915,365,335,1615,515,220,2350,130,90590,24,2275,4128,8010,19680,14212,42986,19432,2538597000,36455000,27775000,56163000,130216000,420376000,364991000,951365000,627976000
Nebraska,Finance and Insurance,2011,12842,8479,1569,724,10772,794,350,11916,926,20880,8505,1630,925,11060,2040,1695,14795,6085,250891,12842,9142,8377,31985,25220,23701,85933,155481,15238979000,462812000,408745000,361161000,1253812000,1208852000,1203193000,3952867000,10756448000
Nebraska,Health Care and Social Assistance,2011,21175,10060,4195,2726,16981,2557,936,20474,701,26425,10075,4255,2820,17150,3490,2490,23130,3295,594735,15082,26902,35056,81426,99680,117416,305804,258457,23413046000,873674000,1113086000,1419693000,3434100000,3987692000,3888492000,11484274000,10243980000
Nebraska,Information,2011,2878,1133,395,340,1868,385,146,2399,479,4535,1135,395,350,1880,480,245,2605,1930,73683,1389,2128,3488,8470,11141,3304,28134,39900,4369988000,54259000,73025000,147841000,284638000,587127000,130985000,1159668000,2345891000
Nebraska,Management of Companies and Enterprises,2011,1381,115,50,35,200,300,351,851,530,1670,115,50,35,200,305,360,865,805,75365,0,21,0,0,4030,9035,13514,61491,6537665000,10728000,7654000,535000,30885000,200380000,1312602000,1547000000,4987517000
Nebraska,Manufacturing,2011,8482,3220,1350,1065,5635,1344,648,7627,855,9110,3220,1350,1070,5640,1470,725,7835,1275,394541,4193,5957,8764,21797,42765,49998,135704,209734,16660822000,161462000,195224000,333862000,817987000,1844611000,2115767000,5558641000,8689183000
Nebraska,"Mining, Quarrying, and Oil and Gas Extraction",2011,562,340,70,45,455,47,15,517,45,615,340,70,45,455,50,15,520,95,4373,365,386,504,1218,553,0,2915,0,245517000,23712000,15479000,23680000,68370000,29758000,0,154430000,0
Nebraska,Other,2011,88,84,4,0,88,0,0,88,0,88,84,4,0,88,0,0,88,0,0,0,26,0,0,0,0,0,0,1125000,1051000,74000,0,1125000,0,0,1125000,0
Nebraska,Other Services (except Public Administration),2011,25994,16900,4770,2252,23922,1481,314,25717,277,27945,16935,4830,2355,24120,1940,960,27020,925,176370,29927,29193,29162,90526,51019,14080,160289,10648,4213270000,674052000,614056000,646231000,1972740000,1166179000,401263000,3685314000,378388000
Nebraska,"Professional, Scientific, and Technical Services",2011,20451,13620,2970,1540,18130,1151,368,19649,802,21985,13620,2980,1550,18150,1455,615,20220,1765,190125,17232,18084,18322,54745,35974,21656,124826,52971,10374893000,760547000,741901000,838893000,2361344000,2072665000,1286898000,6172286000,3684460000
Nebraska,Real Estate and Rental and Leasing,2011,8407,6460,745,355,7560,306,216,8082,325,9675,6485,785,400,7670,440,490,8600,1075,46736,605,4322,3512,15059,7514,10418,40652,5094,1605909000,242081000,141750000,91742000,510831000,240858000,406355000,1355769000,219165000
Nebraska,Retail Trade,2011,25226,12126,5320,3251,20697,2367,725,23789,1437,36690,12175,5445,3560,21180,3710,2300,27190,9500,469846,20896,32589,38842,96637,72898,35298,216595,209796,11078391000,499153000,712227000,892716000,2152708000,2113157000,1237499000,5864224000,4431943000
Nebraska,Total,2011,41569,24320,6890,4254,35464,3716,955,40135,1434,51553,24366,6991,4505,35862,5122,2979,43963,7590,797681,40723,45032,56398,142153,137072,106824,386049,411632,29969153000,1230209000,1301134000,1666605000,4197948000,4634044000,4099410000,12931402000,17037751000
Nebraska,Transportation and Warehousing,2011,10418,7025,1254,695,8974,569,227,9770,648,11350,7025,1255,695,8975,595,325,9895,1455,182610,8035,7029,7857,25606,17319,17099,64457,101053,7027969000,289333000,252253000,283050000,839371000,677119000,657759000,2280361000,4113397000
Nebraska,Utilities,2011,152,50,5,5,60,25,5,90,62,565,50,5,5,60,30,5,95,470,348,0,0,0,92,466,0,558,146,52516000,699000,0,0,8320000,26178000,0,39447000,15628000
Nebraska,Wholesale Trade,2011,11349,4500,1595,1277,7372,1841,822,10035,1314,15235,4515,1620,1410,7545,2470,1875,11890,3345,189854,6368,8861,13924,31720,47943,29862,118400,62075,9571856000,272180000,395861000,604945000,1356719000,2172308000,1561171000,5391633000,3762876000
Nevada,Accommodation and Food Services,2011,20030,6857,4228,3566,14651,3584,741,18976,1054,28595,6870,4280,3715,14865,4325,2340,21530,7065,1475475,10873,27492,46518,84807,131287,113509,331289,1130688,42182693000,396846000,383697000,705445000,1489925000,2471789000,2332203000,6325263000,35587443000
Nevada,Administrative and Support and Waste Management and Remediation Services,2011,18265,10455,2585,1625,14665,1793,671,17129,1136,20005,10455,2590,1665,14710,1865,785,17360,2645,432081,13171,15860,20880,53339,57016,52935,175317,218953,13388492000,708622000,493352000,645426000,1886889000,1706736000,1271644000,5387288000,6942844000
Nevada,"Agriculture, Forestry, Fishing and Hunting",2011,245,225,10,5,240,5,0,245,0,245,225,10,5,240,5,0,245,0,62,78,0,0,62,0,0,62,0,26058000,21762000,0,0,24043000,0,0,26058000,0
Nevada,"Arts, Entertainment, and Recreation",2011,5606,3355,608,525,4488,682,234,5404,202,6425,3360,610,530,4500,770,525,5795,630,136010,2969,3151,6344,13852,27392,30052,79940,46996,4133145000,367828000,122336000,207794000,720404000,732270000,752975000,2441994000,1505832000
Nevada,Construction,2011,23176,13365,3800,2735,19900,2265,495,22660,516,23525,13365,3800,2740,19905,2315,555,22775,750,249596,19825,24428,35492,82008,78656,31955,206192,38713,12154181000,928141000,976053000,1483764000,3402715000,3623016000,1959279000,9400216000,2478595000
Nevada,Educational Services,2011,2939,1535,475,295,2305,340,110,2755,184,3180,1535,480,295,2310,355,140,2805,375,47747,1779,2737,3233,9154,11773,8758,32235,9871,1608664000,81206000,65644000,82803000,241041000,411465000,287381000,1063227000,352658000
Nevada,Finance and Insurance,2011,12006,7832,1203,515,9550,679,502,10731,1275,19670,7905,1250,530,9685,1220,1195,12100,7570,161524,11081,6784,5600,24433,11865,9004,50699,101101,8942653000,564024000,321486000,266990000,1194543000,804867000,491816000,2668925000,6052050000
Nevada,Health Care and Social Assistance,2011,27089,14348,5880,3220,23448,2250,543,26241,848,31175,14385,5895,3320,23600,2820,1570,27990,3185,501841,16505,38743,41542,103980,81340,70915,261111,206657,24065117000,1777179000,1641026000,1865714000,5305888000,3309724000,2666992000,11468267000,11583194000
Nevada,Information,2011,3930,2385,355,270,3010,280,125,3415,515,5555,2385,355,275,3015,290,165,3470,2085,75338,2198,1519,2621,6785,5507,2978,21920,46391,4180900000,160138000,96318000,142234000,449994000,356666000,121856000,1124808000,2696969000
Nevada,Management of Companies and Enterprises,2011,2342,650,55,75,780,320,429,1529,813,2725,660,55,75,790,330,500,1620,1105,65769,0,245,41,1396,2139,10799,14520,50595,6096040000,7424000,14000000,20285000,85807000,175991000,673964000,962220000,5132069000
Nevada,Manufacturing,2011,8148,3430,1405,995,5830,1169,497,7496,652,8415,3430,1405,995,5830,1185,550,7565,850,157889,3618,6675,8131,21751,28794,19861,92379,44852,7888289000,188616000,257111000,350528000,917840000,1226985000,917078000,3851726000,3051787000
Nevada,"Mining, Quarrying, and Oil and Gas Extraction",2011,1133,550,150,90,790,150,80,1020,113,1205,550,150,90,790,150,80,1020,185,55298,1,865,669,2741,3340,7335,13975,35914,4952869000,72577000,75189000,60023000,273289000,396800000,690349000,1773203000,3152945000
Nevada,Other,2011,104,97,7,0,104,0,0,104,0,104,97,7,0,104,0,0,104,0,0,0,50,0,0,0,0,0,0,3057000,1766000,1291000,0,3057000,0,0,3057000,0
Nevada,Other Services (except Public Administration),2011,18614,11825,3355,1615,16795,1123,317,18235,379,20780,11830,3400,1640,16870,1460,690,19020,1760,151298,18600,20212,20057,62342,37236,16115,120700,17934,4238512000,575101000,573431000,564663000,1738356000,1028505000,441875000,3359644000,590656000
Nevada,"Professional, Scientific, and Technical Services",2011,37684,27660,4075,2365,34100,1809,686,36595,1089,40445,27680,4080,2445,34205,2005,870,37080,3365,261435,34817,24831,28846,90150,53737,29388,180775,57028,15524091000,2231865000,1351293000,1649333000,5285002000,3334957000,1722052000,10627673000,4073000000
Nevada,Real Estate and Rental and Leasing,2011,15397,11482,1650,729,13861,646,334,14841,556,18940,11500,1715,775,13990,1050,810,15850,3090,114805,11774,10015,8412,34428,15932,12495,66857,44476,4462312000,622374000,307647000,303149000,1244558000,645037000,467150000,2480404000,1889024000
Nevada,Retail Trade,2011,24140,11812,4570,2776,19158,1846,852,21856,2284,40595,11855,4735,2975,19565,2565,2140,24270,16325,587946,15365,26816,31239,77660,51663,30468,178278,369445,16195717000,533425000,741599000,827956000,2145071000,1597734000,1254198000,5363030000,10309523000
Nevada,Total,2011,46923,27456,7315,4587,39358,4068,1405,44831,2092,58777,27510,7419,4760,39689,5000,2903,47592,11185,1000610,42334,47837,60229,150400,139520,121056,410976,589634,38743505000,2021113000,1656008000,2118905000,5796026000,5167154000,4432384000,15395564000,23347941000
Nevada,Transportation and Warehousing,2011,6042,3080,545,552,4177,510,387,5074,968,7000,3080,545,575,4200,535,445,5180,1820,179056,2956,2381,6654,11516,12105,22240,54838,102073,6769885000,165536000,91437000,227918000,539539000,480313000,794145000,2137593000,3961633000
Nevada,Utilities,2011,258,100,10,20,130,55,21,206,52,590,100,10,20,130,95,50,275,315,1454,0,0,0,140,0,515,715,629,204309000,6231000,0,0,14465000,0,53334000,196979000,69675000
Nevada,Wholesale Trade,2011,12695,5890,1677,1102,8669,1481,904,11054,1641,14295,5895,1695,1135,8725,1660,1105,11490,2805,160563,6898,8570,10549,30789,29840,17768,88343,52137,8329559000,436922000,433611000,579766000,1580995000,1580525000,905401000,4331944000,3017504000
New Hampshire,Accommodation and Food Services,2011,14743,5800,2935,2910,11645,2421,353,14419,324,17920,5810,2945,2950,11705,2765,1230,15700,2220,253622,8034,19823,39103,67642,81499,29081,184084,37657,4416061000,309800000,288052000,573443000,1176165000,1378214000,490512000,3172111000,1269779000
New Hampshire,Administrative and Support and Waste Management and Remediation Services,2011,10139,6598,1393,745,8736,647,237,9620,519,10990,6600,1405,755,8760,730,255,9745,1245,186527,6687,8182,9357,27903,20388,21682,76263,102507,7313423000,426552000,314618000,351334000,1143860000,770085000,711618000,2848085000,4151288000
New Hampshire,"Agriculture, Forestry, Fishing and Hunting",2011,690,530,95,45,670,15,0,685,5,695,530,95,45,670,20,0,690,5,2309,709,471,120,1876,0,0,2241,0,92777000,27409000,18448000,24301000,71664000,0,0,90849000,0
New Hampshire,"Arts, Entertainment, and Recreation",2011,3498,1900,565,395,2860,455,97,3412,86,3650,1900,565,395,2860,505,170,3535,115,60661,2449,3243,4492,10923,14913,13045,41081,16297,1347344000,414045000,90976000,96545000,627954000,332121000,140614000,1136082000,132088000
New Hampshire,Construction,2011,19273,14050,2540,1430,18020,1043,120,19183,90,19370,14050,2540,1430,18020,1065,170,19255,115,111540,19916,16343,18119,57021,36454,6741,105130,3677,5966650000,905209000,736188000,931413000,2583001000,2337870000,434901000,5641965000,184070000
New Hampshire,Educational Services,2011,2782,1315,445,355,2115,411,118,2644,138,3005,1320,445,360,2125,505,145,2775,230,115425,636,2412,4584,8751,13912,13797,41486,68270,4020774000,68336000,53115000,96859000,233748000,377407000,451042000,1162470000,2672018000
New Hampshire,Finance and Insurance,2011,5209,2810,577,355,3742,417,293,4452,757,9385,2810,600,420,3830,685,1330,5845,3540,105195,4919,3256,3178,11765,10590,18356,41541,54322,7116591000,260601000,210266000,225859000,727017000,831568000,1047280000,2831466000,4017094000
New Hampshire,Health Care and Social Assistance,2011,13871,5660,3405,1885,10950,1599,670,13219,652,17860,5670,3425,1960,11055,2060,1755,14870,2990,414769,10469,22148,23180,58327,55445,87369,206848,198686,18726046000,415997000,925583000,1191997000,2560137000,2317767000,2990762000,7997110000,10237353000
New Hampshire,Information,2011,2372,940,375,244,1559,254,157,1970,402,3585,940,375,245,1560,305,230,2095,1490,62827,993,1474,2036,5155,8134,10859,27478,14329,4706124000,109825000,109746000,135982000,407670000,568683000,576312000,1686218000,1175525000
New Hampshire,Management of Companies and Enterprises,2011,782,55,20,25,100,116,160,376,406,995,60,20,25,105,120,165,390,605,75399,0,24,0,20,1370,3871,5729,69534,7399104000,0,2198000,2565000,18765000,96365000,256593000,372219000,7018625000
New Hampshire,Manufacturing,2011,8944,3375,1510,1165,6050,1762,431,8243,701,9240,3375,1510,1165,6050,1795,495,8340,900,256146,3783,7342,10623,25670,55626,25448,129058,97088,14853442000,269150000,322973000,585727000,1370483000,2767747000,1522504000,6702633000,6406165000
New Hampshire,"Mining, Quarrying, and Oil and Gas Extraction",2011,187,140,10,15,165,5,10,180,7,210,140,10,15,165,5,20,190,20,813,0,0,0,253,0,0,729,0,53794000,12530000,0,6979000,27675000,0,0,45412000,0
New Hampshire,Other,2011,61,56,5,0,61,0,0,61,0,61,56,5,0,61,0,0,61,0,0,0,0,0,0,0,0,0,0,1057000,846000,0,0,1057000,0,0,1057000,0
New Hampshire,Other Services (except Public Administration),2011,16736,10425,3695,1450,15570,695,193,16458,278,17765,10440,3715,1465,15620,900,400,16920,845,104834,19051,23155,17067,61582,17935,6593,92774,6561,2881413000,528419000,583619000,427872000,1581706000,536993000,215929000,2533495000,248417000
New Hampshire,"Professional, Scientific, and Technical Services",2011,18217,12025,2585,1510,16120,1133,290,17543,674,19165,12025,2615,1550,16190,1320,370,17880,1285,148754,18496,15649,18310,54853,31129,15634,108378,39253,8560523000,1090273000,920534000,1137240000,3190247000,2210223000,1387515000,7051116000,1470362000
New Hampshire,Real Estate and Rental and Leasing,2011,5724,4055,720,368,5143,198,143,5484,240,6620,4085,760,405,5250,435,185,5870,750,31171,6058,3952,3396,14487,5085,4641,25773,3490,1310189000,246176000,149003000,149955000,569389000,217990000,214087000,1066090000,208231000
New Hampshire,Retail Trade,2011,20421,10010,4310,2303,16623,1880,548,19051,1370,30625,10030,4395,2520,16945,2580,1510,21035,9590,397779,12789,25015,22717,64695,48268,26722,160646,158206,11284313000,505677000,702444000,808941000,2044040000,1859608000,1305420000,5456286000,3734068000
New Hampshire,Total,2011,30554,17156,5386,3250,25792,2779,761,29332,1222,37031,17182,5445,3376,26003,3431,1872,31306,5725,554001,29519,35414,42748,107681,97662,77321,282664,271337,24369871000,1276337000,1250365000,1617425000,4144127000,4089723000,3273923000,11507773000,12862098000
New Hampshire,Transportation and Warehousing,2011,3653,2000,625,364,2989,250,115,3354,299,4095,2000,625,370,2995,280,145,3420,675,57536,2643,3010,3527,10251,5594,3492,27222,12509,2083984000,122649000,122312000,140760000,400023000,204777000,120992000,991246000,562484000
New Hampshire,Utilities,2011,215,73,15,15,103,15,33,151,64,570,75,15,15,105,15,125,245,325,11022,97,69,90,343,0,1144,2272,8137,994286000,7244000,2304000,7484000,23249000,0,82791000,160294000,750338000
New Hampshire,Wholesale Trade,2011,8269,3770,1135,773,5678,1006,510,7194,1075,9105,3770,1140,790,5700,1065,660,7425,1680,111981,5867,5690,7794,22358,24523,16913,71222,31984,7554546000,435832000,354272000,528514000,1438191000,1496328000,1203847000,4568688000,2585969000
New Jersey,Accommodation and Food Services,2011,84596,45322,15505,11936,72763,10091,882,83736,860,98030,45355,15545,12055,72955,10840,2360,86155,11875,1384184,76736,101740,161658,339676,371345,110528,823481,558968,27490173000,2080992000,1606088000,2476544000,6166375000,6161459000,1939838000,14273081000,13119415000
New Jersey,Administrative and Support and Waste Management and Remediation Services,2011,59961,39360,7698,4875,51933,4569,1510,58012,1949,66355,39380,7715,4915,52010,4740,1995,58745,7610,1327972,51032,50012,64782,167540,175504,188663,535337,768246,48060978000,2753912000,2006122000,2793697000,7576867000,6643851000,6448094000,20953752000,26197798000
New Jersey,"Agriculture, Forestry, Fishing and Hunting",2011,1105,860,110,75,1045,40,10,1095,10,1105,860,110,75,1045,40,10,1095,10,5591,902,644,783,2239,1072,0,3755,0,177131000,39563000,17484000,23816000,87516000,27307000,0,135168000,0
New Jersey,"Arts, Entertainment, and Recreation",2011,16071,9620,1877,1795,13292,2060,480,15832,239,17130,9635,1895,1810,13340,2075,630,16045,1085,257978,10647,11571,23291,47806,82616,69492,206152,47887,8079442000,709290000,334785000,478548000,1563084000,1882174000,3569438000,7140998000,731576000
New Jersey,Construction,2011,100956,73699,13635,7211,94545,5265,622,100432,524,101475,73700,13640,7220,94560,5305,700,100565,910,638650,110223,87985,93797,294860,188761,76418,571240,53119,40311200000,5040365000,4361100000,5419320000,14820785000,12976957000,6188655000,34641985000,4385412000
New Jersey,Educational Services,2011,15663,7047,2780,2055,11882,2765,635,15282,381,16960,7060,2790,2080,11930,2915,875,15720,1240,469355,10924,18212,27474,57093,114469,83376,263850,189964,17174885000,344228000,415813000,583758000,1341389000,3523877000,3370884000,8553183000,7623382000
New Jersey,Finance and Insurance,2011,31482,19704,4393,1920,26017,2249,1115,29381,2101,60425,19780,4515,2155,26450,3680,3595,33725,26700,934313,32264,27629,23196,86448,71554,80482,242003,686901,90825882000,2030004000,1839565000,2080454000,6017229000,6223045000,5809590000,18378377000,71846063000
New Jersey,Health Care and Social Assistance,2011,110972,54050,26013,14533,94596,11249,3204,109049,1923,132120,54160,26260,15175,95595,14270,9565,119430,12690,2673761,108926,169477,191087,472889,409299,468011,1354067,1283390,121707999000,5108883000,7496589000,9596612000,22223080000,18863254000,16430390000,57642258000,62243061000
New Jersey,Information,2011,10502,5620,1254,945,7819,1157,465,9441,1061,18795,5620,1255,955,7830,1255,595,9680,9115,441982,7906,7539,11687,28799,32664,35289,104263,312963,38219400000,520195000,446512000,766927000,1773930000,2633000000,2865727000,7628895000,28243690000
New Jersey,Management of Companies and Enterprises,2011,4852,350,160,105,615,740,1073,2428,2424,6790,350,160,105,615,750,1170,2535,4255,637295,513,25,780,2051,11915,39215,53185,584044,77959970000,73915000,275898000,39595000,389408000,1052225000,3588835000,5030870000,72918646000
New Jersey,Manufacturing,2011,38298,14949,6388,5542,26879,6968,2290,36137,2161,39480,14955,6395,5595,26945,7125,2545,36615,2865,1100888,23459,37893,66940,137337,251865,236735,675211,352918,68148840000,1267847000,1643682000,3099328000,6345212000,12825781000,13141812000,34826000000,27963568000
New Jersey,"Mining, Quarrying, and Oil and Gas Extraction",2011,355,150,45,30,225,56,27,308,47,425,150,45,30,225,70,40,335,90,4400,87,58,0,581,1034,50,3290,1189,310949000,10810000,11429000,10924000,45413000,66904000,2704000,268363000,71964000
New Jersey,Other,2011,282,276,5,0,281,1,0,282,0,282,276,5,0,281,1,0,282,0,0,0,0,0,0,0,0,0,0,6273000,5417000,463000,0,5880000,0,0,6273000,0
New Jersey,Other Services (except Public Administration),2011,110172,74330,19325,9305,102960,5698,838,109496,676,114280,74380,19435,9545,103360,6310,1525,111195,3085,721528,136400,124387,122403,385745,197595,62484,658330,51638,20655166000,3365275000,3141982000,3343414000,9877300000,5550153000,2178296000,18064805000,2080743000
New Jersey,"Professional, Scientific, and Technical Services",2011,140153,99888,17163,9946,126997,8077,2393,137467,2686,147650,99925,17210,10130,127265,8895,3020,139180,8470,1583625,149807,109726,129938,393714,277380,217229,894310,645581,126237645000,8419525000,6411788000,8503945000,23384090000,21500721000,17527507000,62771105000,61180952000
New Jersey,Real Estate and Rental and Leasing,2011,35109,24940,4842,2392,32174,1731,482,34387,722,42190,25020,5005,2675,32700,2225,1025,35950,6240,259548,40002,30949,30444,103144,54933,21208,181985,60632,13155180000,1569878000,1274665000,1254888000,4118998000,2759547000,1123965000,8239617000,4416761000
New Jersey,Retail Trade,2011,114194,74712,19029,9697,103438,6454,1639,111531,2663,160265,75030,19455,10280,104765,8445,4100,117310,42955,2122433,110547,111254,107545,336799,202545,105998,667979,1188765,60013197000,3449422000,3145296000,3415915000,10062892000,8408057000,5037212000,23945757000,31051983000
New Jersey,Total,2011,191736,119872,30879,18362,169113,15675,3734,188522,3214,226878,120069,31190,18944,170203,18154,7873,196230,30648,3377848,202287,201329,244028,647644,581170,460202,1689016,1688832,183507386000,8389414000,7943392000,10393001000,26725807000,26993255000,23273392000,76992454000,106514932000
New Jersey,Transportation and Warehousing,2011,30662,17654,4047,2600,24301,3167,1420,28888,1774,34280,17655,4065,2620,24340,3420,1890,29650,4630,709223,24735,25334,32150,84217,115069,121575,329066,360018,31268367000,1037507000,1023572000,1319548000,3421911000,4375314000,4857389000,12950088000,17341012000
New Jersey,Utilities,2011,527,205,55,20,280,55,27,362,165,2015,205,60,20,285,75,60,420,1595,74038,68,207,142,705,1693,1253,5014,61779,9434422000,27767000,18395000,17716000,80228000,134460000,103956000,430947000,6624910000
New Jersey,Wholesale Trade,2011,67082,35710,10311,7185,53206,7815,2730,63751,3331,73210,35745,10370,7280,53395,8330,3665,65390,7820,1248048,58456,63975,89476,222579,268118,205474,708132,517998,103201791000,3607157000,3898891000,6019359000,13622475000,16948682000,13936432000,45171621000,56798051000
New Mexico,Accommodation and Food Services,2011,15037,4965,2790,2980,10735,3168,555,14458,579,20380,4965,2800,3030,10795,3840,1835,16470,3910,391433,7818,18940,40907,67848,117595,63334,257768,131763,5823038000,184999000,220873000,538689000,950000000,1749473000,978303000,3815891000,1921819000
New Mexico,Administrative and Support and Waste Management and Remediation Services,2011,8416,4715,1320,710,6745,665,231,7641,775,9290,4720,1320,725,6765,730,320,7815,1475,168306,7270,7990,8037,25310,20330,17653,71136,85948,5004336000,220913000,212023000,228212000,700445000,601757000,489035000,2096509000,2501090000
New Mexico,"Agriculture, Forestry, Fishing and Hunting",2011,481,345,85,36,466,5,5,476,5,495,345,90,45,480,5,5,490,5,1899,271,256,0,1106,0,0,1566,0,60542000,17478000,11728000,2961000,46404000,0,0,57492000,0
New Mexico,"Arts, Entertainment, and Recreation",2011,3184,1915,392,325,2632,360,80,3072,112,3350,1915,410,325,2650,415,115,3180,170,68240,2205,1881,2154,8676,12507,8922,34262,28061,1479836000,81944000,48526000,55164000,210641000,219137000,233047000,760513000,602277000
New Mexico,Construction,2011,22289,13937,3840,2185,19962,1768,339,22069,220,22450,13940,3840,2190,19970,1790,400,22160,290,196993,20420,24129,28819,76723,63788,36909,185379,4853,7857470000,669682000,752035000,1041837000,2477489000,2676573000,1776594000,7257310000,283047000
New Mexico,Educational Services,2011,2869,1435,425,370,2230,400,130,2760,109,2975,1435,425,370,2230,405,155,2790,185,47665,543,2496,4783,9815,14776,11068,39035,3154,1360058000,68139000,59707000,112828000,244266000,410606000,398153000,1155531000,126899000
New Mexico,Finance and Insurance,2011,7609,4770,990,360,6120,431,262,6813,796,13670,4790,1135,435,6360,1055,1440,8855,4815,103118,7694,5670,3881,18072,14127,19922,54013,35362,5277217000,294969000,218816000,151287000,698103000,667761000,919030000,2490500000,2412506000
New Mexico,Health Care and Social Assistance,2011,20253,9640,4005,2750,16395,2220,796,19411,842,24455,9640,4020,2820,16480,2800,2045,21325,3130,552356,14082,26588,35112,78193,86294,107478,280258,258140,22560256000,747617000,1017319000,1407912000,3211880000,3041975000,3059671000,9493412000,12384347000
New Mexico,Information,2011,2369,1200,270,185,1655,213,105,1973,396,3750,1200,275,190,1665,270,260,2195,1555,58534,1302,880,2072,5671,5020,3745,14400,35012,2523861000,57158000,51133000,65617000,195054000,229760000,159664000,655562000,1817572000
New Mexico,Management of Companies and Enterprises,2011,810,40,20,35,95,160,220,475,335,1120,40,20,35,95,170,235,500,620,32960,50,0,13,256,1816,5360,7580,25380,1958564000,3791000,0,5924000,14979000,86543000,367748000,474004000,1484560000
New Mexico,Manufacturing,2011,6799,3270,1245,875,5390,722,262,6374,425,6960,3270,1245,885,5400,750,290,6440,520,97770,3838,5590,8032,21123,14619,8466,56318,29684,4922588000,160936000,189950000,308617000,759533000,611558000,354305000,2195449000,2038589000
New Mexico,"Mining, Quarrying, and Oil and Gas Extraction",2011,3157,1375,400,354,2129,530,135,2794,363,3565,1375,400,360,2135,540,175,2850,715,77482,1495,2544,4507,9112,16920,14157,40702,35784,5699122000,131287000,134173000,272945000,543945000,1084521000,944931000,2589667000,3039088000
New Mexico,Other,2011,57,54,3,0,57,0,0,57,0,57,54,3,0,57,0,0,57,0,62,47,0,0,62,0,0,62,0,1190000,1035000,155000,0,1190000,0,0,1190000,0
New Mexico,Other Services (except Public Administration),2011,19160,11580,3910,1940,17430,1186,202,18818,342,20325,11580,3915,1975,17470,1455,525,19450,875,132422,19394,24656,24202,71653,38184,6271,122102,5135,3294003000,519576000,590964000,582810000,1715752000,941859000,196831000,2951313000,195387000
New Mexico,"Professional, Scientific, and Technical Services",2011,21741,14690,2940,1696,19326,1061,477,20864,877,23535,14695,2950,1740,19385,1225,545,21155,2380,187927,21560,18312,20632,62956,31457,22623,121647,65384,11226084000,972485000,839259000,1061587000,2935701000,1877510000,1398279000,6402017000,4960008000
New Mexico,Real Estate and Rental and Leasing,2011,9047,6822,995,350,8167,365,138,8670,377,11505,6910,1040,390,8340,635,875,9850,1655,45786,8870,6169,3894,21112,7938,156,33233,8755,1762895000,298605000,185793000,120817000,624806000,338838000,36398000,1102317000,577329000
New Mexico,Retail Trade,2011,21574,11122,4085,2299,17506,1911,602,20019,1555,33595,11175,4185,2435,17795,2970,1700,22465,11130,391407,17561,25081,27656,75970,55699,28208,171646,154075,9536461000,481802000,610286000,743464000,1866141000,1700230000,963147000,4793898000,4300514000
New Mexico,Total,2011,35124,19794,5941,3741,29476,3203,892,33571,1553,43860,19839,6031,3878,29748,4185,2363,36296,7564,597568,33867,39089,49646,122602,114184,90720,327506,270062,22037682000,1084325000,1160594000,1560271000,3805190000,3763345000,3216523000,10785058000,11252624000
New Mexico,Transportation and Warehousing,2011,5600,3240,710,420,4370,475,209,5054,546,6660,3240,710,425,4375,510,285,5170,1490,74135,2448,3663,4561,13250,13666,7714,37584,20760,2872591000,140311000,121800000,179849000,460010000,442469000,312335000,1313399000,1061101000
New Mexico,Utilities,2011,767,465,80,50,595,75,10,680,87,1205,465,80,50,595,135,20,750,455,22469,881,512,306,1957,0,0,5933,169,1652657000,20891000,13901000,24067000,68585000,186352000,0,282108000,9223000
New Mexico,Wholesale Trade,2011,8233,3220,1275,910,5405,1040,455,6900,1333,9730,3225,1280,965,5470,1225,590,7285,2445,93814,3680,6776,7928,21818,18366,7322,56150,33292,4645110000,215260000,287614000,378948000,968394000,777148000,334743000,2397149000,2113791000
New York,Accommodation and Food Services,2011,214277,113586,40030,30106,183722,26480,2661,212863,1414,242765,113620,40080,30335,184035,28750,7410,220195,22570,3120906,194816,262405,408549,866800,977739,410083,2256815,824965,68682660000,4813515000,4196843000,6929133000,15945460000,20057503000,9623025000,45641630000,22918626000
New York,Administrative and Support and Waste Management and Remediation Services,2011,116418,78965,13852,8894,101711,8950,3110,113771,2647,126480,78995,13890,9015,101900,9370,4000,115270,11210,2407741,103844,85118,116035,313179,354619,454388,1131130,1262595,109351381000,5653276000,3775964000,5303661000,14708564000,14976624000,15845763000,45919715000,63242063000
New York,"Agriculture, Forestry, Fishing and Hunting",2011,2830,2195,325,170,2690,100,20,2810,20,2840,2195,325,170,2690,110,20,2820,20,15215,3156,1960,1797,7451,3489,0,14018,479,492138000,96952000,50472000,70960000,224420000,118316000,0,451586000,16659000
New York,"Arts, Entertainment, and Recreation",2011,53812,36935,6222,4366,47523,4670,1063,53256,556,57185,36965,6235,4405,47605,4920,1440,53965,3220,764607,36789,39394,58110,142562,185771,164776,500378,251636,34771825000,5274804000,2005749000,1861077000,9162773000,6117282000,5320724000,21054064000,13285802000
New York,Construction,2011,222293,162240,29010,17152,208402,11908,1401,221711,582,223605,162240,29045,17180,208465,12075,1630,222170,1435,1455960,231913,189303,228845,651041,437584,216133,1313695,121190,90515165000,9935535000,8642688000,12255710000,30834475000,29505026000,17038361000,77946455000,10729538000
New York,Educational Services,2011,33712,16040,4552,3880,24472,6463,1715,32650,1062,36720,16040,4625,3960,24625,6770,2695,34090,2630,1940945,23560,29864,52853,107620,262413,279899,650970,1253665,75449135000,927051000,787580000,1404435000,3133270000,9006871000,10963191000,23119150000,51153846000
New York,Finance and Insurance,2011,80844,51195,12095,5683,68973,6062,2610,77645,3199,139945,51315,12415,6390,70120,8870,8545,87535,52410,2604971,80386,75458,71610,235477,210021,286766,745350,1834702,493220106000,7230748000,7431881000,10284788000,24916553000,38514901000,61031324000,126117396000,365061015000
New York,Health Care and Social Assistance,2011,228155,125978,44735,24610,195323,19029,8387,222739,5416,282175,126185,45150,25545,196880,25325,25025,247230,34945,7082146,224486,291074,326107,852245,734304,1361993,2953948,4109218,315410065000,11699239000,13024528000,15230000000,40046136000,32224887000,46033935000,118368740000,196586416000
New York,Information,2011,37385,22478,4585,3305,30368,3704,1263,35335,2050,54915,22485,4595,3395,30475,4160,1645,36280,18635,1283414,28149,28133,42470,102153,126970,122653,359774,915443,115363219000,2387213000,1604299000,2426389000,6516370000,8412645000,10095562000,25383565000,89615928000
New York,Management of Companies and Enterprises,2011,9304,1060,307,300,1667,1531,2470,5668,3636,13610,1060,320,325,1705,1565,2695,5965,7645,856746,1215,1480,169,4663,22060,89822,116595,740201,109917965000,163825000,248180000,16861000,761465000,2054283000,8359338000,11185070000,98653477000
New York,Manufacturing,2011,80891,36255,13921,11026,61202,13260,3587,78049,2842,83265,36260,13935,11090,61285,13640,4125,79050,4215,2072808,57620,86748,142323,300927,500511,418863,1285168,643617,105450866000,2457228000,3177329000,5640475000,11583575000,22103882000,20220141000,56783037000,42550597000
New York,"Mining, Quarrying, and Oil and Gas Extraction",2011,1295,660,185,130,975,146,89,1210,85,1585,660,185,130,975,190,145,1310,275,20956,726,1041,1371,3452,2509,4609,14925,154,1402181000,59061000,51548000,66762000,193714000,247404000,279510000,979947000,8900000
New York,Other,2011,912,889,14,9,912,0,0,912,0,912,889,14,9,912,0,0,912,0,896,0,81,0,896,0,0,896,0,22826000,20042000,1608000,0,22826000,0,0,22826000,0
New York,Other Services (except Public Administration),2011,257755,179840,42359,20658,242857,12054,1807,256718,1037,271215,180015,42615,21030,243660,13995,4090,261745,9470,1766916,308768,276118,268687,869878,417545,221157,1514933,196101,58332000000,8113105000,7695315000,8166457000,23991678000,14375743000,9981805000,48457205000,7636650000
New York,"Professional, Scientific, and Technical Services",2011,279762,204867,33862,18830,257559,14670,3790,276019,3743,295215,204955,33985,19155,258095,16270,5550,279915,15300,2855445,276700,218315,247446,764027,505597,383952,1667690,1139024,240000596000,17512150000,12972873000,16489801000,46993206000,38459068000,33403895000,119434316000,118065272000
New York,Real Estate and Rental and Leasing,2011,143575,110993,16850,8096,135939,5406,1209,142554,1021,158530,111120,17170,8825,137115,7600,4115,148830,9700,809196,121795,109458,105074,385413,179599,98684,668551,128003,42979210000,6291827000,4597626000,4925227000,15837553000,9723738000,6352424000,32119721000,9925928000
New York,Retail Trade,2011,290651,198395,46861,22907,268163,16437,2726,287326,3325,385180,198705,47495,24390,270590,21885,9455,301930,83250,4241807,305726,288994,284345,895841,560958,228070,1735580,2251958,117569121000,9090287000,8389895000,8521444000,26515996000,19738068000,8513447000,55710855000,58895771000
New York,Total,2011,446405,294765,67775,39555,402095,32877,7147,442119,4286,521537,295077,68361,40897,404335,39273,18365,461973,59564,7369731,478568,442025,526555,1447148,1236108,1077295,3760551,3609180,435008622000,20360737000,17633789000,22704998000,60699524000,60918133000,59889896000,181507553000,253501069000
New York,Transportation and Warehousing,2011,54605,34252,7067,4683,46002,4908,1793,52703,1902,61515,34280,7080,4750,46110,5480,2745,54335,7180,1118974,47339,45119,58494,153595,173340,143067,496218,609730,47488860000,1723715000,1678082000,2164320000,5660398000,6987508000,5602767000,18941978000,27958137000
New York,Utilities,2011,967,390,125,83,598,101,57,756,211,3030,390,125,85,600,150,290,1040,1990,205327,243,610,844,2229,3201,4521,11236,183821,18896448000,40362000,46560000,59516000,172096000,292396000,499610000,1102744000,16897662000
New York,Wholesale Trade,2011,150546,93334,22310,13892,129536,13575,3919,147030,3516,163350,93455,22465,14265,130185,15240,6205,151630,11720,1758814,147316,143263,178545,481489,457622,323958,1271041,427825,113581375000,7737480000,7478674000,10327479000,25543159000,28507578000,21955433000,76564989000,33117432000
North Carolina,Accommodation and Food Services,2011,68631,24996,13288,14395,52679,13147,1428,67254,1377,96120,25035,13355,14645,53035,15480,5495,74010,22110,1674219,38233,89232,196108,325491,458527,198846,985943,693273,23870325000,1059171000,1141230000,2498111000,4701347000,6294458000,2725690000,13768912000,10190810000
North Carolina,Administrative and Support and Waste Management and Remediation Services,2011,50183,30305,8100,4360,42765,4079,1338,48182,2001,57570,30330,8125,4405,42860,4575,1900,49335,8235,1237395,47420,52847,57203,160825,147688,160078,475403,730330,36709186000,1507916000,1492602000,1762711000,4808694000,4470486000,4546874000,14061501000,21921275000
North Carolina,"Agriculture, Forestry, Fishing and Hunting",2011,3763,2365,730,450,3545,115,45,3705,58,3785,2365,730,460,3555,115,55,3725,60,23408,4012,4607,5648,14949,2526,3337,21551,1181,778863000,125682000,143893000,202450000,480978000,79070000,108061000,702000000,39747000
North Carolina,"Arts, Entertainment, and Recreation",2011,16285,9390,2425,1784,13599,1956,427,15982,303,17175,9395,2430,1785,13610,2110,580,16300,875,270006,12189,15208,24441,53880,74046,57653,189330,69545,7501652000,516047000,388399000,501629000,1407217000,1469165000,1694015000,4676714000,2559189000
North Carolina,Construction,2011,105955,71724,16585,9341,97650,6692,832,105174,781,107720,71725,16595,9385,97705,6895,1110,105710,2010,844555,115598,108122,125043,348970,240119,95639,691180,144894,33933135000,3527250000,3316738000,4379124000,11228290000,9662779000,4435253000,25630875000,7970896000
North Carolina,Educational Services,2011,11609,6125,1720,1380,9225,1565,496,11286,323,12345,6125,1720,1385,9230,1625,675,11530,815,441858,7696,10995,18759,39264,64194,83991,189697,241267,16036604000,269680000,202315000,360598000,842745000,1629095000,2575361000,5095248000,10510625000
North Carolina,Finance and Insurance,2011,31536,21280,4173,1727,27180,1610,824,29614,1922,65855,21355,4370,2180,27905,3940,4460,36305,29550,805199,30584,22772,20851,80734,50373,59515,195347,557023,58116621000,1550022000,1196937000,1328751000,4162008000,2984492000,3467669000,10900078000,45537016000
North Carolina,Health Care and Social Assistance,2011,87626,37400,20443,13455,71298,11377,2963,85638,1988,113660,37485,20585,13860,71930,15050,9365,96345,17315,2683970,64884,135390,177553,381523,429741,431054,1257064,1386716,108115061000,3144285000,5548003000,6897685000,15621388000,14834701000,14733631000,45320774000,62336194000
North Carolina,Information,2011,8828,4650,1090,750,6490,845,443,7778,1050,17190,4650,1105,770,6525,1140,910,8575,8615,340484,5781,6587,9061,23550,27313,31141,87093,227791,22932628000,276711000,248670000,383074000,939481000,1469051000,2222195000,4870307000,17935763000
North Carolina,Management of Companies and Enterprises,2011,5061,260,145,155,560,995,1372,2927,2134,7475,260,145,155,560,1015,1490,3065,4410,391080,460,586,32,1670,11005,44912,57760,330561,35130815000,35580000,41049000,34455000,111084000,633510000,2640983000,3393520000,31727551000
North Carolina,Manufacturing,2011,40342,14895,6350,5142,26387,7220,2716,36323,4019,43975,14900,6350,5160,26410,7475,3365,37250,6725,1867150,21357,36891,61992,130318,267824,267901,713626,1070352,82931128000,920416000,1221175000,2157612000,4553912000,10237771000,10561538000,27352560000,51431503000
North Carolina,"Mining, Quarrying, and Oil and Gas Extraction",2011,616,290,70,80,440,70,38,548,68,1040,290,70,80,440,95,75,610,430,13167,118,253,748,1471,2001,1313,5766,6987,667135000,16176000,15273000,28608000,70429000,75979000,69220000,250831000,393978000
North Carolina,Other,2011,359,341,11,7,359,0,0,359,0,359,341,11,7,359,0,0,359,0,0,0,81,97,0,0,0,0,0,6334000,5637000,320000,377000,6334000,0,0,6334000,0
North Carolina,Other Services (except Public Administration),2011,103220,66168,21126,8816,96110,5630,745,102485,735,110935,66220,21300,9165,96685,7430,2400,106515,4420,722623,121365,136770,113114,373780,195565,61599,644740,59473,17197000000,2715539000,2993937000,2701526000,8427470000,4539537000,1665846000,14914856000,1806239000
North Carolina,"Professional, Scientific, and Technical Services",2011,103841,75105,12498,7233,94836,4925,1598,101359,2482,113120,75130,12565,7515,95210,6055,2900,104165,8955,916494,99621,80101,93664,286466,155627,96395,549043,351702,61191715000,5111809000,3625198000,4589717000,13604685000,9447869000,7396276000,30963425000,29811268000
North Carolina,Real Estate and Rental and Leasing,2011,36252,28592,3275,1562,33429,1363,651,35443,809,48490,28680,3420,1790,33890,2515,3050,39455,9035,218505,38670,19726,19379,79623,39534,37182,155945,49211,8452849000,1298857000,683025000,635051000,2632188000,1576696000,1483355000,5759169000,2606377000
North Carolina,Retail Trade,2011,101398,59160,20211,10221,89592,7483,1617,98692,2706,170145,59410,20815,11765,91990,13595,7100,112685,57460,1998058,103809,128871,115181,359224,244724,112704,749938,1136034,47195089000,2538579000,3021549000,3391289000,8979120000,7883087000,3794356000,20942483000,25367528000
North Carolina,Total,2011,165895,98505,28363,17410,144278,14644,3499,162421,3474,215113,98690,28759,18366,145815,19525,10133,175473,39640,3284592,164438,186203,231742,582383,534645,414224,1531252,1753340,131631342000,5542581000,5633097000,7198438000,18374116000,17793239000,15627351000,51794706000,79836636000
North Carolina,Transportation and Warehousing,2011,22798,13805,2851,1816,18472,1740,891,21103,1695,26870,13820,2860,1915,18595,1885,1230,21710,5160,468609,18939,17654,22308,60692,53463,45798,169505,244844,17718122000,661922000,552697000,701196000,1952127000,1876969000,1696753000,5788870000,10033601000
North Carolina,Utilities,2011,755,290,100,60,450,120,80,650,105,2350,290,100,60,450,185,220,855,1495,63231,192,675,720,1881,6119,8766,16803,31064,5784076000,5809000,19615000,25904000,70638000,378295000,618894000,1096652000,2973308000
North Carolina,Wholesale Trade,2011,47219,24208,6944,4939,36091,5202,2544,43837,3382,57950,24280,7100,5315,36695,6445,4285,47425,10525,815366,36316,42591,60674,145772,148890,129149,440220,319618,51562578000,1913562000,2046678000,2911642000,6941540000,7670233000,7118287000,22145100000,28291424000
North Dakota,Accommodation and Food Services,2011,7958,2815,1520,1450,5785,1706,289,7780,178,9205,2825,1530,1480,5835,1920,700,8455,750,159296,4024,9744,19214,34464,61121,33799,129728,27451,2218768000,110968000,95429000,217615000,426058000,809272000,540546000,1778664000,433915000
North Dakota,Administrative and Support and Waste Management and Remediation Services,2011,4211,2455,680,365,3500,292,95,3887,324,4750,2455,680,380,3515,330,180,4025,725,53309,3238,3386,3517,11636,8461,10000,34676,18276,1626797000,131182000,125685000,95580000,383715000,235329000,282000000,983955000,527375000
North Dakota,"Agriculture, Forestry, Fishing and Hunting",2011,570,435,75,35,545,15,0,560,10,575,435,75,35,545,15,0,560,15,2057,464,382,0,1171,0,0,1515,0,91177000,28072000,15848000,0,59787000,0,0,71372000,0
North Dakota,"Arts, Entertainment, and Recreation",2011,1951,1205,250,240,1695,179,50,1924,27,2125,1205,250,245,1700,250,145,2095,30,21423,715,1092,1938,5234,5834,6436,17985,0,337019000,55092000,13775000,30292000,117786000,79931000,78403000,282154000,0
North Dakota,Construction,2011,13308,9020,2105,1149,12274,825,109,13208,100,13435,9020,2105,1155,12280,860,145,13285,150,89205,11516,13104,14349,41789,29342,5764,81625,4083,5089120000,627598000,581392000,727489000,1972987000,1829812000,503439000,4614940000,407067000
North Dakota,Educational Services,2011,700,260,95,90,445,150,50,645,55,725,260,95,95,450,155,50,655,70,20128,214,588,1116,2071,6099,5631,13875,2186,449353000,9336000,6110000,12514000,37364000,121882000,139926000,298229000,52764000
North Dakota,Finance and Insurance,2011,5480,3750,465,360,4575,358,124,5057,423,8595,3755,500,525,4780,1130,890,6800,1795,78959,5630,2579,4517,13264,11073,10550,37314,37741,3761106000,222703000,107339000,191609000,541187000,518986000,487264000,1696492000,1927796000
North Dakota,Health Care and Social Assistance,2011,7550,3310,1455,1090,5855,881,501,7237,313,9015,3310,1470,1130,5910,1090,1045,8045,970,278356,5014,8970,12499,27396,34021,56631,125835,131405,11380890000,229632000,345688000,384716000,1015205000,957108000,1551551000,3775608000,6063461000
North Dakota,Information,2011,1108,315,185,178,678,175,67,920,188,1650,315,185,205,705,275,75,1055,595,31487,419,805,1846,3463,5832,3204,15195,12507,1720209000,13986000,22736000,58807000,121403000,319622000,162081000,650156000,650369000
North Dakota,Management of Companies and Enterprises,2011,471,25,20,25,70,110,115,295,176,510,25,20,25,70,110,125,305,205,21935,0,0,0,258,538,2171,3160,18718,1154105000,1460000,0,993000,28000000,31320000,135514000,201795000,948454000
North Dakota,Manufacturing,2011,3424,1270,580,495,2345,550,269,3164,260,3675,1270,580,495,2345,595,360,3300,375,82183,1226,1985,3679,9880,11432,11792,44447,15213,3597159000,49371000,87596000,145206000,341233000,417061000,478556000,1732380000,769124000
North Dakota,"Mining, Quarrying, and Oil and Gas Extraction",2011,1689,760,175,135,1070,255,80,1405,284,1930,760,175,135,1070,255,100,1425,505,70677,342,988,1636,3609,10146,8205,22040,46074,6502934000,161305000,85969000,119248000,375640000,990995000,591997000,2002925000,4368428000
North Dakota,Other,2011,45,41,2,2,45,0,0,45,0,45,41,2,2,45,0,0,45,0,0,0,0,0,0,0,0,0,0,1221000,724000,0,0,1221000,0,0,1221000,0
North Dakota,Other Services (except Public Administration),2011,11597,7542,2250,993,10785,591,50,11426,171,12060,7545,2270,1020,10835,805,85,11725,335,62386,11966,13082,11652,38783,16364,231,58309,1786,1426082000,287874000,324221000,263265000,896216000,347268000,5651000,1300060000,69428000
North Dakota,"Professional, Scientific, and Technical Services",2011,7492,4975,1045,595,6615,427,166,7208,284,7925,4975,1045,610,6630,555,295,7480,445,53716,5995,4972,6864,20457,11567,6371,41671,6566,2818793000,317267000,265402000,350537000,958264000,642434000,458334000,2221044000,309221000
North Dakota,Real Estate and Rental and Leasing,2011,3782,2790,355,190,3335,178,93,3606,176,4210,2790,355,205,3350,260,270,3880,330,18926,3520,1623,1972,7644,3284,1423,15174,1994,742815000,121539000,69083000,64272000,298455000,130872000,41029000,539323000,134837000
North Dakota,Retail Trade,2011,11897,4924,2682,1690,9296,1346,430,11072,825,15765,4925,2745,1825,9495,1875,1225,12595,3170,210093,7477,15474,19901,45569,35594,27407,117339,67325,5456573000,243926000,395862000,524581000,1227621000,1199839000,843199000,3496603000,1366428000
North Dakota,Total,2011,18612,10473,3098,2014,15585,1783,478,17846,766,22370,10482,3137,2146,15765,2482,1356,19603,2767,306064,16868,20107,26818,63793,64673,53848,182314,123750,12281089000,633401000,634749000,861829000,2129979000,2351592000,1964151000,6445722000,5835367000
North Dakota,Transportation and Warehousing,2011,6557,4505,739,410,5654,382,155,6191,366,7210,4510,740,410,5660,425,230,6315,895,65970,4208,4579,4341,14977,11414,5149,36611,22293,3169860000,297153000,208628000,202530000,745959000,554909000,163760000,1695129000,1255759000
North Dakota,Utilities,2011,204,45,5,15,65,75,10,150,54,590,45,5,20,70,115,40,225,365,3220,0,0,104,144,2925,0,4847,0,257839000,3761000,0,4896000,10985000,208870000,0,361720000,0
North Dakota,Wholesale Trade,2011,5433,1778,825,633,3236,963,449,4648,785,7675,1780,850,725,3355,1390,820,5565,2110,95722,2614,4514,6694,15125,24813,10218,55152,30133,5227396000,119145000,217523000,368070000,796569000,1322128000,647569000,3032148000,1852270000
Ohio,Accommodation and Food Services,2011,83372,31574,16230,16004,63808,16155,1910,81873,1499,115970,31610,16300,16285,64195,19380,8795,92370,23600,2089303,51263,108738,216730,377246,582197,286983,1248497,817454,27803352000,1110054000,1182921000,2482045000,4795065000,7526504000,3551569000,15886035000,11571114000
Ohio,Administrative and Support and Waste Management and Remediation Services,2011,56229,33290,8445,5442,47177,4900,1802,53879,2350,65755,33300,8450,5510,47260,5315,2485,55060,10695,1730235,42393,54975,71669,171767,188612,240485,607346,1100159,47922215000,1812594000,1685954000,2294889000,5921493000,5740585000,5979223000,17736126000,29509876000
Ohio,"Agriculture, Forestry, Fishing and Hunting",2011,1250,910,180,55,1145,55,20,1220,30,1265,910,180,55,1145,55,20,1220,45,5597,1348,1106,148,3106,1234,0,5134,482,157385000,35745000,30449000,10403000,85677000,37809000,0,140246000,17841000
Ohio,"Arts, Entertainment, and Recreation",2011,17896,10120,2945,1935,15000,2156,426,17582,314,19105,10155,2960,1975,15090,2310,590,17990,1115,284007,13815,18623,23937,59124,76602,54841,200291,75396,8999318000,578641000,439981000,429561000,1516824000,1628663000,1700688000,6231161000,2474435000
Ohio,Construction,2011,98260,66185,15247,9183,90615,6144,856,97615,645,99595,66185,15255,9210,90650,6385,1175,98210,1385,785325,101577,99196,122915,324465,221017,111108,662886,112428,41496475000,4322215000,4115510000,5818970000,14256695000,12060069000,6801805000,33440411000,7472091000
Ohio,Educational Services,2011,12946,5310,1995,1727,9032,2781,638,12451,495,14770,5320,2010,1790,9120,3105,955,13180,1590,591487,8362,13042,23770,45528,115195,89440,254876,327686,15337816000,281303000,228987000,448424000,959795000,2969303000,2752983000,6784945000,8209434000
Ohio,Finance and Insurance,2011,42674,28060,6188,2680,36928,2657,893,40478,2196,87295,28135,6490,3310,37935,5900,4465,48300,38995,1194456,48925,38232,33447,121703,92895,81437,303522,876022,76544104000,1906436000,1826308000,1855448000,5636977000,5225752000,4190204000,15176541000,61157743000
Ohio,Health Care and Social Assistance,2011,103563,41230,24974,15692,81896,13769,5035,100700,2863,140735,41375,25370,16650,83395,19330,15245,117970,22765,3981137,83002,164631,207840,457875,552333,743812,1757052,2211891,161756051000,3604134000,6442331000,8664022000,18721344000,20695076000,20872301000,60428697000,101092852000
Ohio,Information,2011,8827,3710,1335,1023,6068,1270,366,7704,1123,19180,3715,1345,1065,6125,1420,955,8500,10680,430189,5113,7853,12629,27074,45142,31777,109660,306430,26261439000,267925000,299856000,604037000,1222433000,2290486000,1462102000,5271090000,19707818000
Ohio,Management of Companies and Enterprises,2011,6660,345,130,280,755,1125,1994,3874,2786,10720,350,130,280,760,1130,2105,3995,6725,716940,533,440,1790,2823,12140,57060,72025,644910,63749405000,55652000,53477000,250535000,364242000,680885000,4466110000,5511340000,58238029000
Ohio,Manufacturing,2011,67609,21414,11875,10104,43393,13992,4980,62365,5244,72630,21445,11880,10210,43535,14655,6145,64335,8295,2966850,35560,73188,129775,249605,522560,551815,1396020,1435661,154537275000,1471948000,2701437000,5348445000,9802674000,23479375000,26528550000,63164769000,83593028000
Ohio,"Mining, Quarrying, and Oil and Gas Extraction",2011,3009,1485,640,367,2492,241,96,2829,180,3705,1490,645,375,2510,325,200,3035,670,40332,2189,3873,4688,11321,7695,3905,25194,17846,2641337000,97357000,192285000,227105000,526460000,447355000,218015000,1323009000,1422565000
Ohio,Other,2011,340,329,5,3,337,3,0,340,0,340,329,5,3,337,3,0,340,0,0,0,28,30,0,98,0,0,0,7044000,5353000,261000,220000,5834000,1210000,0,7044000,0
Ohio,Other Services (except Public Administration),2011,124158,72493,28300,13369,114162,7895,1159,123216,942,138470,72625,28650,14045,115320,10330,3250,128900,9570,998706,144557,183990,173792,504785,263160,96479,871138,99101,24075537000,3104688000,3812306000,3808251000,10740110000,6477022000,2672311000,20049260000,3257979000
Ohio,"Professional, Scientific, and Technical Services",2011,110048,73030,16105,9325,98460,7072,2038,107570,2478,120350,73080,16135,9675,98890,8295,3275,110460,9890,1170267,110263,104558,121725,344935,239261,169391,758636,398895,71377750000,4896460000,4638848000,6032828000,15618515000,14448629000,11463471000,41805974000,29398832000
Ohio,Real Estate and Rental and Leasing,2011,34182,24120,4390,2132,30642,1780,848,33270,912,47490,24165,4570,2540,31275,2920,3735,37930,9560,285449,36959,27341,26190,93683,50695,40006,189546,79229,11286596000,1217891000,875264000,889525000,3005674000,1977387000,1730774000,6919875000,3806993000
Ohio,Retail Trade,2011,105919,56980,22663,11955,91598,9256,2163,103017,2902,184065,57185,23350,13230,93765,14785,8685,117235,66830,2689532,94404,142857,143891,388035,325431,172617,923770,1650725,65505040000,2353242000,3097405000,3744391000,9188145000,10021595000,5680907000,25356323000,37385961000
Ohio,Total,2011,187655,102718,34882,22080,159680,19547,4638,183865,3790,250476,102955,35418,23362,161735,25819,14023,201577,48899,4432849,179927,230193,295631,705751,738055,630789,2074595,2358254,182110083000,6158756000,7137792000,9877452000,23174000000,26915872000,24126253000,74216125000,107893958000
Ohio,Transportation and Warehousing,2011,29091,15735,4009,3108,22852,2863,1135,26850,2241,35335,15745,4040,3185,22970,3335,1710,28015,7320,721642,22921,25629,39968,90354,93419,65688,255289,364500,29050299000,880636000,851062000,1428615000,3189738000,3620890000,2495214000,9452369000,16412654000
Ohio,Utilities,2011,856,265,130,58,453,225,45,723,133,3325,265,135,60,460,325,85,870,2455,3097,167,783,750,1869,8156,0,12149,0,952232000,19869000,50844000,39385000,112695000,507090000,118178000,906238000,0
Ohio,Wholesale Trade,2011,56680,25970,8999,6939,41908,7664,3284,52856,3824,70920,26075,9170,7345,42590,9780,6240,58610,12310,1065709,41818,55786,87558,193914,234334,195616,644734,407145,60033877000,2265517000,2844023000,4420412000,9607345000,12361139000,10523712000,33286178000,26318179000
Oklahoma,Accommodation and Food Services,2011,25530,9455,4710,4655,18820,5263,651,24734,796,35595,9465,4745,4705,18915,6230,2680,27825,7770,667255,16195,31353,63585,111785,193354,85569,397366,265233,9000235000,382390000,355329000,738677000,1477925000,2472551000,1070955000,5116871000,3760794000
Oklahoma,Administrative and Support and Waste Management and Remediation Services,2011,20053,11885,3210,1785,16880,1453,582,18915,1138,22200,11895,3230,1810,16935,1590,910,19435,2765,435136,16449,19242,21461,59619,53062,56525,173268,221131,14268189000,565374000,535405000,631323000,1787449000,1794360000,1427193000,5552786000,8506236000
Oklahoma,"Agriculture, Forestry, Fishing and Hunting",2011,696,470,110,65,645,20,11,676,20,705,470,110,65,645,20,20,685,20,4021,525,164,672,1881,184,0,3746,0,139796000,22637000,21846000,21702000,67859000,6557000,0,122105000,0
Oklahoma,"Arts, Entertainment, and Recreation",2011,4881,2785,630,570,3985,590,207,4782,99,5260,2790,630,580,4000,655,270,4925,335,124498,3011,3722,7085,14999,24138,29412,71930,627,3192165000,121231000,72832000,113300000,324721000,438671000,748596000,1625190000,10008000
Oklahoma,Construction,2011,39359,24935,6960,4020,35915,2780,323,39018,341,39685,24935,6960,4020,35915,2815,400,39130,555,319231,39877,44871,52847,139706,102577,36745,283116,32871,13837960000,1270865000,1421606000,1946979000,4647170000,4511846000,1947199000,11285275000,2413951000
Oklahoma,Educational Services,2011,3216,1550,510,395,2455,405,178,3038,178,3440,1550,510,400,2460,425,240,3125,315,96243,2154,2762,4329,10560,14518,20502,48514,42921,2391819000,53745000,68635000,77203000,211438000,354783000,532654000,1208494000,1020575000
Oklahoma,Finance and Insurance,2011,19839,13795,2185,959,16939,1368,469,18776,1063,33020,13820,2285,1280,17385,3370,2730,23485,9535,292493,22574,12350,11713,48234,49513,43757,147740,128389,14756993000,835011000,498449000,583598000,1977834000,2252549000,1921057000,6536971000,7980815000
Oklahoma,Health Care and Social Assistance,2011,42140,20945,9215,4815,34975,4695,1377,41047,1093,53000,20985,9235,4915,35135,6125,4605,45865,7135,1057382,35695,59303,62902,160208,198277,191761,555313,479888,40565042000,1993775000,2392009000,2339143000,6742074000,6221865000,5790905000,18867638000,20975905000
Oklahoma,Information,2011,4010,1820,565,544,2929,394,182,3505,505,7630,1820,565,590,2975,485,480,3940,3690,137011,1740,3420,6593,12747,12718,5188,37370,91692,6349636000,114354000,107720000,262286000,497066000,533734000,337569000,1591059000,4470056000
Oklahoma,Management of Companies and Enterprises,2011,2207,130,55,105,290,430,621,1341,866,2710,135,55,105,295,430,665,1390,1320,143567,0,0,552,0,3557,14740,19821,123746,14237680000,29028000,454000,34608000,69753000,188682000,861678000,1132953000,13104727000
Oklahoma,Manufacturing,2011,16561,6054,2910,2439,11403,2637,985,15025,1536,17795,6055,2910,2450,11415,2775,1180,15370,2425,552327,7918,14965,27887,57593,84627,74242,250569,259015,25842301000,346650000,548587000,1100872000,2131106000,3786692000,3403115000,10857377000,13060241000
Oklahoma,"Mining, Quarrying, and Oil and Gas Extraction",2011,13185,8530,1754,1004,11288,1020,339,12647,538,14870,8530,1755,1005,11290,1060,450,12800,2070,241897,8186,11144,13216,38103,35086,29505,103811,137567,21303774000,735340000,581203000,938447000,2260917000,2146323000,2152297000,6632597000,14650562000
Oklahoma,Other,2011,125,116,9,0,125,0,0,125,0,125,116,9,0,125,0,0,125,0,147,0,55,0,147,0,0,147,0,2200000,1496000,704000,0,2200000,0,0,2200000,0
Oklahoma,Other Services (except Public Administration),2011,41447,26196,8215,3808,38219,2375,422,41016,431,44050,26245,8285,3970,38500,2965,1025,42490,1560,302189,47160,52197,48669,150747,80898,34465,278427,12318,6905645000,1017890000,1131980000,1110577000,3298531000,1850905000,864111000,6227665000,447900000
Oklahoma,"Professional, Scientific, and Technical Services",2011,43617,31015,6085,2983,40083,1944,639,42666,951,46735,31030,6105,3095,40230,2255,960,43445,3290,307977,37461,37764,36567,125940,61850,47991,244106,55375,16269308000,1962382000,1570014000,1763716000,5365226000,3614505000,3004298000,12411578000,3654764000
Oklahoma,Real Estate and Rental and Leasing,2011,15784,11861,1722,790,14373,627,253,15253,531,19155,11910,1745,945,14600,1015,530,16145,3010,101356,12910,10644,9641,38492,18270,10826,70793,28799,4089721000,524878000,338495000,310752000,1188401000,658210000,454673000,2454147000,1578611000
Oklahoma,Retail Trade,2011,42163,22073,9172,5025,36270,3239,826,40335,1828,64895,22145,9390,5480,37015,4855,3200,45070,19825,742269,36435,57530,62895,164204,104443,52665,331852,367586,17627587000,930219000,1284937000,1591033000,3828750000,3441332000,1622947000,9239628000,7788198000
Oklahoma,Total,2011,71397,41674,12449,7375,61498,6244,1596,69338,2059,89749,41751,12583,7761,62095,8234,4597,74926,14823,1261590,71656,81413,98462,251531,236385,187974,675890,585700,49373824000,2397787000,2447295000,3147549000,7992631000,8075192000,7051302000,23119125000,26254699000
Oklahoma,Transportation and Warehousing,2011,11158,6447,1343,1006,8796,855,443,10094,1064,13065,6450,1350,1025,8825,920,685,10430,2635,180985,6998,7501,12251,30370,25757,19440,81122,79153,8024497000,318740000,256898000,430355000,1038445000,1092426000,1000750000,3269615000,3998283000
Oklahoma,Utilities,2011,651,235,75,20,330,140,60,530,121,1805,235,75,20,330,190,180,700,1105,39315,458,0,150,1195,7675,0,14544,1223,3094914000,16719000,16577000,5082000,42719000,436982000,0,930776000,373364000
Oklahoma,Wholesale Trade,2011,18138,7685,2871,2179,12735,2345,1146,16226,1912,22505,7710,2930,2345,12985,2990,1775,17750,4755,281654,11117,16830,25298,58960,64170,37714,176855,88138,14695650000,606400000,782170000,1255988000,2697727000,3049533000,1988081000,8334131000,5403896000
Oregon,Accommodation and Food Services,2011,41611,14743,9875,9319,33937,6295,772,41004,607,51760,14760,9940,9635,34335,8015,3295,45645,6115,714361,24096,66475,124664,214211,206096,96327,525647,179579,11960015000,519685000,844240000,1766254000,3134495000,3366112000,1571674000,8106764000,3794542000
Oregon,Administrative and Support and Waste Management and Remediation Services,2011,23173,14435,3502,1847,19784,1841,553,22178,995,25855,14435,3520,1900,19855,2015,855,22725,3130,421517,20737,21265,22941,67370,65419,68384,205546,194293,11965430000,651049000,588186000,666986000,1919165000,2089938000,1555922000,5705693000,5911446000
Oregon,"Agriculture, Forestry, Fishing and Hunting",2011,6271,4225,715,615,5555,565,105,6225,46,6410,4235,715,615,5565,600,155,6320,90,56441,5249,4256,8624,19133,19773,12637,53820,2445,2056241000,242400000,183694000,331067000,764822000,698511000,364075000,1881388000,163771000
Oregon,"Arts, Entertainment, and Recreation",2011,7545,4315,1165,840,6320,924,170,7414,131,7995,4315,1180,840,6335,1055,230,7620,375,112930,4832,7507,10906,25354,32167,18657,90341,13336,2687936000,191115000,141853000,223814000,563580000,546941000,446557000,2043747000,331587000
Oregon,Construction,2011,55168,40700,7574,3715,51989,2423,374,54786,382,55725,40700,7580,3720,52000,2600,475,55075,650,318910,59488,48490,46522,158122,83387,26481,280050,27375,15879395000,1973570000,1716742000,2085451000,5799584000,4547250000,1779138000,12904785000,2288907000
Oregon,Educational Services,2011,6447,3125,980,885,4990,995,250,6235,212,7065,3125,990,895,5010,1140,595,6745,320,170401,4213,6065,11349,22278,36126,32209,94081,74340,4103689000,127251000,124911000,213484000,465588000,844098000,947882000,2305225000,1737837000
Oregon,Finance and Insurance,2011,16562,11330,1887,664,13881,827,547,15255,1307,29310,11340,1975,795,14110,1635,2220,17965,11345,278714,18413,11027,7113,37603,25472,28400,98423,161564,16997584000,721655000,494219000,431419000,1690388000,1636945000,1694187000,5158398000,11423231000
Oregon,Health Care and Social Assistance,2011,48858,26265,10685,5256,42206,4086,1522,47814,1044,61620,26285,10735,5475,42495,5995,5560,54050,7570,1045999,44931,69488,68458,185654,159664,176444,534354,478474,47475289000,1977253000,2674319000,2773568000,7443550000,6039825000,5758304000,19626305000,26444441000
Oregon,Information,2011,6264,3191,926,595,4712,585,286,5583,681,9630,3205,945,630,4780,605,640,6025,3605,166421,3915,5885,5930,18220,18135,20971,69391,70224,9884467000,206324000,242040000,295378000,792471000,1043398000,1464966000,3726313000,5901195000
Oregon,Management of Companies and Enterprises,2011,2535,155,55,110,320,551,786,1657,878,3125,155,55,110,320,555,850,1725,1400,186914,0,195,424,866,5897,24136,31026,155888,17041407000,17038000,24680000,18364000,62300000,322353000,1746880000,2135237000,14906170000
Oregon,Manufacturing,2011,24901,10702,4381,3395,18478,3636,1233,23347,1554,26160,10705,4385,3435,18525,3820,1490,23835,2325,663780,15028,23622,39134,86713,122898,92710,348160,236462,32892013000,585521000,844323000,1507143000,3156944000,5232285000,4309786000,14736104000,14566276000
Oregon,"Mining, Quarrying, and Oil and Gas Extraction",2011,570,270,120,70,460,55,5,520,50,680,270,120,70,460,60,5,525,155,5905,376,624,665,1545,0,0,3146,134,337830000,20672000,27614000,34405000,86477000,0,0,162666000,47280000
Oregon,Other,2011,215,211,4,0,215,0,0,215,0,215,211,4,0,215,0,0,215,0,200,0,25,0,200,0,0,200,0,3429000,3039000,390000,0,3429000,0,0,3429000,0
Oregon,Other Services (except Public Administration),2011,43159,27245,8785,3939,39969,2334,400,42703,456,47230,27265,8825,4155,40245,3160,2240,45645,1585,302014,48275,56621,50373,158001,77006,26158,270022,21272,7777975000,1161103000,1303129000,1265220000,3752465000,1974844000,771797000,6795061000,715976000
Oregon,"Professional, Scientific, and Technical Services",2011,55734,39973,7085,3806,50864,2674,814,54352,1382,58490,39995,7100,3905,51000,2980,1125,55105,3385,401120,55544,44613,48386,154231,81475,41496,285512,91457,23700803000,2565010000,1988326000,2384356000,6988090000,5173552000,2905462000,15333013000,7316757000
Oregon,Real Estate and Rental and Leasing,2011,22180,17192,2310,923,20425,874,342,21641,539,27065,17250,2440,1055,20745,1265,1775,23785,3280,124760,24985,14005,10801,51061,25724,16130,96962,25400,4157820000,690834000,415744000,322481000,1467273000,804824000,467604000,2919752000,1157770000
Oregon,Retail Trade,2011,46656,24245,9865,5675,39785,3801,1133,44719,1937,69030,24365,10105,6380,40850,6265,4420,51535,17495,900996,38105,62766,69432,174952,119731,74507,388424,449197,23422232000,994833000,1362021000,1716104000,4106169000,3540339000,2369510000,10304432000,11756696000
Oregon,Total,2011,87018,52391,14909,8945,76245,6927,1740,84912,2106,106340,52473,15088,9436,76997,9302,5780,92079,14261,1341841,86742,98011,118479,303232,248194,198874,750300,591541,56092081000,2798558000,2894711000,3678779000,9372048000,9047813000,7743455000,26163316000,29928765000
Oregon,Transportation and Warehousing,2011,12884,7482,1630,1090,10202,1102,521,11825,1059,14920,7495,1655,1140,10290,1190,750,12230,2690,241101,5867,9372,12326,32670,32667,22308,96207,106368,10117147000,358351000,352147000,422223000,1182335000,1341015000,1031510000,3741616000,4771884000
Oregon,Utilities,2011,627,340,55,25,420,105,20,545,82,1440,340,55,25,420,165,30,615,825,18050,598,0,293,1288,4219,117,5772,14846,2174772000,13412000,8080000,19431000,42942000,357877000,11094000,424131000,1889382000
Oregon,Wholesale Trade,2011,22718,11057,3074,2282,16413,2715,1411,20539,2179,27115,11070,3100,2400,16570,3390,2190,22150,4965,345195,15911,17852,25187,63571,72919,47970,206999,122550,21794407000,806872000,884352000,1280095000,3056337000,3879767000,2720314000,10791450000,10806346000
Pennsylvania,Accommodation and Food Services,2011,110205,51181,21410,17676,90267,16798,1866,108931,1274,138510,51255,21485,17845,90585,18930,6015,115530,22980,2074336,89198,142286,238800,470861,609150,261861,1343440,696915,31116153000,1659290000,1725329000,2889003000,6275740000,8436121000,3762866000,18483145000,11801209000
Pennsylvania,Administrative and Support and Waste Management and Remediation Services,2011,64209,38595,9290,6237,54122,5682,2093,61897,2312,73825,38605,9320,6305,54230,6150,3380,63760,10065,1480337,52749,60749,82498,199856,215695,282019,702569,767518,47180392000,2323394000,1967786000,2764543000,7071139000,7370967000,7633649000,22258833000,24605353000
Pennsylvania,"Agriculture, Forestry, Fishing and Hunting",2011,2495,1900,310,145,2355,90,25,2470,25,2495,1900,310,145,2355,90,25,2470,25,16030,2919,1765,1147,6529,2392,858,12170,0,428664000,80363000,42523000,42272000,175279000,73108000,32315000,366389000,24285000
Pennsylvania,"Arts, Entertainment, and Recreation",2011,20994,11453,3505,2242,17200,2843,577,20620,374,22225,11465,3525,2280,17270,3065,790,21125,1100,445034,14759,22248,29560,68541,114758,79457,270274,160690,13088955000,588102000,495162000,760510000,1912335000,2249345000,1954331000,7041720000,5715461000
Pennsylvania,Construction,2011,130371,88410,19710,11945,120065,8389,1167,129621,750,131635,88415,19710,11970,120095,8580,1450,130125,1510,1098720,139729,128228,159096,428510,303240,159330,895010,186812,59357875000,5430630000,5222630000,7642935000,18296195000,17584425000,10358054000,46471755000,12285188000
Pennsylvania,Educational Services,2011,15831,6430,2335,1980,10745,3431,932,15108,723,18055,6430,2335,2075,10840,3765,1550,16155,1900,1284653,8652,15713,27264,53400,150922,141238,349073,930546,46307773000,394343000,323882000,651412000,1377540000,4411959000,5012736000,10878453000,35256554000
Pennsylvania,Finance and Insurance,2011,46194,28970,7451,3040,39461,3003,1345,43809,2385,88235,29050,7755,3510,40315,5630,6780,52725,35510,1270772,52243,46006,38456,138665,101158,125479,376658,881809,92055647000,2492192000,2443369000,2678234000,7625235000,7073365000,8014835000,23428490000,68266604000
Pennsylvania,Health Care and Social Assistance,2011,125685,54538,28283,17954,100775,15466,5717,121958,3727,181310,54720,28610,19080,102410,22555,21370,146335,34975,4716750,109732,185577,240952,537317,584467,876804,2000655,2713092,194618208000,4539605000,7244363000,9741937000,21538481000,23229124000,28227992000,73087637000,121279284000
Pennsylvania,Information,2011,12643,5585,2000,1585,9170,1607,594,11371,1272,24940,5585,2015,1650,9250,1980,1090,12320,12620,599062,7888,13084,19896,41443,55475,48558,149755,444003,39168223000,374381000,496385000,831877000,1721954000,2892635000,2851396000,7795327000,31226356000
Pennsylvania,Management of Companies and Enterprises,2011,7027,330,140,276,746,1146,2135,4027,3000,10835,335,140,290,765,1170,2305,4240,6595,789175,0,553,1650,3089,15394,72210,90715,698460,75087095000,66123000,106346000,171130000,368770000,976176000,5330070000,6675340000,68411755000
Pennsylvania,Manufacturing,2011,65531,21483,11514,9994,42991,13213,4510,60714,4817,69790,21485,11520,10065,43070,13755,5545,62370,7420,2619266,35812,71839,128241,247596,494685,493607,1289476,1175940,133530436000,1479528000,2547386000,5235293000,9569996000,22239775000,23715033000,57943934000,68376370000
Pennsylvania,"Mining, Quarrying, and Oil and Gas Extraction",2011,4407,2010,695,540,3245,592,211,4048,359,5725,2010,695,540,3245,665,400,4310,1415,139565,3077,4219,6761,14515,21485,16681,54317,70331,10419855000,190521000,210246000,344081000,756364000,1209573000,1204106000,3235174000,5971777000
Pennsylvania,Other,2011,334,322,10,2,334,0,0,334,0,334,322,10,2,334,0,0,334,0,0,0,66,0,0,0,0,0,0,7459000,5761000,1518000,0,7459000,0,0,7459000,0
Pennsylvania,Other Services (except Public Administration),2011,164823,103120,35484,15163,153767,8976,1172,163915,908,176385,103195,35730,15675,154600,11005,3550,169155,7230,1188584,203092,227921,196362,629385,311434,99196,1053817,99632,29691690000,4398648000,4790216000,4534233000,13732444000,7902835000,3465801000,25343815000,3350254000
Pennsylvania,"Professional, Scientific, and Technical Services",2011,135500,90471,18658,11647,120776,9143,2505,132424,3076,147010,90525,18790,11960,121275,11010,3820,136105,10905,1549753,138357,119440,151078,415589,314849,220738,959235,567344,108148635000,6911755000,6308714000,9032495000,22315265000,21681979000,16370604000,60579698000,46696741000
Pennsylvania,Real Estate and Rental and Leasing,2011,33936,22698,5111,2272,30081,2069,807,32957,979,45300,22790,5380,2650,30820,2935,2835,36590,8710,295586,36782,32572,28162,99699,66255,40197,212760,76860,13114588000,1313381000,1224373000,1159228000,3699046000,3091675000,1899864000,8801795000,4018938000
Pennsylvania,Retail Trade,2011,134796,73704,27263,15357,116324,12421,2812,131557,3239,220965,73990,27950,17110,119050,18105,10070,147225,73740,3066684,117138,163281,188029,481081,435394,275652,1203504,1626287,74129478000,3115394000,3841413000,5082103000,11906726000,14002881000,7735432000,34218102000,37763065000
Pennsylvania,Total,2011,229048,129991,41556,25759,197306,22501,5243,225050,3998,295720,130219,42080,27035,199334,28728,15713,243775,51945,5078111,229717,272778,344506,847001,851086,732114,2430201,2647910,222252066000,7867437000,8749120000,12285127000,28901684000,33052688000,29900959000,91855331000,130396735000
Pennsylvania,Transportation and Warehousing,2011,34423,18300,4851,3622,26773,4067,1351,32191,2232,40900,18305,4875,3655,26835,4580,1760,33175,7725,931791,26844,31122,47644,106065,142577,106135,361190,486485,35076573000,974640000,1000214000,1573241000,3583624000,4648363000,3516699000,11989677000,20053683000
Pennsylvania,Utilities,2011,996,360,115,70,545,137,50,732,264,3820,360,120,70,550,200,135,885,2935,153105,566,352,666,2142,5418,1880,10842,139790,16214188000,35954000,11990000,39538000,120943000,388433000,141230000,780824000,15137147000
Pennsylvania,Wholesale Trade,2011,62189,29035,9994,7894,46923,7919,3389,58231,3958,74970,29065,10085,8290,47440,9470,5695,62605,12365,1179227,48829,62213,99163,217796,254629,209164,701431,454657,74848705000,2660910000,3198645000,5512849000,11482666000,14143659000,11491089000,37807910000,36047625000
Rhode Island,Accommodation and Food Services,2011,12703,5555,2180,2280,10015,2166,179,12360,343,14760,5560,2205,2310,10075,2400,515,12990,1770,198061,7719,14540,30561,53344,74486,21181,149612,49212,3359477000,252098000,199856000,421122000,878958000,1205706000,378446000,2480000000,895449000
Rhode Island,Administrative and Support and Waste Management and Remediation Services,2011,8040,5380,955,470,6805,538,215,7558,482,8435,5380,955,475,6810,555,225,7590,845,100928,3314,5206,5488,17244,17879,25323,63095,30184,3209526000,338798000,190859000,204354000,782116000,576686000,586487000,2063828000,981013000
Rhode Island,"Agriculture, Forestry, Fishing and Hunting",2011,200,175,10,10,195,5,0,200,0,200,175,10,10,195,5,0,200,0,348,3,0,0,0,0,0,348,0,15323000,7238000,0,0,9673000,0,0,15323000,0
Rhode Island,"Arts, Entertainment, and Recreation",2011,2484,1355,425,267,2047,302,75,2424,60,2715,1355,425,270,2050,305,185,2540,175,39984,725,2476,3208,7824,9009,5680,24611,5936,1065205000,86190000,101066000,104603000,319753000,219991000,109871000,707577000,129808000
Rhode Island,Construction,2011,14931,11475,1860,905,14240,545,70,14855,76,14945,11475,1860,910,14245,545,70,14860,85,73329,11207,11293,11495,39392,16231,8433,68794,0,4320206000,688196000,521762000,675511000,1921717000,1147272000,467902000,3883752000,8759000
Rhode Island,Educational Services,2011,1911,900,240,195,1335,350,106,1791,120,2015,905,240,200,1345,380,125,1850,165,138017,1285,1008,2144,5339,13595,10136,29688,101086,4587644000,40026000,30878000,44932000,132599000,444419000,386941000,995572000,3355281000
Rhode Island,Finance and Insurance,2011,4292,2335,565,270,3170,278,191,3639,653,6890,2335,570,290,3195,410,600,4205,2685,100828,3509,2981,2232,9276,6889,9500,31129,43489,7355629000,190991000,167648000,254606000,654256000,497503000,657301000,2049592000,3794552000
Rhode Island,Health Care and Social Assistance,2011,12761,5260,2935,1738,9933,1453,803,12189,572,16505,5285,2945,1805,10035,2000,2570,14605,1900,413075,10001,18537,22603,52255,56957,107341,222802,171975,17156957000,436050000,807439000,981712000,2241770000,2352295000,3747457000,8485475000,8348008000
Rhode Island,Information,2011,1325,525,210,125,860,170,65,1095,230,2100,525,210,125,860,220,85,1165,935,32838,473,835,621,2629,5431,1176,13049,13560,1950959000,29598000,50490000,32846000,156756000,244430000,43423000,580451000,964743000
Rhode Island,Management of Companies and Enterprises,2011,612,30,25,35,90,70,166,326,286,865,30,25,35,90,70,185,345,520,66640,40,0,170,390,811,4842,6095,60545,4626765000,1784000,5207000,8192000,15785000,68760000,330543000,418560000,4208205000
Rhode Island,Manufacturing,2011,7473,2900,1359,1110,5369,1462,341,7172,301,7565,2900,1365,1110,5375,1495,370,7240,325,161531,3366,6282,11555,24475,46181,23526,120129,21096,8019344000,166696000,272868000,467725000,1001631000,2018961000,1083920000,5293619000,1382043000
Rhode Island,"Mining, Quarrying, and Oil and Gas Extraction",2011,100,60,25,5,90,5,0,95,5,105,60,25,5,90,5,0,95,10,408,0,0,0,222,0,0,0,0,31215000,2024000,0,0,18772000,0,0,24156000,0
Rhode Island,Other,2011,42,39,3,0,42,0,0,42,0,42,39,3,0,42,0,0,42,0,0,0,22,0,0,0,0,0,0,785000,718000,67000,0,785000,0,0,785000,0
Rhode Island,Other Services (except Public Administration),2011,13467,8715,2605,1196,12516,641,85,13242,225,14085,8730,2615,1210,12555,810,90,13455,630,82942,15654,16142,13962,46676,19859,1843,75494,5634,2364337000,442130000,413204000,415371000,1285961000,633864000,63888000,2182073000,139156000
Rhode Island,"Professional, Scientific, and Technical Services",2011,14307,9880,1885,1018,12783,675,263,13721,586,14920,9885,1890,1020,12795,720,285,13800,1120,114222,13390,11155,10770,39753,17842,11909,76914,31903,7801014000,703910000,605231000,707177000,2088626000,1185801000,769872000,4442116000,3182148000
Rhode Island,Real Estate and Rental and Leasing,2011,4390,3150,465,208,3823,230,104,4157,233,5150,3155,515,265,3935,275,250,4460,690,26242,719,2585,2111,9000,6045,1792,18432,5660,1053802000,182289000,106717000,97656000,411411000,217031000,68778000,732746000,262434000
Rhode Island,Retail Trade,2011,14463,8100,2653,1352,12105,801,310,13216,1247,19155,8130,2720,1450,12300,915,690,13905,5250,228969,10094,15001,15643,44686,19105,12600,80051,75182,6100646000,348498000,393286000,427414000,1204019000,770681000,466278000,2581368000,2041745000
Rhode Island,Total,2011,24203,14133,3950,2401,20484,2109,575,23168,1035,28181,14153,3992,2477,20622,2463,1330,24415,3766,406222,23088,25794,31861,80743,75861,65535,222139,184083,17274591000,878390000,915427000,1172835000,2966652000,2931154000,2623404000,8521210000,8753381000
Rhode Island,Transportation and Warehousing,2011,2873,1750,330,222,2302,249,75,2626,247,3095,1750,330,230,2310,255,85,2650,445,35600,2025,1167,1675,6574,5175,1565,17372,8948,1494517000,90222000,63999000,66650000,256735000,206452000,57464000,656907000,508734000
Rhode Island,Utilities,2011,69,15,5,10,30,5,0,35,34,170,15,5,10,30,5,0,35,135,2342,10,0,0,124,0,0,190,2138,279860000,96000,0,0,6986000,0,0,10808000,201784000
Rhode Island,Wholesale Trade,2011,6589,2915,1030,650,4595,889,315,5799,790,7020,2920,1035,655,4610,945,320,5875,1145,84921,4079,5410,6975,18714,19424,8216,56144,19059,5047079000,220201000,297022000,394113000,1004711000,1080699000,503200000,3188586000,1322279000
South Carolina,Accommodation and Food Services,2011,35853,12803,6848,7051,26702,7075,1097,34874,979,48200,12845,6880,7245,26970,7965,3845,38780,9420,865363,20059,46047,95961,162735,259385,140984,564743,302543,12500543000,494500000,560044000,1207059000,2268182000,3685563000,1968862000,7948178000,4589243000
South Carolina,Administrative and Support and Waste Management and Remediation Services,2011,23705,14110,3490,2310,19910,1892,682,22484,1221,26700,14110,3500,2340,19950,2040,895,22885,3815,676055,22191,22185,28521,75635,66917,96431,246971,402308,17699563000,657784000,578830000,822823000,2117138000,2014229000,2074547000,6441050000,10850427000
South Carolina,"Agriculture, Forestry, Fishing and Hunting",2011,2510,1275,630,345,2250,185,35,2470,40,2530,1275,630,345,2250,195,35,2480,50,17978,2160,4068,4025,10634,4555,219,17619,393,682730000,75939000,136921000,143206000,367032000,172420000,3911000,599527000,25692000
South Carolina,"Arts, Entertainment, and Recreation",2011,6944,3630,1025,805,5460,1093,272,6825,119,7590,3650,1040,815,5505,1210,535,7250,340,117648,4598,6233,10220,22736,42052,29778,99289,14836,2115954000,155358000,109333000,191911000,462682000,817109000,485535000,1843394000,195928000
South Carolina,Construction,2011,43859,28435,7460,4335,40230,2926,297,43453,406,44560,28440,7470,4345,40255,2970,430,43655,905,388550,39185,48581,57757,155030,103008,27352,290395,59717,16700040000,1440795000,1521997000,2046065000,5009155000,4082050000,1228590000,10571765000,3330861000
South Carolina,Educational Services,2011,4950,2455,690,655,3800,780,170,4750,200,5275,2455,690,680,3825,795,260,4880,395,153070,3865,4302,8295,16918,30010,29308,79208,71903,3501949000,93654000,81265000,139607000,321164000,674733000,829517000,1879159000,1566909000
South Carolina,Finance and Insurance,2011,16023,9978,2392,1046,13416,799,565,14780,1243,36005,10025,2590,1465,14080,2275,3770,20125,15880,307398,14544,13984,12413,43452,24327,39264,114636,184988,15849966000,645967000,543807000,576561000,1817473000,1190308000,1949840000,5168624000,10329751000
South Carolina,Health Care and Social Assistance,2011,37783,16395,9075,5595,31065,4337,1194,36596,1187,48365,16430,9145,5815,31390,5280,4000,40670,7695,1080586,30439,59230,73961,164950,159174,160886,494772,582846,45305237000,1477595000,2327036000,2874725000,6690694000,6436031000,4876023000,18250124000,26957341000
South Carolina,Information,2011,3464,1590,425,250,2265,370,189,2824,640,6930,1590,430,265,2285,460,310,3055,3875,142082,1568,1794,2252,7115,10408,4322,31394,109946,7336931000,89641000,61776000,78904000,272402000,460971000,472998000,1466933000,5802339000
South Carolina,Management of Companies and Enterprises,2011,2128,115,45,95,255,315,609,1179,949,3005,115,45,100,260,315,660,1235,1770,109748,140,140,450,775,3131,13463,17448,92300,8616773000,13570000,13560000,19265000,47590000,190624000,825186000,1070771000,7546002000
South Carolina,Manufacturing,2011,18082,6345,2775,2135,11255,2969,1426,15650,2432,19600,6350,2775,2135,11260,3205,1650,16115,3485,896201,7167,15213,23065,51956,100391,117018,308552,511483,41991110000,315365000,528929000,891671000,1912301000,4291975000,5019791000,12754902000,26025975000
South Carolina,"Mining, Quarrying, and Oil and Gas Extraction",2011,313,140,25,45,210,30,15,255,58,415,140,25,45,210,30,15,255,160,4587,32,30,322,879,283,164,1914,2079,262282000,6479000,9910000,21609000,41393000,12101000,9337000,112469000,131453000
South Carolina,Other,2011,172,166,5,1,172,0,0,172,0,172,166,5,1,172,0,0,172,0,205,163,25,0,205,0,0,205,0,2815000,1997000,219000,0,2815000,0,0,2815000,0
South Carolina,Other Services (except Public Administration),2011,51858,31475,11646,4598,47719,3188,446,51353,505,55065,31495,11710,4735,47940,3990,1090,53020,2045,379975,58034,73894,59972,194990,105654,34461,344023,28777,8801663000,1278904000,1541315000,1324187000,4168083000,2374556000,851237000,7497068000,1177524000
South Carolina,"Professional, Scientific, and Technical Services",2011,44669,31605,6145,2932,40682,1975,727,43384,1285,48515,31610,6175,3055,40840,2460,1215,44515,4000,405055,46442,38466,37395,124043,60798,42478,237575,154392,22349060000,2022308000,1595033000,1744153000,5381830000,3795331000,2872668000,12400941000,9699324000
South Carolina,Real Estate and Rental and Leasing,2011,17904,13785,1543,827,16155,704,427,17286,618,22825,13845,1620,945,16410,1190,1060,18660,4165,120454,18834,9185,9667,39610,20236,15442,78781,28075,4213103000,647845000,310813000,311663000,1298111000,639921000,604901000,2628152000,1334802000
South Carolina,Retail Trade,2011,53066,31508,10228,4974,46710,3420,868,50998,2068,87765,31620,10550,5535,47705,5770,3370,56845,30920,1010961,52254,61159,55836,175654,103573,47720,338764,605595,22869997000,1303174000,1481728000,1551768000,4457037000,3555799000,1403686000,9606973000,12526197000
South Carolina,Total,2011,77203,44299,13713,8115,66127,6846,1843,74816,2387,100481,44403,13921,8569,66893,8812,5192,80897,19584,1521123,76820,89714,108022,274556,246451,198061,719068,802055,54433127000,2380213000,2544734000,3177639000,8102586000,7933428000,6616591000,22652605000,31780522000
South Carolina,Transportation and Warehousing,2011,10571,5832,1245,777,7854,894,585,9333,1238,12530,5840,1270,800,7910,955,735,9600,2930,241243,7305,6663,8697,24878,23035,23218,75395,140950,9109714000,281455000,243482000,288057000,859725000,761837000,855400000,2602245000,5596909000
South Carolina,Utilities,2011,462,165,55,35,255,95,55,405,57,1610,165,55,35,255,140,170,565,1045,55969,324,318,252,1132,4270,7023,12535,43434,4437053000,17204000,12570000,17779000,47960000,243355000,408979000,703255000,3733798000
South Carolina,Wholesale Trade,2011,19532,9128,2953,2046,14127,2310,1145,17582,1950,24060,9185,2980,2140,14305,2815,1915,19035,5025,288276,12166,17797,23154,57685,56512,37426,169460,105427,15345584000,700389000,814578000,1042229000,2703908000,2820648000,1925536000,7979713000,6249663000
South Dakota,Accommodation and Food Services,2011,10155,3920,1750,2045,7715,1899,316,9930,225,11655,3930,1775,2090,7795,2175,800,10770,885,187217,5650,11503,27678,45189,65499,36905,148464,38049,2691436000,162648000,116023000,316289000,598331000,848838000,573943000,2054056000,636954000
South Dakota,Administrative and Support and Waste Management and Remediation Services,2011,5014,3205,740,340,4285,273,130,4688,326,5280,3205,740,355,4300,310,170,4780,500,49201,4575,4064,3369,13411,8058,6317,32350,12532,1382392000,159589000,128779000,77899000,399312000,199210000,149659000,927193000,409804000
South Dakota,"Agriculture, Forestry, Fishing and Hunting",2011,615,490,70,30,590,10,10,610,5,615,490,70,30,590,10,10,610,5,1819,557,223,0,1416,0,0,1805,0,74614000,24835000,11240000,10319000,51920000,0,0,73979000,0
South Dakota,"Arts, Entertainment, and Recreation",2011,3212,1925,535,380,2840,243,84,3167,45,3375,1925,535,385,2845,280,200,3325,50,29563,2186,3156,4289,11091,6674,3328,26657,793,520911000,91284000,53068000,74747000,236724000,127273000,44845000,501941000,5905000
South Dakota,Construction,2011,15516,11145,2455,1095,14695,649,107,15451,65,15630,11145,2455,1100,14700,650,170,15520,110,83209,16246,15703,13036,47632,22528,6375,80269,1421,3720829000,656076000,603478000,558741000,1894491000,1136074000,384068000,3542539000,85972000
South Dakota,Educational Services,2011,1015,450,150,95,695,170,95,960,55,1055,450,150,95,695,170,110,975,80,37462,526,923,1132,2740,6852,14528,24263,10724,870047000,14367000,16273000,18399000,54861000,135106000,393882000,580917000,230655000
South Dakota,Finance and Insurance,2011,6119,3947,727,368,5042,358,187,5587,532,9745,3950,755,485,5190,855,1070,7115,2630,109463,5663,4238,4180,15335,9872,12243,38433,63180,5589054000,222632000,165321000,205762000,607975000,433820000,617711000,1718123000,3192941000
South Dakota,Health Care and Social Assistance,2011,9248,4155,1910,1260,7325,1083,540,8948,300,11630,4160,1930,1295,7385,1755,1565,10705,925,301367,6819,11639,13446,35030,40652,65576,146378,135667,11964582000,303353000,378197000,641941000,1351702000,1419217000,2283284000,5181179000,6470763000
South Dakota,Information,2011,1415,580,210,155,945,197,76,1218,197,2105,580,220,155,955,385,250,1590,515,29363,273,884,1475,3706,5964,1808,12431,7047,1139672000,26869000,30247000,50567000,115643000,215623000,72925000,587711000,263351000
South Dakota,Management of Companies and Enterprises,2011,653,26,25,10,61,140,230,431,222,740,30,25,10,65,140,240,445,295,28751,0,0,0,216,1079,4878,6440,22342,1957628000,0,4376000,0,8428000,66610000,303145000,390625000,1568744000
South Dakota,Manufacturing,2011,4654,1815,760,595,3170,759,315,4244,410,4985,1815,760,600,3175,795,430,4400,585,154826,2186,3022,4352,12809,21974,15204,68524,59632,6282568000,84496000,112591000,180330000,443031000,912779000,613285000,2666120000,2384185000
South Dakota,"Mining, Quarrying, and Oil and Gas Extraction",2011,280,130,40,15,185,37,19,241,39,315,130,40,15,185,40,40,265,50,3882,211,167,0,545,376,750,2873,794,243749000,8820000,9386000,0,27514000,33198000,51528000,176292000,38922000
South Dakota,Other,2011,55,52,3,0,55,0,0,55,0,55,52,3,0,55,0,0,55,0,65,40,25,0,65,0,0,65,0,925000,684000,241000,0,925000,0,0,925000,0
South Dakota,Other Services (except Public Administration),2011,12777,8385,2540,1110,12035,522,100,12657,120,13235,8390,2550,1140,12080,755,125,12960,275,69901,15152,15260,12856,45245,14937,503,63018,509,1538036000,324656000,343213000,277144000,973513000,348792000,20129000,1399764000,13548000
South Dakota,"Professional, Scientific, and Technical Services",2011,8571,5645,1280,795,7720,396,128,8244,327,9040,5645,1310,810,7765,520,180,8465,575,50095,8324,7918,8770,26848,10157,2229,42412,6334,2124312000,318510000,290699000,342624000,990427000,503382000,119444000,1753265000,323545000
South Dakota,Real Estate and Rental and Leasing,2011,3976,2985,393,215,3593,155,80,3828,148,4450,2985,420,230,3635,230,275,4140,310,16070,424,2235,2178,8912,2230,2046,14311,1767,494038000,99784000,64090000,58998000,239618000,76604000,61163000,401169000,78636000
South Dakota,Retail Trade,2011,15193,6979,3352,2122,12453,1362,477,14292,901,19740,7015,3375,2240,12630,1970,1775,16375,3365,215479,10742,19008,25098,58416,40727,18948,132479,68905,5078058000,303285000,453995000,586026000,1387882000,1128498000,621001000,3372801000,1399596000
South Dakota,Total,2011,21442,12322,3687,2314,18323,1815,523,20661,781,25494,12341,3732,2428,18501,2566,1677,22744,2750,326749,20589,24208,30417,75214,65543,56768,197525,129224,11188600000,633077000,656623000,863038000,2152738000,2028443000,1953731000,6134912000,5053688000
South Dakota,Transportation and Warehousing,2011,5292,3540,695,415,4650,284,129,5063,229,5685,3540,695,425,4660,315,170,5145,540,42554,4384,4117,4762,14355,7632,1213,28279,11613,1578561000,165018000,136928000,156943000,483832000,283949000,68809000,973542000,469823000
South Dakota,Utilities,2011,355,50,60,65,175,100,10,285,70,785,50,60,70,180,165,50,395,390,9968,64,0,930,1416,2936,0,5646,58,642939000,877000,17737000,45790000,65798000,172890000,0,325938000,4144000
South Dakota,Wholesale Trade,2011,5485,2010,775,576,3361,961,423,4745,740,7130,2010,780,610,3400,1310,755,5465,1665,81045,2119,3598,5365,14141,24911,13209,57207,16848,3687576000,117119000,159699000,236817000,579756000,992099000,713003000,2520171000,945151000
Tennessee,Accommodation and Food Services,2011,40060,14447,7390,7680,29517,8275,1074,38866,1194,58550,14465,7420,7915,29800,9720,4475,43995,14555,1161888,22967,49389,104061,177838,293031,151927,623181,537149,17158335000,569150000,622980000,1348416000,2541615000,4199722000,2050610000,8797503000,8326438000
Tennessee,Administrative and Support and Waste Management and Remediation Services,2011,26821,14730,3945,2650,21325,2711,1016,25052,1769,32340,14735,3965,2680,21380,2880,1455,25715,6625,965129,23359,24331,34173,82818,101686,124249,323465,632484,28947285000,906842000,845473000,1093789000,2922057000,3679990000,3641066000,10517169000,18145157000
Tennessee,"Agriculture, Forestry, Fishing and Hunting",2011,1155,815,200,70,1085,35,20,1140,15,1170,815,205,70,1090,35,20,1145,25,6657,1534,1194,904,3735,220,0,6275,0,230003000,45160000,41792000,30051000,122339000,6364000,0,219518000,0
Tennessee,"Arts, Entertainment, and Recreation",2011,10814,6155,1910,1205,9270,1073,252,10595,219,11305,6155,1925,1210,9290,1155,305,10750,555,145717,7474,12735,14649,37204,38729,22295,107133,34604,5767063000,544921000,429983000,604815000,1630508000,1212523000,985711000,4587738000,688049000
Tennessee,Construction,2011,46754,28145,8170,5339,41654,4065,582,46301,453,47585,28145,8170,5340,41655,4125,795,46575,1010,481020,45342,53087,71264,172896,150520,69191,397550,73807,20759590000,1588810000,1824083000,2757490000,6174740000,6962599000,3486331000,16806495000,3558324000
Tennessee,Educational Services,2011,5634,2420,880,690,3990,890,428,5308,326,5995,2425,880,720,4025,895,505,5425,570,281996,3645,5718,8657,19273,36620,72449,131561,147003,8842956000,152540000,121557000,166382000,450402000,987797000,2319265000,3931619000,4847566000
Tennessee,Finance and Insurance,2011,22844,14468,2798,1312,18578,1600,922,21100,1744,48620,14525,3060,1760,19345,4410,5425,29180,19440,531060,24401,17103,15810,59880,59560,74334,203256,297755,33455859000,1179858000,828231000,921125000,3034417000,4486906000,4026681000,11939851000,20998061000
Tennessee,Health Care and Social Assistance,2011,55502,23955,14018,7701,45674,6150,1991,53815,1687,74115,23995,14110,8125,46230,7960,6530,60720,13395,1885136,48253,91642,100508,242164,234946,298266,784678,1072063,81836561000,2277951000,3706080000,4297946000,10314511000,10620431000,11737964000,32829680000,48431912000
Tennessee,Information,2011,6954,3330,1021,714,5065,690,311,6066,888,12120,3340,1030,730,5100,790,600,6490,5630,217096,3979,5709,6964,19133,21056,14008,62402,128517,11413605000,248450000,245875000,280047000,837348000,978458000,644329000,2934433000,8111195000
Tennessee,Management of Companies and Enterprises,2011,3688,155,45,75,275,651,1056,1982,1706,6665,155,45,80,280,655,1085,2020,4645,374404,161,128,44,678,5198,31341,37092,336865,35977125000,60191000,11160000,29279000,102671000,529993000,2268061000,2913100000,33064025000
Tennessee,Manufacturing,2011,26925,9250,4256,3620,17126,4574,2147,23847,3078,28950,9250,4270,3630,17150,4805,2630,24585,4365,1281009,14443,23432,42328,87140,156589,176902,467603,738364,59065314000,587058000,811892000,1573797000,3206023000,6365391000,7405131000,18827083000,37220215000
Tennessee,"Mining, Quarrying, and Oil and Gas Extraction",2011,650,230,70,100,400,90,45,535,115,1025,230,70,100,400,95,110,605,420,8893,74,352,760,1382,1467,2133,6139,481,614663000,13050000,14142000,36322000,66298000,70199000,118819000,316297000,30548000
Tennessee,Other,2011,215,206,9,0,215,0,0,215,0,215,206,9,0,215,0,0,215,0,248,0,0,0,248,0,0,248,0,4080000,3828000,252000,0,4080000,0,0,4080000,0
Tennessee,Other Services (except Public Administration),2011,64381,39530,12950,6238,58718,4393,641,63752,629,69315,39555,12990,6550,59095,5520,1275,65890,3425,536153,75577,82113,81345,240384,161400,53509,463298,54611,13089728000,1668411000,1793678000,1936292000,5423015000,3813721000,1228922000,10573050000,2030328000
Tennessee,"Professional, Scientific, and Technical Services",2011,49620,32752,7105,4258,44115,2984,1027,48126,1494,54430,32770,7145,4390,44305,3590,1515,49410,5020,498815,53434,45295,54684,156465,90372,75046,327068,156720,28912520000,2508814000,2043139000,2783228000,7397187000,5380734000,4541632000,17558012000,10758079000
Tennessee,Real Estate and Rental and Leasing,2011,18618,12859,2385,1223,16467,929,534,17930,688,26820,12915,2485,1480,16880,1715,2250,20845,5975,154206,20480,14856,14050,52405,23274,21325,102978,44723,5759011000,666692000,507388000,527682000,1745395000,803980000,835681000,3586766000,1953907000
Tennessee,Retail Trade,2011,69301,39661,13493,7041,60195,5448,1197,66840,2461,112115,39815,13800,7815,61430,7870,5155,74455,37660,1362800,65666,85608,87764,242391,176463,85134,522874,773234,33537465000,1689392000,2009034000,2390004000,6126194000,6301100000,2784596000,15456315000,17347937000
Tennessee,Total,2011,96143,52537,17435,10909,80881,9593,2653,93127,3016,129489,52643,17682,11545,81870,12504,7606,101980,27509,2300542,96015,114781,145190,355986,352147,309784,1017917,1282625,91783286000,3276164000,3585970000,4880191000,11742325000,13277859000,12234006000,37254190000,54529096000
Tennessee,Transportation and Warehousing,2011,15383,7305,2407,1589,11301,1499,797,13597,1786,20245,7310,2415,1600,11325,1635,1070,14030,6215,463148,10820,15374,19280,47475,46581,53461,154705,296870,18422555000,402388000,502742000,659784000,1609939000,1822833000,2147776000,5857845000,11790795000
Tennessee,Utilities,2011,292,55,20,5,80,105,40,225,67,715,55,50,5,110,210,185,505,210,14703,24,0,0,0,5431,5506,11548,2790,938505000,4132000,0,0,3218000,316245000,346264000,732501000,176953000
Tennessee,Wholesale Trade,2011,27494,11510,4257,3376,19143,3676,1783,24602,2892,34290,11530,4330,3525,19385,4455,2645,26485,7805,541383,17371,25439,41545,90034,105344,74740,285852,242403,31018162000,991048000,1216788000,2171565000,4487365000,5772059000,4163304000,15274136000,15051038000
Texas,Accommodation and Food Services,2011,161639,60420,31560,30292,122272,33415,3864,159551,2088,235045,60540,31730,30840,123110,38985,17630,179725,55320,4689333,97214,209448,411868,719103,1237378,610256,2570138,2007460,72252128000,2401796000,2647790000,5361651000,10420935000,17993131000,9360728000,37821033000,34378748000
Texas,Administrative and Support and Waste Management and Remediation Services,2011,106691,59987,16745,10640,87372,11374,4168,102914,3777,127060,60040,16780,10885,87705,12150,5865,105720,21340,4262774,95346,109251,138048,341533,448773,646329,1463725,2773631,146564565000,4354073000,3704582000,5077951000,13182520000,16390689000,21171850000,50992975000,94454475000
Texas,"Agriculture, Forestry, Fishing and Hunting",2011,4830,3080,1025,400,4505,205,75,4785,45,5105,3080,1025,400,4505,225,300,5030,75,32563,3898,6570,4898,15959,5639,6116,28653,3798,1096209000,157846000,210723000,190816000,572214000,203669000,152413000,957079000,133082000
Texas,"Arts, Entertainment, and Recreation",2011,27895,15342,4385,3800,23527,3200,739,27466,429,31015,15375,4420,3905,23700,3370,1025,28095,2920,578024,21000,28214,51423,103454,113418,106703,341657,198373,16137648000,994803000,610019000,951107000,2561129000,2208891000,5787189000,10939934000,3798412000
Texas,Construction,2011,186772,110426,32965,20577,163968,18090,3153,185211,1561,191400,110440,32985,20640,164065,18665,4390,187120,4280,2662525,189384,217200,278530,686295,707357,474868,1872175,785272,129123665000,7590285000,7856675000,11076785000,26523745000,31711604000,23968236000,82311035000,46559070000
Texas,Educational Services,2011,26019,12565,4225,3493,20283,4118,993,25394,625,29055,12575,4235,3550,20360,4460,1770,26590,2465,792485,18185,27743,46544,92510,169669,141619,410206,370678,27000010000,738887000,548876000,988845000,2294697000,4649687000,4797931000,11804145000,14669488000
Texas,Finance and Insurance,2011,95389,65425,13009,5250,83684,5753,2658,92095,3294,189500,65615,13465,6530,85610,12540,14300,112450,77050,2314073,111088,80495,66169,259502,208410,265471,747409,1514970,155581783000,5346057000,4078777000,4365687000,13890836000,14007031000,16515781000,44999020000,108611979000
Texas,Health Care and Social Assistance,2011,246939,119753,57033,34309,211095,25546,6861,243502,3437,301700,119920,57225,35145,212290,32790,18450,263530,38170,6564545,211049,378192,455432,1049168,989017,1105914,3154994,3251996,267404291000,14854020000,16170856000,18375919000,49398234000,35668693000,34928335000,120061895000,139958717000
Texas,Information,2011,22188,11575,3120,2334,17029,2245,1015,20289,1899,44560,11605,3145,2385,17135,2735,1915,21785,22775,1159266,15068,19976,29966,69241,78991,80679,238822,911141,83076867000,935861000,886628000,1477308000,3350430000,4623633000,5585896000,13816656000,68792206000
Texas,Management of Companies and Enterprises,2011,12651,991,325,516,1832,2326,3382,7540,5111,20305,995,325,535,1855,2365,3685,7905,12400,1360200,13,1695,3487,6695,29930,103385,140010,1220190,161426080000,156265000,115560000,329291000,601160000,2293225000,8575670000,11470055000,149956025000
Texas,Manufacturing,2011,88996,34091,15655,12295,62041,15513,5281,82835,6161,97430,34110,15670,12370,62150,16150,6475,84775,12655,3554286,55732,96927,155618,322273,592720,573054,1557836,1855430,199461390000,2613272000,3591812000,6380298000,12897239000,27239067000,27677711000,70410414000,121191404000
Texas,"Mining, Quarrying, and Oil and Gas Extraction",2011,33219,19403,4598,3390,27391,3805,1000,32196,1023,39565,19425,4610,3410,27445,4140,1520,33105,6460,933629,30544,29703,45779,106345,144601,131223,383731,549432,92817421000,2620231000,2098286000,3105813000,7833655000,11230887000,12780331000,31916554000,60879018000
Texas,Other,2011,1298,1251,40,3,1294,4,0,1298,0,1298,1251,40,3,1294,4,0,1298,0,1406,0,245,0,0,109,0,1406,0,24342000,20590000,2313000,0,23251000,1091000,0,24342000,0
Texas,Other Services (except Public Administration),2011,216802,129117,44138,23603,196858,16061,2365,215284,1518,240445,129240,44415,24565,198220,20805,5535,224560,15885,2051048,244177,286528,312867,844406,583115,255704,1688556,314268,55403285000,5943685000,6704600000,7445692000,20106215000,13771493000,7307647000,41326645000,12755467000
Texas,"Professional, Scientific, and Technical Services",2011,278078,199258,35773,19812,254843,15062,3997,273902,4176,303255,199330,35980,20395,255705,17620,6990,280315,22940,2894275,277979,232820,260080,798508,521550,400138,1727510,1121146,214498250000,17613190000,12238035000,15588742000,45501555000,36983497000,31093649000,113903690000,100043562000
Texas,Real Estate and Rental and Leasing,2011,92187,67847,11519,5415,84781,4231,1611,90623,1564,129600,68110,11775,6035,85920,7765,7100,100785,28815,801415,104523,72886,68186,247552,134479,124752,512879,267424,36573124000,3840547000,2501287000,2775972000,9125124000,5945660000,5944815000,21181025000,14763086000
Texas,Retail Trade,2011,222269,132271,44246,22798,199315,15622,3890,218827,3442,386085,132845,45520,25695,204060,25370,16055,245485,140600,5206901,229899,275406,282727,782025,548154,380901,1769195,3226213,131485994000,6184190000,6748632000,7973726000,21071485000,18189605000,15078775000,54687101000,74971075000
Texas,Total,2011,395817,229492,70283,43695,343470,38150,8813,390433,5384,525420,229980,71122,45892,346994,49197,26005,422196,103224,8987663,395595,461091,585024,1441710,1448038,1230053,4119801,4867862,414113062000,17020240000,16074007000,21053341000,54147588000,55925839000,53908272000,163981699000,250131363000
Texas,Transportation and Warehousing,2011,62975,34629,9894,6274,50797,5996,2452,59245,3730,82015,34700,9940,6400,51040,6755,4750,62545,19470,1591425,51361,62388,80321,195053,198829,185443,598016,983931,74253128000,2369545000,2289126000,3010414000,7722824000,8916112000,8920252000,25901634000,48135397000
Texas,Utilities,2011,4801,2620,845,350,3815,428,220,4463,338,9745,2625,870,360,3855,565,630,5050,4695,238143,5067,5188,4044,15293,19036,30632,64790,145621,20521151000,221286000,252461000,268934000,780113000,1144576000,2298618000,4243807000,16142583000
Texas,Wholesale Trade,2011,123994,62854,20888,14406,98148,14464,5561,118173,5821,157725,63075,21295,15400,99770,18510,11640,129920,27805,2279880,105861,133812,185892,430726,449656,358055,1255670,967835,148413502000,5854776000,6814296000,9800160000,22508610000,24911752000,21326150000,69360710000,74660419000
United States,Accommodation and Food Services,2011,2437106,1010243,485006,452579,1947828,434520,43418,2425766,11340,3245055,1012105,487465,460635,1960205,505210,201265,2666680,578375,57781425,1689884,3235134,6158930,11084020,15890690,7567674,34547805,21747153,971070145000,41134405000,42416774000,82873355000,166427090000,243546820000,121454685000,531428595000,439571932000
United States,Administrative and Support and Waste Management and Remediation Services,2011,1609246,1040684,233800,143397,1417881,132738,39149,1589768,19478,1903355,1041595,235110,146510,1423215,150180,69205,1642600,260755,46949750,1540880,1533135,1929615,5024570,5296175,6779172,17102710,29707132,1631318735000,61907795000,49440155000,65364730000,176712680000,184358695000,206155994000,567382560000,1062907683000
United States,"Agriculture, Forestry, Fishing and Hunting",2011,103283,71406,16855,8346,96607,5053,1108,102768,515,106700,71425,16870,8390,96685,5570,2310,104565,2135,782600,99926,109865,108705,324377,182645,146207,657955,118133,27416690000,4026350000,3693301000,3891923000,11628840000,6635003000,4563578000,22933335000,4300069000
United States,"Arts, Entertainment, and Recreation",2011,570617,360621,75975,56777,493373,60082,12968,566423,4194,616635,361195,76535,57910,495640,65345,21100,582085,34550,10015645,417950,498062,765270,1737855,2404910,2149307,6302235,3686659,317859090000,40942587000,13871755000,17453885000,72310495000,54323320000,80944543000,208679300000,108288004000
United States,Construction,2011,3229695,2236138,484066,277562,2997766,201440,24339,3223545,6150,3288690,2236350,484385,278510,2999245,209015,37740,3246000,42690,25954605,3429720,3160750,3708255,10298725,7529440,3888355,21716520,4230761,1326062025000,131138310000,123143710000,165287825000,419569845000,395532270000,230541970000,1045644085000,279985218000
United States,Educational Services,2011,404427,198775,61935,52176,312886,67921,16803,397610,6817,457460,199030,62265,53685,314980,75085,28865,418930,38530,16930235,310945,414245,709395,1434585,2842340,2900900,7177825,9744019,575856260000,10258990000,9039890000,15379355000,34678235000,80882760000,98953390000,214514385000,361184414000
United States,Finance and Insurance,2011,1177818,843043,162112,69085,1074240,69179,22079,1165498,12320,2337685,846500,168965,85145,1100610,164285,176145,1441040,896645,29433010,1393620,1027369,908728,3416717,2745184,3412255,9581250,19705612,2467914435000,68606573000,56723840000,66050497000,191394263000,210610624000,269515615000,671837113000,1795469006000
United States,Health Care and Social Assistance,2011,3212392,1615729,725358,413136,2754223,314700,103492,3172415,39977,4093630,1619265,731535,431535,2782335,432250,340885,3555470,538160,90195189,2957537,4791028,5490225,13281830,12349957,16374468,42009130,48197525,3900656620000,153880960000,196086110000,231889281000,581881410000,487817127000,545616363000,1615350680000,2281274463000
United States,Information,2011,350210,210464,49600,36345,296409,37135,9780,343324,6886,672260,210925,50175,38130,299230,48660,29485,377375,294885,15606585,305911,327935,486092,1123850,1437418,1545714,4111095,10791310,1170068225000,22564640000,15279050000,24325166000,62180310000,87417803000,109161591000,259034570000,909688433000
United States,Management of Companies and Enterprises,2011,135964,14481,3963,5766,24210,29283,44944,98437,37527,247485,14610,4030,5920,24560,30245,50400,105205,142280,14608345,18554,18165,34392,71380,352590,1445765,1870050,12738295,1494092810000,2557098000,1913465000,2901277000,7362896000,24640185000,105885085000,138069670000,1356023140000
United States,Manufacturing,2011,1306462,536328,236633,193209,966170,236134,66760,1269064,37398,1478215,536550,236960,194785,968295,251790,101290,1321375,156840,54822967,988400,1574624,2628879,5204324,9513331,10098189,24861585,29782681,2869772047000,39682766000,55958119000,103958329000,199800434000,423225586000,482437762000,1107365713000,1754774968000
United States,"Mining, Quarrying, and Oil and Gas Extraction",2011,107952,62072,16046,11741,89859,12530,3334,105723,2229,140110,62180,16225,12050,90455,15150,7140,112745,27365,3250779,97887,105678,157389,362242,467144,480644,1312708,1933088,275922454000,6996249000,6208477000,9876026000,23226636000,32376575000,38548070000,94302757000,181189368000
United States,Other,2011,17243,16777,360,86,17223,20,0,17243,0,17243,16777,360,86,17223,20,0,17243,0,0,0,2233,1089,0,595,0,0,0,288159000,247715000,23943000,9110000,280768000,7391000,0,288159000,0
United States,Other Services (except Public Administration),2011,3306520,2113140,660275,311686,3085101,192984,21302,3299387,7133,3611990,2115630,665690,325095,3106415,249530,79295,3435240,176750,25876200,3964468,4279395,4098171,12343675,6901335,2916036,22168630,3450972,721128205000,94994215000,101534880000,104036245000,300565340000,188866845000,100088297000,589826790000,129900463000
United States,"Professional, Scientific, and Technical Services",2011,3836110,2829350,492016,271867,3593233,189744,34373,3817350,18760,4254515,2831640,495895,283160,3610695,244110,94980,3949785,304730,39649550,4186625,3206820,3614265,11032475,7058775,5317832,23412580,15989654,2840152035000,223609785000,166578740000,210523240000,600711765000,500400785000,407509230000,1509072065000,1328976736000
United States,Real Estate and Rental and Leasing,2011,1320196,1030876,149674,69812,1250362,50340,12831,1313533,6663,1708415,1034560,155520,80340,1270420,92175,83645,1446240,262175,9233129,1519842,956017,900238,3369319,1753550,1423783,6566055,2712841,416663542000,54103370000,34247455000,35121345000,123472170000,76816530000,65570670000,265880550000,144851567000
United States,Retail Trade,2011,3290816,1975155,665642,354371,2995168,239914,41644,3276726,14090,5314710,1983815,683430,394680,3061925,385635,231415,3678975,1635735,71544224,3403899,4329064,4599323,12403257,8693432,5311552,26561641,42913849,1808437064000,88933748000,102355800000,120461458000,311979517000,281512231000,180098462000,773640157000,1022905245000
United States,Total,2011,5684424,3532058,978993,592963,5104014,481496,81243,5666753,17671,7354043,3540155,993101,626981,5160237,651624,350197,6162058,1191985,113425965,5857662,6431931,7961281,20250874,18880001,15867437,54998312,58427653,5164897905000,230422086000,218085669000,284251614000,732759369000,746085051000,690509553000,2169353973000,2995543932000
United States,Transportation and Warehousing,2011,831868,531228,117995,77991,727214,70819,19275,817308,14560,1059270,532010,119105,80840,731955,86695,49385,868035,191235,20514690,779430,774799,1036743,2608279,2602910,2345202,7561798,12880594,878777678000,28812671000,26556713000,36860625000,92250465000,100610707000,95455459000,288582383000,588019313000
United States,Utilities,2011,29641,15188,4845,2269,22302,4443,1559,28304,1337,88170,15225,4990,2540,22755,7285,6415,36455,51715,3198975,28894,31267,30336,91321,196839,257515,546272,2652660,289544310000,1101546000,1349981000,1746295000,4205930000,13141907000,19690993000,37083145000,252461165000
United States,Wholesale Trade,2011,1561856,888472,262310,179828,1330610,170408,41053,1542071,19785,2059650,892280,268555,194615,1355450,239805,140020,1735275,324375,28131640,1504870,1721795,2382825,5616260,6164955,4884770,16665985,11360015,1785874680000,74975325000,83841145000,122955910000,281772380000,337105580000,285238545000,904116505000,878084723000
Utah,Accommodation and Food Services,2011,18296,6105,3543,3670,13318,3960,495,17773,523,24785,6125,3580,3735,13440,4605,1970,20015,4770,459698,7882,24037,50063,83714,142148,69111,296718,156552,6452366000,244442000,270397000,590578000,1109576000,1770698000,978875000,3883571000,2556422000
Utah,Administrative and Support and Waste Management and Remediation Services,2011,17745,11475,2135,1463,15073,1183,553,16809,936,19230,11475,2140,1480,15095,1240,635,16970,2260,503692,12394,13051,18359,46273,43916,51475,152154,335746,15740616000,513292000,347998000,518847000,1414765000,1450783000,1462371000,4572596000,10815715000
Utah,"Agriculture, Forestry, Fishing and Hunting",2011,320,220,50,30,300,5,10,315,5,335,220,50,30,300,5,10,315,20,1359,68,254,0,782,0,0,965,0,62921000,6725000,8383000,0,27147000,0,0,42115000,0
Utah,"Arts, Entertainment, and Recreation",2011,4322,2705,540,380,3625,465,122,4212,110,4430,2705,540,380,3625,490,165,4280,150,87083,2982,2122,4248,10970,14790,13679,45094,34361,1748523000,110887000,72257000,71737000,279182000,255281000,198206000,873844000,580799000
Utah,Construction,2011,41546,29760,5734,3183,38677,2192,316,41185,361,41770,29760,5740,3185,38685,2225,345,41255,515,279235,35207,36387,41257,123054,76402,34391,241693,26851,12278084000,1426345000,1205017000,1554670000,4205155000,3493917000,1868432000,9905834000,1733553000
Utah,Educational Services,2011,4413,2190,660,595,3445,670,150,4265,148,4685,2190,660,600,3450,700,160,4310,375,123487,983,4009,7389,13846,27993,14895,59655,1215,3302248000,97668000,69090000,117287000,293380000,755675000,486768000,1626630000,39585000
Utah,Finance and Insurance,2011,15632,11120,1600,690,13410,749,260,14419,1213,24025,11150,1620,805,13575,1450,1215,16240,7785,258008,14896,9201,7628,33647,22398,21444,84369,163892,13551909000,604271000,402444000,402271000,1436300000,1310728000,1149030000,4511552000,8793145000
Utah,Health Care and Social Assistance,2011,30248,16265,6678,3765,26708,2322,548,29578,670,35145,16290,6700,3895,26885,3035,1565,31485,3660,601392,20396,43737,47574,119834,91875,71084,290138,196443,23619344000,1579487000,1312569000,1464413000,4386166000,3091559000,2315771000,10134829000,8470504000
Utah,Information,2011,5001,2595,535,380,3510,529,291,4330,671,6965,2600,535,390,3525,550,435,4510,2455,152149,1956,2862,3721,10461,16615,28626,58897,77193,9484892000,150805000,127450000,136780000,453685000,1011297000,1699840000,3253267000,5436500000
Utah,Management of Companies and Enterprises,2011,1657,220,20,30,270,330,385,985,672,2130,220,20,30,270,335,400,1005,1125,89697,211,0,0,503,3804,12661,16899,72425,7374497000,11597000,0,0,24390000,216739000,917717000,1164217000,6210280000
Utah,Manufacturing,2011,15087,5975,2705,2175,10855,2280,696,13831,1256,15525,5975,2710,2180,10865,2325,755,13945,1580,435744,7118,14157,22558,48390,72527,42407,194019,186007,21662321000,311747000,475411000,778979000,1736970000,2985503000,2026319000,8057402000,10465331000
Utah,"Mining, Quarrying, and Oil and Gas Extraction",2011,2232,1174,260,190,1624,250,76,1950,282,2390,1175,260,190,1625,255,80,1960,430,46759,1571,1446,2283,5683,5991,2884,15027,29818,3580938000,83260000,77721000,139607000,310313000,385403000,262217000,1000109000,2452662000
Utah,Other,2011,73,70,2,1,73,0,0,73,0,73,70,2,1,73,0,0,73,0,0,0,0,0,0,0,0,0,0,1211000,1141000,0,0,1211000,0,0,1211000,0
Utah,Other Services (except Public Administration),2011,20498,13025,3775,1971,18771,1135,192,20098,400,22830,13055,3805,2110,18970,1960,410,21340,1490,229667,19449,22409,22743,67027,33325,7322,113752,49031,7360357000,553817000,590162000,619246000,1793141000,805808000,265672000,3158186000,1914737000
Utah,"Professional, Scientific, and Technical Services",2011,42006,31025,4320,2570,37915,2082,761,40758,1248,44245,31025,4345,2615,37985,2445,905,41335,2910,340961,31972,27408,32169,99124,68190,59099,235962,95332,18481281000,1752346000,1160486000,1575343000,4530215000,4033839000,3596390000,12427754000,5652318000
Utah,Real Estate and Rental and Leasing,2011,18345,15235,1353,576,17164,550,212,17926,419,20760,15250,1400,620,17270,860,415,18545,2215,89061,7512,7822,6419,31602,15296,8859,61380,15782,2996949000,546312000,244094000,216896000,1032071000,548966000,337008000,2040130000,595734000
Utah,Retail Trade,2011,29989,15407,5803,3867,25077,2541,701,28319,1670,44540,15465,6000,4150,25615,3845,2660,32120,12420,661569,19914,34225,46415,106267,85137,52742,261116,347246,16342745000,618772000,837582000,1125742000,2628883000,2396192000,1527912000,6823696000,9090729000
Utah,Total,2011,57455,35651,8560,5521,49732,4619,1201,55552,1903,68747,35705,8663,5742,50110,5866,2793,58769,9978,1029103,52190,56261,73196,181647,169821,134857,486325,542778,39922601000,1908341000,1644165000,2204929000,5757435000,5986131000,5468843000,17212409000,22710192000
Utah,Transportation and Warehousing,2011,9720,6010,1045,760,7815,747,327,8889,831,10750,6010,1045,820,7875,785,375,9035,1715,211521,5911,6164,9256,24174,22632,21935,70943,122584,8867052000,300845000,214628000,344605000,891545000,898481000,869971000,2714764000,5107726000
Utah,Utilities,2011,396,240,35,30,305,37,10,352,44,1080,240,35,30,305,90,20,415,665,693,380,255,415,1050,1159,0,4275,0,25155000,9123000,11065000,15800000,35988000,82709000,0,311326000,0
Utah,Wholesale Trade,2011,15524,7210,2098,1422,10730,1934,1019,13683,1841,17750,7245,2120,1460,10825,2130,1445,14400,3350,243015,7611,11169,14493,39143,49270,34205,141585,79097,13297585000,479412000,548802000,732507000,1840158000,2442426000,2060644000,7339707000,4925120000
Vermont,Accommodation and Food Services,2011,8422,3395,1650,1710,6755,1303,163,8221,201,9400,3395,1665,1740,6800,1480,380,8660,740,146083,4733,10943,23483,39255,41600,16418,99176,40655,2346965000,128022000,148004000,321522000,606835000,700126000,305500000,1617395000,684569000
Vermont,Administrative and Support and Waste Management and Remediation Services,2011,5131,3650,615,255,4520,285,40,4845,286,5320,3650,615,265,4530,320,40,4890,430,31858,4185,3453,2049,10883,7625,0,22506,5005,1013153000,202060000,98459000,59748000,403774000,228852000,0,733617000,181710000
Vermont,"Agriculture, Forestry, Fishing and Hunting",2011,625,535,55,25,615,5,5,625,0,625,535,55,25,615,5,5,625,0,1573,327,257,107,1318,0,0,1573,0,54323000,20996000,7651000,3394000,40581000,0,0,54323000,0
Vermont,"Arts, Entertainment, and Recreation",2011,2204,1475,310,185,1970,170,39,2179,25,2250,1475,310,185,1970,185,65,2220,30,33571,1397,1662,1716,6290,3986,5762,18699,8920,553502000,88718000,45534000,55678000,215065000,86809000,69440000,420527000,79115000
Vermont,Construction,2011,13518,10510,1650,760,12920,485,63,13468,50,13535,10510,1650,765,12925,490,70,13485,50,59219,13132,10276,8910,34258,13922,3135,56777,73,3010165000,664750000,465602000,456543000,1639740000,783725000,199712000,2843435000,5885000
Vermont,Educational Services,2011,1768,945,205,195,1345,248,115,1708,60,1860,945,205,195,1345,315,135,1795,65,72158,1281,1108,1770,5499,9105,21042,37413,34403,1993886000,48300000,34403000,48535000,139329000,254289000,663107000,1103636000,880797000
Vermont,Finance and Insurance,2011,2684,1480,290,150,1920,194,114,2228,456,4890,1490,300,235,2025,540,680,3245,1645,46164,1963,1724,1422,5408,5489,8034,22309,17717,2765154000,112121000,87180000,94792000,325526000,421069000,393515000,1409071000,1262648000
Vermont,Health Care and Social Assistance,2011,8751,4090,1820,1150,7060,1045,357,8462,289,10495,4100,1825,1170,7095,1370,1005,9470,1025,247955,7630,9956,13304,33583,38831,41714,118568,112527,8622105000,342147000,416797000,466267000,1254228000,1171863000,1400920000,3904950000,4389030000
Vermont,Information,2011,1807,800,285,210,1295,230,87,1612,195,2340,800,285,215,1300,310,130,1740,600,20610,806,1352,2351,5846,6519,1090,16674,4008,1241606000,43573000,48853000,83758000,200730000,323775000,56656000,695957000,256029000
Vermont,Management of Companies and Enterprises,2011,375,20,20,15,55,85,85,225,150,390,20,20,15,55,85,90,230,160,13913,0,60,0,169,0,1729,2858,0,1005045000,0,7268000,3640000,16610000,0,110184000,194795000,648200000
Vermont,Manufacturing,2011,4723,2200,750,545,3495,690,301,4486,237,4930,2200,750,550,3500,705,420,4625,305,89172,1716,2995,4530,12954,16436,11834,58517,18692,4540473000,105532000,99466000,167050000,463444000,753662000,559946000,2678148000,1073690000
Vermont,"Mining, Quarrying, and Oil and Gas Extraction",2011,206,135,25,5,165,20,10,195,11,230,135,25,5,165,40,10,215,15,1584,9,16,0,312,563,0,1152,0,101657000,13709000,4477000,0,26245000,25790000,0,72852000,0
Vermont,Other,2011,55,54,1,0,55,0,0,55,0,55,54,1,0,55,0,0,55,0,0,0,0,0,0,0,0,0,0,936000,902000,0,0,936000,0,0,936000,0
Vermont,Other Services (except Public Administration),2011,9671,6585,1830,730,9145,326,78,9549,122,10070,6615,1855,780,9250,480,150,9880,190,43547,11738,10807,8250,32301,6269,159,42323,456,1160699000,323811000,271450000,208531000,813286000,202604000,14173000,1120811000,19608000
Vermont,"Professional, Scientific, and Technical Services",2011,10571,7440,1520,700,9660,460,105,10225,346,10845,7440,1530,705,9675,560,130,10365,480,94789,9666,9518,8302,29890,12822,6373,53068,29114,4928970000,502445000,467778000,501443000,1512766000,813971000,499683000,3156746000,1671302000
Vermont,Real Estate and Rental and Leasing,2011,3203,2430,330,170,2930,105,45,3080,123,3570,2445,330,195,2970,170,140,3280,290,13925,3495,1905,1721,7691,1884,449,11833,1095,477051000,129338000,61955000,56944000,260073000,76639000,13268000,411281000,45336000
Vermont,Retail Trade,2011,13369,6044,2999,1869,10912,1238,324,12474,895,17915,6060,3040,2025,11125,1980,1470,14575,3340,187516,9222,16631,18752,49064,29911,15055,103622,37388,4738496000,273395000,424162000,547457000,1296712000,1046582000,465873000,3099956000,770673000
Vermont,Total,2011,18361,10993,3029,1820,15842,1458,359,17659,702,21190,11013,3056,1915,15984,1980,1095,19059,2131,264208,18290,19783,23897,61970,51684,43106,156760,107448,9589916000,654964000,620542000,746110000,2021616000,1850599000,1712650000,5584865000,4005051000
Vermont,Transportation and Warehousing,2011,2207,1330,305,125,1760,211,75,2046,161,2445,1330,305,125,1760,225,110,2095,350,25577,1476,1480,914,4913,4707,1283,13808,4826,914094000,61679000,58421000,39221000,177422000,169752000,46683000,544626000,181878000
Vermont,Utilities,2011,142,45,10,10,65,15,28,108,34,305,45,10,10,65,20,85,170,135,8087,41,0,0,88,294,2110,2701,0,735359000,2923000,0,0,9961000,19812000,190978000,264402000,0
Vermont,Wholesale Trade,2011,3833,1603,500,370,2473,510,283,3266,567,4260,1605,500,370,2475,620,360,3455,805,48383,1577,1727,3189,8641,11113,7532,36539,7605,2419304000,90996000,108430000,136862000,410004000,541274000,430975000,1819057000,434356000
Virginia,Accommodation and Food Services,2011,59678,22520,12109,11863,46492,10420,1331,58243,1435,82310,22535,12190,11970,46695,11670,5350,63715,18595,1500584,37983,79897,158421,276856,369377,179599,826880,674929,24093500000,887784000,1126518000,2215254000,4231435000,5821967000,2619543000,12683957000,11070129000
Virginia,Administrative and Support and Waste Management and Remediation Services,2011,43506,24905,6662,4125,35692,4230,1617,41539,1967,50750,24920,6695,4145,35760,4835,2370,42965,7785,1195746,37885,42757,54468,137932,151733,203907,500821,665545,49078793000,1350282000,1359110000,1876503000,4608440000,5461426000,6845637000,17192529000,29542053000
Virginia,"Agriculture, Forestry, Fishing and Hunting",2011,3300,2300,655,215,3170,65,30,3265,35,3315,2300,655,215,3170,65,45,3280,35,17032,2780,4002,2358,10387,382,332,13518,610,716865000,117402000,122732000,67062000,319061000,56340000,9843000,430175000,55447000
Virginia,"Arts, Entertainment, and Recreation",2011,12525,7355,1565,1325,10245,1650,347,12242,283,13550,7355,1565,1330,10250,1735,510,12495,1055,225616,9108,9866,17142,37665,63457,39888,145198,65991,4985904000,375490000,205792000,316837000,920048000,1201241000,1002281000,3347277000,1226455000
Virginia,Construction,2011,96622,63805,15355,8817,87977,6948,1036,95961,661,98055,63805,15355,8855,88015,7140,1290,96445,1610,854170,105551,99780,119250,326345,256492,132070,720745,122694,40366985000,3488590000,3584261000,4850545000,11924600000,12111720000,7268385000,31445560000,8337364000
Virginia,Educational Services,2011,11930,5997,1640,1530,9167,1897,487,11551,379,13050,6010,1640,1575,9225,2030,620,11875,1175,352171,9024,10476,20849,40828,76337,75948,197173,143698,11523590000,315081000,228878000,470277000,1023031000,2252498000,2875795000,6316713000,5080544000
Virginia,Finance and Insurance,2011,27910,18319,3665,1491,23475,1679,908,26062,1848,55950,18390,3855,1960,24205,3235,4670,32110,23840,704943,30548,21675,17529,70630,54181,65038,202984,473020,50754364000,1463511000,1131728000,1279074000,3913780000,3907672000,4052669000,12498989000,36751763000
Virginia,Health Care and Social Assistance,2011,71017,31420,16918,10521,58859,8333,2012,69204,1813,91125,31520,17130,11180,59830,11140,6630,77600,13525,1953894,57209,111457,138642,308389,313494,302464,941261,959378,87456178000,2897624000,4914030000,6404199000,14221602000,13328248000,11534372000,39468968000,45718901000
Virginia,Information,2011,9855,4585,1225,972,6782,1164,650,8596,1259,19260,4595,1225,985,6805,1335,905,9045,10215,457445,5177,7790,12374,27413,36071,52951,123605,291345,38312119000,421980000,383358000,679434000,1520317000,2364474000,4981410000,9177381000,28678455000
Virginia,Management of Companies and Enterprises,2011,4007,230,55,115,400,615,1187,2202,1805,5815,230,55,115,400,620,1285,2305,3510,282610,208,196,720,1224,7514,33303,42041,239436,26509085000,60777000,20130000,75540000,156447000,521455000,2481620000,3159522000,23064484000
Virginia,Manufacturing,2011,23806,8755,4455,3055,16265,3845,1496,21606,2200,25525,8755,4455,3080,16290,4085,1755,22130,3395,942247,13007,26226,35421,81316,127652,119060,373843,468297,46835487000,550242000,888978000,1348461000,2984366000,5330454000,5437245000,15658418000,27164094000
Virginia,"Mining, Quarrying, and Oil and Gas Extraction",2011,1016,290,90,155,535,219,102,856,160,1510,290,90,155,535,255,185,975,535,48396,157,362,1704,2552,6698,7442,18678,27830,3343305000,24064000,17203000,91768000,148737000,352366000,394394000,996510000,2253630000
Virginia,Other,2011,352,346,3,3,352,0,0,352,0,352,346,3,3,352,0,0,352,0,0,0,0,0,0,0,0,0,0,6214000,5787000,85000,0,6214000,0,0,6214000,0
Virginia,Other Services (except Public Administration),2011,97452,58870,20062,10274,89206,6545,898,96649,803,105525,58945,20175,10660,89780,7940,2480,100200,5325,814051,111246,130327,133191,377607,229180,81385,696442,86624,27443682000,2818140000,3321072000,3993761000,10162955000,8088414000,4238174000,22671727000,3242743000
Virginia,"Professional, Scientific, and Technical Services",2011,124370,85114,15135,8862,109111,9075,3038,121224,3146,145535,85135,15200,9040,109375,10570,4680,124625,20910,2102307,107385,98870,117060,337097,327131,338841,1015318,1064702,179830154000,7686549000,6068330000,8020771000,21801294000,26110552000,28858619000,77176885000,101193589000
Virginia,Real Estate and Rental and Leasing,2011,31193,23274,3129,1599,28002,1494,769,30265,928,42775,23360,3275,1850,28485,3160,3030,34675,8100,250872,32187,19620,19610,74504,44066,45739,169171,71498,11479508000,1249346000,753181000,830211000,2851308000,2142780000,2125171000,7341375000,3945095000
Virginia,Retail Trade,2011,80311,43802,16650,9298,69750,5926,1781,77457,2854,137125,44015,17175,10280,71470,8770,5575,85815,51310,1890261,72808,105907,113771,292233,187023,111248,626541,1125125,48510723000,1959478000,2477031000,2944329000,7417789000,6520611000,4633809000,19134413000,27218567000
Virginia,Total,2011,146922,85837,25175,15741,126753,13450,3409,143612,3310,191063,85995,25511,16493,127999,17010,9169,154178,36885,3029030,146360,165602,209202,521164,493802,416835,1431801,1597229,145346258000,5514102000,5752394000,7736306000,19002802000,21051145000,20646665000,60700612000,84645646000
Virginia,Transportation and Warehousing,2011,20492,11814,2704,1814,16332,1781,844,18957,1535,23995,11820,2715,1855,16390,1955,1200,19545,4450,442498,15790,16518,22636,58471,56234,44420,162350,242704,18756436000,565260000,552491000,798394000,1956072000,2262843000,1905664000,6245448000,10815613000
Virginia,Utilities,2011,480,155,25,5,185,72,65,322,158,1675,155,25,5,185,100,175,460,1215,39767,102,0,0,367,1856,7230,9633,7418,3630941000,11186000,0,0,17277000,141266000,549561000,713985000,3225537000
Virginia,Wholesale Trade,2011,28861,14085,3985,3074,21144,3547,1666,26357,2504,36710,14110,4065,3195,21370,4410,3090,28870,7840,486243,20696,24442,37950,88860,101631,76716,282956,189926,29815574000,1167844000,1294236000,1917598000,4483065000,5526220000,4719556000,15285953000,13730854000
Washington,Accommodation and Food Services,2011,64467,26470,14810,12163,53443,9116,1095,63654,813,80440,26515,14880,12465,53860,11165,4520,69545,10895,1097544,42565,95357,161182,299744,304733,146924,750134,330382,20581510000,920670000,1324916000,2521831000,4744246000,5569877000,2786633000,13195910000,6804211000
Washington,Administrative and Support and Waste Management and Remediation Services,2011,39424,25260,6005,3165,34430,2710,787,37927,1497,43905,25260,6045,3235,34540,2980,1125,38645,5260,672419,35948,37288,41219,118484,94527,81209,312932,341825,27922323000,1246794000,1180098000,1376444000,3852323000,3696617000,2673146000,10654118000,16768982000
Washington,"Agriculture, Forestry, Fishing and Hunting",2011,6721,5030,720,405,6155,349,140,6644,77,6820,5030,720,405,6155,365,170,6690,130,57673,4141,4638,4571,15137,12926,18653,48069,7879,2612602000,366843000,192805000,214908000,844758000,565263000,690817000,2161488000,368585000
Washington,"Arts, Entertainment, and Recreation",2011,12745,7230,1900,1315,10445,1600,471,12516,229,13635,7230,1900,1325,10455,1670,820,12945,690,293478,7283,11580,16186,37630,65235,74615,183429,98984,8203147000,380850000,255001000,365484000,1064651000,1216094000,1591077000,3965342000,3209679000
Washington,Construction,2011,98002,71175,13540,7097,91812,5000,644,97456,546,98795,71175,13545,7105,91825,5150,865,97840,955,631930,102927,87612,93467,286245,182983,79944,553073,65502,34868710000,3929885000,3540399000,4540380000,12013210000,10594431000,6067218000,28876616000,5051140000
Washington,Educational Services,2011,11448,5895,1810,1568,9273,1563,320,11156,292,12130,5895,1820,1590,9305,1745,460,11510,620,252702,8458,12050,20881,42046,61346,38510,147047,103837,6750824000,292376000,250322000,438191000,990444000,1516586000,1215269000,3915236000,2771579000
Washington,Finance and Insurance,2011,24942,16987,2955,1243,21185,1264,790,23239,1703,48845,17080,3020,1440,21540,2490,3935,27965,20880,456760,26846,18091,14903,62397,37589,65995,174113,267842,32332106000,1363775000,928762000,1124747000,3445855000,2690300000,3905523000,10641592000,21173881000
Washington,Health Care and Social Assistance,2011,80780,41905,18795,9704,70404,6611,2222,79237,1543,96700,41930,18935,10020,70885,9330,6310,86525,10175,1846470,70883,123648,126016,328746,249410,325747,914324,916058,85851563000,2902489000,4759281000,5033626000,12722820000,9837393000,12473289000,35400302000,49844761000
Washington,Information,2011,9918,4826,1336,1090,7252,1132,453,8837,1081,15830,4830,1345,1100,7275,1285,580,9140,6690,546260,5507,7180,12344,24296,37133,33326,108853,229808,65070504000,391491000,417491000,692513000,1579088000,2444629000,2828827000,7833334000,22169897000
Washington,Management of Companies and Enterprises,2011,3718,340,115,135,590,710,1028,2328,1390,4890,340,115,135,590,720,1090,2400,2490,449950,394,640,746,1784,8962,28353,39242,410708,43224368000,37307000,59045000,86105000,182457000,535954000,1968536000,2695613000,40528755000
Washington,Manufacturing,2011,33127,14595,5645,4383,24623,4863,1681,31167,1960,34530,14595,5655,4410,24660,4975,2015,31650,2880,920473,21524,31052,51019,112774,171000,150484,482945,308220,49980660000,890043000,1229005000,2187677000,4586168000,8099071000,8110195000,22621411000,18810066000
Washington,"Mining, Quarrying, and Oil and Gas Extraction",2011,725,320,125,85,530,64,49,643,82,905,320,125,90,535,85,105,725,180,11582,410,705,781,2080,1451,0,5886,3562,838585000,40119000,36111000,45257000,138899000,103128000,0,421656000,289637000
Washington,Other,2011,387,375,8,3,386,1,0,387,0,387,375,8,3,386,1,0,387,0,0,0,43,38,0,0,0,0,0,7017000,5562000,309000,1097000,6968000,0,0,7017000,0
Washington,Other Services (except Public Administration),2011,74868,47876,14895,6721,69492,4071,696,74259,609,81895,47905,14975,6995,69875,5465,2060,77400,4495,535448,83864,93735,83545,264960,130906,51382,459176,51359,15538070000,2147414000,2390518000,2237021000,6813748000,3701214000,1599588000,12336997000,2260090000
Washington,"Professional, Scientific, and Technical Services",2011,93479,67010,11365,6527,84902,4931,1609,91442,2037,99670,67010,11400,6710,85120,5505,2465,93090,6580,828034,91977,72591,84441,252861,164026,131944,556820,244209,60059259000,5253920000,4021835000,5110580000,14464474000,12776405000,10012022000,37767517000,20595236000
Washington,Real Estate and Rental and Leasing,2011,36319,28071,4016,1631,33718,1331,558,35607,712,46480,28180,4175,1910,34265,2195,2620,39080,7400,216973,39886,24793,20223,86584,35777,30425,160990,48017,9281205000,1277985000,829306000,823792000,2936087000,1598196000,1420590000,6201269000,2477901000
Washington,Retail Trade,2011,72198,38590,15429,8397,62416,6089,1463,69968,2230,107870,38760,15760,9230,63750,9630,4940,78320,29550,1479928,55375,91716,104020,256766,206476,100751,593790,759819,42620609000,1698515000,2340035000,2878691000,6910809000,7126612000,4200092000,18675276000,21125600000
Washington,Total,2011,142185,86952,24351,14177,125480,11081,2841,139402,2783,173511,87079,24614,14855,126548,14516,7911,148975,24536,2355123,141260,159498,187306,488064,403197,330558,1221819,1133304,118647827000,5171828000,5346173000,6765829000,17283830000,16752467000,15319652000,49355949000,69291878000
Washington,Transportation and Warehousing,2011,20997,12000,2710,1802,16512,1839,1016,19367,1630,24350,12010,2745,1865,16620,2070,1595,20285,4065,406470,14744,16430,21849,56321,54889,37917,160470,210292,19786880000,700274000,660985000,857297000,2291207000,2151892000,1913041000,6512778000,11500057000
Washington,Utilities,2011,983,585,155,55,795,72,33,900,83,1525,585,160,55,800,120,80,1000,525,4619,1135,837,627,2817,0,0,4648,70,286592000,22490000,27242000,34025000,95912000,190057000,0,263756000,5016000
Washington,Wholesale Trade,2011,37751,18842,5619,3873,28334,4454,2143,34931,2820,46405,18870,5710,4175,28755,5630,3800,38185,8220,601738,27572,32697,46563,112651,133403,99061,361353,207677,37586430000,1660084000,1801454000,2514793000,6076772000,7485310000,5387690000,19483043000,16845711000
West Virginia,Accommodation and Food Services,2011,13523,5105,2825,2313,10243,2339,488,13070,453,18330,5110,2870,2365,10345,3015,2080,15440,2890,299395,7063,18550,31657,58973,82783,54583,197088,95031,3958111000,138303000,218633000,367733000,730001000,1058777000,691197000,2504656000,1291260000
West Virginia,Administrative and Support and Waste Management and Remediation Services,2011,6446,3486,1025,605,5116,570,197,5883,563,7270,3490,1025,605,5120,635,215,5970,1300,156840,3691,5797,7091,18707,19117,27435,69124,69513,4238267000,153552000,152465000,211206000,552382000,624053000,798360000,2064674000,1570078000
West Virginia,"Agriculture, Forestry, Fishing and Hunting",2011,1100,900,140,35,1075,15,5,1095,5,1100,900,140,35,1075,15,5,1095,5,2987,1419,854,377,2666,0,0,2947,0,77935000,33990000,18089000,11107000,67035000,0,0,74385000,0
West Virginia,"Arts, Entertainment, and Recreation",2011,3284,1795,615,465,2875,261,64,3200,84,3490,1795,615,510,2920,365,85,3370,120,53424,1201,3617,6011,12644,7264,5262,27125,25585,1214200000,73125000,55309000,112481000,247150000,129271000,48305000,455686000,735968000
West Virginia,Construction,2011,17315,11385,2900,1670,15955,1024,185,17164,151,17440,11385,2900,1670,15955,1055,235,17245,195,122178,17442,17901,21107,58976,36753,8527,114382,3868,5721555000,544730000,590797000,864388000,2037434000,1997787000,554954000,5194411000,290139000
West Virginia,Educational Services,2011,1343,620,225,160,1005,208,75,1288,55,1405,620,225,160,1005,225,105,1335,70,42062,824,1255,1806,4615,5633,11883,26740,18092,1280795000,19838000,20821000,35059000,84352000,108816000,360679000,614836000,576439000
West Virginia,Finance and Insurance,2011,5701,3358,850,320,4528,451,149,5128,573,10550,3360,875,450,4685,1240,685,6610,3940,86400,6483,5131,3752,15820,15887,9640,42974,17636,3692225000,206200000,178531000,167127000,567257000,575761000,394284000,1616839000,1908094000
West Virginia,Health Care and Social Assistance,2011,17601,6720,4325,2758,13803,2129,985,16917,684,24735,6725,4330,2825,13880,3135,3040,20055,4680,625599,13736,27841,34498,78109,81658,123953,291995,312376,23607520000,485563000,938346000,1336351000,2787450000,2773260000,3427846000,9172234000,14089394000
West Virginia,Information,2011,1353,420,215,165,800,172,76,1048,305,3620,420,215,165,800,245,150,1195,2425,50642,387,1066,1121,3811,4053,946,11753,31944,2229446000,21915000,24913000,37963000,98187000,147647000,36116000,377014000,1682727000
West Virginia,Management of Companies and Enterprises,2011,795,55,5,20,80,185,255,520,275,990,55,5,20,80,185,260,525,465,25586,0,0,0,233,2359,4422,7086,18500,1721425000,4625000,0,0,10790000,93796000,405969000,511930000,1209495000
West Virginia,Manufacturing,2011,5956,1865,1005,908,3778,1089,439,5306,650,6390,1865,1010,910,3785,1160,590,5535,855,186491,2011,4976,8752,18817,30389,21543,83619,74022,9363852000,91823000,145616000,313913000,604580000,1168711000,959440000,3331358000,4903138000
West Virginia,"Mining, Quarrying, and Oil and Gas Extraction",2011,2554,1020,420,300,1740,395,191,2326,228,3425,1020,430,300,1750,420,240,2410,1015,163061,901,1743,2944,5773,15676,24444,51463,99934,12475535000,86219000,91067000,203487000,446581000,903175000,1759352000,3341114000,9123627000
West Virginia,Other,2011,59,54,3,2,59,0,0,59,0,59,54,3,2,59,0,0,59,0,0,0,17,0,0,0,0,0,0,987000,670000,205000,0,987000,0,0,987000,0
West Virginia,Other Services (except Public Administration),2011,21195,13490,4495,1761,19746,969,194,20909,286,22625,13525,4530,1830,19885,1325,260,21470,1155,125527,25207,28276,21685,77122,27076,4862,115101,7334,2845004000,475224000,531190000,484089000,1511526000,658166000,148632000,2506146000,265771000
West Virginia,"Professional, Scientific, and Technical Services",2011,13321,7910,2275,1190,11375,939,347,12661,660,14880,7930,2280,1230,11440,1205,565,13210,1670,120090,12701,13704,14439,42256,31316,10756,92398,22763,5522720000,518466000,520136000,587183000,1658571000,1530347000,475700000,4003194000,1389547000
West Virginia,Real Estate and Rental and Leasing,2011,5728,4150,685,340,5175,177,93,5445,283,6800,4170,720,355,5245,290,270,5805,995,28066,6636,3842,3976,14982,2262,329,20721,6085,912982000,182670000,112042000,114696000,436178000,76892000,32688000,647637000,219925000
West Virginia,Retail Trade,2011,19420,9159,4021,2565,15745,2003,418,18166,1254,32300,9210,4115,2765,16090,3180,1655,20925,11375,353532,14457,23114,28677,71189,57194,24982,163836,159185,8118183000,339200000,533999000,772369000,1670834000,1755307000,654847000,4203446000,3734892000
West Virginia,Total,2011,28977,15368,5569,3367,24304,2709,754,27767,1210,38150,15407,5636,3522,24565,3877,2257,30699,7451,568344,28510,36269,44635,109414,98579,86401,294394,273950,20681836000,754172000,949171000,1302103000,3005446000,3231969000,3002777000,9240192000,11441644000
West Virginia,Transportation and Warehousing,2011,5379,3034,800,585,4419,419,142,4980,399,6240,3035,800,590,4425,435,175,5035,1205,58118,4540,4719,6881,17402,12409,3196,36014,12835,2213970000,153452000,157723000,239327000,566445000,476141000,113670000,1241239000,607349000
West Virginia,Utilities,2011,332,110,55,30,195,25,30,250,82,1145,110,55,30,195,75,130,400,745,28274,200,268,0,768,578,1142,2497,20059,2398716000,7670000,7326000,0,29460000,21477000,82084000,128182000,1757548000
West Virginia,Wholesale Trade,2011,6163,2030,1006,750,3786,921,364,5071,1092,7720,2040,1025,785,3850,1180,540,5570,2150,88268,2929,4569,7467,17111,18734,9755,51384,25084,4282568000,145279000,197800000,296049000,700178000,840255000,519096000,2425761000,1488080000
Wisconsin,Accommodation and Food Services,2011,58199,23725,11227,11103,46055,10263,1023,57341,858,70315,23805,11285,11200,46290,11920,3715,61925,8390,1082575,40032,74230,150348,265580,362168,134071,762322,267291,14044705000,783835000,785561000,1578397000,3152330000,4380188000,1975944000,9512462000,4375342000
Wisconsin,Administrative and Support and Waste Management and Remediation Services,2011,28693,17430,4298,2572,24300,2261,864,27425,1268,33625,17430,4300,2600,24330,2545,1345,28220,5405,665482,23369,26356,32677,84814,84016,118877,296303,334597,18152077000,918275000,788860000,928324000,2682917000,2408723000,2563590000,7906601000,9151224000
Wisconsin,"Agriculture, Forestry, Fishing and Hunting",2011,2465,1905,335,110,2350,65,30,2445,20,2490,1905,335,110,2350,65,45,2460,30,13939,2484,2144,921,6198,598,0,11244,0,547298000,78722000,63290000,39926000,190902000,21880000,0,434423000,0
Wisconsin,"Arts, Entertainment, and Recreation",2011,12923,7400,1977,1595,10972,1468,300,12740,183,13380,7400,1990,1615,11005,1590,395,12990,390,202438,9540,12350,21633,44811,53204,39780,144485,37835,5408655000,355426000,272128000,369730000,1005394000,934871000,917536000,3396012000,676035000
Wisconsin,Construction,2011,68271,49525,9670,5153,64348,3165,429,67942,329,69050,49530,9675,5210,64415,3360,595,68370,680,431025,71212,61095,67379,203367,111279,47779,369435,46981,24609995000,3163435000,2725737000,3458432000,9356075000,6894051000,3392147000,20049955000,3382811000
Wisconsin,Educational Services,2011,6964,2915,1110,1035,5060,1395,193,6648,316,7475,2915,1110,1055,5080,1490,255,6825,650,272154,4213,6874,13924,25294,53608,26968,108832,162040,8379580000,137993000,115687000,250309000,518560000,1209527000,735064000,2546858000,5774543000
Wisconsin,Finance and Insurance,2011,23786,15295,2825,1413,19533,2012,769,22314,1472,46060,15330,2895,1710,19935,5010,4385,29330,16730,684863,23410,16398,17514,60512,71862,82917,218492,454134,43206776000,1072622000,746883000,860036000,2727824000,3600344000,4205397000,10730768000,32227620000
Wisconsin,Health Care and Social Assistance,2011,50710,21815,10805,7431,40051,6388,2443,48882,1828,72455,21980,10940,7830,40750,9745,7340,57835,14620,1913813,36477,71503,99121,212195,246236,355253,819435,1074881,79434319000,2034850000,2743451000,3878577000,8663978000,9467809000,9828102000,28107806000,50714175000
Wisconsin,Information,2011,5522,2120,815,757,3692,762,303,4757,765,11515,2125,830,810,3765,1030,635,5430,6085,264297,2898,4118,9763,18610,24507,23743,69368,192438,14294562000,150028000,189761000,401489000,780379000,1060515000,1202522000,3139600000,10918228000
Wisconsin,Management of Companies and Enterprises,2011,3477,225,75,140,440,640,1062,2142,1335,4845,225,75,140,440,650,1125,2215,2630,330263,62,462,612,274,6945,29638,37956,292307,28723988000,5539000,40493000,41425000,21854000,356495000,1789430000,2852086000,25871902000
Wisconsin,Manufacturing,2011,41014,12781,6725,6038,25544,8840,3477,37861,3153,44695,12785,6735,6090,25610,9360,4420,39390,5305,2013884,19452,39041,75128,143219,350260,418468,967592,950446,99521207000,911200000,1504160000,3110721000,5777824000,15758195000,19909893000,43797125000,50915019000
Wisconsin,"Mining, Quarrying, and Oil and Gas Extraction",2011,660,315,85,85,485,70,43,598,62,770,315,85,95,495,90,90,675,95,11170,163,395,1055,1998,0,0,6473,133,851665000,30503000,30290000,70460000,135568000,46577000,21806000,452231000,351971000
Wisconsin,Other,2011,342,331,6,5,342,0,0,342,0,342,331,6,5,342,0,0,342,0,0,0,33,57,0,0,0,0,0,3668000,3123000,300000,245000,3668000,0,0,3668000,0
Wisconsin,Other Services (except Public Administration),2011,68592,40395,14907,7649,62951,4514,575,68040,552,73625,40450,15060,7940,63450,6005,1345,70800,2825,530452,75957,96165,98129,273312,150874,34292,468900,54389,12452695000,1756386000,2035704000,1988945000,5825908000,3545265000,1037248000,10693568000,1604220000
Wisconsin,"Professional, Scientific, and Technical Services",2011,52348,34215,7625,4691,46531,3479,897,50907,1441,56350,34245,7690,4860,46795,4190,1440,52425,3925,519222,48091,47781,60063,162815,113886,69833,354932,131999,28235812000,2212191000,2181962000,2839857000,7289042000,6562301000,4802909000,18969173000,8663931000
Wisconsin,Real Estate and Rental and Leasing,2011,17941,13065,2190,1075,16330,815,410,17555,386,21815,13080,2300,1145,16525,1385,1675,19585,2230,114036,19258,13672,13101,46880,24549,17244,92788,13653,3936170000,623387000,410670000,454275000,1502561000,898340000,631858000,3099647000,688158000
Wisconsin,Retail Trade,2011,64049,31614,13337,8382,53333,6833,1608,61774,2275,97235,31760,13740,9280,54780,10300,6040,71120,26115,1397302,52932,84516,106661,251806,230567,135299,630443,665640,33189447000,1367829000,1865948000,2578306000,5839514000,6463335000,3661405000,16215269000,16022590000
Wisconsin,Total,2011,108918,60478,19083,12896,92457,11326,2653,106436,2482,138045,60618,19340,13561,93519,15276,7895,116690,21355,2354284,101741,125171,172952,399864,429513,370705,1200082,1154202,95532272000,3664183000,3767540000,5323800000,12755523000,15000284000,14215124000,41970931000,53561341000
Wisconsin,Transportation and Warehousing,2011,22971,13275,3040,2296,18611,2318,729,21658,1313,25975,13290,3045,2350,18685,2540,1100,22325,3650,460428,17701,18472,29189,67221,77559,61802,211989,242028,17326201000,744037000,679840000,987336000,2458489000,2746368000,2193656000,7510238000,9566347000
Wisconsin,Utilities,2011,387,85,25,30,140,125,10,275,112,1525,85,25,35,145,180,20,345,1180,62910,14,108,380,573,4098,0,5336,57107,5701388000,3282000,4759000,17536000,24993000,237890000,0,311673000,5381579000
Wisconsin,Wholesale Trade,2011,28976,12735,4492,3475,20702,4060,1924,26686,2290,35315,12780,4555,3705,21040,4925,3510,29475,5840,541927,14877,27541,41277,93436,124269,118030,352242,157674,29967081000,1037965000,1352617000,2191437000,4652118000,6516033000,5922541000,17851257000,9846934000
Wyoming,Accommodation and Food Services,2011,7853,3030,1510,1551,6091,1286,268,7645,208,8900,3045,1510,1580,6135,1525,670,8330,570,129780,3371,10126,20247,34727,45398,24947,107763,6842,2284681000,163503000,134966000,288075000,588039000,729805000,445858000,1766283000,347847000
Wyoming,Administrative and Support and Waste Management and Remediation Services,2011,4566,3090,615,388,4093,175,45,4313,253,4785,3090,630,410,4130,190,50,4370,415,28022,3719,3626,3986,12981,3813,456,18307,7597,816815000,155139000,97894000,120282000,410346000,106046000,10526000,543609000,193270000
Wyoming,"Agriculture, Forestry, Fishing and Hunting",2011,415,355,35,20,410,0,0,410,5,415,355,35,20,410,0,0,410,5,654,132,150,221,733,0,0,733,0,25722000,12910000,3785000,4564000,23526000,0,0,23526000,0
Wyoming,"Arts, Entertainment, and Recreation",2011,2090,1445,290,145,1880,175,20,2075,15,2135,1445,290,145,1880,205,30,2115,20,16309,1147,1312,1511,4243,4652,608,12503,0,340605000,69650000,26239000,24067000,130420000,97805000,16209000,293262000,0
Wyoming,Construction,2011,13288,9220,2005,1135,12360,712,90,13162,126,13360,9220,2005,1140,12365,725,105,13195,165,85999,13379,12555,14603,42237,22013,3646,73669,5065,4452267000,568638000,515341000,724513000,1848893000,1304812000,381043000,3710832000,326651000
Wyoming,Educational Services,2011,767,405,110,115,630,60,37,727,40,805,405,110,115,630,60,75,765,40,8633,147,590,1280,2550,2109,1558,7608,0,231743000,16281000,9492000,20331000,48993000,51099000,43586000,202466000,0
Wyoming,Finance and Insurance,2011,3143,2060,325,157,2542,236,49,2827,316,5025,2065,340,200,2605,720,155,3480,1545,31676,2528,1910,1523,6206,7993,1777,18792,5440,1543891000,111299000,68716000,57794000,252609000,408578000,83800000,841849000,635062000
Wyoming,Health Care and Social Assistance,2011,8382,4183,1800,1114,7097,741,270,8108,274,9135,4185,1805,1115,7105,1000,500,8605,530,153837,3616,11105,14188,33856,23978,37731,103093,45861,6503677000,408410000,444111000,559904000,1434897000,915132000,1590422000,4166559000,2185205000
Wyoming,Information,2011,1038,355,175,120,650,187,75,912,126,1575,360,190,125,675,245,155,1075,500,17284,272,598,1322,2772,4306,2010,12070,4983,683946000,20058000,17594000,47196000,96628000,133991000,100217000,429393000,262999000
Wyoming,Management of Companies and Enterprises,2011,372,60,5,30,95,70,70,235,137,420,60,5,30,95,70,75,240,180,5130,122,0,0,333,658,975,2042,3065,432835000,3548000,0,7120000,12471000,56405000,87574000,168700000,256215000
Wyoming,Manufacturing,2011,2577,1305,435,270,2010,240,107,2357,220,2700,1305,435,285,2025,245,115,2385,315,31593,1354,1539,1773,5837,4138,1506,15480,10549,1989962000,59510000,51995000,77347000,219977000,224096000,102045000,793719000,828192000
Wyoming,"Mining, Quarrying, and Oil and Gas Extraction",2011,3681,1690,695,380,2765,344,115,3224,457,4345,1690,695,380,2765,390,120,3275,1070,134375,697,4179,4500,11146,12010,7822,32923,94802,10637155000,145975000,241090000,288615000,685228000,857331000,544247000,2230529000,7951872000
Wyoming,Other,2011,57,53,3,1,57,0,0,57,0,57,53,3,1,57,0,0,57,0,75,0,0,0,75,0,0,75,0,1356000,820000,0,0,1356000,0,0,1356000,0
Wyoming,Other Services (except Public Administration),2011,8711,5585,1845,765,8195,265,100,8560,151,8995,5585,1845,810,8240,320,115,8675,320,43509,9022,11222,8635,31706,5620,103,39809,2021,1331118000,290008000,294907000,249072000,855636000,201487000,14927000,1136220000,146207000
Wyoming,"Professional, Scientific, and Technical Services",2011,10148,7460,1235,670,9365,370,120,9855,293,10475,7465,1235,685,9385,455,175,10015,460,42384,10010,7490,7618,27143,9228,1631,39636,1945,2176629000,538311000,312183000,421741000,1296291000,486527000,108825000,2034916000,112625000
Wyoming,Real Estate and Rental and Leasing,2011,4661,3690,375,215,4280,130,50,4460,201,5295,3690,375,265,4330,215,180,4725,570,19385,4010,2091,2365,8440,2341,508,13821,4723,843409000,163483000,60167000,87725000,335083000,81293000,34842000,486947000,338387000
Wyoming,Retail Trade,2011,10401,5035,2322,1169,8526,833,353,9712,689,13430,5035,2355,1285,8675,1150,890,10715,2715,123092,6562,14079,11867,38686,21971,7826,75845,35384,3304377000,213447000,319235000,386698000,959791000,704523000,340729000,2103140000,963049000
Wyoming,Total,2011,17604,10590,2943,1767,15300,1230,360,16890,714,20329,10602,2965,1866,15433,1664,804,17901,2428,208385,17441,19331,23122,59894,41417,29434,130745,77640,9109733000,653350000,605133000,796448000,2054931000,1588738000,1239518000,4883187000,4226546000
Wyoming,Transportation and Warehousing,2011,3927,2460,525,335,3320,220,86,3626,301,4745,2460,525,345,3330,240,180,3750,995,46283,2847,3218,3123,10426,5852,3512,23415,14968,2452669000,148049000,143646000,160656000,488339000,281199000,201036000,1186322000,1001548000
Wyoming,Utilities,2011,254,75,20,25,120,30,20,170,84,670,75,20,35,130,55,55,240,430,38,44,0,316,229,1203,0,2879,0,3008000,1450000,1510000,20859000,25921000,80823000,35156000,190550000,0
Wyoming,Wholesale Trade,2011,3162,1195,390,337,1922,398,242,2562,600,4150,1210,405,355,1970,510,375,2855,1295,36534,1254,1674,2841,7058,5562,3497,20049,14408,2209302000,78369000,98437000,114540000,351628000,355303000,214156000,1030021000,1041354000
