state_name,industry_name,YEAR,firms_01: Total,firms_02: <5,firms_03: 5-9,firms_04: 10-19,firms_05: <20,firms_06: 20-99,firms_07: 100-499,firms_08: <500,firms_09: 500+,establishments_01: Total,establishments_02: <5,establishments_03: 5-9,establishments_04: 10-19,establishments_05: <20,establishments_06: 20-99,establishments_07: 100-499,establishments_08: <500,establishments_09: 500+,employment_01: Total,employment_02: <5,employment_03: 5-9,employment_04: 10-19,employment_05: <20,employment_06: 20-99,employment_07: 100-499,employment_08: <500,employment_09: 500+,annual_payroll_01: Total,annual_payroll_02: <5,annual_payroll_03: 5-9,annual_payroll_04: 10-19,annual_payroll_05: <20,annual_payroll_06: 20-99,annual_payroll_07: 100-499,annual_payroll_08: <500,annual_payroll_09: 500+
Alabama,Accommodation and Food Services,2009,27835,10635,5555,5080,21270,4961,774,27005,830,40285,10735,5570,5160,21465,5920,3070,30455,9830,756075,17667,36912,69274,124780,181029,104143,411840,343978,9455614000,361684000,406837000,779271000,1558549000,2162651000,1250475000,4992199000,4460700000
Alabama,Administrative and Support and Waste Management and Remediation Services,2009,18123,9885,2755,1830,14470,1785,656,16911,1212,20730,9890,2765,1850,14505,1965,915,17385,3345,577490,15748,16886,23213,57779,64866,71422,207765,341196,14058422000,500554000,450427000,644159000,1623987000,1780237000,1685479000,5371817000,8393736000
Alabama,"Agriculture, Forestry, Fishing and Hunting",2009,4074,2065,1200,500,3765,218,30,4013,61,4150,2065,1200,500,3765,225,45,4035,115,29191,4032,7556,6219,18479,5774,1341,27179,1073,929109000,121370000,223607000,202028000,551483000,210960000,33729000,860921000,51958000
Alabama,"Arts, Entertainment, and Recreation",2009,5307,2925,845,655,4425,669,124,5218,89,5650,2930,845,655,4430,740,180,5350,300,83998,4191,5124,6594,18234,24144,12764,60013,16011,1648949000,125291000,92903000,118054000,357624000,389760000,251024000,1120632000,283105000
Alabama,Construction,2009,43746,25960,7850,4885,38695,4073,528,43296,450,44315,25960,7850,4890,38700,4130,585,43415,900,478190,45210,51235,64982,163160,152542,76842,401310,58218,18654785000,1296025000,1432445000,2092547000,4826990000,5936077000,3389248000,14522285000,3241273000
Alabama,Educational Services,2009,3853,1660,665,490,2815,705,173,3693,160,4120,1660,680,525,2865,760,210,3835,285,142210,2360,4313,6366,13979,28704,26466,71490,65219,3754264000,79842000,57854000,95417000,242773000,554850000,693158000,1571444000,2032804000
Alabama,Finance and Insurance,2009,16348,10378,2029,965,13372,1218,577,15167,1181,35975,10400,2145,1435,13980,3140,3470,20590,15385,352696,17554,11334,10916,42046,40231,40392,130704,210969,19724603000,693617000,521341000,508739000,1777112000,1798190000,1726367000,5580294000,13157957000
Alabama,Health Care and Social Assistance,2009,40946,16315,10790,6673,33778,4539,1488,39805,1141,51555,16340,10845,6995,34180,6020,4785,44985,6570,1196404,33561,70150,88512,194503,166254,201438,567450,620270,47516820000,1877188000,2991671000,3713676000,8608180000,7460409000,6848206000,23038783000,24074867000
Alabama,Information,2009,3949,1570,645,435,2650,457,275,3382,567,7950,1575,650,445,2670,565,465,3700,4250,189002,1780,3646,4343,10561,12443,13292,48898,123646,9106866000,85023000,124170000,202935000,433121000,612962000,649130000,2038978000,6806473000
Alabama,Management of Companies and Enterprises,2009,2225,85,35,110,230,401,669,1300,925,2905,90,35,110,235,405,745,1385,1520,86220,111,0,680,961,3807,15110,19925,66277,6523705000,69476000,6310000,39965000,115931000,203940000,793520000,1113670000,5406901000
Alabama,Manufacturing,2009,21123,6980,3530,2775,13285,3805,1572,18662,2461,22985,6980,3530,2790,13300,3860,1830,18990,3995,1128618,10726,19610,31026,67671,134201,142124,379963,656830,46508661000,363616000,585497000,1007088000,2097437000,4901032000,5091262000,13284197000,29447668000
Alabama,"Mining, Quarrying, and Oil and Gas Extraction",2009,1000,320,105,120,545,150,90,785,215,1240,320,105,120,545,155,115,815,425,37641,368,514,1286,2360,5489,5717,14342,21574,2241935000,19206000,22901000,41060000,87809000,243528000,287363000,657943000,1523828000
Alabama,Other,2009,135,125,8,1,134,1,0,135,0,135,125,8,1,134,1,0,135,0,197,0,50,0,176,0,0,197,0,2559000,2002000,438000,0,2448000,0,0,2559000,0
Alabama,Other Services (except Public Administration),2009,51678,31315,11265,4901,47481,3307,394,51182,496,55770,31320,11370,5045,47735,4285,730,52750,3020,394917,60076,72361,62872,198506,112102,26223,345956,29522,8517610000,1209923000,1358011000,1323126000,3919138000,2268273000,568624000,6981666000,1217445000
Alabama,"Professional, Scientific, and Technical Services",2009,43193,28510,6415,3570,38495,2665,869,42029,1164,47210,28510,6435,3600,38545,3335,1215,43095,4115,470578,44461,40082,45271,134365,89324,66127,295847,163007,28266081000,1819962000,1652307000,2154166000,5648669000,5334281000,5008716000,16271006000,11574696000
Alabama,Real Estate and Rental and Leasing,2009,16054,11770,1803,902,14475,705,397,15577,477,21110,11775,1900,1040,14715,1350,1220,17285,3825,121564,18841,11256,11166,42542,19105,19605,83306,33869,3760177000,513199000,315791000,348100000,1191247000,672930000,616082000,2546152000,1140418000
Alabama,Retail Trade,2009,58747,33204,11878,6082,51164,4541,1031,56736,2011,93245,33275,12220,6855,52350,7860,4310,64520,28725,983202,58707,74520,76153,213287,144298,78798,452199,498603,22536920000,1295593000,1669729000,1939376000,4926598000,4102208000,2029244000,11239228000,10248576000
Alabama,Total,2009,77035,42158,14544,8694,65396,7381,1909,74686,2349,100805,42226,14736,9191,66153,9983,5409,81545,19260,1612258,78847,95665,115523,290035,272924,224647,787606,824652,56972095000,2320634000,2681241000,3498747000,8500622000,9027366000,7887754000,25415742000,31556353000
Alabama,Transportation and Warehousing,2009,12573,7080,1610,1063,9753,1200,541,11494,1079,14745,7080,1610,1100,9790,1320,750,11860,2885,261583,10395,9660,13304,35636,35870,33487,109202,141883,9935504000,346325000,258324000,409776000,1041574000,1141212000,1180075000,3534478000,6065306000
Alabama,Utilities,2009,537,140,150,25,315,95,25,435,102,2130,140,150,25,315,195,75,585,1545,34970,341,909,259,1509,5131,2730,9410,0,2590043000,7005000,31340000,11758000,50103000,308815000,167460000,527963000,0
Alabama,Wholesale Trade,2009,22169,9420,3703,2668,15791,2858,1314,19963,2206,27280,9460,3735,2810,16005,3680,2330,22015,5265,365270,15435,22322,30118,72003,81244,53442,225830,120320,16901099000,660531000,959064000,1384822000,3129864000,3469577000,2612514000,9943627000,6427202000
Alaska,Accommodation and Food Services,2009,8653,4478,1623,1209,7310,993,178,8481,172,9980,4490,1625,1230,7345,1240,710,9295,685,127130,5865,10417,15529,31993,35793,21496,90975,33983,2870049000,237923000,173159000,249191000,667555000,682919000,416883000,1811484000,1057094000
Alaska,Administrative and Support and Waste Management and Remediation Services,2009,4707,2785,710,470,3965,246,148,4359,348,5335,2785,755,470,4010,320,265,4595,740,103325,2394,3849,4885,13049,4711,5339,31476,65608,4764463000,156822000,140525000,185355000,524341000,201752000,224774000,1417250000,2929649000
Alaska,"Agriculture, Forestry, Fishing and Hunting",2009,1730,1625,50,15,1690,25,5,1720,10,1740,1625,50,15,1690,25,10,1725,15,3397,75,191,0,594,160,0,2164,0,189846000,71256000,12445000,0,97074000,10332000,0,151676000,0
Alaska,"Arts, Entertainment, and Recreation",2009,2555,1785,290,245,2320,205,15,2540,15,2705,1790,300,285,2375,210,15,2600,105,19959,1555,1322,2556,6039,5937,681,12530,0,385602000,91333000,38491000,49887000,198832000,99075000,6591000,327153000,0
Alaska,Construction,2009,12213,8745,1580,1040,11365,574,88,12027,186,12435,8745,1580,1045,11370,600,130,12100,335,86292,10859,9854,12937,35464,18056,5613,63107,19442,7230794000,756811000,658130000,1009565000,2491709000,1592296000,496862000,4863434000,2018023000
Alaska,Educational Services,2009,1115,570,230,120,920,120,50,1090,25,1265,570,230,125,925,125,175,1225,40,13573,640,979,1296,3693,2790,4230,13164,0,349196000,27375000,27138000,34431000,95436000,63023000,133172000,336738000,0
Alaska,Finance and Insurance,2009,2236,1190,355,110,1655,131,95,1881,355,4045,1190,365,120,1675,250,395,2320,1725,36732,510,1870,889,4776,2778,228,11365,17478,2132655000,85498000,80266000,53692000,254656000,136081000,160156000,719848000,1074741000
Alaska,Health Care and Social Assistance,2009,9378,4440,2260,1225,7925,817,366,9108,270,10780,4440,2270,1260,7970,1040,880,9890,890,200350,7348,14759,14474,38103,28509,34297,108986,73652,9739340000,482233000,731004000,973609000,2228571000,1340923000,1343023000,5079236000,4012883000
Alaska,Information,2009,1061,440,180,103,723,121,68,912,149,1980,440,190,120,750,205,215,1170,810,32869,420,638,614,1937,2469,1070,6003,6952,1939703000,23135000,26644000,21965000,76548000,116216000,53027000,403517000,1279398000
Alaska,Management of Companies and Enterprises,2009,525,50,15,35,100,100,130,330,195,695,50,15,35,100,100,150,350,345,28241,30,0,0,204,767,0,5013,22085,2945871000,3291000,0,0,21316000,28842000,0,316103000,2565572000
Alaska,Manufacturing,2009,2306,1245,425,235,1905,200,30,2135,171,2640,1250,425,235,1910,215,45,2170,470,49569,614,1795,1270,5581,4025,0,14777,34299,2054434000,72925000,105586000,108611000,353360000,208721000,0,725423000,1286417000
Alaska,"Mining, Quarrying, and Oil and Gas Extraction",2009,580,300,30,45,375,35,50,460,120,705,300,30,50,380,35,60,475,230,42148,42,40,87,587,263,4338,7124,35434,3717763000,33644000,5162000,6296000,77306000,26672000,420153000,687539000,3206061000
Alaska,Other,2009,26,25,1,0,26,0,0,26,0,26,25,1,0,26,0,0,26,0,0,0,0,0,0,0,0,0,0,802000,754000,0,0,802000,0,0,802000,0
Alaska,Other Services (except Public Administration),2009,8271,5035,1863,735,7633,377,90,8100,171,8800,5045,1880,770,7695,525,230,8450,350,50796,8885,11412,8368,30735,10542,2747,47718,1109,1526570000,266187000,339572000,269934000,905141000,342672000,70905000,1401786000,71137000
Alaska,"Professional, Scientific, and Technical Services",2009,8588,5650,1030,680,7360,562,199,8121,467,9560,5650,1035,720,7405,730,245,8380,1180,70876,7893,6311,7300,23315,15804,4348,46439,21511,4853152000,472379000,384712000,520190000,1426434000,1193002000,337176000,3144407000,1629364000
Alaska,Real Estate and Rental and Leasing,2009,3746,2685,495,200,3380,162,67,3609,137,4185,2690,495,230,3415,290,85,3790,395,25111,3087,2674,2047,8729,3463,1415,15174,4204,954234000,139108000,98019000,83689000,339418000,148867000,71534000,646094000,193260000
Alaska,Retail Trade,2009,9788,4842,2053,1323,8218,844,220,9282,506,12735,4865,2160,1465,8490,1350,535,10375,2360,154497,5581,11529,13932,34937,22166,9502,77309,42890,4473587000,239926000,341585000,421962000,1096893000,738986000,340219000,2384512000,1319971000
Alaska,Total,2009,16418,9950,2805,1642,14397,1144,297,15838,580,19901,9974,2867,1776,14617,1652,1016,17285,2616,252882,14895,18531,21770,55196,40714,34943,130853,122029,12405674000,712533000,727362000,967418000,2407313000,1819195000,1523798000,5750306000,6655368000
Alaska,Transportation and Warehousing,2009,4239,2575,513,275,3363,260,212,3835,404,5555,2580,520,305,3405,415,520,4340,1215,71473,1940,2352,1200,7226,6351,12207,31815,35460,4076897000,170093000,100277000,85573000,414203000,328579000,555892000,1630236000,2111480000
Alaska,Utilities,2009,282,80,60,42,182,60,35,277,5,445,80,65,85,230,85,115,430,15,8163,16,261,389,691,1803,3574,7765,0,655186000,3352000,9252000,18391000,33539000,139390000,316391000,615638000,0
Alaska,Wholesale Trade,2009,2902,1155,335,275,1765,376,198,2339,563,3790,1160,340,315,1815,500,300,2615,1175,35573,795,1440,2061,5715,5756,2914,20522,10797,2108723000,81656000,86092000,117707000,345530000,296137000,174377000,1039684000,871021000
Arizona,Accommodation and Food Services,2009,39326,13284,8000,7545,28829,8064,1267,38160,1166,57475,13375,8025,7710,29110,9445,4745,43300,14175,1211525,20836,52795,101487,177425,298806,176068,656322,553334,18734960000,494530000,631197000,1205221000,2346515000,4089845000,2605630000,9077899000,9613464000
Arizona,Administrative and Support and Waste Management and Remediation Services,2009,36011,20900,5460,3215,29575,3437,1242,34254,1757,41140,20900,5500,3285,29685,3670,1585,34940,6200,994094,30146,34348,40286,109360,130922,157498,416627,564430,32532663000,999937000,900970000,1088104000,2993260000,3485724000,4429960000,11268411000,19703027000
Arizona,"Agriculture, Forestry, Fishing and Hunting",2009,865,600,155,30,785,50,15,850,15,885,600,155,30,785,70,15,870,15,5507,560,749,0,1521,1651,0,5745,0,168319000,25481000,25503000,0,66871000,41250000,30184000,157944000,0
Arizona,"Arts, Entertainment, and Recreation",2009,7655,4340,965,693,5998,1012,389,7399,256,8705,4340,975,715,6030,1050,675,7755,950,196353,3930,4302,8137,16277,37505,52405,118203,65664,5903381000,341584000,104911000,152799000,619851000,681330000,2596347000,4025837000,1402917000
Arizona,Construction,2009,65692,39870,11220,6985,58075,5886,994,64955,737,66410,39870,11230,6990,58090,5945,1150,65185,1225,733381,62882,73637,93040,233573,220797,118849,581068,132882,29557775000,1957452000,2092485000,3081091000,7143503000,8228232000,4841483000,20555077000,7843983000
Arizona,Educational Services,2009,8266,3843,1250,1120,6213,1410,348,7971,295,9435,3860,1250,1125,6235,1515,550,8300,1135,248599,2592,8143,14614,27449,54891,41556,132666,115245,9059913000,237594000,184887000,301505000,732430000,1581183000,1339877000,3806070000,5227627000
Arizona,Finance and Insurance,2009,26141,18450,2638,1029,22117,1232,784,24133,2008,49200,18495,2700,1145,22340,2020,2200,26560,22640,652268,28454,15936,12341,57149,36019,40792,138825,479575,35673488000,1146388000,675092000,658936000,2519741000,1962698000,2105344000,6861758000,28373361000
Arizona,Health Care and Social Assistance,2009,64934,35805,13515,7089,56409,5299,1699,63407,1527,80010,35830,13660,7300,56790,7215,5185,69190,10820,1505279,55889,88255,89953,235827,197698,251752,700449,761669,68404092000,3831210000,3663050000,3928871000,11476397000,8576562000,9742769000,30162928000,37144410000
Arizona,Information,2009,6517,3335,840,500,4675,630,302,5607,910,10985,3335,840,505,4680,740,440,5860,5125,198283,2842,4628,5485,16059,19812,16257,60172,133957,14244987000,231401000,199939000,239992000,710297000,1125942000,922913000,3195919000,7824668000
Arizona,Management of Companies and Enterprises,2009,3011,230,55,65,350,490,807,1647,1364,4480,230,55,65,350,495,855,1700,2780,208167,316,26,0,1032,5983,20530,27586,179649,16295124000,24999000,8220000,1179000,82235000,317533000,1253665000,1653433000,14553843000
Arizona,Manufacturing,2009,21746,8865,3870,2894,15629,3303,1187,20119,1627,22825,8865,3870,2895,15630,3390,1365,20385,2440,642903,11408,20132,30983,70559,104551,79851,289529,302652,34486558000,486770000,692476000,1058749000,2427011000,4194372000,3225311000,11160114000,20995149000
Arizona,"Mining, Quarrying, and Oil and Gas Extraction",2009,832,330,120,75,525,150,36,711,121,1125,330,120,75,525,170,60,755,370,30925,315,596,724,1878,3968,431,8861,2504,1636053000,26652000,22415000,25421000,87191000,204714000,29253000,492530000,1194812000
Arizona,Other,2009,168,157,8,3,168,0,0,168,0,168,157,8,3,168,0,0,168,0,231,0,50,39,231,0,0,231,0,4755000,3208000,937000,610000,4755000,0,0,4755000,0
Arizona,Other Services (except Public Administration),2009,47571,29149,8845,5100,43094,3049,754,46897,674,53535,29180,8930,5275,43385,4010,2400,49795,3740,421952,51971,56848,65037,176802,106877,61349,351679,47792,10603780000,1323716000,1322457000,1553182000,4219882000,2517025000,1579428000,8556239000,1526500000
Arizona,"Professional, Scientific, and Technical Services",2009,75552,54990,8600,5012,68602,3682,1320,73604,1948,79985,54995,8625,5100,68720,4170,2185,75075,4910,600429,68122,53546,63923,193049,111832,81354,396133,187894,35469700000,3727492000,2503917000,3213004000,9482414000,6176878000,5079826000,21205517000,13479357000
Arizona,Real Estate and Rental and Leasing,2009,31914,24988,2851,1438,29277,1232,570,31079,835,40450,25050,2990,1650,29690,1960,1480,33130,7320,207272,29657,16842,17306,64522,34156,24381,131395,68463,7691174000,1118944000,580063000,544048000,2256196000,1328234000,912461000,4688305000,2970885000
Arizona,Retail Trade,2009,52887,29306,10424,5442,45172,3805,1426,50403,2484,92205,29415,10820,6345,46580,6535,4975,58090,34115,1524686,42517,55372,56339,159087,122750,106795,404738,1014717,35541620000,1181088000,1395082000,1487499000,4043474000,3628183000,3703690000,11982265000,22277436000
Arizona,Total,2009,104191,62193,16924,10372,89489,9132,2607,101228,2963,134072,62296,17158,10839,90293,11514,6636,108443,25629,2122265,99565,111267,137757,348589,334208,292640,975437,1146828,82941093000,3787716000,3358329000,4254872000,11400917000,10973890000,10729855000,33104662000,49836431000
Arizona,Transportation and Warehousing,2009,13399,7310,1815,1120,10245,1168,679,12092,1307,15885,7320,1820,1155,10295,1305,895,12495,3390,311450,7769,9306,14081,32385,32715,31589,104220,187701,11058415000,341269000,328907000,428097000,1120392000,1127132000,1008217000,3385246000,7433959000
Arizona,Utilities,2009,782,445,100,50,595,35,57,687,95,1290,445,105,50,600,90,165,855,435,30544,924,549,468,1941,0,4563,10421,1993,2553361000,23111000,22765000,33468000,79708000,0,331275000,657750000,214874000
Arizona,Wholesale Trade,2009,28388,14230,4012,2677,20919,3232,1568,25719,2669,33495,14260,4080,2765,21105,3775,2255,27135,6360,470129,17011,23391,29049,77897,86226,51757,235541,218683,26080444000,1102464000,1051230000,1360277000,3601426000,3819636000,2853156000,10951142000,14544850000
Arkansas,Accommodation and Food Services,2009,20001,6895,3880,3900,14675,4166,563,19404,597,26140,6975,3900,3975,14850,4775,2245,21870,4270,454713,11146,25513,53039,90087,145813,68710,308503,145279,5501321000,232834000,280955000,587335000,1103630000,1671046000,780299000,3640556000,1858983000
Arkansas,Administrative and Support and Waste Management and Remediation Services,2009,11271,6545,1720,1020,9285,937,329,10551,720,12685,6545,1725,1045,9315,1105,525,10945,1740,230486,8628,10602,11265,33394,32710,25733,103630,119981,5349356000,264457000,275603000,287496000,886934000,816307000,497821000,2379377000,2782202000
Arkansas,"Agriculture, Forestry, Fishing and Hunting",2009,3278,1905,795,325,3025,150,35,3210,68,3420,1905,795,325,3025,165,35,3225,195,20812,3200,5145,4138,12819,3201,1069,19184,944,654414000,116419000,165214000,119688000,410931000,110743000,17200000,566165000,59970000
Arkansas,"Arts, Entertainment, and Recreation",2009,3904,2300,640,390,3330,437,62,3829,75,3990,2300,640,395,3335,480,90,3905,85,43079,2859,3479,3827,12206,13992,6145,35985,1728,736204000,84579000,53467000,58852000,206552000,271926000,104380000,616118000,60792000
Arkansas,Construction,2009,28351,18060,4865,2925,25850,2000,286,28136,215,28615,18060,4865,2925,25850,2070,355,28275,340,224594,29640,31983,38723,100587,69066,28171,207057,10249,8222534000,819620000,873728000,1295160000,2999440000,2540730000,1328575000,7203281000,531226000
Arkansas,Educational Services,2009,2515,1215,415,265,1895,395,120,2410,105,2800,1215,415,265,1895,415,325,2635,165,70656,1681,2552,3360,7721,15523,14285,39669,25332,1402129000,49896000,40396000,57658000,156380000,338783000,315267000,974164000,402018000
Arkansas,Finance and Insurance,2009,12248,8390,1405,467,10262,722,388,11372,876,22385,8395,1445,590,10430,2090,2175,14695,7690,179216,13952,8040,5561,28854,24491,26192,84560,92414,8514301000,430848000,317637000,212994000,1011255000,1078097000,1012571000,3346874000,4916010000
Arkansas,Health Care and Social Assistance,2009,29363,14110,6625,3640,24375,2811,1352,28538,825,36690,14110,6640,3750,24500,4070,4050,32620,4070,811581,23240,43030,46510,114601,119260,170734,409452,394160,30153609000,1528906000,1555656000,1762771000,4877011000,3847860000,4920794000,13990245000,15998113000
Arkansas,Information,2009,2672,1195,355,270,1820,330,105,2255,417,5090,1195,355,270,1820,415,175,2410,2680,98820,1132,1883,2886,7106,9451,2543,20815,52755,4547385000,54973000,51084000,97182000,224272000,404442000,65437000,827214000,2497856000
Arkansas,Management of Companies and Enterprises,2009,1572,105,45,50,200,325,431,956,616,5620,105,45,50,200,335,470,1005,4615,183065,88,141,0,492,3586,8929,13061,169633,15967615000,8483000,14680000,10193000,34363000,165920000,525720000,726130000,15241485000
Arkansas,Manufacturing,2009,13166,4528,2390,1690,8608,1942,902,11452,1714,14385,4535,2390,1690,8615,2130,1100,11845,2540,713495,6511,11443,18723,40966,56204,60170,191175,470234,25349459000,204104000,339170000,557430000,1223610000,1929920000,2109987000,6279007000,16845093000
Arkansas,"Mining, Quarrying, and Oil and Gas Extraction",2009,1768,765,225,235,1225,200,78,1503,265,1960,765,225,235,1225,205,105,1535,425,40729,1135,1399,3168,5959,5185,7141,20646,20064,2548825000,55320000,53819000,132095000,247903000,272878000,505395000,1115439000,1432974000
Arkansas,Other,2009,94,87,6,1,94,0,0,94,0,94,87,6,1,94,0,0,94,0,119,76,33,0,119,0,0,119,0,2515000,1966000,524000,0,2515000,0,0,2515000,0
Arkansas,Other Services (except Public Administration),2009,31660,20305,6412,2615,29332,1796,193,31321,339,33205,20310,6460,2705,29475,2345,380,32200,1005,209574,36322,40846,33498,114010,58772,10768,189421,13413,4430614000,748814000,804667000,698415000,2265439000,1081440000,258200000,3817533000,450037000
Arkansas,"Professional, Scientific, and Technical Services",2009,26730,18940,3886,1935,24761,953,368,26082,648,28735,18945,3895,2085,24925,1210,830,26965,1770,168552,25403,23932,24660,78136,27198,16516,129068,33526,7853754000,1124634000,850263000,999064000,2995724000,1290084000,807297000,5341377000,2278023000
Arkansas,Real Estate and Rental and Leasing,2009,11788,9255,1075,528,10858,399,178,11435,353,14450,9265,1090,635,10990,835,515,12340,2110,63263,13086,6467,6085,26318,11723,4098,44028,15983,1796096000,323861000,162284000,173975000,673286000,330795000,129696000,1223058000,525719000
Arkansas,Retail Trade,2009,37432,19560,8530,4451,32541,2765,629,35935,1497,55730,19670,8665,4915,33250,4745,2610,40605,15125,541777,34454,53533,54033,146421,81859,34221,277863,254697,12459417000,767150000,1155946000,1309237000,3274839000,2366809000,899424000,6787071000,5316625000
Arkansas,Total,2009,51425,29368,9377,5430,44175,4422,1156,49753,1672,65451,29421,9455,5722,44598,6214,3562,54374,11077,970748,51067,61293,71869,184229,160560,132702,477491,493257,33065154000,1523353000,1587377000,1988461000,5099191000,4609985000,4156955000,13866131000,19199023000
Arkansas,Transportation and Warehousing,2009,10598,6360,1430,899,8689,825,254,9768,830,12235,6360,1445,920,8725,880,360,9965,2270,224221,9284,8606,10561,30535,25591,16095,75587,123618,8221791000,272148000,251384000,330948000,888635000,861089000,525331000,2379729000,4841328000
Arkansas,Utilities,2009,742,425,115,15,555,55,53,663,79,1715,425,115,15,555,135,165,855,860,32900,977,699,110,1840,1222,8741,13748,578,2628687000,24972000,20176000,6412000,53453000,151257000,585513000,806902000,53067000
Arkansas,Wholesale Trade,2009,13962,5585,2099,1732,9416,1970,836,12222,1740,16935,5590,2135,1815,9540,2665,1300,13505,3430,207996,7490,11857,18749,42980,49077,24775,131683,68886,9718504000,367914000,464353000,795637000,1691486000,2231218000,1200014000,5602858000,3705323000
California,Accommodation and Food Services,2009,283194,113378,61541,52336,227255,48130,5682,281067,2127,376580,113530,61895,53500,228925,58155,23760,310840,65740,6666185,196947,399848,696615,1293489,1793261,935050,4009074,2563927,116148455000,4128440000,5267342000,9783501000,19179283000,29646266000,16199039000,65294575000,50150175000
California,Administrative and Support and Waste Management and Remediation Services,2009,178743,107226,26939,17560,151725,18107,5263,175095,3648,210150,107350,27130,17890,152370,20400,8545,181315,28835,4946496,175067,176318,232804,587200,679444,802271,2110752,2810858,177320273000,6510682000,5594656000,7858913000,19966778000,23549743000,25381628000,69156413000,107867483000
California,"Agriculture, Forestry, Fishing and Hunting",2009,9156,5875,1295,790,7960,874,220,9054,102,9385,5875,1295,800,7970,950,290,9210,175,122787,7525,8073,10400,27075,36788,26136,91256,24280,4150221000,436540000,343228000,452287000,1237002000,1326344000,721182000,3320426000,601520000
California,"Arts, Entertainment, and Recreation",2009,93709,69225,9050,5964,84239,6903,1732,92874,835,99920,69265,9105,6020,84390,7645,2355,94390,5530,1479010,51618,57905,77378,209760,279881,264336,764898,698192,63906200000,19067030000,2810885000,2421868000,24332100000,6729931000,12012117000,43976706000,19364269000
California,Construction,2009,350666,221904,57282,37448,316634,28969,3678,349281,1385,355140,221920,57310,37490,316720,29510,4935,351165,3975,3347440,358743,377985,502443,1239595,1092200,554933,2889430,417261,165891565000,13028580000,14062800000,21398747000,48516955000,53614020000,31379702000,133590295000,29890160000
California,Educational Services,2009,51393,24640,8023,6868,39531,8665,2303,50499,894,58200,24655,8070,7010,39735,9885,3690,53310,4890,1707370,39314,53017,93630,184592,339981,347080,877965,820031,58910615000,1364785000,1253225000,2128625000,4746635000,10413174000,12389489000,27633045000,31085204000
California,Finance and Insurance,2009,141462,101354,16996,8409,126759,8078,3031,137868,3594,253810,101590,17525,9525,128640,13320,14650,156610,97200,2988054,161449,108001,108568,380620,272414,344221,1011315,1677735,245513807000,8433368000,6710391000,7768802000,23216796000,23175281000,29288643000,76670617000,165939096000
California,Health Care and Social Assistance,2009,424136,245020,91539,44436,380995,30692,8580,420267,3869,497080,245385,92365,46580,384330,42930,28295,455555,41525,8389644,445571,600343,582763,1634507,1172080,1218372,4026980,4278364,409509368000,24949749000,24398091000,23534825000,72887304000,44664775000,43726007000,161333721000,243886124000
California,Information,2009,71111,45638,7821,5980,59439,6743,2332,68514,2597,102090,45705,7870,6145,59720,7605,3730,71055,31035,2636158,53108,50029,73671,185992,249306,276128,716978,1749033,226592592000,8272489000,3107298000,4962733000,16782150000,18027452000,22132556000,57182870000,152746541000
California,Management of Companies and Enterprises,2009,16290,1440,526,585,2551,3466,4794,10811,5479,24860,1450,530,620,2600,3525,5205,11330,13530,1324385,1798,2343,3659,7800,42796,151099,201935,1122284,133797945000,280445000,131140000,225476000,637955000,3052280000,10582135000,14273300000,119513025000
California,Manufacturing,2009,192744,78113,34911,28763,141787,34254,9153,185194,7550,202785,78160,34965,28865,141990,35200,11025,188215,14570,6119726,134081,226053,379090,757549,1327802,1116360,3281031,2670906,334169758000,5475509000,7748352000,13855770000,27465726000,54668739000,53484566000,138370651000,187112935000
California,"Mining, Quarrying, and Oil and Gas Extraction",2009,3225,1415,445,414,2274,461,166,2901,324,4165,1415,445,435,2295,485,230,3010,1155,109256,1353,2736,5118,9752,15752,14097,42489,63362,9071491000,312969000,159128000,297761000,785270000,971408000,1106532000,2947859000,5860827000
California,Other,2009,2239,2153,52,28,2233,6,0,2239,0,2239,2153,52,28,2233,6,0,2239,0,2649,0,314,370,2467,0,0,2649,0,79751000,69954000,4828000,3278000,78060000,0,0,79751000,0
California,Other Services (except Public Administration),2009,310838,199502,56486,29329,285317,20931,3055,309303,1535,345005,199620,56855,30570,287045,25870,8735,321650,23355,2750474,367356,363880,384305,1116148,729111,343507,2201299,507101,77679120000,9333530000,9332584000,10444581000,29127953000,20275472000,11379583000,60934233000,15739930000
California,"Professional, Scientific, and Technical Services",2009,521348,376072,66721,38082,480875,27978,6759,515612,5736,559235,376230,67050,39205,482485,32940,12285,527710,31525,5670255,556229,431334,498918,1495226,972854,686683,3165940,2418690,415110905000,33213865000,23578725000,30148270000,86962697000,71971391000,54023162000,213595125000,199405682000
California,Real Estate and Rental and Leasing,2009,184428,139788,21767,10721,172276,8252,2274,182802,1626,232490,140110,22720,12405,175235,13460,10615,199310,33180,1385499,209014,138090,136431,482620,275669,217263,980101,395494,62499482000,8582288000,5186909000,5486125000,19264901000,12129039000,9771182000,41340690000,21075515000
California,Retail Trade,2009,352956,210981,69486,37224,317691,25977,5438,349106,3850,539855,212065,71595,42265,325925,40555,24605,391085,148770,7382222,320974,422252,462607,1227863,912222,592542,2804071,4260581,197272764000,9641753000,10450751000,12686560000,32495202000,28607755000,21142609000,83793670000,110107143000
California,Total,2009,697082,428785,117537,72287,618609,60843,12027,691479,5603,857831,429556,119076,75898,624530,77280,36667,738477,119354,12833709,712653,771180,963131,2446964,2309165,1785702,6541831,6291878,621734902000,33784962000,27315628000,35348574000,96449164000,93150192000,82081356000,271680712000,350054190000
California,Transportation and Warehousing,2009,86141,47145,13901,9651,70697,8795,2789,82281,3860,105890,47190,13985,9925,71100,10285,5410,86795,19095,2134141,70695,88035,122655,287733,283566,205703,788036,1280710,89987003000,2590708000,2933063000,4319098000,9806428000,11069042000,8694515000,30069043000,56853973000
California,Utilities,2009,2402,1315,405,190,1910,174,75,2159,243,5475,1320,425,205,1950,215,140,2305,3170,20416,2298,2507,2260,7318,4892,7002,20378,6217,1544408000,98564000,114873000,130868000,402386000,335365000,476025000,1320300000,865950000
California,Wholesale Trade,2009,258433,143762,43387,28756,215905,28060,7895,251860,6573,295845,144180,43985,29895,218060,33435,14835,266330,29515,4133070,245291,280345,370848,903908,966911,672073,2553910,1526502,271496210000,11740680000,12549185000,17834639000,42156660000,49843860000,39973462000,132377678000,137113258000
Colorado,Accommodation and Food Services,2009,45665,16085,9055,9221,34361,9224,941,44526,1139,60310,16105,9115,9370,34590,10800,3960,49350,10960,1122810,25517,59708,122483,208498,320660,145687,675143,435950,18054290000,636101000,805390000,1648834000,3084338000,4859976000,2261978000,10256310000,7792097000
Colorado,Administrative and Support and Waste Management and Remediation Services,2009,37151,23230,5415,3036,31681,2897,871,35449,1702,41455,23240,5420,3075,31735,3155,1145,36035,5420,979364,30576,34311,39531,108305,100587,98232,322380,648452,37955160000,1174698000,1062813000,1238187000,3510884000,3250849000,3602444000,10975229000,26610368000
Colorado,"Agriculture, Forestry, Fishing and Hunting",2009,1430,1080,210,75,1365,45,10,1420,10,1430,1080,210,75,1365,45,10,1420,10,6883,1162,1285,346,3494,1749,0,6843,0,239285000,41169000,43920000,20381000,119445000,64928000,0,234955000,0
Colorado,"Arts, Entertainment, and Recreation",2009,11483,7385,1490,980,9855,1084,287,11226,257,12120,7385,1490,980,9855,1215,370,11440,680,232682,7077,9234,12528,31826,41260,39624,115669,91214,6279896000,399931000,202326000,264248000,890611000,743182000,1057302000,2695455000,1608659000
Colorado,Construction,2009,88861,63485,11955,6760,82200,5101,859,88160,701,89610,63485,11960,6770,82215,5190,990,88395,1215,707100,91864,77499,89334,259022,188062,104782,559250,114097,32689205000,3085150000,2796381000,3554284000,9454260000,8554661000,5391852000,23554130000,8169384000
Colorado,Educational Services,2009,10144,5955,1345,1040,8340,1280,291,9911,233,10640,5955,1345,1055,8355,1355,390,10100,540,210744,7770,8929,13512,31462,54051,33666,122634,78715,5973290000,269965000,227306000,310507000,816780000,1465115000,1035900000,3453010000,2173536000
Colorado,Finance and Insurance,2009,31360,22845,3122,1215,27182,1338,835,29355,2005,51865,22865,3265,1360,27490,2515,3195,33200,18665,489430,30730,17868,14678,69956,38848,56377,169860,286733,32477876000,1492314000,959868000,920626000,3411805000,2801137000,3215712000,9762723000,20686665000
Colorado,Health Care and Social Assistance,2009,59249,32940,12124,6415,51479,4951,1570,58000,1249,70340,32950,12180,6665,51795,6460,4610,62865,7475,1241299,51166,79377,84940,217240,184702,234698,651542,567689,53006928000,2602621000,3225483000,3777830000,9622670000,7450591000,8601148000,25912030000,26107420000
Colorado,Information,2009,9712,5205,1210,855,7270,781,506,8557,1155,15360,5205,1210,885,7300,870,695,8865,6495,393479,5457,7139,9406,23005,23408,25291,90902,296679,27997477000,418521000,342541000,544943000,1345954000,1452526000,1700665000,5365912000,21897589000
Colorado,Management of Companies and Enterprises,2009,3293,300,85,70,455,572,858,1885,1408,4425,300,85,70,455,600,915,1970,2455,220214,0,339,257,985,7038,24005,32060,187543,21340875000,67933000,58500000,20470000,147035000,541104000,1970470000,2662680000,18359077000
Colorado,Manufacturing,2009,24122,11385,4126,2974,18485,3095,992,22572,1550,24855,11385,4135,2980,18500,3200,1090,22790,2065,503887,15702,21877,32566,77808,96529,50513,267632,191891,25184959000,666821000,819142000,1280715000,2993350000,4175215000,2313688000,11257859000,10911710000
Colorado,"Mining, Quarrying, and Oil and Gas Extraction",2009,5833,3330,705,594,4629,549,202,5380,453,6310,3330,705,600,4635,570,230,5435,875,121378,531,4452,7631,17448,15475,19840,54100,64339,9377385000,310823000,253807000,547682000,1122023000,1232827000,1428263000,3859785000,5343399000
Colorado,Other,2009,252,234,13,5,252,0,0,252,0,252,234,13,5,252,0,0,252,0,325,0,77,63,325,0,0,325,0,6397000,4505000,1616000,276000,6397000,0,0,6397000,0
Colorado,Other Services (except Public Administration),2009,58005,36920,10903,5377,53200,3423,672,57295,710,63470,36950,10970,5585,53505,4415,1830,59750,3720,479370,62565,70777,69296,206102,119297,50304,383171,79110,13243735000,1710276000,1837217000,1820805000,5402388000,3102315000,1640512000,10342037000,2550972000
Colorado,"Professional, Scientific, and Technical Services",2009,110233,84690,10905,6207,101802,4514,1636,107952,2281,116715,84695,10960,6345,102000,4990,2350,109340,7375,838493,106929,69795,78837,261212,141566,86160,498085,327315,59087632000,5525340000,3521867000,4420375000,13491070000,9380297000,6905323000,30242192000,28391740000
Colorado,Real Estate and Rental and Leasing,2009,39221,31587,3562,1557,36706,1121,514,38341,880,46100,31655,3620,1680,36955,1730,1135,39820,6280,205665,28786,22822,19719,83142,34560,18836,141122,61321,7743905000,1333281000,733236000,692501000,2767579000,1295452000,752058000,4972200000,2880157000
Colorado,Retail Trade,2009,61961,35339,12299,6532,54170,4187,1189,59546,2415,93670,35430,12615,7300,55345,6685,4635,66665,27005,1109094,52304,71830,69134,198884,130345,59194,419303,483153,29308570000,1471508000,1832263000,2038630000,5405092000,4261865000,2065762000,12294054000,12177859000
Colorado,Total,2009,126771,81769,18915,11282,111966,9316,2492,123774,2997,152997,81840,19118,11745,112703,11719,6200,130622,22375,2005578,124933,124010,149737,398680,334583,255522,988785,1016793,87461719000,4605421000,4110912000,5152647000,13868980000,12413655000,11061836000,37344471000,50117248000
Colorado,Transportation and Warehousing,2009,14850,9275,1825,930,12030,982,602,13614,1236,17090,9280,1835,940,12055,1070,815,13940,3150,283356,2992,10165,10901,34358,29148,19310,90874,165483,11317958000,384598000,387274000,345367000,1164047000,1137883000,735285000,3219373000,7101788000
Colorado,Utilities,2009,1043,585,125,40,750,147,45,942,101,1885,585,125,40,750,230,125,1105,780,34374,894,715,0,2055,5543,4990,13030,2385,3070011000,26022000,24279000,28976000,100245000,415992000,351215000,876982000,194115000
Colorado,Wholesale Trade,2009,30815,16120,4233,2856,23209,2879,1786,27874,2941,36075,16150,4280,2925,23355,3500,2510,29365,6710,480770,22416,24707,33121,85169,82384,51949,242868,216978,29245704000,1165406000,1183379000,1637681000,4062240000,4225031000,2935898000,11841870000,16896501000
Connecticut,Accommodation and Food Services,2009,32511,14190,6515,5733,26438,4983,514,31935,576,39420,14200,6525,5800,26525,5655,1805,33985,5435,611609,24999,43273,77797,146190,175308,65051,391025,219176,11257600000,573115000,637465000,1184928000,2408620000,2937901000,1003144000,6418445000,4816905000
Connecticut,Administrative and Support and Waste Management and Remediation Services,2009,24083,15390,3330,1885,20605,1802,558,22965,1118,26510,15390,3350,1905,20645,1955,685,23285,3225,385873,19601,21142,23236,66524,61048,56127,191072,189630,15387984000,1088197000,845288000,891368000,2900127000,2568671000,1752025000,7420697000,6709489000
Connecticut,"Agriculture, Forestry, Fishing and Hunting",2009,370,270,70,15,355,10,0,365,5,370,270,70,15,355,10,0,365,5,1213,306,17,0,196,0,0,1173,0,47704000,12507000,2098000,0,26471000,0,0,45136000,0
Connecticut,"Arts, Entertainment, and Recreation",2009,7604,4152,1050,934,6136,1114,203,7453,151,8145,4155,1050,945,6150,1170,345,7665,480,117313,3980,6465,11408,24307,44992,24201,99696,14973,3250940000,431956000,187561000,304331000,935174000,1252131000,406670000,2706275000,333665000
Connecticut,Construction,2009,42954,30840,5970,3275,40085,2354,292,42731,223,43115,30840,5975,3280,40095,2375,310,42780,335,265245,45913,38737,43084,129191,82135,25717,245927,11370,15253134000,2109636000,1831255000,2314463000,6289545000,5135630000,1776529000,13721520000,1078842000
Connecticut,Educational Services,2009,5946,2615,1125,780,4520,903,353,5776,170,6275,2620,1125,780,4525,935,430,5890,385,321184,4336,6639,9639,21104,35901,51790,118352,190353,13561983000,137921000,162266000,212524000,530805000,1203298000,2260440000,4291093000,8833297000
Connecticut,Finance and Insurance,2009,18682,10835,2568,1470,14873,1474,739,17086,1596,31995,10840,2655,1565,15060,2365,2220,19645,12350,527769,18718,16095,16299,52214,47650,56808,162052,356479,65648419000,1380877000,1510483000,2381296000,5437315000,6818617000,9535222000,23021088000,41279103000
Connecticut,Health Care and Social Assistance,2009,38638,16025,8810,5866,30701,4575,2223,37499,1139,50740,16055,8955,6340,31350,6710,6145,44205,6535,1293334,31657,57072,76278,167529,169882,315183,659821,605675,57376930000,1431418000,2512604000,3760042000,7745898000,7964185000,11386574000,27300237000,28933618000
Connecticut,Information,2009,5260,2280,730,545,3555,720,245,4520,740,8655,2280,730,550,3560,785,335,4680,3975,171303,2166,4021,5990,14011,23335,18630,62055,108441,11382716000,213667000,253652000,298891000,807775000,1410335000,979544000,3411013000,7447080000
Connecticut,Management of Companies and Enterprises,2009,2531,175,80,120,375,360,586,1321,1210,3630,175,80,120,375,360,660,1395,2235,193822,0,382,895,1560,3975,22484,28419,165403,22455044000,30665000,38465000,87265000,156555000,235531000,2136140000,2606605000,19848439000
Connecticut,Manufacturing,2009,22319,8084,3995,3320,15399,4237,1358,20994,1325,23010,8085,3995,3340,15420,4340,1465,21225,1785,628132,11370,21557,38919,78725,147592,121535,389073,187725,33848557000,597667000,929918000,1751454000,3499625000,7329168000,6020692000,18599094000,12228403000
Connecticut,"Mining, Quarrying, and Oil and Gas Extraction",2009,257,130,25,45,200,20,5,225,32,355,130,25,45,200,30,5,235,120,2790,186,48,447,792,354,0,1553,874,201538000,9904000,17243000,17759000,46978000,28170000,0,120372000,51955000
Connecticut,Other,2009,134,126,6,2,134,0,0,134,0,134,126,6,2,134,0,0,134,0,187,124,0,0,187,0,0,187,0,5996000,4616000,769000,0,5996000,0,0,5996000,0
Connecticut,Other Services (except Public Administration),2009,43395,26250,9625,4307,40182,2385,402,42969,426,46260,26270,9725,4440,40435,2795,825,44055,2205,313433,49064,62464,55061,169545,75784,23268,278759,19649,9082162000,1341980000,1657255000,1509251000,4566085000,2128889000,970522000,7881276000,776033000
Connecticut,"Professional, Scientific, and Technical Services",2009,45103,30000,6645,3653,40298,2646,789,43733,1370,47845,30045,6670,3715,40430,2885,1020,44335,3510,462703,44170,41677,45087,136606,84359,45668,276257,177485,35382375000,2637040000,2446296000,3065707000,8288689000,6580003000,3770163000,19537314000,15048634000
Connecticut,Real Estate and Rental and Leasing,2009,12462,8730,1705,738,11173,536,287,11996,466,16390,8765,1770,775,11310,770,1325,13405,2985,105111,14519,10440,8797,34248,16091,12743,67331,21886,4797611000,612947000,451241000,412792000,1513609000,736749000,504626000,2923044000,1654607000
Connecticut,Retail Trade,2009,45695,25550,8808,4691,39049,3644,962,43655,2040,65310,25610,8990,5000,39600,4960,2585,47145,18165,872196,35746,51193,52080,145425,100080,52806,318520,358378,24277582000,1217062000,1523151000,1802199000,4581258000,4178114000,1962853000,11216556000,8494644000
Connecticut,Total,2009,73515,41737,13006,8036,62779,6794,1873,71446,2069,90048,41788,13157,8346,63291,8318,4443,76052,13996,1468291,72867,85546,106433,264846,247745,221973,734564,733727,78026725000,3102146000,3349733000,4622076000,11073955000,11768298000,11494238000,34336491000,43690234000
Connecticut,Transportation and Warehousing,2009,6804,3195,935,754,4884,858,328,6070,734,8250,3200,935,785,4920,930,425,6275,1975,191854,4007,5377,8505,18989,27527,10186,65037,121620,7742960000,234607000,244560000,430720000,935335000,1509176000,374417000,3125302000,4393631000
Connecticut,Utilities,2009,354,95,30,25,150,45,30,225,129,800,95,30,25,150,45,85,280,520,4315,7,0,253,219,712,4759,6244,862,745610000,1392000,0,15344000,35996000,47249000,357380000,464878000,74880000
Connecticut,Wholesale Trade,2009,19957,9282,3090,2230,14602,2305,1196,18103,1854,22495,9285,3100,2295,14680,2515,1545,18740,3755,374001,13429,17004,26622,60893,67988,54709,209730,132233,25539960000,1000624000,1084339000,1670098000,3899022000,4262082000,3672693000,12903459000,10449201000
Delaware,Accommodation and Food Services,2009,7688,3145,1255,1370,5770,1341,250,7361,327,9515,3160,1255,1400,5815,1455,790,8060,1455,162739,4641,7893,18175,30669,50389,26281,109340,52567,2647011000,170543000,125444000,274166000,578522000,774814000,345822000,1725459000,914120000
Delaware,Administrative and Support and Waste Management and Remediation Services,2009,6194,3460,805,570,4835,545,190,5570,624,6715,3460,810,570,4840,580,195,5615,1100,124430,5219,4535,6246,16607,16179,14688,52585,49791,4300758000,192835000,137519000,202732000,554350000,553082000,403441000,1702950000,1907877000
Delaware,"Agriculture, Forestry, Fishing and Hunting",2009,215,170,25,15,210,0,0,210,5,215,170,25,15,210,0,0,210,5,667,8,0,0,452,0,0,452,0,23812000,7212000,4497000,0,18092000,0,0,18092000,0
Delaware,"Arts, Entertainment, and Recreation",2009,1895,1135,213,195,1543,235,55,1833,62,2015,1135,215,195,1545,270,60,1875,140,32178,837,769,2243,4615,7060,2748,19834,9139,698823000,51937000,20147000,35691000,132489000,176791000,61670000,494321000,164736000
Delaware,Construction,2009,12013,7695,1935,1200,10830,914,145,11889,124,12080,7695,1940,1200,10835,935,150,11920,160,101037,12392,12082,14730,41159,31285,10423,90698,6123,4839580000,424696000,445583000,629666000,1539049000,1684834000,584803000,4146778000,396335000
Delaware,Educational Services,2009,1323,563,190,180,933,225,75,1233,90,1375,565,190,185,940,240,75,1255,120,33168,623,1145,1540,3895,9589,10777,25073,3190,1057033000,24538000,20288000,32486000,93600000,230943000,446672000,812947000,99342000
Delaware,Finance and Insurance,2009,6391,3550,628,280,4458,358,318,5134,1257,11035,3575,640,330,4545,570,540,5655,5380,187543,3221,3133,2644,10673,6662,5229,27483,154249,12929259000,179003000,156915000,161985000,542448000,590891000,334553000,1690165000,10896530000
Delaware,Health Care and Social Assistance,2009,9331,3495,2120,1616,7231,1162,406,8799,532,12205,3505,2140,1670,7315,1575,1340,10230,1975,283417,6538,13698,20682,41557,37675,36228,126287,152277,12924860000,325114000,665546000,969738000,1987601000,1864419000,1392520000,5495585000,7347539000
Delaware,Information,2009,1126,530,95,123,748,100,40,888,238,1910,530,95,125,750,110,75,935,975,37900,79,276,612,1653,2562,690,8534,20646,1964027000,20527000,14677000,52351000,130060000,130587000,28413000,404341000,1091376000
Delaware,Management of Companies and Enterprises,2009,5635,2710,75,71,2856,310,671,3837,1798,6925,2735,80,90,2905,355,825,4085,2840,69920,3156,0,0,3776,1788,4644,10724,59196,5459902000,69048000,26400000,12029000,107477000,90585000,233866000,453235000,5006799000
Delaware,Manufacturing,2009,2882,1065,425,370,1860,423,221,2504,378,3060,1065,425,380,1870,435,250,2555,505,106121,1039,1276,2014,6075,7676,8002,29110,68269,4782943000,59010000,65027000,113161000,278795000,345563000,455025000,1404377000,2981321000
Delaware,"Mining, Quarrying, and Oil and Gas Extraction",2009,37,20,10,0,30,0,0,30,7,50,20,10,0,30,0,0,30,20,64,0,0,0,40,0,0,40,0,4145000,0,0,0,2997000,0,0,2997000,0
Delaware,Other,2009,47,45,2,0,47,0,0,47,0,47,45,2,0,47,0,0,47,0,0,0,0,0,0,0,0,0,0,1360000,1099000,0,0,1360000,0,0,1360000,0
Delaware,Other Services (except Public Administration),2009,10094,5905,2215,969,9089,625,159,9873,221,10550,5905,2245,1025,9175,700,260,10135,415,69764,10176,13192,11873,37472,18997,5115,64775,3400,1847478000,289275000,335538000,295058000,960848000,467537000,124825000,1689905000,110243000
Delaware,"Professional, Scientific, and Technical Services",2009,11392,7435,1323,836,9594,858,330,10782,610,12130,7435,1325,910,9670,1015,395,11080,1050,111471,8336,7933,10271,29072,24710,17999,75485,25759,8630267000,593507000,449699000,617421000,1724362000,1828929000,1711337000,5462923000,2264238000
Delaware,Real Estate and Rental and Leasing,2009,4627,3110,385,240,3735,261,138,4134,493,5590,3110,390,260,3760,455,275,4490,1100,28145,3835,1699,2120,8912,5729,3592,20735,5406,1112551000,172071000,80817000,101778000,372177000,217010000,131626000,780567000,235739000
Delaware,Retail Trade,2009,13114,6675,2349,1169,10193,1002,400,11595,1519,18410,6690,2375,1335,10400,1515,625,12540,5870,242084,9393,12371,12216,37092,26599,15418,88697,128963,6011597000,272749000,316778000,352152000,1009375000,956983000,562884000,2691726000,2918404000
Delaware,Total,2009,19741,10972,2982,1930,15884,1771,681,18336,1405,24523,10995,3020,2051,16066,2217,1282,19565,4958,370846,17917,19541,25601,63059,60044,47888,170991,199855,16777392000,652729000,665640000,912150000,2230519000,2415682000,1984895000,6631096000,10146296000
Delaware,Transportation and Warehousing,2009,3155,1785,363,234,2382,288,125,2795,360,3355,1785,365,235,2385,315,130,2830,525,55611,1154,1830,1798,6015,5776,3592,22970,16783,1811784000,70385000,44452000,50847000,189280000,203687000,122503000,741304000,812639000
Delaware,Utilities,2009,127,65,10,0,75,5,15,95,32,225,65,20,0,85,5,25,115,110,6452,0,0,0,54,0,0,33,0,569525000,5074000,0,0,6570000,0,0,5418000,0
Delaware,Wholesale Trade,2009,4557,2145,540,315,3000,505,330,3835,722,5020,2145,545,330,3020,555,400,3975,1045,64538,2170,2563,2997,9278,6768,5719,28555,26840,4764214000,141720000,131890000,135072000,468659000,342192000,295807000,1528469000,2390096000
District of Columbia,Accommodation and Food Services,2009,8258,3030,1445,1200,5675,1775,330,7780,478,11015,3030,1445,1225,5700,1845,585,8130,2885,274588,5534,9092,15555,31025,66503,23101,122306,137943,6935275000,150168000,177845000,369330000,699898000,1421247000,514535000,2620481000,3867428000
District of Columbia,Administrative and Support and Waste Management and Remediation Services,2009,3959,1535,440,305,2280,555,551,3386,573,5675,1540,445,315,2300,560,635,3495,2180,161205,1505,1988,2734,8331,16304,53350,85120,72497,6494180000,165867000,129781000,163037000,549914000,652781000,1714203000,3217441000,2656546000
District of Columbia,"Agriculture, Forestry, Fishing and Hunting",2009,10,10,0,0,10,0,0,10,0,10,10,0,0,10,0,0,10,0,0,0,0,0,0,0,0,0,0,0,0,0,0,0,0,0,0,0
District of Columbia,"Arts, Entertainment, and Recreation",2009,1287,675,175,125,975,165,60,1200,87,1455,675,175,125,975,180,110,1265,190,30725,695,702,791,2464,4683,7692,18105,10626,1591507000,44791000,60381000,31831000,158091000,174752000,242750000,632533000,582916000
District of Columbia,Construction,2009,1875,850,320,280,1450,280,80,1810,65,1920,850,320,280,1450,280,90,1820,100,30749,963,1904,3039,6434,8504,5824,23817,927,1713997000,68619000,98094000,167088000,359853000,495838000,257244000,1250547000,87942000
District of Columbia,Educational Services,2009,2389,775,325,330,1430,498,283,2211,178,2670,775,325,330,1430,590,385,2405,265,241596,373,1517,2991,6162,21209,34421,66009,175120,10705306000,92498000,78184000,108388000,288594000,959226000,1545385000,2999582000,7685124000
District of Columbia,Finance and Insurance,2009,2941,975,300,200,1475,437,216,2128,813,5450,975,300,210,1485,565,385,2435,3015,61045,792,1045,2018,4197,8206,4975,21132,35453,7327883000,116829000,135595000,256598000,568049000,767471000,426074000,2151535000,4823048000
District of Columbia,Health Care and Social Assistance,2009,8982,4185,1700,1002,6887,1195,503,8585,397,10695,4185,1700,1105,6990,1460,1000,9450,1245,330795,7045,10774,11766,30895,35615,56383,126663,183722,16548938000,486362000,607840000,645780000,1769282000,1457887000,1869617000,5170789000,10735420000
District of Columbia,Information,2009,2540,890,305,170,1365,355,184,1904,636,3635,895,305,170,1370,355,185,1910,1725,97433,499,1208,1131,3304,7104,8174,27606,66737,9670657000,85332000,101207000,103899000,373859000,556000000,590995000,1986484000,6978114000
District of Columbia,Management of Companies and Enterprises,2009,821,40,15,10,65,85,160,310,511,965,40,15,10,65,85,160,310,655,36080,0,0,0,131,925,3998,5106,29610,4721510000,0,0,0,29430000,69869000,255511000,357727000,4359081000
District of Columbia,Manufacturing,2009,510,255,95,75,425,45,15,485,25,520,255,95,75,425,50,15,490,30,7340,332,397,454,1316,569,0,3777,1128,266045000,12662000,17594000,18969000,55374000,24543000,0,127861000,44968000
District of Columbia,"Mining, Quarrying, and Oil and Gas Extraction",2009,15,5,0,0,5,0,5,10,5,15,5,0,0,5,0,5,10,5,0,0,0,0,0,0,0,0,0,0,0,0,0,0,0,0,0,0
District of Columbia,Other,2009,58,55,0,2,57,1,0,58,0,58,55,0,2,57,1,0,58,0,0,0,0,0,0,0,0,0,0,2863000,2082000,0,0,2197000,0,0,2863000,0
District of Columbia,Other Services (except Public Administration),2009,17970,7880,3518,2361,13759,2806,1056,17621,349,20335,7880,3535,2390,13805,3005,1380,18190,2145,356279,13446,22654,29765,68243,97104,112542,278766,49662,23026392000,848266000,1237876000,1797655000,3896552000,6495631000,8172652000,18702763000,3045537000
District of Columbia,"Professional, Scientific, and Technical Services",2009,20725,10735,2858,2025,15618,2107,1171,18896,1829,24100,10735,2860,2030,15625,2170,1330,19125,4975,447354,14277,16007,23024,54203,59401,62704,181600,257977,48698026000,1899871000,1693717000,2483630000,6099585000,6220519000,5953794000,18823894000,29576800000
District of Columbia,Real Estate and Rental and Leasing,2009,3489,1910,490,255,2655,298,219,3172,317,5300,1925,520,260,2705,495,425,3625,1675,44465,2511,2264,2529,9172,7896,8358,28216,14894,2825100000,170731000,150134000,152762000,493427000,485014000,553930000,1748697000,979231000
District of Columbia,Retail Trade,2009,7121,4010,1070,568,5648,444,233,6325,796,8820,4025,1075,595,5695,565,380,6640,2180,86516,6013,4410,4363,17495,6524,1469,32179,46443,2451819000,201526000,140238000,130687000,519373000,214305000,31023000,911445000,1249148000
District of Columbia,Total,2009,16728,7820,2664,1818,12302,2203,966,15471,1257,21210,7829,2682,1866,12377,2491,1456,16324,4886,466550,13957,17517,23503,54977,74883,87436,217296,249254,30236461000,952889000,1023790000,1423539000,3400218000,4256508000,4999630000,12656356000,17580105000
District of Columbia,Transportation and Warehousing,2009,780,360,45,40,445,85,76,606,174,890,360,45,40,445,90,85,620,270,10304,298,162,0,626,976,1533,4733,3629,470640000,21557000,22843000,0,61169000,24872000,63027000,204032000,154465000
District of Columbia,Utilities,2009,160,10,0,5,15,0,5,20,140,210,10,0,5,15,0,5,20,190,0,0,0,0,12,0,0,0,0,0,0,0,0,429000,0,0,0,0
District of Columbia,Wholesale Trade,2009,1719,695,240,150,1085,145,110,1340,379,2080,700,250,155,1105,155,120,1380,700,21329,649,942,1309,3306,2404,72,8682,9424,1644863000,55041000,55972000,63906000,201473000,97640000,2622000,475268000,816758000
Florida,Accommodation and Food Services,2009,128734,57613,24267,20451,102331,21487,3010,126828,1906,174230,57690,24450,20765,102905,23685,9630,136220,38010,3643870,94990,160940,274683,531200,808309,478063,1818948,1797385,59101104000,2207449000,2069990000,3593758000,7871569000,11699458000,7500055000,27080493000,31498729000
Florida,Administrative and Support and Waste Management and Remediation Services,2009,142807,102098,16581,9657,128336,8403,2785,139524,3283,159990,102130,16690,9800,128620,9125,4675,142420,17570,6435085,138425,106281,128028,387797,312937,365149,1084843,5333522,209647921000,4325964000,3030527000,3859528000,11311203000,9192604000,9977353000,30700843000,178498441000
Florida,"Agriculture, Forestry, Fishing and Hunting",2009,4818,3130,735,425,4290,351,106,4747,71,4935,3130,735,425,4290,410,120,4820,115,66542,4603,4046,5130,15005,11349,13439,41085,19746,1659251000,146487000,146032000,159987000,468027000,312376000,271707000,1092237000,494226000
Florida,"Arts, Entertainment, and Recreation",2009,34649,22840,3985,2623,29448,3492,1077,34017,632,36835,22840,3990,2655,29485,3650,1350,34485,2350,766602,26601,25881,34353,93175,151586,144045,400281,347429,21061160000,1246319000,652992000,691338000,2659770000,3303942000,4608466000,12093771000,7843193000
Florida,Construction,2009,234179,169133,29326,18607,217066,14092,1936,233094,1085,237110,169140,29350,18660,217150,14670,2435,234255,2855,1708070,229040,192905,248884,688858,526380,267117,1487050,198084,65534465000,6568825000,5825650000,8678639000,21078860000,20581190000,12015538000,53762370000,11370311000
Florida,Educational Services,2009,24898,14093,3250,2455,19798,3573,983,24354,544,27595,14110,3270,2525,19905,4000,1475,25380,2215,692155,14406,21436,33190,75488,144666,136269,363150,325167,22830760000,614905000,432831000,696045000,1747335000,3870356000,4329467000,10088800000,12552660000
Florida,Finance and Insurance,2009,89821,65261,11103,4577,80941,4017,1891,86849,2972,161505,65390,11370,5150,81910,7195,8330,97435,64070,1671097,89120,69818,55925,219607,129802,162475,529306,1126295,99217211000,4455834000,3354798000,3088560000,10976010000,7801482000,9977058000,29173043000,69214381000
Florida,Health Care and Social Assistance,2009,224747,126945,50165,25301,202411,14893,4494,221798,2949,265975,127155,50435,26220,203810,20450,14485,238745,27230,4714045,205720,328146,330179,879383,553812,655893,2105151,2574529,205118445000,11581411000,14025689000,14094723000,39709097000,24554070000,25068210000,89640726000,113740639000
Florida,Information,2009,23834,15615,2615,1655,19885,1689,758,22332,1502,39040,15635,2620,1705,19960,2000,1230,23190,15850,779873,16999,16826,20810,58978,58599,46293,172790,603926,46051092000,1073231000,693132000,914856000,2728065000,3069877000,2416176000,8799447000,37122080000
Florida,Management of Companies and Enterprises,2009,8005,1165,220,335,1720,1406,1926,5052,2953,12980,1170,220,340,1730,1435,2070,5235,7745,652615,1715,1135,2488,5360,18482,60720,84690,567658,46869635000,256100000,80435000,173719000,511820000,1277840000,4334315000,6143875000,40725760000
Florida,Manufacturing,2009,60972,31570,9725,7036,48331,7254,2431,58016,2956,64310,31570,9725,7055,48350,7475,2710,58535,5775,1374976,47055,57657,84259,203247,252877,203278,716514,595528,60368369000,1623382000,1813709000,2892025000,6621950000,9461143000,8103790000,26241606000,31342762000
Florida,"Mining, Quarrying, and Oil and Gas Extraction",2009,1080,565,150,85,800,145,27,972,108,1325,565,150,85,800,165,60,1025,300,19460,588,800,409,2720,3828,0,7866,11275,1027547000,41080000,28417000,19114000,109447000,159098000,11096000,333951000,687291000
Florida,Other,2009,536,514,17,5,536,0,0,536,0,536,514,17,5,536,0,0,536,0,0,0,111,59,0,0,0,0,0,14739000,11621000,2988000,130000,14739000,0,0,14739000,0
Florida,Other Services (except Public Administration),2009,199051,137197,32497,16205,185899,10542,1495,197936,1115,215455,137280,32635,16525,186440,12505,4175,203120,12335,1470318,234093,209532,212925,659500,370269,149712,1184395,253406,35664425000,5363740000,4765108000,4923096000,15065640000,8818079000,3742510000,27782415000,7321955000
Florida,"Professional, Scientific, and Technical Services",2009,319037,249553,33670,17346,300569,12050,3141,315760,3277,339410,249655,33810,17825,301290,14560,6225,322075,17335,2140430,338744,215438,223118,787673,393413,230770,1425599,683795,122388773000,16440010000,10166953000,11556265000,38179520000,23053834000,15191748000,76727011000,44852320000
Florida,Real Estate and Rental and Leasing,2009,115098,95175,9966,4356,109497,2859,1341,113697,1401,141865,95360,10330,4870,110560,4145,5290,119995,21870,765864,93546,61789,53245,238823,85893,89185,417803,322608,27653690000,3974281000,2013991000,1785694000,7802418000,3136722000,3248943000,14382776000,12762386000
Florida,Retail Trade,2009,222794,154135,35580,15973,205688,10857,2816,219361,3433,353140,154745,36495,18240,209480,17165,10115,236760,116380,4199877,203863,214637,186738,654711,365309,234908,1255996,2061015,102940897000,6042132000,5152519000,5058013000,16286335000,11535122000,8217605000,36468606000,49314342000
Florida,Total,2009,399819,274647,57678,32043,364368,25195,5899,395462,4357,491249,275028,58285,33514,366827,31540,16772,415139,76110,6861612,429477,376039,422698,1228214,927518,745513,2901245,3960367,253360443000,14825249000,12181815000,13991598000,40998662000,32087293000,28272050000,101358005000,152002438000
Florida,Transportation and Warehousing,2009,53544,37280,5860,3484,46624,2965,1497,51086,2458,62295,37320,5895,3575,46790,3365,2260,52415,9880,995045,45367,36168,43813,133198,89947,93975,324337,653761,39272713000,1914502000,1228070000,1376101000,4540964000,3251820000,3517738000,11627272000,27298117000
Florida,Utilities,2009,1467,745,255,85,1085,119,97,1301,166,2985,745,255,95,1095,200,320,1615,1370,139197,783,1004,0,3557,5625,16290,28085,110092,10700142000,41975000,59291000,22587000,141184000,275685000,1096908000,1630948000,8976858000
Florida,Wholesale Trade,2009,133203,86862,18734,10527,116123,9455,3582,129160,4043,152585,86940,18915,11030,116885,11500,6905,135290,17295,1426519,130166,116470,130940,385884,285170,207145,902562,474129,69650261000,5667660000,4964334000,5690124000,16336658000,13276658000,9842652000,40103636000,27736699000
Georgia,Accommodation and Food Services,2009,66214,25845,11716,12498,50059,13101,1689,64849,1365,92630,25855,11765,12655,50275,14970,6470,71715,20915,1755540,44002,78121,169364,291683,466566,248062,1008035,742758,24639305000,914615000,943174000,2007896000,3870715000,5892380000,3186750000,12971145000,11654864000
Georgia,Administrative and Support and Waste Management and Remediation Services,2009,50822,31520,6800,4500,42820,4191,1634,48645,2177,59940,31520,6815,4555,42890,4400,2440,49730,10210,1488829,43835,42293,59792,149329,153668,188947,503914,947520,44446639000,1598990000,1303841000,1856171000,4807907000,4945495000,5986965000,16013454000,27463839000
Georgia,"Agriculture, Forestry, Fishing and Hunting",2009,4730,2495,1225,530,4250,391,45,4686,44,4840,2500,1225,530,4255,420,80,4755,85,36420,4053,8230,7035,19838,11128,563,34925,299,1258904000,145626000,275750000,247285000,674641000,387257000,21030000,1178474000,16086000
Georgia,"Arts, Entertainment, and Recreation",2009,12721,7755,1635,1355,10745,1405,312,12462,259,13545,7755,1635,1360,10750,1515,445,12710,835,209509,9094,10164,17725,39131,53632,37242,136985,37776,6292632000,397313000,203627000,311160000,930419000,949179000,1233502000,3563723000,1115632000
Georgia,Construction,2009,92289,60075,14615,8889,83579,6786,1131,91496,793,93565,60095,14615,8895,83605,6890,1350,91845,1720,876550,91876,95724,118377,310285,252359,158468,724140,132903,35589440000,2845910000,3078235000,4128240000,10052385000,10297692000,6829446000,27265580000,7326269000
Georgia,Educational Services,2009,11838,6225,1810,1320,9355,1645,488,11488,350,13090,6230,1820,1400,9450,1845,610,11905,1185,385174,7547,11517,17490,38289,70194,75787,189349,194269,13264983000,246232000,218882000,306865000,780585000,1758125000,2342507000,4969413000,8260252000
Georgia,Finance and Insurance,2009,39335,25867,4999,2263,33129,2576,1341,37046,2289,75920,25920,5210,2895,34025,5640,5470,45135,30785,832795,38192,29249,26028,92307,87442,92535,291552,413105,52381190000,1730709000,1405358000,1513179000,4702795000,4447701000,5488041000,14911154000,36410240000
Georgia,Health Care and Social Assistance,2009,88497,42720,20407,12497,75624,9046,1902,86572,1925,107585,42765,20525,13090,76380,11520,6180,94080,13505,2150152,71699,134700,165559,373692,329605,267136,982801,1135948,89518939000,3964689000,5574679000,7056874000,16628591000,13270231000,9295275000,39539581000,48347520000
Georgia,Information,2009,11068,5670,1330,980,7980,1180,491,9651,1417,20560,5670,1335,1055,8060,1305,805,10170,10390,610956,7111,7026,12350,27368,39658,41264,113477,480274,41209863000,351223000,321792000,585153000,1327735000,2277385000,2510100000,6254603000,33313645000
Georgia,Management of Companies and Enterprises,2009,5630,465,135,180,780,876,1337,2993,2637,8280,465,135,180,780,895,1415,3090,5190,530770,0,564,1415,2432,11670,38169,52905,477636,46647885000,68883000,45555000,96750000,211500000,643565000,2423900000,3279055000,43368830000
Georgia,Manufacturing,2009,36413,13590,5950,4774,24314,5643,2579,32536,3877,40050,13590,5950,4810,24350,5925,3085,33360,6690,1676971,20279,34277,57627,120595,197973,208736,577511,991658,67288195000,778372000,1119238000,1931932000,4047703000,7307220000,8083228000,21284390000,42242039000
Georgia,"Mining, Quarrying, and Oil and Gas Extraction",2009,618,200,125,65,390,95,35,520,98,970,200,125,65,390,105,50,545,425,24086,312,549,659,1778,2234,1364,8116,11542,1204013000,12314000,25683000,20944000,63464000,87068000,81718000,400379000,529126000
Georgia,Other,2009,265,253,10,1,264,1,0,265,0,265,253,10,1,264,1,0,265,0,297,0,64,0,0,0,0,297,0,6907000,5434000,676000,0,6192000,0,0,6907000,0
Georgia,Other Services (except Public Administration),2009,95632,60480,18475,8668,87623,6109,990,94722,910,102365,60505,18525,8885,87915,7405,1725,97045,5320,792280,108243,119037,112053,344497,215601,78283,645337,121620,19929667000,2512051000,2635025000,2591143000,7759719000,4982519000,2118056000,15019972000,4089161000
Georgia,"Professional, Scientific, and Technical Services",2009,129839,96354,14295,8169,118818,6153,2118,127089,2750,138125,96370,14325,8330,119025,6805,3165,128995,9130,1194974,125758,91752,105718,328482,201771,148432,687963,487781,73932725000,6413194000,4314610000,5290580000,16065095000,12215081000,8620875000,37240570000,36527116000
Georgia,Real Estate and Rental and Leasing,2009,40255,31037,3745,1951,36733,1574,831,39138,1117,54270,31110,3955,2130,37195,2455,3000,42650,11620,280853,38360,22352,22984,86789,48586,43401,183049,102954,11685628000,1288538000,720490000,810056000,2832220000,2044944000,2086609000,7071678000,4760299000
Georgia,Retail Trade,2009,108370,67758,20137,9366,97261,6513,1710,105484,2886,170680,67950,20540,10265,98755,9800,6135,114690,55990,1979266,112813,128676,119395,371338,214798,112328,713889,1187407,45616836000,2692364000,2852447000,3055544000,8608283000,6465082000,3634279000,19031929000,25865411000
Georgia,Total,2009,171747,104423,27646,17078,149147,14693,4024,167864,3883,219348,104551,27936,17843,150330,18308,9906,178544,40804,3410505,171287,180877,226612,578776,528063,427078,1533917,1876588,136632394000,5797887000,5648625000,7285304000,18731816000,18025451000,16393715000,53150982000,83481412000
Georgia,Transportation and Warehousing,2009,24200,13985,2535,1949,18469,2045,1322,21836,2364,29420,14010,2550,2005,18565,2255,1875,22695,6725,753328,16570,15576,23536,61697,55226,61027,185717,483692,30056524000,649171000,523712000,765293000,1970423000,1926549000,2214877000,6282955000,20968381000
Georgia,Utilities,2009,615,170,50,15,235,145,127,507,108,2965,170,50,15,235,220,350,805,2160,61040,2,213,0,673,6658,20742,28163,0,8601167000,10636000,10238000,3995000,28238000,358697000,1335126000,1727394000,5494000
Georgia,Wholesale Trade,2009,56905,28752,8417,5879,43048,6219,3401,52668,4237,66615,28810,8530,6090,43430,7165,4880,55475,11140,957120,42145,52674,71375,175933,175531,154895,522842,411300,55239280000,2158211000,2351255000,3297057000,7907361000,8523084000,7975018000,25154184000,29174782000
Hawaii,Accommodation and Food Services,2009,13633,4923,2653,2649,10225,2589,413,13227,406,17425,4930,2655,2695,10280,3095,1225,14600,2825,451880,8787,16811,34597,60200,99481,65805,226375,222381,10612117000,225414000,245498000,482995000,956242000,1761099000,1444926000,4193478000,6369839000
Hawaii,Administrative and Support and Waste Management and Remediation Services,2009,8082,4310,1300,800,6410,900,317,7627,455,9365,4310,1305,800,6415,1170,575,8160,1205,216392,6498,7874,8604,25092,28314,37619,103777,73550,6044789000,221062000,217763000,224702000,711946000,925620000,893001000,2803021000,2035100000
Hawaii,"Agriculture, Forestry, Fishing and Hunting",2009,195,155,15,10,180,15,0,195,0,195,155,15,10,180,15,0,195,0,799,0,0,0,0,640,0,799,0,22520000,1017000,0,0,13060000,9348000,0,22520000,0
Hawaii,"Arts, Entertainment, and Recreation",2009,2345,1095,370,265,1730,372,161,2263,82,2535,1095,370,270,1735,410,245,2390,145,50191,1156,2046,2376,6302,13795,19671,44957,2298,1117455000,68572000,49794000,63611000,197822000,264027000,462202000,1006938000,53674000
Hawaii,Construction,2009,14047,8075,2590,1620,12285,1347,224,13856,191,14205,8075,2590,1620,12285,1385,280,13950,255,147650,12649,16159,19173,51517,45416,21604,127953,14589,8531995000,530415000,668325000,1000408000,2249688000,2680000000,1448554000,6968000000,1263109000
Hawaii,Educational Services,2009,2400,995,410,345,1750,425,110,2285,115,2625,995,410,350,1755,465,200,2420,205,96330,1074,2354,4182,8407,15758,15025,40785,52169,3114745000,41672000,40354000,88980000,187835000,378521000,549633000,1176424000,1828743000
Hawaii,Finance and Insurance,2009,4348,2551,430,265,3246,298,187,3731,617,7640,2565,455,305,3325,585,660,4570,3070,90340,3792,2123,1928,9203,7904,11227,30689,55141,5165564000,196273000,117461000,133347000,480608000,388726000,640982000,1675002000,3354790000
Hawaii,Health Care and Social Assistance,2009,14588,7660,3645,1488,12793,1029,435,14257,331,17580,7670,3660,1600,12930,1615,1395,15940,1640,306425,14185,21953,17257,55278,40448,69089,171849,123902,14090524000,805236000,1020466000,773221000,2617494000,1478736000,2950660000,7316538000,6477201000
Hawaii,Information,2009,1757,845,255,115,1215,200,55,1470,287,2900,850,255,120,1225,245,120,1590,1310,46063,486,978,596,2797,5201,711,9989,31121,2401532000,46991000,59348000,27126000,164568000,268274000,34086000,561064000,1656116000
Hawaii,Management of Companies and Enterprises,2009,971,25,30,70,125,230,245,600,371,1285,25,30,70,125,235,275,635,650,30095,0,0,317,409,2461,7240,10076,19823,1936420000,0,3203000,18868000,25475000,122475000,371260000,521230000,1402357000
Hawaii,Manufacturing,2009,4207,2040,760,635,3435,529,111,4075,132,4380,2040,760,645,3445,565,155,4165,215,49912,1656,3529,5846,13392,12225,4199,40980,4573,1596451000,79031000,90734000,173146000,388991000,356171000,127385000,1291887000,223699000
Hawaii,"Mining, Quarrying, and Oil and Gas Extraction",2009,51,5,5,15,25,0,5,30,21,55,5,5,15,25,0,5,30,25,735,0,0,0,0,0,0,0,0,66871000,0,0,0,0,0,0,0,0
Hawaii,Other,2009,54,51,3,0,54,0,0,54,0,54,51,3,0,54,0,0,54,0,0,0,0,0,0,0,0,0,0,981000,879000,0,0,981000,0,0,981000,0
Hawaii,Other Services (except Public Administration),2009,15539,10155,2510,1415,14080,1010,224,15314,225,17330,10185,2520,1450,14155,1425,570,16150,1180,123944,17565,14699,15370,50736,31508,15535,104107,7503,3280578000,493228000,429927000,459402000,1435376000,881587000,406528000,2875068000,181341000
Hawaii,"Professional, Scientific, and Technical Services",2009,15113,9950,2065,1252,13267,918,268,14453,660,16635,9950,2075,1300,13325,1050,335,14710,1925,114133,13279,12463,15111,41122,28800,9008,84214,23746,6389018000,779230000,615651000,836358000,2264717000,1792569000,598773000,4812644000,1403897000
Hawaii,Real Estate and Rental and Leasing,2009,8183,5710,1090,489,7289,378,221,7888,295,10190,5745,1145,520,7410,705,380,8495,1695,63312,8758,5004,5033,17484,9885,6265,39092,16637,2645086000,368775000,220938000,222938000,822244000,428451000,264457000,1594168000,834658000
Hawaii,Retail Trade,2009,15414,7575,3319,1765,12659,1199,454,14312,1102,23685,7620,3450,2040,13110,2310,2215,17635,6050,318751,9453,15511,19018,45286,30189,27354,112638,151807,8187571000,323868000,438048000,465477000,1309092000,792703000,838393000,3211685000,4181283000
Hawaii,Total,2009,25746,14320,4658,2846,21824,2404,610,24838,908,32372,14357,4738,3027,22122,3415,1945,27482,4890,488403,25409,30696,37481,93586,90411,82481,266478,221925,17742683000,929669000,972841000,1201712000,3104222000,3058702000,2949946000,9112870000,8629813000
Hawaii,Transportation and Warehousing,2009,3616,1530,490,410,2430,500,285,3215,401,4350,1535,490,425,2450,565,530,3545,805,114801,1556,2553,4570,9859,14923,14185,44058,42035,4440746000,83526000,90154000,125361000,316975000,529523000,483570000,1522283000,1861979000
Hawaii,Utilities,2009,130,40,10,10,60,10,20,90,40,270,40,10,10,60,55,55,170,100,6893,0,0,0,282,0,0,1426,0,520489000,2657000,0,0,11325000,0,0,91189000,5457000
Hawaii,Wholesale Trade,2009,7908,3730,1406,841,5977,928,313,7218,690,8940,3740,1475,890,6105,1180,505,7790,1150,91674,4777,7076,8106,23350,22283,10879,68090,17586,4010434000,219856000,295807000,337374000,922481000,894454000,480710000,2713275000,1067216000
Idaho,Accommodation and Food Services,2009,14149,5240,3033,2995,11268,2134,369,13771,378,17390,5260,3045,3035,11340,2805,1265,15410,1980,264787,7802,20304,39739,68100,68701,40312,178095,85410,3297889000,155203000,203416000,426295000,788005000,822419000,462403000,2094645000,1194407000
Idaho,Administrative and Support and Waste Management and Remediation Services,2009,10103,6560,1395,760,8715,665,250,9630,473,10760,6565,1395,775,8735,735,315,9785,975,184013,7701,8292,8898,26326,17285,22844,73792,98911,4837028000,272270000,192157000,234702000,732980000,455427000,476511000,1863776000,2503473000
Idaho,"Agriculture, Forestry, Fishing and Hunting",2009,2280,1675,335,135,2145,80,35,2260,20,2290,1675,335,135,2145,80,45,2270,20,14702,2230,2146,1619,6415,1925,2388,14412,0,439300000,92640000,67496000,64607000,235280000,88641000,45317000,424930000,0
Idaho,"Arts, Entertainment, and Recreation",2009,3512,2220,485,350,3055,347,45,3447,65,3595,2230,490,360,3080,370,45,3495,100,40690,2164,2813,4138,9855,11487,3483,27036,6321,619791000,82374000,43728000,53107000,197099000,219674000,55890000,498294000,61006000
Idaho,Construction,2009,34641,25985,4755,2210,32950,1409,145,34504,137,34795,25985,4755,2210,32950,1470,170,34590,205,164044,35663,30542,28590,98438,47754,8200,159539,2096,5905030000,1093180000,858159000,1004012000,2994167000,1961978000,422519000,5607158000,121811000
Idaho,Educational Services,2009,1905,935,300,275,1510,280,40,1830,75,2005,935,300,275,1510,295,100,1905,100,48612,1052,1471,3343,6825,9727,2288,19353,27480,986689000,27488000,31656000,57651000,125966000,226530000,42733000,408534000,544060000
Idaho,Finance and Insurance,2009,8118,5475,885,335,6695,328,284,7307,811,14515,5490,950,415,6855,675,1310,8840,5675,100223,8138,4932,3679,18129,6024,14937,43469,50798,4524133000,261717000,175582000,158561000,622445000,315539000,730549000,1776106000,2658782000
Idaho,Health Care and Social Assistance,2009,20875,10435,4620,2640,17695,2083,566,20344,531,23360,10440,4635,2680,17755,2825,1520,22100,1260,387879,15921,29439,33084,81037,79663,69342,236693,143937,13257726000,812163000,1039444000,1116450000,3000626000,2615434000,1819222000,7536024000,5567215000
Idaho,Information,2009,2353,1100,305,250,1655,286,87,2028,325,3565,1100,320,250,1670,400,120,2190,1375,61500,1118,1319,2155,5065,6924,2464,16918,40675,2509007000,49135000,40547000,76157000,181293000,298161000,113259000,751955000,1719265000
Idaho,Management of Companies and Enterprises,2009,876,55,10,25,90,187,291,568,308,1195,55,10,30,95,195,295,585,610,38746,0,0,88,24,2311,6583,9106,29566,2926036000,7098000,0,4087000,13605000,113689000,346511000,472721000,2450386000
Idaho,Manufacturing,2009,8701,3920,1615,1080,6615,1244,357,8216,485,9000,3920,1620,1085,6625,1275,420,8320,680,208764,4501,7180,10447,27515,37467,18639,102387,90430,8456622000,179017000,214683000,331205000,841838000,1291899000,702638000,3432864000,4354339000
Idaho,"Mining, Quarrying, and Oil and Gas Extraction",2009,564,280,85,50,415,76,36,527,37,610,280,85,50,415,90,40,545,65,9188,287,245,398,1226,1759,0,4438,1618,576595000,15075000,18887000,17092000,61025000,107008000,41137000,317647000,119848000
Idaho,Other,2009,59,56,2,1,59,0,0,59,0,59,56,2,1,59,0,0,59,0,0,0,0,0,0,0,0,0,0,1098000,856000,0,0,1098000,0,0,1098000,0
Idaho,Other Services (except Public Administration),2009,15612,10300,2955,1307,14562,664,140,15366,246,16580,10300,2960,1425,14685,940,260,15885,695,93055,16948,18419,13941,53406,18225,5993,80756,5192,2063358000,400002000,409736000,343086000,1188117000,377169000,140157000,1751002000,193653000
Idaho,"Professional, Scientific, and Technical Services",2009,19961,14125,2635,1420,18180,872,263,19315,646,21310,14130,2655,1450,18235,1135,425,19795,1515,137448,18732,16218,17051,54784,23786,7967,91776,44838,6704120000,787907000,589347000,657676000,2061920000,1178037000,344099000,3777267000,2865538000
Idaho,Real Estate and Rental and Leasing,2009,9525,7815,811,341,8967,220,135,9322,203,10915,7820,835,430,9085,415,425,9925,990,33483,7869,4061,3621,18542,4569,2365,28681,3547,914007000,262757000,115930000,96760000,484695000,139202000,63692000,750284000,110850000
Idaho,Retail Trade,2009,20972,10215,4370,2669,17254,1955,492,19701,1271,29895,10255,4445,2945,17645,3000,2455,23100,6795,358603,14337,27031,30855,79154,56264,26387,171067,167738,8611543000,381439000,576757000,729784000,1719694000,1522767000,762034000,4200832000,4084343000
Idaho,Total,2009,37482,23115,6120,3602,32837,2769,713,36319,1163,44300,23142,6180,3781,33103,3778,2099,38980,5320,500226,36549,40085,47241,123875,95824,67307,287006,213220,16328394000,1077581000,1038136000,1252982000,3368699000,2885241000,1998250000,8252190000,8076204000
Idaho,Transportation and Warehousing,2009,7559,5005,965,465,6435,537,189,7161,398,8270,5005,970,470,6445,610,275,7330,940,76836,5545,5159,5638,18207,16733,10871,47115,20870,2481284000,189211000,165949000,169607000,543488000,496722000,360239000,1445773000,738329000
Idaho,Utilities,2009,596,345,55,65,465,50,5,520,76,950,345,55,65,465,85,30,580,370,16134,429,307,694,1615,1745,0,3552,0,1043687000,8940000,7252000,21820000,44020000,117853000,0,171317000,0
Idaho,Wholesale Trade,2009,8326,3640,1010,770,5420,1138,619,7177,1149,10205,3640,1030,815,5485,1490,980,7955,2250,114931,4074,5033,6360,16995,27457,15832,74485,29778,5028494000,193951000,200100000,273295000,758971000,1026301000,700657000,2861452000,1776729000
Illinois,Accommodation and Food Services,2009,101427,42535,20063,17654,80252,17788,1869,99909,1518,132155,42640,20150,17850,80640,20100,6055,106795,25360,2285065,75391,133447,234560,447967,658580,269741,1377055,899808,36010850000,1559817000,1630874000,2991108000,6189260000,9305394000,4311542000,19825149000,16121308000
Illinois,Administrative and Support and Waste Management and Remediation Services,2009,72803,46006,9395,5980,61381,6376,2462,70219,2584,82795,46025,9430,6050,61505,6845,3270,71620,11175,2253741,59406,58939,79185,199696,238650,329578,783749,1431923,63709234000,2886476000,2206220000,2826867000,7940173000,8135438000,9644467000,26229503000,35585856000
Illinois,"Agriculture, Forestry, Fishing and Hunting",2009,1420,1105,165,65,1335,30,25,1390,30,1535,1105,165,65,1335,35,50,1420,115,7162,1471,607,817,3103,312,1016,5091,0,318378000,50121000,35000000,24826000,112375000,9121000,51380000,195305000,0
Illinois,"Arts, Entertainment, and Recreation",2009,21053,12350,3070,2165,17585,2550,555,20690,363,22495,12355,3080,2180,17615,2635,875,21125,1370,387633,14859,18970,29268,66585,97957,80119,247523,124273,11410735000,650347000,425856000,543249000,1682288000,2213613000,3397462000,7420809000,2896989000
Illinois,Construction,2009,148211,106310,20704,11265,138279,8113,1113,147505,706,149135,106310,20720,11290,138320,8270,1310,147900,1235,1032260,153286,134699,150195,438459,298894,154134,901195,121859,60852245000,6075220000,5793950000,7844750000,19713920000,19131547000,11390948000,50443735000,9771015000
Illinois,Educational Services,2009,16725,7760,2390,2055,12205,3254,730,16189,536,18445,7770,2400,2155,12325,3555,930,16810,1635,757161,9458,15511,28003,54685,132375,99870,292019,447045,26234364000,372756000,342939000,593060000,1317475000,3386343000,3380561000,8150285000,17444404000
Illinois,Finance and Insurance,2009,67422,44568,8350,4136,57054,5153,2135,64342,3080,117075,44640,8525,4810,57975,9075,8375,75425,41650,1604457,74338,51549,51328,179343,177651,197426,564455,1028869,137368979000,3914408000,2680114000,3457628000,10220229000,13567156000,15529008000,39849466000,96184139000
Illinois,Health Care and Social Assistance,2009,129416,65350,27236,16701,109287,12746,4846,126879,2537,158480,65475,27505,17645,110625,17085,14085,141795,16685,3659937,113097,178429,220643,519971,494961,699089,1724293,1911257,153293465000,6150107000,7969597000,10555388000,24684539000,20494603000,21860269000,67401081000,84863493000
Illinois,Information,2009,15506,7795,1923,1440,11158,1794,859,13811,1695,27665,7800,1940,1465,11205,2010,1155,14370,13295,625758,7106,10819,16621,34536,60998,65827,176870,447983,41817380000,563483000,470194000,869366000,1989767000,4101405000,4051009000,10497840000,31292444000
Illinois,Management of Companies and Enterprises,2009,7517,605,170,231,1006,1400,1921,4327,3190,11250,605,170,235,1010,1425,2120,4555,6695,873630,529,0,1477,2833,16975,65715,85540,788090,86913210000,149415000,0,101105000,304080000,1128910000,4705255000,6138245000,80774965000
Illinois,Manufacturing,2009,69641,24452,11525,10259,46236,13964,4641,64841,4800,73610,24460,11530,10305,46295,14565,5315,66175,7435,2684528,39254,69759,131633,251729,544041,513931,1379918,1147031,126236285000,1734413000,2474009000,5038544000,9533141000,23153041000,23440110000,58738149000,60606698000
Illinois,"Mining, Quarrying, and Oil and Gas Extraction",2009,2451,1376,365,272,2013,212,91,2316,135,2845,1380,365,290,2035,250,230,2515,330,41493,2431,2137,3275,8338,6047,6406,23407,16861,2443879000,131625000,103277000,154415000,410968000,358413000,366710000,1314550000,1040288000
Illinois,Other,2009,339,326,8,4,338,1,0,339,0,339,326,8,4,338,1,0,339,0,378,0,51,0,356,0,0,378,0,9662000,7424000,556000,0,8843000,0,0,9662000,0
Illinois,Other Services (except Public Administration),2009,145930,88182,30314,15386,133882,9513,1462,144857,1073,157810,88310,30625,16015,134950,11775,3305,150030,7780,1234951,161734,196607,200602,563524,318894,136808,1030028,178792,36042346000,3939739000,4653152000,5201198000,13804324000,8896263000,5573935000,28422425000,6683427000
Illinois,"Professional, Scientific, and Technical Services",2009,181356,131517,21378,12947,165842,9458,2890,178190,3166,191860,131605,21465,13200,166270,11050,3900,181220,10640,1794457,156439,136698,163558,484588,305166,242191,1038156,719332,130793648000,11001920000,7037535000,9539351000,27680825000,21013351000,18737823000,67851178000,61542323000
Illinois,Real Estate and Rental and Leasing,2009,49668,36511,5833,2858,45202,2421,893,48516,1152,62815,36565,5985,3170,45720,3560,2565,51845,10970,396759,35533,36548,35599,122255,75241,55245,263859,121919,19104928000,1905514000,1342903000,1434635000,4710865000,3416748000,2790286000,11131040000,7458131000
Illinois,Retail Trade,2009,128233,72429,25209,13702,111340,11101,2672,125113,3120,204280,72650,25840,15065,113555,16320,10935,140810,63470,2959252,116225,142302,166559,429092,393891,174839,1068713,1649357,72244243000,3180845000,3643642000,4228213000,11135671000,12684042000,5725630000,30364954000,39856905000
Illinois,Total,2009,254007,153446,41222,25905,220573,23233,5832,249638,4369,314977,153675,41684,27086,222445,29155,14829,266429,48548,5120970,247277,269762,344663,861702,864951,728047,2454700,2666270,233992734000,9933990000,9327472000,12797957000,32059419000,35135892000,32073640000,99268951000,134723783000
Illinois,Transportation and Warehousing,2009,52746,35285,5555,3800,44640,3781,1723,50144,2602,59530,35295,5565,3850,44710,4025,2335,51070,8460,1078555,38377,34818,47152,124899,111493,103533,358137,604355,44250826000,1476902000,1165225000,1719118000,4405463000,4364066000,4085148000,13283090000,26762977000
Illinois,Utilities,2009,841,280,105,75,460,185,35,680,161,2375,280,105,80,465,305,40,810,1565,73720,415,580,505,1933,7177,1428,11201,53849,6592292000,24781000,17460000,53329000,107356000,491459000,105970000,827519000,5128353000
Illinois,Wholesale Trade,2009,83084,41398,12665,9292,63355,10554,4303,78212,4872,97035,41475,12815,9690,63980,12885,7295,84160,12875,1522474,64907,80098,117543,266234,331768,247206,854401,616399,93512715000,3490283000,4160505000,6043233000,13821685000,17904017000,14451613000,46411033000,43449634000
Indiana,Accommodation and Food Services,2009,45389,16355,8795,9020,34170,8746,1316,44232,1157,63015,16355,8820,9150,34325,10160,5040,49525,13490,1251871,27872,59281,123863,211336,324038,187477,723621,527437,16275785000,550940000,619713000,1331575000,2503630000,3741142000,2053114000,8308100000,7951659000
Indiana,Administrative and Support and Waste Management and Remediation Services,2009,31187,18335,4868,3005,26208,2676,921,29805,1382,36000,18340,4890,3060,26290,2995,1395,30680,5320,743121,25621,31438,39120,97100,96878,114713,320426,407770,20427625000,851363000,812282000,1019413000,2713026000,2761007000,2884410000,8698386000,11502335000
Indiana,"Agriculture, Forestry, Fishing and Hunting",2009,1161,930,105,45,1080,25,25,1130,31,1245,930,105,45,1080,25,30,1135,110,5239,1066,521,462,2687,201,0,5701,0,167409000,36267000,11155000,14963000,69672000,8911000,0,162762000,0
Indiana,"Arts, Entertainment, and Recreation",2009,10311,5665,1540,1330,8535,1361,225,10121,190,10755,5665,1555,1360,8580,1480,345,10405,350,144078,6951,9839,17850,36228,50254,22141,112462,18060,4153899000,254226000,188268000,293778000,760028000,948670000,496931000,2383871000,408408000
Indiana,Construction,2009,71066,46640,12015,6644,65299,4558,696,70553,513,71735,46645,12015,6660,65320,4645,845,70810,925,592410,77346,77896,87709,243718,167865,75745,496705,67237,27769060000,2521670000,2588122000,3494396000,8607790000,7949435000,4425223000,21318560000,4917275000
Indiana,Educational Services,2009,7260,3340,1345,940,5625,1122,243,6990,270,7930,3340,1360,970,5670,1285,360,7315,615,297103,4461,8791,11799,24831,43734,28813,100642,192194,7728952000,128932000,153555000,205557000,497009000,985712000,789073000,2394437000,5268078000
Indiana,Finance and Insurance,2009,25074,16579,3190,1321,21090,1496,901,23487,1587,50085,16585,3295,1675,21555,3325,4775,29655,20430,494065,26502,19217,15709,63591,49224,85245,204893,276488,26455038000,1059024000,807873000,729118000,2622869000,2099322000,3914368000,8897857000,17190400000
Indiana,Health Care and Social Assistance,2009,53978,23655,12765,7445,43865,5858,2593,52316,1662,74110,23695,12860,7890,44445,8400,8140,60985,13125,1905224,43193,83749,97512,228264,228094,385620,853760,1023230,72367891000,1876243000,3263360000,4022302000,9184729000,9042404000,12483073000,31014669000,41013606000
Indiana,Information,2009,5440,2445,686,615,3746,701,293,4740,700,10995,2445,690,635,3770,895,550,5215,5780,211311,3407,3994,7111,16865,21420,21218,64785,143312,10261616000,144323000,134958000,279619000,577374000,797404000,1000330000,2528604000,7569780000
Indiana,Management of Companies and Enterprises,2009,3229,155,40,95,290,581,1011,1882,1347,4475,155,40,95,290,590,1135,2015,2460,234055,0,0,56,74,5629,28094,34645,197748,21763235000,28778000,10721000,19295000,62667000,340841000,1615021000,2037080000,19726155000
Indiana,Manufacturing,2009,38773,11694,6350,5688,23732,7850,3307,34889,3884,42155,11695,6350,5715,23760,8285,3975,36020,6135,2102511,18665,37363,68901,135344,286665,319722,798273,1178282,95386325000,772820000,1176189000,2441185000,4717490000,10727699000,12158860000,29591292000,61285566000
Indiana,"Mining, Quarrying, and Oil and Gas Extraction",2009,981,370,145,135,650,144,62,856,125,1550,380,145,135,660,255,120,1035,515,27572,281,718,1129,2988,3436,4373,12149,13611,1567936000,23802000,22613000,62068000,115139000,179064000,316591000,677445000,778921000
Indiana,Other,2009,125,110,12,2,124,1,0,125,0,125,110,12,2,124,1,0,125,0,231,0,86,0,192,0,0,231,0,3239000,1655000,871000,0,2657000,0,0,3239000,0
Indiana,Other Services (except Public Administration),2009,75834,44763,16679,8224,69666,4680,801,75147,687,82570,44815,16810,8625,70250,6390,2300,78940,3630,622715,87798,104923,107871,303476,158329,52556,523082,61876,14295775000,1817525000,2130529000,2256444000,6213149000,3590441000,1456799000,11445755000,2064006000
Indiana,"Professional, Scientific, and Technical Services",2009,59931,40550,8561,5008,54119,3485,982,58586,1345,64290,40565,8590,5130,54285,4170,1520,59975,4315,506668,61856,54362,63961,185494,109892,59992,361367,129954,25657941000,2343453000,2067533000,2655242000,7100850000,5380806000,3804294000,16678560000,8551843000
Indiana,Real Estate and Rental and Leasing,2009,22190,16295,2465,1338,20098,943,491,21532,658,29345,16335,2580,1465,20380,2020,1590,23990,5355,166958,19984,15265,15628,54945,27499,22361,112283,52724,5220262000,678671000,413345000,476216000,1587470000,849777000,748804000,3326566000,1789996000
Indiana,Retail Trade,2009,66312,34165,14043,8002,56210,6136,1502,63848,2464,111310,34295,14420,9000,57715,10480,6440,74635,36675,1569391,58310,83593,101093,258412,203178,103313,583568,919226,34311961000,1361369000,1907908000,2325673000,5616710000,5779080000,2944734000,14643636000,18480973000
Indiana,Total,2009,111972,61984,20320,12886,95190,10957,2932,109079,2893,146017,62071,20550,13577,96198,14652,8604,119454,26563,2449980,108897,133397,171844,414138,406121,365648,1185907,1264073,88394198000,3339650000,3683609000,4974588000,11997847000,13008871000,12736069000,37742787000,50651411000
Indiana,Transportation and Warehousing,2009,22113,12255,3090,2171,17516,2060,782,20358,1755,25210,12270,3100,2210,17580,2235,970,20785,4425,524712,12318,19470,27139,65872,66571,52239,194099,270344,18357178000,651444000,623324000,874424000,2119514000,2363488000,1830095000,6829458000,9561131000
Indiana,Utilities,2009,961,320,200,85,605,215,25,845,116,3060,320,200,100,620,255,70,945,2115,65216,519,1175,571,2839,8583,0,13951,43689,5615155000,22822000,43945000,26681000,102637000,515838000,144384000,915466000,3794005000
Indiana,Wholesale Trade,2009,32599,14915,4773,3751,23439,4384,2113,29936,2663,39625,14975,4865,3955,23795,5365,3420,32580,7045,539957,20121,29653,44882,100632,126514,88858,332275,183677,25026414000,998501000,1220502000,1906645000,4197088000,5482539000,3899797000,14085312000,10330252000
Iowa,Accommodation and Food Services,2009,27653,10475,5278,5265,21018,5233,771,27022,631,34210,10480,5280,5350,21110,6245,2620,29975,4235,562344,16772,34710,72012,124666,181658,89150,396303,163659,6793857000,290166000,318929000,677959000,1294306000,1926379000,923373000,4154402000,2634193000
Iowa,Administrative and Support and Waste Management and Remediation Services,2009,15785,9895,2045,1374,13314,1127,479,14920,865,17985,9900,2055,1410,13365,1265,765,15395,2590,321067,13970,12931,16923,44726,36468,59484,149244,147371,8286673000,463893000,330718000,509130000,1330148000,961239000,1435401000,3946151000,3803797000
Iowa,"Agriculture, Forestry, Fishing and Hunting",2009,1250,970,100,65,1135,55,45,1235,15,1415,970,100,65,1135,110,95,1340,75,8137,844,592,457,2455,2109,913,6142,0,373061000,40828000,32060000,14848000,94413000,71205000,48484000,241716000,0
Iowa,"Arts, Entertainment, and Recreation",2009,7104,4225,1150,785,6160,690,135,6985,119,7345,4225,1150,795,6170,730,175,7075,270,104246,4814,6653,10259,23737,24152,18648,68489,21586,1762192000,152327000,103789000,134980000,409708000,355725000,264913000,1081320000,453234000
Iowa,Construction,2009,42480,28950,6965,3410,39325,2548,399,42272,208,43005,28950,6965,3430,39345,2710,540,42595,410,297788,42481,45283,43898,135502,92037,45748,280055,8109,13624756000,1599533000,1657842000,1839320000,5117610000,4344045000,2701176000,12415710000,713323000
Iowa,Educational Services,2009,3269,1450,525,450,2425,498,175,3098,171,3775,1450,530,495,2475,560,390,3425,350,183585,1692,3321,5865,11553,19308,23197,56942,124574,4229766000,46995000,47328000,83074000,185734000,362022000,596976000,1247496000,2922824000
Iowa,Finance and Insurance,2009,18597,11815,2350,1307,15472,1364,651,17487,1110,30595,11845,2440,1780,16065,3740,3365,23170,7425,459918,18537,14042,16461,51173,45439,65897,167813,229046,24707520000,650514000,557475000,650836000,1873177000,2001433000,3058435000,7199242000,14340067000
Iowa,Health Care and Social Assistance,2009,28799,12480,5540,3703,21723,4133,1930,27786,1013,39500,12485,5580,3850,21915,6045,5930,33890,5610,1024009,22688,35696,48593,108890,169151,274791,561066,422067,35370599000,1018078000,1363838000,1999751000,4408332000,4953931000,7889311000,17390906000,17848863000
Iowa,Information,2009,4616,1845,775,713,3333,543,233,4109,507,7730,1845,785,735,3365,840,605,4810,2920,164635,3018,4867,9054,17498,16786,16343,53964,108291,6982774000,90539000,144770000,266518000,519736000,675595000,618567000,1859095000,5050217000
Iowa,Management of Companies and Enterprises,2009,1959,75,30,110,215,396,720,1331,628,2375,75,30,115,220,400,795,1415,960,98965,0,84,278,62,3670,22615,26755,71958,6453005000,4465000,6289000,11216000,23440000,191150000,1371000000,1585590000,4845077000
Iowa,Manufacturing,2009,16402,5395,2600,2035,10030,3049,1539,14618,1784,18330,5395,2615,2045,10055,3315,2135,15505,2825,820435,7059,13084,21394,49057,104454,142956,328893,422933,34404594000,253740000,426141000,722781000,1535378000,4023817000,5502035000,12191351000,18712795000
Iowa,"Mining, Quarrying, and Oil and Gas Extraction",2009,327,110,25,47,182,81,31,294,33,910,110,25,75,210,220,170,600,310,9238,134,0,549,871,3330,2089,6359,0,426268000,7222000,0,21878000,35749000,158704000,94907000,294898000,80819000
Iowa,Other,2009,117,116,0,1,117,0,0,117,0,117,116,0,1,117,0,0,117,0,83,73,0,0,83,0,0,83,0,1502000,1484000,0,0,1502000,0,0,1502000,0
Iowa,Other Services (except Public Administration),2009,43081,28020,8920,3667,40607,1815,303,42725,356,45795,28060,9160,4030,41250,2450,685,44385,1410,259689,52703,55890,46418,156092,56099,15508,237380,14404,5612979000,1018279000,1094383000,946798000,3100722000,1271012000,339870000,4870148000,449392000
Iowa,"Professional, Scientific, and Technical Services",2009,29026,19235,4540,2410,26185,1612,463,28260,766,31085,19245,4540,2535,26320,2110,665,29095,1990,233169,27663,28313,28764,90669,50552,22263,172082,47951,10934450000,1072808000,991148000,1168365000,3295698000,2654219000,1252283000,7411228000,3409600000
Iowa,Real Estate and Rental and Leasing,2009,11197,8498,1048,535,10081,480,289,10850,347,13855,8510,1050,620,10180,1175,595,11950,1905,71181,10809,6196,5471,25181,13013,7895,48900,14121,2364400000,327790000,160948000,147053000,673861000,423999000,246927000,1441354000,494544000
Iowa,Retail Trade,2009,40860,19738,8733,5830,34301,3804,1032,39137,1723,62430,19790,8880,6300,34970,6035,3665,44670,17760,818919,32029,54917,70933,163712,113334,53000,348175,364161,17292447000,751553000,1139509000,1599636000,3516210000,3092237000,1529957000,8387746000,7281855000
Iowa,Total,2009,63720,36263,11070,7040,54373,5942,1651,61966,1754,80971,36302,11217,7550,55069,8754,5493,69316,11655,1283769,61799,72350,93368,227517,221807,215340,664664,619105,43832368000,1750347000,1920877000,2613581000,6284805000,6775538000,7161319000,20221662000,23610706000
Iowa,Transportation and Warehousing,2009,16288,10455,2140,1245,13840,1158,428,15426,862,18330,10455,2145,1260,13860,1355,620,15835,2495,276582,8360,13410,15433,45402,34408,29970,112871,157387,9379942000,406898000,386103000,459338000,1280501000,1094318000,1090004000,3535630000,5561277000
Iowa,Utilities,2009,437,55,50,85,190,152,17,359,78,1300,55,50,85,190,310,40,540,760,1491,45,267,1118,1560,6401,0,8683,0,66135000,2838000,8985000,56241000,69906000,341282000,0,462696000,0
Iowa,Wholesale Trade,2009,18104,7075,2653,2580,12308,2840,1367,16515,1589,24300,7085,2705,2770,12560,4155,3610,20325,3975,324560,9395,16114,31055,60775,83269,69479,230259,81617,14186068000,428783000,621051000,1300178000,2437323000,3539117000,2995791000,9558959000,4185435000
Kansas,Accommodation and Food Services,2009,21196,7480,3771,4094,15345,4379,641,20365,831,28970,7490,3780,4140,15410,4975,2105,22490,6480,527001,12168,25200,56461,94546,153067,74576,323587,202272,6359158000,223785000,243183000,549111000,1019323000,1719026000,868809000,3617678000,2725919000
Kansas,Administrative and Support and Waste Management and Remediation Services,2009,15790,9275,2360,1365,13000,1348,446,14794,996,17525,9275,2370,1400,13045,1460,540,15045,2480,317083,12236,15172,16398,46545,44782,46877,146415,151188,8928300000,440483000,377224000,482320000,1356593000,1312322000,1060130000,4006264000,4257321000
Kansas,"Agriculture, Forestry, Fishing and Hunting",2009,955,725,145,45,915,30,5,950,5,955,725,145,45,915,30,5,950,5,3471,841,899,561,2269,789,0,3446,0,111974000,33522000,30145000,21502000,89714000,17592000,0,110479000,0
Kansas,"Arts, Entertainment, and Recreation",2009,5110,2865,795,608,4268,632,100,5000,110,5315,2865,795,615,4275,680,140,5095,220,69451,4225,4632,7569,17015,22391,11084,53871,13416,1119761000,104730000,73159000,112680000,299485000,366864000,191196000,903077000,177740000
Kansas,Construction,2009,36368,23465,6300,3328,33093,2623,313,36029,339,36710,23465,6300,3350,33115,2665,335,36115,595,307554,39596,40550,42691,124589,100477,30554,264649,32867,13549320000,1210351000,1283203000,1659356000,4171310000,4818284000,1473439000,10813505000,2107451000
Kansas,Educational Services,2009,3181,1460,500,350,2310,575,158,3043,138,3450,1460,505,350,2315,605,270,3190,260,91044,2183,3091,4551,10329,23231,29617,65722,23731,2193576000,70299000,51271000,75214000,213217000,552015000,662551000,1539403000,624766000
Kansas,Finance and Insurance,2009,18546,12059,1999,1150,15208,1433,551,17192,1354,29665,12070,2130,1510,15710,3355,2550,21615,8050,281998,19870,11673,14229,48459,47145,43712,143821,129924,15566866000,712078000,519846000,616708000,1900952000,2344190000,2246715000,6803477000,8241561000
Kansas,Health Care and Social Assistance,2009,29538,13000,6065,3974,23039,3799,1710,28548,990,38480,13025,6095,4165,23285,5015,4945,33245,5235,916922,22815,39101,51566,114749,149447,246960,518966,385454,33501607000,1047767000,1494244000,2167876000,4743397000,5630751000,7124789000,17703199000,15480344000
Kansas,Information,2009,3708,1445,476,425,2346,500,236,3082,626,7100,1450,480,435,2365,565,725,3655,3445,236186,1844,2739,4959,10616,12258,14134,42549,189231,15062508000,83287000,62259000,212531000,382852000,623193000,593699000,1712550000,13165941000
Kansas,Management of Companies and Enterprises,2009,2249,190,55,100,345,416,575,1336,913,2875,190,55,100,345,430,615,1390,1485,106275,0,181,509,915,3715,15417,20215,86028,8005790000,0,11220000,35016000,64235000,278585000,917164000,1268365000,6732593000
Kansas,Manufacturing,2009,14127,4505,2440,1970,8915,2560,1177,12652,1475,15130,4505,2450,1975,8930,2775,1410,13115,2015,732995,5842,12069,20835,44835,85270,104747,262810,412175,32340822000,214910000,398453000,729617000,1474509000,3107006000,4168895000,9865509000,20444218000
Kansas,"Mining, Quarrying, and Oil and Gas Extraction",2009,4775,2760,815,474,4049,396,110,4555,220,5080,2760,820,500,4080,485,145,4710,370,46082,4750,5175,5999,16048,11453,6613,34834,9944,2272264000,191477000,189199000,275501000,657202000,562934000,293144000,1547915000,609889000
Kansas,Other,2009,109,103,5,1,109,0,0,109,0,109,103,5,1,109,0,0,109,0,102,65,27,0,102,0,0,102,0,1707000,1434000,223000,0,1707000,0,0,1707000,0
Kansas,Other Services (except Public Administration),2009,38025,24570,7419,3129,35118,2125,421,37664,361,40200,24585,7480,3245,35310,2590,930,38830,1370,262369,42524,46809,39053,133190,67747,28402,239374,15462,5803974000,902668000,942243000,857084000,2728089000,1508639000,710821000,5273541000,402468000
Kansas,"Professional, Scientific, and Technical Services",2009,33201,22373,4670,2556,29599,1878,724,32201,1000,35610,22380,4690,2640,29710,2160,1130,33000,2610,297694,29379,29137,32096,92215,56754,48912,207625,68011,15290880000,1363804000,1113444000,1399456000,3910505000,2821025000,2505318000,9503288000,4816870000
Kansas,Real Estate and Rental and Leasing,2009,12397,9313,1240,666,11219,461,266,11946,451,15610,9320,1295,750,11365,805,1095,13265,2345,71918,12293,7423,7652,28687,9812,8975,51785,15106,2254188000,433166000,228899000,240459000,925984000,352227000,317837000,1660554000,481539000
Kansas,Retail Trade,2009,37946,18666,8648,4569,31883,3401,929,36213,1733,53800,18700,8795,4925,32420,4920,2785,40125,13675,660351,31846,52515,56388,148979,97660,51654,310583,319610,14590209000,734766000,1128534000,1258586000,3133625000,2749414000,1574447000,7731217000,6380735000
Kansas,Total,2009,59667,33719,10300,6321,50340,5731,1626,57697,1970,74698,33756,10430,6685,50871,7714,4587,63172,11526,1146263,58627,67373,83800,209800,207330,187483,604613,541650,42146866000,1756450000,1869355000,2529746000,6155551000,6885962000,6336107000,19377620000,22769246000
Kansas,Transportation and Warehousing,2009,11283,6805,1400,1024,9229,783,366,10378,905,13175,6805,1400,1045,9250,850,640,10740,2435,207049,9391,7973,12725,32276,20305,16503,77072,123904,7318716000,312343000,234846000,390956000,976746000,710976000,657220000,2587033000,4429563000
Kansas,Utilities,2009,378,70,45,40,155,100,40,295,83,1110,70,45,40,155,155,245,555,555,35146,0,147,558,1009,3797,1102,8396,19007,2661238000,2977000,5557000,29527000,44040000,240963000,247957000,555610000,1478868000
Kansas,Wholesale Trade,2009,17136,7110,2427,2071,11608,2654,1178,15440,1696,22185,7125,2495,2190,11810,4050,2325,18185,4000,292188,10333,13046,22836,50178,71048,39614,177298,93002,14070671000,543420000,677251000,1055215000,2377850000,3094858000,1955957000,8027370000,5744563000
Kentucky,Accommodation and Food Services,2009,26364,8785,4560,5225,18570,5691,1097,25358,1006,36660,8800,4580,5280,18660,6625,3820,29105,7555,766990,14211,30747,71337,116625,210794,139771,469805,295250,9668235000,305635000,337852000,803617000,1448820000,2368139000,1630139000,5482775000,4181028000
Kentucky,Administrative and Support and Waste Management and Remediation Services,2009,16933,9695,2515,1645,13855,1465,561,15881,1052,20080,9700,2515,1660,13875,1540,825,16240,3840,381371,13643,15608,20706,52717,50696,55652,167697,194828,9421279000,467911000,396622000,578222000,1499854000,1397613000,1185878000,4351507000,4605177000
Kentucky,"Agriculture, Forestry, Fishing and Hunting",2009,1335,970,190,65,1225,55,40,1320,15,1350,970,190,65,1225,55,55,1335,15,8269,1517,1062,783,3583,1014,2634,8171,0,271265000,40397000,29515000,22248000,94164000,51739000,116832000,266736000,0
Kentucky,"Arts, Entertainment, and Recreation",2009,6262,3295,1085,775,5155,874,98,6127,135,6470,3300,1095,790,5185,930,140,6255,215,82981,4209,6540,9566,21930,31882,7404,68440,11536,1649397000,149126000,118227000,177545000,460412000,609839000,135120000,1346402000,174888000
Kentucky,Construction,2009,40377,25405,6985,4124,36514,3047,507,40068,309,40830,25405,6985,4140,36530,3130,595,40255,575,354200,39767,44576,55201,143773,113733,55014,320455,28319,14094450000,1240782000,1363497000,1901161000,4532190000,4941470000,2696594000,12462600000,1363664000
Kentucky,Educational Services,2009,3778,1720,580,529,2829,530,243,3602,176,4445,1720,580,540,2840,580,440,3860,585,130021,2693,3798,6634,13757,17869,37774,72913,55267,3176886000,59137000,63773000,103737000,237256000,387848000,925812000,1637803000,1253767000
Kentucky,Finance and Insurance,2009,15803,9560,2377,930,12867,1173,482,14522,1281,32945,9580,2480,1165,13225,3190,3255,19670,13275,328200,17683,13518,11686,44441,40380,39596,130302,191024,15996606000,584875000,551056000,492329000,1656740000,1783216000,1582377000,5278781000,10435262000
Kentucky,Health Care and Social Assistance,2009,41061,17491,10185,5950,33626,4555,1534,39715,1346,53345,17525,10270,6195,33990,6145,4230,44365,8980,1190241,31920,65605,77794,180124,160305,190939,547226,635778,45840273000,1589444000,2405813000,2994166000,7021344000,6763979000,5740973000,19796267000,25897395000
Kentucky,Information,2009,4060,1715,595,430,2740,477,227,3444,616,7530,1725,595,440,2760,650,380,3790,3740,123472,2116,3594,5215,12040,13828,4565,38406,86910,6056490000,83919000,104519000,152709000,360343000,558775000,197355000,1385630000,3640766000
Kentucky,Management of Companies and Enterprises,2009,2324,180,65,70,315,391,621,1327,997,3375,180,65,70,315,400,685,1400,1975,124695,24,29,412,829,4360,12827,18355,106340,9791105000,20661000,22295000,13425000,57594000,238165000,779135000,1075145000,8715960000
Kentucky,Manufacturing,2009,17830,5340,2816,2415,10571,3241,1544,15356,2474,19470,5340,2830,2420,10590,3585,1855,16030,3440,971151,6417,15558,27521,56138,109884,141468,356023,550722,40471377000,256618000,439785000,901680000,1844358000,3960991000,5288591000,12802701000,24566562000
Kentucky,"Mining, Quarrying, and Oil and Gas Extraction",2009,2760,945,415,400,1760,572,195,2527,233,3315,945,415,405,1765,595,325,2685,630,113158,1464,2552,5291,9389,20493,21147,52783,56909,6658258000,93231000,94160000,197833000,381860000,964948000,1168008000,2585526000,3807509000
Kentucky,Other,2009,214,209,5,0,214,0,0,214,0,214,209,5,0,214,0,0,214,0,0,0,0,0,0,0,0,0,0,2846000,2593000,0,0,2846000,0,0,2846000,0
Kentucky,Other Services (except Public Administration),2009,43648,27673,8476,4035,40184,2517,443,43144,504,47365,27685,8560,4255,40500,3390,1015,44905,2460,325819,52176,53516,51517,158705,79118,19464,268280,32265,7331519000,1054257000,1113092000,1102553000,3310550000,1865981000,465630000,5870881000,905111000
Kentucky,"Professional, Scientific, and Technical Services",2009,37598,25365,5555,3010,33930,2027,630,36587,1011,40385,25380,5565,3060,34005,2465,970,37440,2945,318897,37840,34833,38536,116704,65149,32295,226584,82508,14449541000,1462422000,1282048000,1543333000,4336658000,3091989000,1783259000,9496401000,4756010000
Kentucky,Real Estate and Rental and Leasing,2009,14312,10503,1665,710,12878,569,329,13776,536,18255,10510,1735,770,13015,1020,815,14850,3405,85747,16900,10545,7845,36209,15017,5432,62628,20164,2743389000,430566000,288595000,270460000,1001226000,480859000,179820000,1850627000,742171000
Kentucky,Retail Trade,2009,50639,26093,10861,6397,43351,4363,978,48692,1947,78265,26145,11065,7125,44335,6610,3775,54720,23545,1016644,45084,68802,80519,197115,137608,53135,406663,491912,23711415000,1014223000,1462732000,1894275000,4399118000,3860831000,1328666000,9867144000,11387820000
Kentucky,Total,2009,69606,38070,12675,7951,58696,6752,1852,67300,2306,90661,38115,12825,8365,59305,9018,5170,73493,17168,1486545,68743,83201,105716,257660,244766,211849,714275,772270,51716876000,1992481000,2247070000,2996670000,7236221000,7761811000,6859580000,21857612000,29859264000
Kentucky,Transportation and Warehousing,2009,12560,6805,1800,1165,9770,1008,502,11280,1280,14810,6810,1805,1190,9805,1110,585,11500,3310,316089,9761,10824,14062,37722,26977,17358,89837,211501,12073927000,316207000,300641000,437115000,1093021000,1018575000,712299000,2939694000,8611507000
Kentucky,Utilities,2009,465,135,70,45,250,75,55,380,85,1700,135,70,45,250,145,240,635,1065,40396,184,390,517,1220,4272,5952,12170,16981,3094490000,8676000,12940000,16593000,40345000,265632000,353007000,691463000,1828516000
Kentucky,Wholesale Trade,2009,18094,7660,2669,2097,12426,2468,1135,16029,2065,21640,7675,2700,2210,12585,2925,1845,17355,4285,339245,11863,14554,23242,54076,62624,51139,185872,134401,16923094000,517377000,581993000,944808000,2139994000,2746376000,2359482000,7990107000,7859239000
Louisiana,Accommodation and Food Services,2009,31474,11215,6040,5750,23005,6877,785,30667,807,42255,11215,6060,5855,23130,7675,3095,33900,8355,918543,17970,40347,78626,137461,257107,125666,521921,390500,13877905000,413225000,473260000,941741000,1831574000,3359467000,1902865000,7128759000,6637992000
Louisiana,Administrative and Support and Waste Management and Remediation Services,2009,19805,10525,3185,2040,15750,2243,742,18735,1070,22515,10540,3200,2065,15805,2535,1115,19455,3060,525997,14322,20407,27177,64803,86920,93388,250167,264053,14696658000,577082000,556562000,838913000,1995389000,2512526000,2438837000,7122559000,7306722000
Louisiana,"Agriculture, Forestry, Fishing and Hunting",2009,3034,1561,845,410,2816,150,25,2991,43,3105,1575,845,410,2830,150,60,3040,65,18806,2387,5235,4873,13104,3711,160,17926,362,692130000,86803000,180110000,150027000,430605000,151907000,8153000,637565000,21826000
Louisiana,"Arts, Entertainment, and Recreation",2009,6446,3600,1025,752,5377,800,137,6314,132,6885,3600,1030,795,5425,960,225,6610,275,96952,4443,6362,9151,21945,29879,9148,67665,37025,2292316000,146035000,130271000,154216000,443722000,562969000,171735000,1483738000,895596000
Louisiana,Construction,2009,43264,24715,8305,4880,37900,4098,695,42693,571,43730,24715,8310,4885,37910,4110,805,42825,905,667120,43306,54716,65444,164535,154039,97782,422665,229489,31695075000,1366155000,1692284000,2350170000,5420675000,6631710000,4957618000,17219995000,13907799000
Louisiana,Educational Services,2009,4846,1955,660,595,3210,1200,290,4700,146,5280,1965,665,605,3235,1310,405,4950,330,165479,2785,4248,7638,15696,54310,35325,107157,49876,5407057000,126419000,81347000,175449000,391397000,1367201000,1058488000,2927241000,2261733000
Louisiana,Finance and Insurance,2009,20007,12355,3340,1250,16945,1359,552,18856,1151,38270,12415,3450,1565,17430,4510,3975,25915,12355,318771,20687,20700,14746,58437,53869,55396,172733,137573,15962359000,890059000,811911000,712715000,2430073000,2484827000,2492019000,7620632000,8110212000
Louisiana,Health Care and Social Assistance,2009,49851,21605,11950,7077,40632,6029,2063,48724,1127,58955,21635,11995,7330,40960,7540,4540,53040,5915,1373323,39302,79117,92294,212949,251552,305272,779851,571948,49652635000,2297376000,2930706000,3289396000,8540315000,7227171000,8288526000,24444312000,24197869000
Louisiana,Information,2009,3302,1395,420,350,2165,463,181,2809,493,7120,1395,430,360,2185,550,350,3085,4035,138921,1731,2083,3667,9402,12740,2371,33542,89738,6218514000,80370000,67484000,141391000,322703000,512278000,173408000,1283609000,4805082000
Louisiana,Management of Companies and Enterprises,2009,2262,150,55,140,345,450,640,1435,827,2940,150,55,140,345,455,675,1475,1465,88645,261,277,0,210,4800,21719,28685,59542,6986640000,24816000,17304000,57525000,100640000,278230000,1296867000,1677255000,5281996000
Louisiana,Manufacturing,2009,15430,5290,2880,2189,10359,2685,877,13921,1509,16750,5290,2880,2190,10360,2840,1235,14435,2315,561038,7404,14792,23619,53580,91600,54051,238671,286079,28390825000,298422000,507797000,916414000,1890658000,3736053000,2650949000,9727112000,17198544000
Louisiana,"Mining, Quarrying, and Oil and Gas Extraction",2009,6298,3050,775,650,4475,906,310,5691,607,7665,3060,775,660,4495,1035,440,5970,1695,250720,4895,5222,8820,19103,33385,34580,87361,163355,16902299000,346045000,259092000,465947000,1070990000,1950254000,2221345000,5260942000,11639435000
Louisiana,Other,2009,116,112,3,0,115,1,0,116,0,116,112,3,0,115,1,0,116,0,138,96,0,0,117,0,0,138,0,2547000,1938000,0,0,2415000,0,0,2547000,0
Louisiana,Other Services (except Public Administration),2009,44788,26180,9617,4760,40557,3133,504,44194,594,48305,26185,9665,5025,40875,3875,975,45725,2580,377139,48730,62522,61513,175604,111458,36880,334050,25483,9199387000,1123546000,1338139000,1416484000,3911466000,2669835000,1002961000,7783720000,1034963000
Louisiana,"Professional, Scientific, and Technical Services",2009,53724,36745,7700,4215,48660,3277,758,52695,1029,57020,36755,7715,4315,48785,3860,1135,53780,3240,444234,56723,48920,54344,164190,107180,62114,338615,97172,23535492000,2702078000,2046914000,2587618000,7374921000,6166305000,3759134000,17594268000,5626935000
Louisiana,Real Estate and Rental and Leasing,2009,17827,12631,2205,1062,15898,958,409,17265,562,22365,12640,2255,1145,16040,1475,1185,18700,3665,147842,19226,13248,12452,47259,28488,21040,99898,43161,5968694000,653149000,410659000,475877000,1559742000,1140023000,841349000,3594162000,2238729000
Louisiana,Retail Trade,2009,55572,28983,11707,7083,47773,4990,971,53734,1838,83810,29035,11950,7865,48850,7120,3375,59345,24465,948593,51928,75312,87534,223113,175852,64771,489600,375315,21860991000,1222951000,1648106000,2141986000,5062769000,4789272000,2337515000,12492635000,8595962000
Louisiana,Total,2009,81541,43993,15345,9497,68835,8579,1989,79403,2138,103384,44046,15487,10001,69534,11158,5358,86050,17334,1639104,78794,101269,126788,306851,329348,254674,890873,748231,61387794000,2729555000,2991796000,3909464000,9630815000,10711864000,9443740000,29786419000,31601375000
Louisiana,Transportation and Warehousing,2009,15304,8125,2240,1460,11825,1542,622,13989,1315,19145,8125,2250,1510,11885,1655,825,14365,4780,331376,11417,13570,16575,45979,48181,51627,152574,149203,15943133000,451076000,492008000,686319000,1662418000,2191679000,3128495000,7211977000,7447555000
Louisiana,Utilities,2009,1167,660,215,65,940,70,48,1058,109,2710,660,215,65,940,110,180,1230,1480,4545,1375,1243,681,3395,1146,5619,12716,329,314526000,25975000,34767000,23024000,88700000,91720000,301403000,533288000,162811000
Louisiana,Wholesale Trade,2009,21711,8697,3635,3041,15373,3168,1249,19790,1921,27515,8715,3675,3220,15610,4020,2195,21825,5690,372615,14224,22367,37319,77576,96352,48007,238286,121561,17996377000,665598000,1037439000,1589333000,3364258000,4334852000,2162069000,10591169000,7188258000
Maine,Accommodation and Food Services,2009,17343,8805,3028,2830,14663,2172,234,17069,274,19470,8810,3035,2900,14745,2545,965,18255,1215,221210,9017,20396,37624,68234,76411,30914,176851,42963,3970590000,542591000,409406000,602253000,1562329000,1260079000,450548000,3307320000,589056000
Maine,Administrative and Support and Waste Management and Remediation Services,2009,9046,5950,1175,670,7795,635,202,8632,414,9615,5950,1180,685,7815,720,290,8825,790,109114,7806,7057,7631,24275,19873,19791,71489,30327,2946448000,298688000,192158000,223182000,733573000,554651000,556823000,1991948000,729466000
Maine,"Agriculture, Forestry, Fishing and Hunting",2009,3710,2910,345,260,3515,165,20,3700,10,3755,2910,345,260,3515,200,20,3735,20,16917,2968,2083,3445,8590,5153,352,16642,0,601633000,105033000,66640000,111065000,286465000,182545000,19063000,580743000,0
Maine,"Arts, Entertainment, and Recreation",2009,4302,2935,620,340,3895,265,82,4242,60,4395,2935,625,340,3900,285,145,4330,65,34453,2607,3246,3780,11074,9207,8165,30495,2267,695557000,149642000,109063000,92244000,369651000,156191000,70882000,632370000,37933000
Maine,Construction,2009,25207,19610,3095,1395,24100,934,77,25111,96,25285,19610,3095,1400,24105,970,85,25160,125,115476,28326,19035,17935,67154,31108,4887,108698,2403,4877316000,996516000,727191000,737218000,2487855000,1462650000,220972000,4466478000,181761000
Maine,Educational Services,2009,2285,1200,350,255,1805,280,110,2195,90,2400,1200,350,255,1805,315,140,2260,140,74444,1440,2108,2707,6744,11546,13969,34671,38438,2035322000,48593000,45425000,78315000,189282000,314084000,397013000,964908000,1036670000
Maine,Finance and Insurance,2009,4905,2635,610,340,3585,489,221,4295,610,9920,2635,635,445,3715,1215,1560,6490,3430,119535,3451,3516,4056,11668,17225,21138,52099,59449,6854051000,158183000,156283000,196962000,519829000,830605000,954376000,2385617000,3542728000
Maine,Health Care and Social Assistance,2009,16644,7940,3328,1845,13113,1745,1056,15914,730,23915,7945,3370,1910,13225,2705,4035,19965,3950,534250,13170,21270,23636,59795,68910,132709,266392,255336,20447566000,522117000,815307000,961243000,2356788000,2124512000,4178776000,8735311000,11280140000
Maine,Information,2009,2446,1130,450,210,1790,274,122,2186,260,3805,1130,450,210,1790,350,225,2365,1440,59307,1188,2593,2306,6882,8860,4489,25690,27379,2318423000,47588000,70277000,63658000,209190000,328157000,175524000,937024000,1187754000
Maine,Management of Companies and Enterprises,2009,866,50,15,45,110,145,286,541,325,1065,50,15,45,110,150,300,560,505,38250,0,0,135,0,1866,6277,8460,29758,2588644000,1562000,0,8565000,12425000,78538000,302404000,395939000,2190428000
Maine,Manufacturing,2009,7982,3505,1340,1080,5925,1139,387,7451,531,8300,3520,1340,1085,5945,1195,455,7595,705,199068,3565,5558,9187,23210,32671,23866,100167,72706,8605609000,173757000,195000000,339261000,810854000,1248305000,1001059000,3678806000,3688956000
Maine,"Mining, Quarrying, and Oil and Gas Extraction",2009,131,95,15,0,110,10,0,120,11,135,95,15,0,110,10,0,120,15,311,0,0,0,150,0,0,287,0,20067000,5160000,1605000,0,7619000,0,0,14619000,0
Maine,Other,2009,52,47,5,0,52,0,0,52,0,52,47,5,0,52,0,0,52,0,60,31,29,0,60,0,0,60,0,956000,627000,329000,0,956000,0,0,956000,0
Maine,Other Services (except Public Administration),2009,17181,11695,3320,1200,16215,625,124,16964,217,17945,11725,3355,1230,16310,875,315,17500,445,88481,21057,20110,13943,58099,17742,3300,82848,3586,2160287000,517434000,466441000,353048000,1358379000,437459000,89490000,1968894000,95437000
Maine,"Professional, Scientific, and Technical Services",2009,16812,11510,2488,1165,15163,853,231,16247,565,17580,11510,2515,1205,15230,1015,305,16550,1030,116158,13632,15230,14217,45452,25218,10851,87706,25410,5870458000,660954000,688936000,671111000,2059491000,1398688000,718271000,4344327000,1460573000
Maine,Real Estate and Rental and Leasing,2009,7057,5505,690,330,6525,228,90,6843,214,8055,5525,705,380,6610,315,130,7055,1000,31736,6387,3741,3336,13995,5425,1565,24869,2242,1051059000,238641000,131721000,118001000,516258000,171414000,53198000,832957000,128750000
Maine,Retail Trade,2009,24008,12374,4940,3148,20462,1863,468,22793,1215,32825,12440,5015,3415,20870,2795,1540,25205,7620,354776,18139,28776,34446,88252,53068,30445,184838,94032,8575393000,501612000,668884000,863865000,2050493000,1498649000,1076411000,4878970000,2210217000
Maine,Total,2009,33795,21029,5460,3214,29703,2460,649,32812,983,40616,21071,5523,3394,29988,3398,2281,35667,4949,488932,33159,35909,42397,111465,90097,80560,282122,206810,17167557000,1092559000,1053416000,1264326000,3410301000,2876470000,2747197000,9033968000,8133589000
Maine,Transportation and Warehousing,2009,5478,3480,645,434,4559,439,138,5136,342,5995,3480,650,450,4580,500,185,5265,730,58877,4281,2857,4371,13351,11404,5000,36045,13941,2120972000,153962000,97830000,126529000,412912000,399575000,204953000,1288377000,535135000
Maine,Utilities,2009,243,105,15,20,140,25,20,185,58,450,105,15,30,150,35,55,240,210,1098,132,0,126,508,570,0,2275,158,350569000,10324000,2116000,6845000,23346000,30648000,0,144835000,11814000
Maine,Wholesale Trade,2009,7012,3515,875,696,5086,701,426,6213,799,7910,3545,880,725,5150,795,655,6600,1310,77960,2564,4531,6500,17363,14660,10555,48792,13809,3662530000,207404000,182431000,273053000,736618000,638789000,481059000,2152951000,857446000
Maryland,Accommodation and Food Services,2009,42006,17720,7948,6781,32449,7679,941,41069,937,54235,17730,8025,6850,32605,8415,2740,43760,10475,965775,30575,51929,91458,175036,289253,116632,583765,378136,15746290000,806715000,765091000,1296146000,2876194000,4512458000,1747738000,9179772000,6499040000
Maryland,Administrative and Support and Waste Management and Remediation Services,2009,35292,19815,5095,3773,28683,3833,1258,33774,1518,39675,19820,5105,3810,28735,3960,1555,34250,5425,875332,28076,33044,48746,114079,145037,155452,419984,435370,31116275000,1145887000,1128001000,1817202000,4114347000,5001533000,4904799000,14275901000,16225248000
Maryland,"Agriculture, Forestry, Fishing and Hunting",2009,948,735,135,35,905,25,0,930,18,960,735,135,35,905,25,0,930,30,3586,751,777,96,2000,458,0,2620,518,136699000,27089000,19650000,11570000,65223000,16926000,0,87233000,19644000
Maryland,"Arts, Entertainment, and Recreation",2009,9489,5308,1277,1140,7725,1260,281,9266,223,10175,5310,1280,1175,7765,1350,375,9490,685,175566,6285,7864,14411,30093,47028,37651,117958,29533,4405066000,323688000,188587000,286444000,823524000,903984000,1065279000,2865832000,413761000
Maryland,Construction,2009,75084,47685,11685,7545,66915,6454,1145,74514,570,75715,47685,11695,7550,66930,6510,1265,74705,1010,780765,76027,76005,100757,255085,242812,162360,669500,98181,38775125000,2827272000,2907097000,4506690000,10247435000,12121276000,8989895000,31585800000,6602038000
Maryland,Educational Services,2009,9256,4250,1400,1195,6845,1520,598,8963,293,9990,4250,1405,1255,6910,1720,685,9315,675,376751,5751,8890,15915,31204,60665,82149,183559,186550,14748991000,224460000,207086000,344840000,794230000,1752136000,3002453000,5815356000,8568980000
Maryland,Finance and Insurance,2009,22252,13395,3285,1613,18293,1484,810,20587,1665,41685,13410,3345,1755,18510,3040,2430,23980,17705,532590,22720,20402,20296,64267,49827,61723,183696,326464,38994434000,1214091000,1094078000,1417227000,3778322000,3338628000,4590122000,12123268000,25257219000
Maryland,Health Care and Social Assistance,2009,61554,30220,13570,8029,51819,5975,2200,59994,1560,76920,30320,13715,8630,52665,8830,7045,68540,8380,1632754,57563,88294,104547,252933,219138,296996,779683,822749,71512979000,2777617000,4003352000,4726870000,11530572000,9690661000,10024693000,31814504000,38443419000
Maryland,Information,2009,6849,3355,815,573,4743,845,407,5995,854,12300,3360,815,580,4755,920,540,6215,6085,269038,2560,5069,6814,16931,27067,28270,78562,172513,18559579000,291991000,283456000,403561000,1008173000,1554558000,2226169000,5002750000,12098202000
Maryland,Management of Companies and Enterprises,2009,3011,150,75,115,340,591,810,1741,1270,5535,150,75,115,340,600,920,1860,3675,246963,0,260,605,1120,8300,28321,37741,209222,21725215000,31893000,26670000,33900000,92551000,574876000,1575628000,2243055000,19482160000
Maryland,Manufacturing,2009,15821,6070,2685,2254,11009,2661,820,14490,1331,16485,6070,2690,2295,11055,2750,955,14760,1725,469510,7484,13794,23910,52544,85635,49920,222675,206284,26265396000,412687000,523689000,1017433000,2172360000,3947019000,2359791000,10120226000,14110153000
Maryland,"Mining, Quarrying, and Oil and Gas Extraction",2009,316,105,50,25,180,65,15,260,56,390,105,50,25,180,65,40,285,105,6615,58,180,72,360,2482,0,3545,2524,318570000,9108000,6265000,4866000,25092000,106012000,0,148971000,120645000
Maryland,Other,2009,214,208,5,0,213,1,0,214,0,214,208,5,0,213,1,0,214,0,242,0,0,0,0,0,0,242,0,5944000,4750000,0,0,5341000,0,0,5944000,0
Maryland,Other Services (except Public Administration),2009,62500,36684,12515,7268,56467,4643,748,61858,642,66970,36720,12580,7470,56770,5410,1320,63500,3470,545752,69268,80004,95549,247926,162386,62599,481231,55491,17276856000,1929285000,2143356000,2660147000,6758851000,4948580000,2771356000,14688136000,2394540000
Maryland,"Professional, Scientific, and Technical Services",2009,88763,59993,10945,7159,78097,6612,1972,86681,2082,96395,60010,10985,7285,78280,7220,2505,88005,8390,1121275,76667,70647,93564,253431,232296,179930,675039,427162,83746233000,5377380000,4114907000,5773912000,15307595000,16984213000,13486629000,46206368000,35987796000
Maryland,Real Estate and Rental and Leasing,2009,22414,15743,2525,1386,19654,1408,581,21643,771,30035,15755,2590,1565,19910,2040,2015,23965,6070,221621,19977,15952,15484,53717,39497,41665,139046,77295,10804887000,918802000,612962000,697579000,2213093000,2160938000,2344374000,6825514000,3459990000
Maryland,Retail Trade,2009,59483,32028,12251,6908,51187,4472,1430,57089,2394,92700,32085,12550,7570,52205,6535,4090,62830,29870,1339937,50092,74527,82017,209466,146655,102765,486233,756383,33929186000,1501869000,1881758000,2232470000,5664827000,4729553000,3633420000,14507383000,18582377000
Maryland,Total,2009,109087,62872,18403,11916,93191,10546,2704,106441,2646,135633,62940,18603,12436,93979,12962,6273,113214,22419,2122388,106825,120602,158537,385964,391937,327330,1105231,1017157,96620659000,4283847000,4351225000,6028792000,14663864000,16314170000,14676079000,45654113000,50966546000
Maryland,Transportation and Warehousing,2009,15330,8485,2165,1382,12032,1420,594,14046,1284,17055,8485,2165,1390,12040,1500,755,14295,2760,304590,11540,13076,16220,44610,42894,22753,118949,119173,12153622000,428943000,391917000,501201000,1358971000,1511640000,903267000,4074410000,5383152000
Maryland,Utilities,2009,295,95,15,25,135,15,25,175,120,655,95,15,25,135,15,75,225,430,51287,14,42,171,273,0,0,85,34643,5119308000,4754000,1796000,9619000,18459000,0,0,11236000,3485177000
Maryland,Wholesale Trade,2009,25067,11560,3747,2746,18053,3388,1361,22802,2265,29220,11565,3770,2800,18135,3900,2055,24090,5130,446442,15331,22562,32263,76475,105379,68065,267225,163482,26586729000,944928000,1153675000,1863293000,4046183000,5767651000,3671891000,14240562000,11452556000
Massachusetts,Accommodation and Food Services,2009,63742,28160,12672,10820,51652,10134,1116,62902,840,81040,28225,12695,10955,51875,11585,4245,67705,13335,1280474,48264,82521,148646,280587,362770,157677,803160,477607,23194390000,1475663000,1250839000,2311523000,5041593000,6166379000,2768084000,13997985000,9186436000
Massachusetts,Administrative and Support and Waste Management and Remediation Services,2009,43225,27910,5465,3476,36851,3594,1230,41675,1550,48310,27915,5475,3520,36910,3815,1505,42230,6080,928073,35116,34450,45029,116478,138016,150037,421325,488144,34326635000,1985670000,1418344000,1836878000,5288768000,5280207000,4817994000,15818787000,17370788000
Massachusetts,"Agriculture, Forestry, Fishing and Hunting",2009,1765,1380,260,95,1735,20,5,1760,5,1770,1380,260,95,1735,20,5,1760,10,4668,1458,1447,1010,4189,0,0,4290,0,144135000,55738000,23827000,24806000,116093000,0,0,132901000,0
Massachusetts,"Arts, Entertainment, and Recreation",2009,14214,7790,2235,1693,11718,1846,409,13973,241,15270,7795,2240,1740,11775,2025,695,14495,775,252505,9947,14478,21528,47866,67019,52954,175178,64450,8068985000,635274000,462894000,658195000,1788245000,1487753000,1544534000,5116377000,1573923000
Massachusetts,Construction,2009,86293,62035,12384,6480,80899,4401,578,85878,415,86595,62035,12385,6485,80905,4440,620,85965,630,569340,92936,80131,85928,261853,164512,70300,506790,45182,32572770000,4250555000,3866176000,4667249000,12805180000,10629306000,4703710000,28852775000,2982060000
Massachusetts,Educational Services,2009,12218,5420,1905,1570,8895,1961,865,11721,497,13205,5420,1905,1610,8935,2100,1230,12265,940,955191,7191,12503,20728,41866,81177,131781,258695,692399,36455766000,300807000,296814000,543933000,1152561000,2559723000,4769644000,8682390000,27721729000
Massachusetts,Finance and Insurance,2009,27882,15095,4198,2567,21860,2571,1404,25835,2047,48475,15155,4330,3030,22515,4295,5415,32225,16250,1019565,19922,25760,32653,83785,85186,128166,305195,708574,99502290000,1842278000,2039978000,2848833000,6779622000,8466159000,10245581000,25671538000,73584530000
Massachusetts,Health Care and Social Assistance,2009,65809,28555,14555,9387,52497,7524,3496,63517,2292,89600,28595,14645,9785,53025,10340,11305,74670,14930,2743789,54681,95609,124317,276235,282864,489671,1055963,1630864,127940271000,2707701000,4451588000,5970418000,13171681000,13106103000,17075595000,43511477000,83878070000
Massachusetts,Information,2009,11037,4875,1555,1255,7685,1468,605,9758,1279,17925,4880,1570,1255,7705,1525,710,9940,7985,495692,6356,9846,14297,31883,52080,65295,156419,335123,41726856000,443922000,523617000,1042850000,2042918000,4010538000,5677550000,11943145000,29446494000
Massachusetts,Management of Companies and Enterprises,2009,4009,290,75,130,495,621,1112,2228,1781,5800,290,75,130,495,630,1140,2265,3535,415225,409,304,784,1638,8094,35030,45485,369661,42140425000,108893000,23626000,73886000,220282000,654803000,2496692000,3451059000,38677416000
Massachusetts,Manufacturing,2009,34598,12150,6255,5437,23842,6666,1955,32463,2135,35700,12155,6255,5475,23885,6870,2165,32920,2780,1124345,17075,36366,66442,131591,240706,186833,615430,443154,65929487000,907925000,1589061000,2899658000,5703909000,11444084000,10275400000,29959813000,30983885000
Massachusetts,"Mining, Quarrying, and Oil and Gas Extraction",2009,383,150,60,65,275,59,22,356,27,445,150,60,65,275,75,55,405,40,4101,95,286,756,1382,552,316,3953,0,262027000,15174000,14079000,40773000,72718000,44244000,16338000,217898000,0
Massachusetts,Other,2009,485,443,28,13,484,1,0,485,0,485,443,28,13,484,1,0,485,0,746,387,174,163,724,0,0,746,0,20942000,12839000,4493000,2899000,20231000,0,0,20942000,0
Massachusetts,Other Services (except Public Administration),2009,76702,46715,16305,8211,71231,4111,693,76035,667,82765,46780,16470,8650,71900,4990,1975,78865,3900,597743,87473,105265,105410,301049,135874,69995,516168,73191,17364785000,2549953000,2742167000,2787987000,8098863000,4039275000,2212405000,14562060000,2516492000
Massachusetts,"Professional, Scientific, and Technical Services",2009,101314,68655,13445,7941,90041,6458,2098,98597,2717,106750,68680,13475,8085,90240,6875,2590,99705,7045,1257561,90230,86183,101933,294216,219132,200655,724477,517901,109413065000,6349805000,5102915000,6726270000,18269420000,18927856000,18519423000,56037466000,52750480000
Massachusetts,Real Estate and Rental and Leasing,2009,25032,17914,3020,1725,22659,1138,564,24361,671,32255,18045,3180,1890,23115,1700,1555,26370,5885,207224,26630,18464,21904,68732,34648,38738,145952,58606,10417355000,1231189000,825963000,1045543000,3126926000,1712345000,1978727000,6926973000,3418325000
Massachusetts,Retail Trade,2009,83110,48236,16251,8726,73213,5973,1531,80717,2393,122985,48560,16675,9525,74760,8840,5760,89360,33625,1509841,76558,97718,99675,278658,181248,98630,588157,683285,39873139000,2407496000,2624021000,3003578000,8168340000,6978472000,3666660000,19822679000,15794357000
Massachusetts,Total,2009,138370,80635,23739,15012,119386,12615,3403,135404,2966,170473,80812,23999,15661,120472,15474,8918,144864,25609,2967877,137336,155560,200400,493296,469895,439749,1402940,1564937,153775380000,5969162000,6067177000,8278490000,20314829000,22090999000,21434521000,63840349000,89935031000
Massachusetts,Transportation and Warehousing,2009,15751,8343,2235,1528,12106,1654,818,14578,1173,17965,8350,2235,1545,12130,1765,1030,14925,3040,382748,10593,13641,19715,46937,58496,54998,170859,198401,14494271000,485365000,468454000,692354000,1672522000,1995023000,1780926000,5746504000,8067381000
Massachusetts,Utilities,2009,458,175,40,25,240,40,42,322,136,1325,175,40,25,240,40,85,365,960,52249,18,94,211,628,1739,2985,6432,45310,5971678000,12893000,7786000,13084000,52071000,341038000,364699000,888699000,5033993000
Massachusetts,Wholesale Trade,2009,36922,17225,5853,4253,27331,4879,1902,34112,2810,41760,17260,5885,4375,27520,5435,2505,35460,6300,668794,28002,35666,53699,123037,161152,100351,406135,233442,47094020000,1776445000,2126687000,3278292000,7277982000,10153677000,6969328000,25448490000,20276472000
Michigan,Accommodation and Food Services,2009,74705,28740,15200,14519,58459,13832,1267,73558,1147,96975,28755,15230,14765,58750,16155,5375,80280,16695,1639441,46657,101838,197961,346991,495938,191327,1037578,599583,21672395000,967980000,1104785000,2132085000,4208125000,6208822000,2207797000,12670922000,8966797000
Michigan,Administrative and Support and Waste Management and Remediation Services,2009,51411,30805,6780,4419,42004,5577,2165,49746,1665,58410,30820,6820,4500,42140,5965,2750,50855,7555,1312324,37320,42653,57312,140705,229193,313599,697028,581210,38304400000,1896806000,1322671000,1721331000,4972247000,7793692000,9335184000,22408712000,14722126000
Michigan,"Agriculture, Forestry, Fishing and Hunting",2009,2649,1885,395,180,2460,119,35,2614,35,2655,1885,395,180,2460,120,35,2615,40,14534,3066,2491,1877,7779,2914,1278,14059,172,486769000,86230000,64663000,67344000,237135000,83279000,48596000,446894000,32986000
Michigan,"Arts, Entertainment, and Recreation",2009,16952,9960,2385,2047,14392,1977,339,16708,244,17740,9970,2400,2070,14440,2140,520,17100,640,255324,11380,15111,26638,53958,73643,41653,180866,50554,7600483000,579968000,316619000,522005000,1445755000,1355080000,2553388000,5524955000,1325350000
Michigan,Construction,2009,97096,71569,12780,6805,91154,4950,625,96729,367,97850,71570,12780,6830,91180,5025,880,97085,765,582085,99154,82546,88917,272895,174006,74353,526705,47216,28716830000,4118070000,3312350000,4004433000,11476040000,8746031000,4188740000,24646365000,3462538000
Michigan,Educational Services,2009,9852,4770,1617,1320,7707,1384,464,9555,297,10970,4775,1620,1355,7750,1585,840,10175,795,347055,6778,10319,18155,35926,57196,53332,160226,171555,8736160000,194175000,191310000,348051000,733601000,1364119000,1466083000,3953365000,4289089000
Michigan,Finance and Insurance,2009,35715,23118,4810,2638,30566,2602,906,34074,1641,71090,23165,4945,3125,31235,5625,4790,41650,29440,780008,41066,30041,32558,105585,97112,96305,304883,371823,43623803000,1574439000,1301870000,1620207000,4510612000,4704639000,4734747000,14214741000,28795922000
Michigan,Health Care and Social Assistance,2009,104638,47207,26409,15100,88716,10672,3350,102738,1900,130640,47290,26635,15690,89615,15360,11745,116720,13920,2839997,87711,176302,198763,465712,404380,491057,1370407,1461002,117728360000,4164666000,7237309000,8697729000,20148565000,16392293000,15966173000,52841504000,64495973000
Michigan,Information,2009,8629,3960,1297,993,6250,977,353,7580,1049,16845,3960,1300,1005,6265,1335,570,8170,8675,352013,5075,7135,11795,26653,32129,20146,87545,257029,20420942000,249462000,280679000,454751000,1028573000,1266323000,908364000,3584384000,16347396000
Michigan,Management of Companies and Enterprises,2009,5425,375,105,255,735,1131,1604,3470,1955,7595,375,115,255,745,1155,1735,3635,3960,502610,340,382,1375,2237,14910,57880,75030,427205,48363035000,43007000,28424000,114525000,191512000,759400000,2984465000,3935640000,44401892000
Michigan,Manufacturing,2009,59660,21455,10348,9207,41010,11222,4022,56254,3406,63480,21465,10355,9270,41090,11840,5130,58060,5420,2258340,34896,64393,116856,228167,411526,446440,1140005,1033717,109622216000,1648985000,2237425000,4641134000,8838168000,17254749000,19011637000,47261323000,58149734000
Michigan,"Mining, Quarrying, and Oil and Gas Extraction",2009,1744,915,250,150,1315,221,80,1616,128,1895,915,255,160,1330,245,80,1655,240,23331,373,1568,1852,4769,6265,0,14570,6705,1396064000,84802000,74250000,98171000,260412000,323391000,0,834401000,551056000
Michigan,Other,2009,767,717,34,12,763,4,0,767,0,767,717,34,12,763,4,0,767,0,1176,0,207,145,1038,138,0,1176,0,12223000,9332000,1765000,955000,12052000,171000,0,12223000,0
Michigan,Other Services (except Public Administration),2009,107579,64556,24177,11051,99784,6262,812,106858,721,115415,64630,24400,11660,100690,8340,1805,110835,4580,787600,123346,156005,141615,425010,205407,71248,711992,48526,19057707000,2719034000,3207779000,3066400000,9005438000,5045072000,1999523000,16371920000,1709553000
Michigan,"Professional, Scientific, and Technical Services",2009,101172,68920,13565,8324,90809,6107,1894,98810,2362,109145,68955,13645,8510,91110,7260,3015,101385,7760,1141651,95510,87737,106062,298503,207765,186084,698238,403439,72553896000,4835226000,4151579000,5236386000,14294105000,11706428000,10331571000,36554230000,30403382000
Michigan,Real Estate and Rental and Leasing,2009,30292,21553,3931,1931,27415,1580,610,29605,687,39185,21630,4160,2125,27915,2710,1720,32345,6840,249735,32171,23732,23014,80201,48164,42936,174326,59858,8221849000,989440000,757840000,675613000,2481060000,1583037000,1288316000,5488330000,2436471000
Michigan,Retail Trade,2009,117697,69743,22930,11973,104646,8818,1630,115094,2603,177325,69990,23540,13380,106910,14025,7045,127980,49345,2238281,116849,145574,147876,409895,312520,141790,901453,1204170,50413249000,2814768000,3077526000,3709068000,9690090000,8674305000,3625551000,22354357000,25781841000
Michigan,Total,2009,176303,102250,31406,19573,153229,16339,3716,173284,3019,221682,102436,31826,20604,154866,21698,10744,187308,34374,3383615,171565,206839,260364,638768,612414,517940,1769122,1614493,135807633000,6007768000,6340307000,8374691000,20722766000,21193739000,19160674000,61077179000,74730454000
Michigan,Transportation and Warehousing,2009,23013,13780,2895,1998,18673,2077,828,21578,1435,27260,13810,2915,2085,18810,2310,1230,22350,4910,441479,14073,17833,24729,61190,64625,53494,187424,189758,16754924000,665536000,578985000,793473000,2067618000,2234139000,1969168000,6506363000,7694210000
Michigan,Utilities,2009,510,190,45,30,265,55,36,356,154,2015,190,45,60,295,80,110,485,1530,7870,148,213,0,785,2374,3444,8060,7134,938437000,14969000,6937000,0,42123000,148735000,390225000,739834000,513663000
Michigan,Wholesale Trade,2009,48752,24397,7290,5632,37319,5806,2375,45500,3252,58085,24445,7405,5935,37785,7195,4345,49325,8760,785129,36919,45431,70302,157668,175117,133134,483156,280662,43342094000,1808107000,2087019000,3355439000,7297063000,8658659000,6669272000,23330580000,18882989000
Minnesota,Accommodation and Food Services,2009,41711,14329,7425,8896,30650,9096,1041,40787,924,55185,14355,7455,8975,30785,10360,3220,44365,10820,1065680,21287,50873,124521,194670,335331,133759,667787,388719,15341695000,541569000,522413000,1287629000,2353789000,4279858000,1820324000,8474436000,6810235000
Minnesota,Administrative and Support and Waste Management and Remediation Services,2009,31653,20005,4305,2730,27040,2561,857,30458,1195,35095,20005,4325,2810,27140,2870,1095,31105,3990,619135,24369,26651,34499,89134,102019,98787,300247,287596,21052421000,1076262000,856844000,1119153000,3074368000,3089983000,2788395000,9187938000,10460182000
Minnesota,"Agriculture, Forestry, Fishing and Hunting",2009,2270,1505,440,160,2105,95,35,2235,35,2315,1505,440,160,2105,105,45,2255,60,11161,680,2751,1725,6960,3032,522,10553,341,367620000,78655000,76212000,49276000,212001000,96536000,21279000,344355000,16407000
Minnesota,"Arts, Entertainment, and Recreation",2009,13001,8125,1937,1310,11372,1166,251,12789,212,13585,8125,1950,1340,11415,1215,275,12905,680,197079,10680,12313,16575,41112,39394,40627,126887,36813,5409747000,360526000,226853000,260918000,863342000,686345000,2338148000,3975693000,684033000
Minnesota,Construction,2009,84095,64930,9765,5053,79748,3424,516,83688,407,84705,64930,9765,5055,79750,3535,620,83905,800,489699,83991,61814,65402,214707,122071,63921,409005,50809,27792670000,3840818000,2743767000,3374993000,9992041000,7055097000,4190975000,21692730000,3516218000
Minnesota,Educational Services,2009,8515,3885,1173,1195,6253,1690,295,8238,277,9285,3890,1175,1200,6265,1820,440,8525,760,331776,4814,7278,16241,30008,66476,45546,148432,171781,8307240000,182479000,138097000,335600000,656017000,1633883000,1238564000,3654194000,4340762000
Minnesota,Finance and Insurance,2009,30972,20730,3545,1931,26206,2213,823,29242,1730,47420,20775,3680,2360,26815,4685,3325,34825,12595,709238,30656,20982,23722,77003,76385,63255,226255,429539,49248909000,1366008000,1056938000,1316168000,3876992000,4142031000,3526630000,11968583000,34957757000
Minnesota,Health Care and Social Assistance,2009,49703,22355,9300,6694,38349,6612,3176,48137,1566,72575,22390,9360,7045,38795,9945,11480,60220,12355,2100094,34736,62396,89730,190440,272550,501470,971664,1109675,81274916000,1505398000,2312117000,3146149000,6976532000,9230647000,14602799000,30932694000,49452955000
Minnesota,Information,2009,8484,4020,1193,905,6118,1004,386,7508,976,13155,4020,1210,925,6155,1340,765,8260,4895,308628,4662,6450,11230,23679,36788,28437,107020,176541,19483046000,304328000,262809000,462539000,1015860000,1810903000,1483896000,5371608000,12625888000
Minnesota,Management of Companies and Enterprises,2009,3980,285,90,140,515,705,1150,2370,1610,5585,285,95,140,520,710,1195,2425,3160,590620,392,28,734,1433,8955,36211,47090,543465,46234135000,32409000,17052000,63784000,116085000,616145000,2465310000,3197540000,43019637000
Minnesota,Manufacturing,2009,35271,13410,5920,4712,24042,6468,2333,32843,2428,37545,13410,5920,4725,24055,6750,2860,33665,3880,1415321,19791,34282,56347,119006,242053,262321,671996,620559,67501700000,806580000,1234540000,2253682000,4520367000,10146713000,12339921000,28933284000,32905420000
Minnesota,"Mining, Quarrying, and Oil and Gas Extraction",2009,624,350,80,65,495,45,21,561,63,705,350,80,65,495,50,25,570,135,22506,429,469,260,1577,943,471,3739,18155,1547556000,34220000,25546000,21812000,118762000,56443000,34731000,250262000,1229096000
Minnesota,Other,2009,202,193,3,4,200,2,0,202,0,202,193,3,4,200,2,0,202,0,290,0,16,51,220,0,0,290,0,5619000,4044000,946000,514000,5504000,0,0,5619000,0
Minnesota,Other Services (except Public Administration),2009,70458,41210,14786,8176,64172,5003,684,69859,599,76110,41290,14950,8545,64785,6330,1780,72895,3215,595358,76030,95784,106463,281594,162836,64125,514063,58084,14468564000,1843825000,1912992000,2241192000,6029047000,3642495000,1684423000,11504000000,2657743000
Minnesota,"Professional, Scientific, and Technical Services",2009,78042,56620,8880,5444,70944,4120,1207,76271,1771,82105,56640,8945,5665,71250,4785,1605,77640,4465,686733,58560,56133,69719,196154,136979,96791,445202,210928,40323570000,3662567000,2640998000,3504114000,9867805000,8682939000,6600483000,25590022000,14371779000
Minnesota,Real Estate and Rental and Leasing,2009,25585,19680,2570,1104,23354,1078,551,24983,602,31295,19710,2630,1300,23640,1750,1905,27295,4000,179125,23044,15891,13070,54379,36644,38507,130727,36613,6568275000,830490000,526776000,473478000,1865092000,1281206000,1111800000,4269976000,2009128000
Minnesota,Retail Trade,2009,66260,32898,14262,8896,56056,6221,1604,63881,2379,98755,33010,14470,9775,57255,9485,5620,72360,26395,1390383,55519,90523,112227,261705,211047,123675,619248,618045,32478743000,1383902000,1846859000,2540271000,5789367000,5464824000,3502829000,15192255000,15892373000
Minnesota,Total,2009,118744,71129,18565,12549,102243,11170,2797,116210,2534,146453,71220,18773,13217,103210,14668,8086,125964,20489,2417174,109600,122203,168201,400004,424144,381601,1205749,1211425,102179234000,4008403000,3768580000,5290818000,13067801000,14688794000,14756560000,42513155000,59666079000
Minnesota,Transportation and Warehousing,2009,20694,12855,2310,1746,16911,1894,696,19501,1193,22960,12855,2325,1765,16945,2085,935,19965,2995,320381,2359,14114,22491,53667,64908,54688,179898,123710,11605158000,589060000,462037000,708353000,1774664000,1882986000,1838429000,5611138000,5592332000
Minnesota,Utilities,2009,575,110,30,70,210,155,70,435,140,1390,110,30,70,210,205,120,535,855,953,0,78,859,1209,5830,5411,12638,462,2683689000,5400000,6960000,55268000,81722000,360370000,409785000,861155000,37059000
Minnesota,Wholesale Trade,2009,35503,17439,4970,3999,26408,4519,1875,32802,2701,41485,17480,5045,4145,26670,5305,3120,35095,6390,652680,24222,28638,47783,108969,146606,95082,364910,237685,41410450000,1377710000,1610982000,2607501000,5708439000,7758520000,5128651000,19193656000,17364199000
Mississippi,Accommodation and Food Services,2009,17621,6235,3445,3453,13133,3331,461,16925,696,24445,6250,3445,3495,13190,3755,1595,18540,5905,583216,9153,22572,46834,79607,114846,56970,255877,324194,8960313000,197559000,240230000,492566000,933814000,1322755000,622055000,2953743000,5947188000
Mississippi,Administrative and Support and Waste Management and Remediation Services,2009,9663,5365,1495,960,7820,828,373,9021,642,10955,5365,1500,965,7830,900,510,9240,1715,230924,8005,8642,11911,30670,31995,29674,108658,100957,5171362000,242568000,217621000,276538000,755637000,710916000,564384000,2337753000,2254813000
Mississippi,"Agriculture, Forestry, Fishing and Hunting",2009,3428,1905,920,405,3230,130,20,3380,48,3510,1905,920,405,3230,135,35,3400,110,20388,3447,5837,4935,14763,3082,0,18751,584,668253000,105915000,162810000,160085000,445968000,105237000,0,581268000,34807000
Mississippi,"Arts, Entertainment, and Recreation",2009,3210,1830,510,450,2790,335,35,3160,50,3280,1830,515,450,2795,355,60,3210,70,34925,2122,3003,5653,11606,11792,3752,30581,0,618201000,79502000,42813000,76395000,216660000,189955000,48980000,518772000,0
Mississippi,Construction,2009,22613,13635,3980,2550,20165,1955,273,22393,220,22820,13635,3980,2550,20165,1975,300,22440,380,232028,23261,24979,33252,83990,69563,35243,195018,19750,8631895000,650745000,676444000,1036462000,2380417000,2690983000,1664803000,6888620000,917126000
Mississippi,Educational Services,2009,2406,985,371,245,1601,560,135,2296,110,2935,985,375,245,1605,575,275,2455,480,86097,1270,2280,2815,7508,23690,17027,48817,36987,1867893000,37315000,41295000,47172000,141456000,485783000,447066000,1094252000,757803000
Mississippi,Finance and Insurance,2009,12098,8050,1440,650,10140,716,363,11219,879,24325,8080,1505,995,10580,2510,3045,16135,8190,170853,13567,8602,7344,31750,23943,28817,86743,42549,7620180000,471438000,314999000,302974000,1115517000,995660000,1151366000,3324983000,4186615000
Mississippi,Health Care and Social Assistance,2009,24380,10630,6020,3495,20145,2539,945,23629,751,29950,10640,6040,3605,20285,3320,2290,25895,4055,750988,19951,39284,44026,105840,94836,124405,329955,381843,29534934000,1008461000,1516017000,1707452000,4295862000,3346530000,4043209000,11829428000,17241758000
Mississippi,Information,2009,2032,680,425,270,1375,211,115,1701,331,4830,680,425,285,1390,305,205,1900,2930,57082,777,2199,2808,6769,5836,2274,19065,29644,2419668000,36116000,52739000,72634000,178699000,172219000,105311000,591984000,1747568000
Mississippi,Management of Companies and Enterprises,2009,1225,80,5,40,125,231,411,767,458,1605,80,5,40,125,235,465,825,780,37357,96,0,0,0,2027,9958,12192,25165,2484416000,12202000,0,398000,14875000,84292000,572888000,669845000,1792774000
Mississippi,Manufacturing,2009,11013,3410,1745,1421,6576,1988,927,9491,1522,12155,3410,1745,1425,6580,2025,1155,9760,2395,571683,3331,8433,15271,31853,62391,78379,198630,338902,19998709000,167561000,249953000,464228000,975078000,2035564000,2416187000,6194779000,12742154000
Mississippi,"Mining, Quarrying, and Oil and Gas Extraction",2009,1713,920,160,185,1265,174,75,1514,199,1820,920,160,190,1270,180,90,1540,280,23978,449,700,1920,3901,6166,3121,14865,7669,1352262000,50314000,32558000,91324000,188050000,401352000,126190000,738662000,636610000
Mississippi,Other,2009,77,74,2,1,77,0,0,77,0,77,74,2,1,77,0,0,77,0,97,72,0,0,97,0,0,97,0,1493000,1348000,0,0,1493000,0,0,1493000,0
Mississippi,Other Services (except Public Administration),2009,30879,19150,6630,2935,28715,1605,254,30574,305,32450,19160,6655,3080,28895,2005,500,31400,1050,197665,37394,41924,36184,118322,50018,10713,187383,6432,4012826000,726965000,760189000,752818000,2260812000,951502000,240374000,3691580000,238154000
Mississippi,"Professional, Scientific, and Technical Services",2009,21695,14475,3295,1765,19535,1182,376,21093,602,23640,14480,3315,1790,19585,1565,570,21720,1920,161875,23100,20251,22096,67934,35026,19535,125314,31065,6806716000,824162000,734292000,866896000,2468114000,1629251000,918990000,5071326000,1560156000
Mississippi,Real Estate and Rental and Leasing,2009,9726,7407,1070,421,8898,328,185,9411,315,12130,7415,1100,475,8990,450,670,10110,2020,51201,7462,5529,3911,22956,7109,4304,38922,8888,1482248000,289697000,163622000,121295000,598498000,232499000,175048000,1099821000,333698000
Mississippi,Retail Trade,2009,38987,21165,8074,4433,33672,3121,616,37409,1578,59180,21210,8250,4765,34225,4560,3125,41910,17270,593094,37458,51146,54557,148864,96069,41416,298674,279592,12476690000,771043000,1072064000,1334119000,3197644000,2579123000,853473000,6859781000,5395765000
Mississippi,Total,2009,46137,25439,8602,5186,39227,4180,1111,44518,1619,59607,25474,8693,5465,39632,5566,3344,48542,11065,904037,46885,56306,68458,171649,150435,124471,446555,457482,28452219000,1270810000,1433331000,1849847000,4553988000,4369928000,3795972000,12719888000,15732331000
Mississippi,Transportation and Warehousing,2009,9121,4905,1340,920,7165,727,311,8203,918,10470,4905,1340,930,7175,800,410,8385,2085,164346,7680,8033,10659,27898,21818,12980,66221,74788,5860065000,226998000,248947000,315445000,831864000,768037000,386464000,2169150000,2907481000
Mississippi,Utilities,2009,1803,1155,340,65,1560,105,60,1725,78,2895,1160,340,100,1600,180,210,1990,905,43580,2773,2095,794,5800,5700,8932,20809,0,3219813000,54824000,52736000,27264000,143491000,299461000,490663000,945342000,40476000
Mississippi,Wholesale Trade,2009,11859,4885,1810,1449,8144,1581,772,10497,1362,14255,4890,1840,1530,8260,2000,1210,11470,2785,165551,7264,10162,16397,37025,36078,26003,115092,43777,7122577000,285408000,387509000,637082000,1370692000,1497684000,1195612000,4488947000,2255083000
Missouri,Accommodation and Food Services,2009,44250,17059,7055,8156,32270,9510,1252,43032,1218,60675,17165,7090,8260,32515,10960,4280,47755,12920,1179310,27705,47111,111467,187083,342491,165724,697551,479238,16323985000,580884000,521012000,1286081000,2393979000,4298139000,2149991000,8887674000,7421510000
Missouri,Administrative and Support and Waste Management and Remediation Services,2009,32924,20512,4665,2800,27977,2598,835,31410,1514,37015,20525,4670,2820,28015,2815,1085,31915,5100,726928,27957,30052,35697,97939,90528,85856,298066,411237,19738200000,888899000,798145000,1056276000,2781586000,2706032000,2186684000,7970756000,11429700000
Missouri,"Agriculture, Forestry, Fishing and Hunting",2009,1175,845,150,75,1070,60,20,1150,25,1195,845,150,75,1070,65,20,1155,40,5624,692,853,461,2386,1568,0,5208,0,167748000,29341000,23395000,9506000,71453000,38627000,0,147863000,0
Missouri,"Arts, Entertainment, and Recreation",2009,9878,5642,1365,1197,8204,1187,229,9620,258,10530,5650,1365,1225,8240,1280,315,9835,695,192648,7639,8520,15834,33061,43451,21192,104317,77915,6586222000,257812000,150815000,275951000,693887000,796826000,2316176000,3950067000,1587371000
Missouri,Construction,2009,72191,47291,12185,6610,66086,4905,716,71707,484,72850,47300,12190,6625,66115,5040,875,72030,820,628199,76401,78819,87055,242547,172062,84197,508565,109166,28845798000,2324000000,2535470000,3407340000,8268390000,8381598000,4613734000,21586745000,6768808000
Missouri,Educational Services,2009,6942,3030,975,980,4985,1295,395,6675,267,7565,3030,975,990,4995,1385,505,6885,680,345151,4254,5740,12556,24287,56332,64388,149131,191242,11836612000,117372000,113193000,205747000,460848000,1339487000,1783426000,3623927000,8118935000
Missouri,Finance and Insurance,2009,29566,19780,3215,1629,24624,2257,849,27730,1836,55205,19820,3325,1950,25095,5695,4560,35350,19855,625739,33341,19212,19559,73347,78982,75886,233377,364331,34557563000,1237823000,793061000,951391000,3019144000,3555135000,3891410000,10690875000,23431989000
Missouri,Health Care and Social Assistance,2009,64095,32620,12350,7870,52840,7067,2478,62385,1710,82195,32665,12470,8150,53285,9130,7710,70125,12070,1866382,50082,81514,102426,234857,292578,333993,875226,977751,70721480000,2158427000,3181446000,4116498000,9499370000,9912377000,9444162000,29092845000,41109614000
Missouri,Information,2009,6422,2765,924,765,4454,826,312,5592,830,12305,2765,935,790,4490,1025,575,6090,6215,307935,4444,5768,9567,20226,22621,21465,69878,236953,17396417000,159301000,209867000,363664000,750045000,940421000,838673000,2714484000,14647950000
Missouri,Management of Companies and Enterprises,2009,4129,235,70,165,470,823,1217,2510,1619,7435,235,70,165,470,845,1300,2615,4820,369530,52,308,456,1184,9675,32270,43140,326390,29903880000,21596000,13645000,22150000,58960000,613805000,2030805000,2703945000,27199935000
Missouri,Manufacturing,2009,29840,11255,5145,4317,20717,4861,1801,27379,2461,31935,11255,5155,4345,20755,5235,2235,28225,3710,1142032,17913,30160,50119,106860,163125,152498,467889,564628,49432130000,567589000,926546000,1754077000,3466300000,6205269000,6142629000,17592994000,26957668000
Missouri,"Mining, Quarrying, and Oil and Gas Extraction",2009,825,275,180,100,555,122,74,751,74,1280,275,180,100,555,260,185,1000,280,14886,286,1060,1138,2747,3180,3853,10144,3193,741273000,16650000,41015000,42840000,105226000,152317000,203150000,476712000,262421000
Missouri,Other,2009,4026,3990,33,3,4026,0,0,4026,0,4026,3990,33,3,4026,0,0,4026,0,0,0,220,0,0,0,0,0,0,23134000,21976000,667000,491000,23134000,0,0,23134000,0
Missouri,Other Services (except Public Administration),2009,72909,45730,14437,6703,66870,4625,725,72220,689,78645,45745,14555,7060,67360,5675,2045,75080,3565,566548,85275,93334,85859,267653,159071,45120,482485,66646,13728522000,1819540000,1981228000,1912611000,5746922000,3692339000,1169603000,10879403000,2196666000
Missouri,"Professional, Scientific, and Technical Services",2009,62292,41390,9330,4980,55700,3756,1189,60645,1647,66970,41425,9360,5140,55925,4445,1715,62085,4885,706262,64055,58336,63613,188978,118987,77041,391836,274367,39460059000,2566004000,2426940000,2969525000,8009499000,6977369000,4686603000,20010455000,17268437000
Missouri,Real Estate and Rental and Leasing,2009,25130,18927,2550,1227,22704,1120,571,24395,735,31905,18960,2640,1360,22960,1635,1605,26200,5705,178222,27477,15674,14881,60181,33035,30315,128696,47339,6315065000,789382000,515160000,462440000,1788127000,1200203000,981825000,4200901000,1901048000
Missouri,Retail Trade,2009,69712,36857,13991,8383,59231,6463,1534,67228,2484,110850,36955,14350,9275,60580,10490,6510,77580,33270,1377918,63025,87178,105965,261767,209803,102595,594620,708525,31663279000,1414990000,1884520000,2572502000,5897812000,6148295000,2824259000,15228758000,15624401000
Missouri,Total,2009,118502,70377,19264,12259,101900,11055,2733,115688,2814,150892,70494,19493,12863,102850,14736,8028,125614,25278,2358706,117471,126360,162530,406361,411450,317758,1135569,1223137,88809106000,3378916000,3652454000,4981884000,12013254000,13466132000,11299023000,36778409000,52030697000
Missouri,Transportation and Warehousing,2009,20678,12475,2725,1789,16989,1559,694,19242,1436,23630,12475,2735,1805,17015,1690,920,19625,4005,392551,16607,17686,20943,59968,48780,45665,162038,190150,13927692000,546489000,543355000,701754000,1820893000,1529366000,1572570000,5161957000,7252876000
Missouri,Utilities,2009,561,115,55,50,220,180,49,449,112,1810,115,55,50,220,285,245,750,1060,75148,218,307,447,972,9335,4712,14669,41419,6027767000,6505000,8239000,19698000,38927000,601040000,316862000,984903000,3470054000
Missouri,Wholesale Trade,2009,33732,15256,4975,3950,24181,4717,2047,30945,2787,40335,15315,5030,4115,24460,5725,3455,33640,6695,614977,24231,29929,48360,108105,137159,97066,356635,247815,28056194000,1106352000,1378780000,2140377000,4733443000,6493894000,4438885000,16238723000,11179469000
Montana,Accommodation and Food Services,2009,15138,5945,3179,3015,12139,2487,298,14924,214,16810,5945,3205,3065,12215,2850,770,15835,975,223476,8874,21630,41217,72048,85664,31686,190950,21175,3020985000,213948000,255671000,476726000,949042000,1111352000,421645000,2515730000,400753000
Montana,Administrative and Support and Waste Management and Remediation Services,2009,7984,5425,1210,545,7180,377,126,7683,301,8445,5425,1220,550,7195,445,190,7830,615,73056,6156,7306,5281,21122,12705,6808,48123,4293,1792623000,291629000,179795000,165240000,674842000,271347000,158852000,1256023000,104039000
Montana,"Agriculture, Forestry, Fishing and Hunting",2009,1806,1570,125,55,1750,10,21,1781,25,1845,1570,125,55,1750,10,40,1800,45,4990,1492,590,532,3351,0,318,4424,29,184546000,71473000,14542000,23718000,120129000,0,12469000,164386000,745000
Montana,"Arts, Entertainment, and Recreation",2009,5212,3105,890,650,4645,452,70,5167,45,5755,3105,900,670,4675,525,80,5280,475,49836,3576,5326,8488,18141,15078,9265,43613,0,742181000,128109000,91212000,114918000,339576000,201323000,77921000,638550000,0
Montana,Construction,2009,27008,21580,3105,1315,26000,770,122,26892,116,27105,21580,3105,1315,26000,770,155,26925,180,111371,28486,19453,16530,67136,23390,9415,105179,3098,4711721000,1018700000,659906000,660304000,2364295000,1147295000,600384000,4361507000,194269000
Montana,Educational Services,2009,1620,925,235,180,1340,185,65,1590,30,1680,925,235,180,1340,200,90,1630,50,24329,1180,1263,2241,4939,6105,10125,22479,1787,535915000,29194000,28517000,29840000,91784000,135135000,249570000,502930000,32505000
Montana,Finance and Insurance,2009,6532,4240,725,398,5363,404,183,5950,582,10195,4240,730,550,5520,1040,615,7175,3020,86037,6695,3555,4267,16137,12932,9674,41377,29386,3919804000,225793000,154307000,174071000,568135000,483523000,443163000,1629721000,1692139000
Montana,Health Care and Social Assistance,2009,14613,7605,3190,1625,12420,1142,649,14211,402,16780,7605,3210,1675,12490,1390,1620,15500,1280,306314,12072,19916,20111,54188,44011,76632,179345,108571,11006879000,496065000,779720000,728807000,2036848000,1345367000,2323192000,5797968000,4566933000
Montana,Information,2009,1976,950,320,230,1500,128,113,1741,235,2935,965,320,235,1520,165,410,2095,840,43085,958,1501,2028,5747,2702,9673,21979,19072,1523186000,34984000,40609000,85132000,174074000,97995000,393466000,766655000,681827000
Montana,Management of Companies and Enterprises,2009,550,35,5,50,90,120,145,355,195,615,35,5,50,90,125,145,360,255,13093,0,0,0,0,419,4001,4683,8368,825625000,2372000,0,6691000,10546000,15310000,252937000,280260000,542352000
Montana,Manufacturing,2009,5966,3150,1075,734,4959,628,156,5743,223,6135,3150,1075,735,4960,670,185,5815,320,67007,3748,5055,6047,17254,16079,5037,47266,9908,2728818000,121857000,147437000,200019000,546501000,540421000,193639000,1568364000,681799000
Montana,"Mining, Quarrying, and Oil and Gas Extraction",2009,1503,795,215,130,1140,139,65,1344,159,1570,795,215,130,1140,140,75,1355,215,16513,764,1292,1230,3651,2357,4540,10892,2666,1032827000,46687000,63189000,64790000,187531000,154956000,260166000,622404000,454677000
Montana,Other,2009,38,38,0,0,38,0,0,38,0,38,38,0,0,38,0,0,38,0,0,0,0,0,0,0,0,0,0,761000,761000,0,0,761000,0,0,761000,0
Montana,Other Services (except Public Administration),2009,14534,9465,2985,1272,13722,591,80,14393,141,15160,9465,2990,1295,13750,815,120,14685,475,73978,15096,18574,14909,50918,15591,818,69851,1523,1633011000,359521000,399865000,325226000,1117282000,351547000,17120000,1553044000,39074000
Montana,"Professional, Scientific, and Technical Services",2009,16864,12380,2140,1147,15667,620,138,16425,439,17725,12380,2155,1185,15720,845,415,16980,745,85040,14215,13139,13523,44604,15727,5811,73691,7619,3560075000,614509000,460857000,554485000,1666407000,771980000,380388000,3071694000,427821000
Montana,Real Estate and Rental and Leasing,2009,8000,6630,635,323,7588,190,69,7847,153,8825,6645,650,430,7725,390,130,8245,580,28305,7531,3516,3650,15965,4921,1403,23410,3124,733741000,222789000,82698000,85676000,408308000,111881000,34047000,588427000,100113000
Montana,Retail Trade,2009,19553,10030,4321,2399,16750,1631,366,18747,806,25130,10065,4405,2645,17115,2375,1210,20700,4430,266803,15318,25634,27557,76178,47431,16319,152954,96190,6128720000,397203000,568590000,716711000,1713112000,1244409000,440505000,3639888000,2279548000
Montana,Total,2009,31670,20187,5157,2976,28320,2077,485,30882,788,36326,20207,5202,3163,28572,2828,1431,32831,3495,341357,31713,33908,39419,105040,73326,54274,232640,108717,10654179000,945518000,877039000,1029158000,2851715000,1999105000,1752509000,6603329000,4050850000
Montana,Transportation and Warehousing,2009,5692,3885,635,385,4905,306,165,5376,316,6535,3890,640,395,4925,320,260,5505,1030,50598,3051,3628,4267,13262,8138,7700,33475,9078,1751842000,140122000,107258000,132170000,405719000,272118000,232600000,1014430000,390390000
Montana,Utilities,2009,383,175,30,30,235,90,20,345,38,955,175,30,35,240,125,40,405,550,13208,112,86,0,609,2387,0,4637,3764,974194000,8927000,4270000,14143000,32497000,146184000,0,284589000,310886000
Montana,Wholesale Trade,2009,5973,2880,785,573,4238,700,316,5254,719,7240,2885,795,620,4300,940,605,5845,1395,62513,3389,3085,5941,14760,18329,6830,46294,15030,2680378000,149908000,159586000,228597000,594851000,659902000,283169000,1770065000,757063000
Nebraska,Accommodation and Food Services,2009,16583,6190,3099,3215,12504,3119,454,16077,506,21060,6190,3130,3255,12575,3695,1870,18140,2920,344271,10398,20661,43306,75042,108540,57155,242121,101807,3970680000,158984000,186957000,406800000,755304000,1209045000,657659000,2644040000,1322441000
Nebraska,Administrative and Support and Waste Management and Remediation Services,2009,11748,7395,1710,900,10005,755,295,11055,693,13065,7395,1710,905,10010,860,400,11270,1795,212247,9969,9602,10223,31898,25130,29971,91895,97052,6017731000,310734000,246542000,277019000,893667000,655778000,738815000,2407076000,2876651000
Nebraska,"Agriculture, Forestry, Fishing and Hunting",2009,825,600,100,45,745,40,20,805,20,865,600,100,45,745,40,55,840,25,4963,661,493,584,1814,672,0,3368,1595,216006000,36073000,17613000,17898000,72355000,22311000,10070000,127756000,88250000
Nebraska,"Arts, Entertainment, and Recreation",2009,4044,2385,620,345,3350,515,80,3945,99,4215,2385,620,350,3355,550,105,4010,205,52664,2541,3579,4185,10975,17354,7664,39828,10302,806853000,86360000,54908000,53284000,209012000,274416000,123471000,657277000,106537000
Nebraska,Construction,2009,28858,19685,4655,2414,26754,1598,292,28644,214,29105,19685,4660,2420,26765,1625,380,28770,335,210330,29938,29972,30741,93098,59984,28729,188105,11511,8543473000,958511000,940646000,1168870000,3085802000,2713905000,1345617000,7376352000,638083000
Nebraska,Educational Services,2009,2343,1010,370,315,1695,465,105,2265,78,2570,1015,370,315,1700,520,245,2465,105,89892,330,2421,3794,8046,18995,16395,44800,18200,2344869000,34446000,26278000,60879000,126579000,382431000,373528000,912952000,581648000
Nebraska,Finance and Insurance,2009,12969,8340,1626,852,10818,874,316,12008,961,20990,8370,1675,1090,11135,2295,1415,14845,6145,266811,13340,9923,9887,34005,29098,23420,89364,166885,14605932000,425069000,370190000,468497000,1288232000,1328514000,1191813000,3928037000,9813807000
Nebraska,Health Care and Social Assistance,2009,20461,9770,3960,2558,16288,2608,891,19787,674,25150,9780,3970,2665,16415,3590,2370,22375,2775,573242,13900,25810,32333,76574,99876,109414,291737,249889,22145178000,873762000,1026027000,1322606000,3241355000,3915864000,3510371000,10809255000,10678744000
Nebraska,Information,2009,2953,1165,415,383,1963,375,166,2504,449,4840,1165,415,390,1970,480,265,2715,2125,74983,996,2399,4163,9068,9021,5400,28127,38939,4483272000,45328000,71546000,168868000,299611000,493386000,170938000,1257829000,2081125000
Nebraska,Management of Companies and Enterprises,2009,1452,115,60,50,225,310,396,931,521,1815,115,60,50,225,315,430,970,845,71110,108,324,183,600,3017,9195,13080,57941,5387110000,11756000,14528000,8525000,35430000,145640000,573830000,754900000,4632210000
Nebraska,Manufacturing,2009,8626,3270,1455,997,5722,1351,726,7799,827,9290,3270,1455,1010,5735,1460,840,8035,1255,395072,4418,6949,7550,21073,41664,53634,139943,209589,15239559000,138340000,229036000,292509000,758370000,1563247000,2031974000,5070693000,8200555000
Nebraska,"Mining, Quarrying, and Oil and Gas Extraction",2009,572,330,70,65,465,32,20,517,55,630,330,70,65,465,35,20,520,110,3242,105,337,800,1156,321,0,2063,737,207417000,20668000,12116000,32347000,72384000,21779000,0,130027000,37507000
Nebraska,Other,2009,72,70,2,0,72,0,0,72,0,72,70,2,0,72,0,0,72,0,0,0,0,0,0,0,0,0,0,1067000,937000,0,0,1067000,0,0,1067000,0
Nebraska,Other Services (except Public Administration),2009,26494,17190,4920,2282,24392,1521,299,26212,282,28505,17230,4995,2375,24600,1995,995,27590,915,177915,27356,30119,29446,92236,51315,14042,162886,10212,4022391000,642915000,618246000,601220000,1883898000,1190806000,350533000,3601776000,290801000
Nebraska,"Professional, Scientific, and Technical Services",2009,20177,13315,3000,1585,17900,1103,370,19373,804,21605,13320,3005,1615,17940,1370,610,19920,1685,199955,16526,15999,18842,55793,34640,21841,123261,68083,10575886000,706680000,716411000,803582000,2290144000,1865462000,1320656000,5783162000,4326039000
Nebraska,Real Estate and Rental and Leasing,2009,8436,6453,775,400,7628,281,191,8100,336,9750,6460,830,430,7720,410,350,8480,1270,48008,1010,4189,4246,14761,6985,10692,39436,7283,1560645000,229078000,136852000,108999000,508250000,214089000,393925000,1293383000,231512000
Nebraska,Retail Trade,2009,25760,12248,5563,3480,21291,2332,775,24398,1362,37230,12305,5660,3805,21770,3690,2755,28215,9015,470979,20662,34238,38897,101318,73558,41272,228689,215177,10275150000,466627000,687378000,887802000,2087824000,1961661000,1196634000,5502183000,4366454000
Nebraska,Total,2009,41861,24341,7029,4351,35721,3743,992,40456,1405,51633,24382,7118,4619,36119,5204,3113,44436,7197,779508,40987,45941,57547,144475,137904,115006,397385,382123,27474673000,1155805000,1227400000,1618137000,4001342000,4409342000,3860106000,12270790000,15203883000
Nebraska,Transportation and Warehousing,2009,10748,7360,1175,714,9249,592,233,10074,674,11670,7360,1175,715,9250,615,325,10190,1480,189516,9729,5792,8263,26429,18804,16283,66084,105024,6616086000,269854000,212407000,272179000,778114000,700809000,576293000,2138319000,3793286000
Nebraska,Utilities,2009,142,40,5,0,45,35,5,85,57,510,40,5,0,45,60,5,110,400,434,0,0,0,42,276,0,294,336,556796000,681000,0,0,1326000,27183000,0,34567000,532891000
Nebraska,Wholesale Trade,2009,11509,4540,1650,1414,7604,1870,817,10291,1218,14940,4545,1675,1595,7815,2415,2130,12360,2580,187719,5937,9314,14659,32532,49820,32450,127489,51154,9071132000,255167000,363412000,614924000,1303141000,2161546000,1432012000,5311820000,3274217000
Nevada,Accommodation and Food Services,2009,19804,6745,4280,3699,14724,3304,791,18819,985,28570,6745,4330,3850,14925,3980,2740,21645,6925,1415821,10645,26305,45012,81759,119800,119280,326573,1084068,38725614000,430436000,353534000,683049000,1472169000,2003884000,2422574000,5929429000,32761613000
Nevada,Administrative and Support and Waste Management and Remediation Services,2009,18744,10660,2570,1820,15050,1870,664,17584,1160,20465,10660,2580,1850,15090,1935,800,17825,2640,448181,13978,16402,21854,54289,61302,57411,182162,217705,12756678000,638301000,437314000,639383000,1736045000,1705835000,1367694000,5216564000,6549227000
Nevada,"Agriculture, Forestry, Fishing and Hunting",2009,240,220,15,5,240,0,0,240,0,240,220,15,5,240,0,0,240,0,52,52,0,0,52,0,0,52,0,23275000,22025000,0,0,23275000,0,0,23275000,0
Nevada,"Arts, Entertainment, and Recreation",2009,5301,3120,538,490,4148,702,242,5092,209,6175,3120,540,490,4150,815,555,5520,655,128926,1964,2619,6323,13676,29944,31339,79424,42324,3564726000,316928000,80928000,162620000,602855000,864195000,698232000,2281980000,950568000
Nevada,Construction,2009,26599,14200,4745,3185,22130,3139,747,26016,583,26950,14200,4755,3185,22140,3175,795,26110,840,438585,22411,31308,43015,97274,115799,88226,309340,119593,20745793000,881588000,1147865000,1686396000,3721397000,4831892000,4280259000,13150833000,7058701000
Nevada,Educational Services,2009,2917,1605,390,305,2300,380,90,2770,147,3140,1610,395,310,2315,400,100,2815,325,44577,1840,2322,3939,8457,12937,7147,31207,8479,1411405000,79453000,53925000,73143000,217376000,450194000,242177000,1005606000,258440000
Nevada,Finance and Insurance,2009,13097,8550,1317,559,10426,805,565,11796,1301,21355,8580,1370,620,10570,1360,1465,13395,7960,178043,11104,7484,5937,27282,16724,14392,60992,111909,9310915000,575796000,306510000,259444000,1188671000,899098000,489355000,2658896000,6429019000
Nevada,Health Care and Social Assistance,2009,26795,14433,5605,3255,23293,2126,566,25985,810,30650,14485,5610,3380,23475,2750,1405,27630,3020,480565,22773,36523,40868,102660,77384,66881,251455,214406,22851779000,1784117000,1603965000,1667837000,5094509000,3422490000,2584872000,11278650000,11053772000
Nevada,Information,2009,3868,2240,430,265,2935,290,169,3394,474,5505,2245,435,265,2945,305,240,3490,2015,74417,2071,1844,1987,8615,7253,5584,25294,48563,3993230000,207306000,93568000,105833000,475378000,426767000,238809000,1417890000,2736141000
Nevada,Management of Companies and Enterprises,2009,2606,810,60,105,975,366,432,1773,833,3055,815,60,110,985,380,480,1845,1210,60520,791,249,709,1826,3159,6982,11967,48553,5595053000,37566000,22091000,60518000,129163000,173299000,537280000,842225000,4755311000
Nevada,Manufacturing,2009,8642,3655,1490,1055,6200,1273,482,7955,687,8930,3655,1490,1055,6200,1300,540,8040,890,172672,3943,7014,10155,24980,33783,20401,94590,57046,8087557000,213510000,246220000,393074000,954867000,1383895000,829899000,3822391000,3447606000
Nevada,"Mining, Quarrying, and Oil and Gas Extraction",2009,1003,475,150,85,710,105,85,900,103,1080,475,150,85,710,105,85,900,180,54408,300,446,590,1579,1635,4783,12310,40406,4638085000,56193000,69527000,46290000,193101000,76689000,418054000,894379000,3569018000
Nevada,Other,2009,107,103,4,0,107,0,0,107,0,107,103,4,0,107,0,0,107,0,121,95,0,0,121,0,0,121,0,2790000,2418000,0,0,2790000,0,0,2790000,0
Nevada,Other Services (except Public Administration),2009,18247,11465,3260,1610,16335,1143,374,17852,395,20280,11490,3305,1665,16460,1515,750,18725,1555,156889,19471,20459,18175,60157,36228,19074,125680,22006,4276130000,576025000,546943000,496072000,1658248000,974217000,536291000,3347928000,732518000
Nevada,"Professional, Scientific, and Technical Services",2009,37093,26560,4165,2495,33220,2057,701,35978,1115,39360,26565,4195,2540,33300,2280,1030,36610,2750,262405,29073,25556,30460,91045,58417,28170,186864,59346,15063591000,2134542000,1304511000,1560467000,5039445000,3408914000,1709769000,10479999000,3650373000
Nevada,Real Estate and Rental and Leasing,2009,15607,11352,1705,940,13997,720,311,15028,579,19275,11380,1745,1000,14125,1095,730,15950,3325,140474,15490,10209,11582,38385,18212,13017,71867,63507,5279128000,566441000,317061000,343087000,1243677000,692601000,416264000,2417549000,2691790000
Nevada,Retail Trade,2009,24946,12019,4668,2954,19641,1962,959,22562,2384,41170,12075,4805,3205,20085,2775,2590,25450,15720,596063,16257,27245,33279,82436,49879,34806,188805,366227,15956733000,527926000,730358000,831230000,2134394000,1598358000,1242562000,5350651000,9600944000
Nevada,Total,2009,47929,27536,7514,4900,39950,4358,1506,45814,2115,59785,27588,7604,5099,40291,5331,3196,48818,10967,1042166,43018,49539,64316,156873,149438,134764,441075,601091,39137038000,1987859000,1629614000,2084099000,5701572000,5379442000,4689236000,15770250000,23366788000
Nevada,Transportation and Warehousing,2009,6105,2920,650,582,4152,579,392,5123,982,7095,2935,650,600,4185,610,485,5280,1815,195475,3357,2822,5918,13083,12976,21270,53174,103321,6932622000,148346000,101479000,206983000,516902000,469860000,778064000,1979481000,3479260000
Nevada,Utilities,2009,264,95,25,15,135,50,21,206,58,590,95,25,15,135,80,50,265,325,1348,82,0,0,518,0,512,1469,702,120272000,3106000,0,0,28797000,0,48373000,141388000,72739000
Nevada,Wholesale Trade,2009,13033,6070,1532,1235,8837,1615,928,11380,1653,14505,6075,1545,1265,8885,1795,1140,11820,2685,170962,6135,7324,12670,30543,33239,21889,96587,46775,8793278000,452417000,367462000,636348000,1550148000,1644019000,1012319000,4550225000,2830030000
New Hampshire,Accommodation and Food Services,2009,14398,5805,2780,2725,11310,2423,341,14074,324,17515,5815,2805,2810,11430,2775,1090,15295,2220,253877,8208,18721,36297,64165,80776,32174,176743,72265,4223260000,296405000,279283000,512970000,1098797000,1309495000,528910000,2967020000,1253933000
New Hampshire,Administrative and Support and Waste Management and Remediation Services,2009,10155,6513,1395,850,8758,717,210,9685,470,10955,6515,1400,860,8775,810,255,9840,1115,179557,8617,8001,10041,29465,24340,19284,79469,85163,7019954000,395905000,263637000,380105000,1109923000,870944000,627159000,2823438000,3718645000
New Hampshire,"Agriculture, Forestry, Fishing and Hunting",2009,660,470,125,40,635,20,0,655,5,665,470,125,40,635,25,0,660,5,2515,645,624,417,2020,473,0,2493,0,86782000,23565000,22635000,17923000,66124000,20358000,0,86482000,0
New Hampshire,"Arts, Entertainment, and Recreation",2009,3583,2035,535,365,2935,462,95,3492,91,3730,2035,535,365,2935,535,140,3610,120,64428,2850,2971,3875,10239,14936,11701,40113,20534,1204157000,311591000,86491000,108510000,535421000,280913000,116873000,986544000,146639000
New Hampshire,Construction,2009,21093,15400,2805,1530,19735,1143,140,21018,75,21145,15400,2805,1530,19735,1165,150,21050,95,119498,21579,16891,19487,60748,38857,12066,116539,1261,5931054000,934192000,751385000,911305000,2615844000,2240716000,663554000,5761094000,102441000
New Hampshire,Educational Services,2009,2800,1335,430,325,2090,451,118,2659,141,3020,1335,435,330,2100,550,135,2785,235,145646,1475,2342,4155,8835,15573,16452,42233,100919,3769523000,62504000,55992000,81068000,214954000,384964000,528820000,1161170000,2548797000
New Hampshire,Finance and Insurance,2009,5563,3015,630,352,3997,417,337,4751,812,10015,3025,640,420,4085,690,1350,6125,3890,115631,4551,3648,3890,13252,10251,19914,48506,56086,8547772000,274887000,205772000,255577000,760488000,702703000,1269321000,3377221000,4531504000
New Hampshire,Health Care and Social Assistance,2009,13895,5670,3400,1963,11033,1641,641,13315,580,17625,5670,3405,2035,11110,2160,1615,14885,2740,406321,10272,22504,25546,59262,56456,82201,204548,190487,17825465000,419055000,926701000,1229466000,2600964000,2298677000,2832890000,7916539000,9367000000
New Hampshire,Information,2009,2445,975,365,299,1639,264,135,2038,407,3885,975,365,305,1645,315,200,2160,1725,73445,486,2012,2867,5639,6953,10537,28606,43664,4771430000,64324000,155755000,170514000,429210000,438462000,573425000,1566070000,3110695000
New Hampshire,Management of Companies and Enterprises,2009,806,65,20,20,105,130,165,400,406,1065,70,20,20,110,130,175,415,650,49745,114,76,96,335,2200,3880,6289,43250,4528135000,8522000,10040000,2349000,24855000,100540000,248605000,377525000,4150610000
New Hampshire,Manufacturing,2009,9491,3695,1410,1325,6430,1815,472,8717,774,9825,3695,1410,1325,6430,1880,515,8825,1000,268877,4139,6156,13141,28700,58245,29995,139834,99031,14210013000,220285000,273935000,600578000,1250074000,2718934000,1526727000,6453641000,5683783000
New Hampshire,"Mining, Quarrying, and Oil and Gas Extraction",2009,172,115,20,15,150,5,5,160,12,195,115,20,15,150,5,15,170,25,572,64,99,37,377,0,0,430,0,45116000,10625000,8637000,1907000,27369000,0,0,37636000,0
New Hampshire,Other,2009,46,45,1,0,46,0,0,46,0,46,45,1,0,46,0,0,46,0,45,40,0,0,45,0,0,45,0,1154000,1116000,0,0,1154000,0,0,1154000,0
New Hampshire,Other Services (except Public Administration),2009,16855,10570,3720,1450,15740,700,148,16588,267,17860,10580,3740,1470,15790,905,320,17015,845,103202,19084,23161,16935,61222,18382,5875,92346,5269,2806845000,519508000,561358000,410761000,1514623000,539333000,174618000,2386049000,251810000
New Hampshire,"Professional, Scientific, and Technical Services",2009,18501,12390,2715,1350,16455,1098,320,17873,628,19490,12390,2715,1405,16510,1265,425,18200,1290,154219,19109,16864,16568,54658,31563,18705,108727,36074,9189185000,1026181000,948845000,1074025000,3088259000,2032011000,1437135000,6724520000,1615887000
New Hampshire,Real Estate and Rental and Leasing,2009,5868,4230,735,293,5258,233,123,5614,254,6890,4265,775,330,5370,490,165,6025,865,32116,6448,4113,3124,14379,5576,937,26019,4575,1214301000,255605000,153933000,100979000,530424000,280133000,33613000,987847000,200576000
New Hampshire,Retail Trade,2009,21359,10374,4485,2512,17371,2031,547,19949,1410,31390,10395,4550,2795,17740,2735,1515,21990,9400,448403,15125,23668,24519,68425,48500,31473,166840,170282,10950605000,490440000,693435000,790033000,2028683000,1835347000,1256742000,5409191000,3733428000
New Hampshire,Total,2009,31371,17766,5464,3301,26531,2887,766,30184,1187,37873,17793,5507,3454,26754,3585,1801,32140,5733,568043,30436,35889,43675,110000,100583,79195,289778,278265,23628247000,1196026000,1243099000,1576520000,4015645000,3904653000,3384680000,11304978000,12323269000
New Hampshire,Transportation and Warehousing,2009,3666,2080,570,319,2969,300,115,3384,282,4085,2080,570,325,2975,325,135,3435,650,60101,2670,2257,2517,8886,7095,2852,26026,14148,2047462000,122268000,95198000,97886000,346470000,218792000,89485000,912186000,551579000
New Hampshire,Utilities,2009,244,78,20,15,113,25,30,168,76,580,80,20,15,115,25,110,250,330,12413,16,87,0,454,0,0,239,7937,1276683000,7638000,2868000,8956000,27068000,0,0,15355000,708519000
New Hampshire,Wholesale Trade,2009,8416,3830,1190,863,5883,1055,535,7473,943,9200,3830,1195,875,5900,1140,695,7735,1465,119456,4965,5899,9300,23055,25615,16719,76572,34441,7735374000,372280000,373594000,497502000,1352477000,1500426000,998813000,4314676000,3020999000
New Jersey,Accommodation and Food Services,2009,82407,44335,15310,11125,70770,9854,898,81522,885,95975,44365,15335,11250,70950,10475,2075,83500,12475,1317993,76315,99876,149842,326473,355349,107961,792972,520224,24293854000,1827167000,1568834000,2289235000,5691845000,5772304000,1746808000,13248890000,11034440000
New Jersey,Administrative and Support and Waste Management and Remediation Services,2009,59894,39015,8060,4570,51645,4836,1436,57917,1977,66480,39030,8085,4610,51725,5035,1895,58655,7825,1289652,51907,52260,61078,167443,189138,195587,559253,712865,44879401000,2513313000,2041829000,2468376000,7073168000,6849104000,5729393000,19820026000,24132717000
New Jersey,"Agriculture, Forestry, Fishing and Hunting",2009,1105,845,135,85,1065,30,5,1100,5,1105,845,135,85,1065,30,5,1100,5,4932,938,699,1020,2838,860,0,4306,0,146385000,37795000,17614000,35110000,101435000,13072000,0,137475000,0
New Jersey,"Arts, Entertainment, and Recreation",2009,16273,9785,2050,1737,13572,2055,432,16059,214,17300,9800,2050,1765,13615,2080,580,16275,1025,253783,9934,12567,22873,49551,82143,69267,207581,42187,7858191000,708490000,331528000,486929000,1559242000,1900345000,3518439000,7121048000,613658000
New Jersey,Construction,2009,108382,77540,15439,8185,101164,6010,704,107878,504,108945,77540,15440,8195,101175,6055,765,107995,950,721270,116068,99634,107924,327943,219579,90598,650470,63627,41814350000,4946455000,4579037000,5822908000,15355770000,14034150000,6309668000,36330530000,4863539000
New Jersey,Educational Services,2009,15391,6945,2665,2072,11682,2705,673,15060,331,16660,6960,2665,2095,11720,2855,935,15510,1150,462615,10150,17396,27618,56680,114359,90236,267181,170963,16221945000,325766000,383923000,599050000,1311770000,3505121000,3534344000,8482077000,6843720000
New Jersey,Finance and Insurance,2009,33057,20655,4410,2281,27346,2516,1118,30980,2077,65265,20725,4525,2460,27710,4070,3790,35570,29695,984364,32414,27282,27512,91557,80262,89835,264487,717486,86024450000,2006900000,1878521000,2315697000,6266617000,6675437000,6337571000,19535870000,66435563000
New Jersey,Health Care and Social Assistance,2009,109688,53665,25426,14742,93833,10871,3156,107860,1828,129450,53815,25625,15440,94880,14170,9300,118350,11100,2567335,109075,165692,194730,472514,397982,453557,1327724,1207426,115558832000,5083880000,7369061000,9527016000,22025406000,18479828000,15719798000,56324293000,57708606000
New Jersey,Information,2009,10912,5610,1360,1104,8074,1289,454,9817,1095,19050,5610,1360,1110,8080,1385,610,10075,8975,491153,6258,8081,13725,30910,41566,38741,117697,347661,40818054000,534517000,498426000,827011000,1887473000,2914109000,2872343000,8082775000,30405878000
New Jersey,Management of Companies and Enterprises,2009,4885,370,120,175,665,805,1032,2502,2383,6905,370,120,175,665,815,1125,2605,4300,637701,0,532,1058,1937,13470,38045,53775,584005,73128037000,58226000,26696000,105160000,192000000,999045000,3338425000,4529470000,68603380000
New Jersey,Manufacturing,2009,41054,15750,6993,6090,28833,7512,2305,38650,2404,42235,15755,7000,6135,28890,7670,2565,39125,3110,1185864,25383,40670,74542,149749,275848,239151,710915,386374,66556769000,1162543000,1692720000,3301677000,6430484000,12855052000,11925436000,33276523000,28050398000
New Jersey,"Mining, Quarrying, and Oil and Gas Extraction",2009,380,165,45,30,240,56,27,323,57,465,165,45,30,240,70,40,350,115,4853,60,0,175,84,1156,58,3265,1493,310985000,13897000,11565000,9434000,45856000,64964000,2490000,256067000,77313000
New Jersey,Other,2009,263,254,5,4,263,0,0,263,0,263,254,5,4,263,0,0,263,0,0,0,34,0,0,0,0,0,0,9358000,8232000,818000,0,9358000,0,0,9358000,0
New Jersey,Other Services (except Public Administration),2009,110693,74480,19380,9496,103356,5771,813,109940,753,114900,74525,19470,9810,103805,6385,1470,111660,3240,738479,139591,124681,124864,391053,199471,70241,669102,55423,20409681000,3304246000,3140643000,3364062000,9828235000,5289731000,2236644000,17716981000,2198180000
New Jersey,"Professional, Scientific, and Technical Services",2009,142571,101139,17880,10291,129310,8109,2449,139868,2703,149755,101195,17925,10455,129575,8975,3055,141605,8150,1610694,155799,115117,134483,408910,278638,221410,918676,669610,120381046000,8245770000,6362040000,8372663000,23007602000,19838232000,16605562000,59910843000,58720687000
New Jersey,Real Estate and Rental and Leasing,2009,36766,25958,5372,2471,33801,1701,498,36000,766,44850,26030,5545,2795,34370,2290,925,37585,7265,277864,41589,34068,31884,109443,53155,27742,192116,67206,13529757000,1609714000,1327844000,1245109000,4203467000,2620864000,1385223000,8302989000,4333706000
New Jersey,Retail Trade,2009,117791,76965,19550,9942,106457,6995,1666,115118,2673,163505,77165,19940,10645,107750,9170,4535,121455,42050,2101682,115467,114253,107786,351444,213164,97983,688640,1185166,58656995000,3449832000,3155353000,3371007000,10166416000,8675380000,4177262000,23592412000,30813452000
New Jersey,Total,2009,195445,121666,31796,18893,172355,16102,3787,192244,3201,231186,121837,32073,19529,173439,18760,7913,200112,31074,3443211,208575,207356,251192,667123,595296,469369,1731788,1711423,177070691000,8137990000,7928342000,10452266000,26518598000,26700547000,22130205000,75349350000,101721341000
New Jersey,Transportation and Warehousing,2009,30396,17040,4057,2869,23966,3108,1504,28578,1818,34035,17040,4070,2885,23995,3335,2020,29350,4685,711579,24590,25137,36244,89716,106579,127403,331100,364041,30661168000,996268000,958907000,1408898000,3414378000,3893134000,4779151000,12376585000,16694741000
New Jersey,Utilities,2009,409,125,45,25,195,40,17,252,157,1830,125,50,25,200,50,45,295,1535,70643,101,27,0,538,1252,698,3065,62121,8246549000,15053000,953000,0,58542000,114376000,67862000,327739000,7513550000
New Jersey,Wholesale Trade,2009,69870,36830,10873,7569,55272,8287,2855,66414,3456,75905,36855,10955,7660,55470,8885,3830,68185,7720,1284618,60553,68829,94995,232982,275961,211457,734576,520909,95589392000,3540328000,3870906000,5869419000,13363795000,16735557000,12710754000,43385758000,50026135000
New Mexico,Accommodation and Food Services,2009,15041,5170,2555,3049,10774,3141,498,14413,628,20285,5170,2560,3090,10820,3780,1565,16165,4120,393335,8267,17124,42071,68031,114989,53353,246377,143747,5730050000,194342000,189044000,539497000,924072000,1650280000,833555000,3580899000,2091130000
New Mexico,Administrative and Support and Waste Management and Remediation Services,2009,8670,4865,1405,780,7050,705,181,7936,734,9585,4875,1405,805,7085,785,255,8125,1460,177465,6823,8845,9468,26997,23950,9843,70320,99347,4473508000,219329000,206073000,246091000,713140000,791599000,211026000,2015595000,2353524000
New Mexico,"Agriculture, Forestry, Fishing and Hunting",2009,461,315,90,35,440,11,5,456,5,475,315,95,35,445,20,5,470,5,2056,386,276,242,1201,0,0,1808,0,77306000,15065000,9602000,10437000,42503000,0,0,68682000,0
New Mexico,"Arts, Entertainment, and Recreation",2009,3139,1867,450,275,2592,370,70,3032,107,3305,1870,450,290,2610,425,105,3140,165,70506,1551,2373,2445,8861,13494,7407,33891,30431,1503160000,75642000,57013000,44879000,198633000,224337000,208578000,701806000,673960000
New Mexico,Construction,2009,25345,15690,4355,2629,22674,2091,372,25137,208,25505,15690,4355,2635,22680,2115,415,25210,295,236770,26080,27932,34754,90572,75854,47894,221880,7994,9155435000,713300000,786834000,1156393000,2679475000,3082828000,2317920000,8316635000,556456000
New Mexico,Educational Services,2009,2936,1530,395,365,2290,395,140,2825,111,3035,1530,395,365,2290,395,160,2845,190,48858,1590,2315,4729,9630,14784,13793,40953,3172,1353522000,79594000,52417000,94513000,236922000,416500000,440672000,1163727000,118863000
New Mexico,Finance and Insurance,2009,8123,5070,1090,395,6555,438,338,7331,792,14490,5085,1170,535,6790,1150,1515,9455,5035,100390,7917,6374,4160,19603,13847,21529,57534,41264,5534035000,308379000,253255000,180181000,757545000,637217000,976744000,2657803000,2321498000
New Mexico,Health Care and Social Assistance,2009,19560,9020,3985,2682,15687,2330,768,18785,775,23605,9020,4000,2740,15760,2925,2020,20705,2900,530721,14901,26162,34888,77534,89507,93672,271340,245656,21154925000,667497000,1028573000,1430339000,3162942000,2954522000,2872709000,9217251000,11267986000
New Mexico,Information,2009,2529,1260,320,240,1820,213,120,2153,376,4180,1260,330,245,1835,270,280,2385,1795,64005,1201,1171,2564,6482,4617,4392,16714,37028,2752699000,59596000,50961000,84676000,219645000,205503000,150317000,619731000,1967862000
New Mexico,Management of Companies and Enterprises,2009,850,35,35,35,105,175,200,480,370,1030,35,35,35,105,185,210,500,530,30886,29,11,0,45,2669,3611,6798,24062,1693865000,1202000,279000,8801000,17983000,156695000,219058000,398462000,1291406000
New Mexico,Manufacturing,2009,7007,3320,1345,909,5574,728,266,6568,439,7185,3320,1345,915,5580,770,285,6635,550,105197,3976,5988,8270,21364,17878,9438,60499,27878,4711697000,157228000,185425000,291080000,746781000,662710000,382867000,2237465000,1550478000
New Mexico,"Mining, Quarrying, and Oil and Gas Extraction",2009,3039,1295,395,334,2024,525,115,2664,375,3440,1295,395,340,2030,535,155,2720,720,79343,1634,2511,4089,9248,15141,8972,33765,45894,4726685000,97346000,93162000,210088000,404921000,820430000,512566000,1758540000,2982708000
New Mexico,Other,2009,54,47,7,0,54,0,0,54,0,54,47,7,0,54,0,0,54,0,69,30,0,0,69,0,0,69,0,800000,562000,0,0,800000,0,0,800000,0
New Mexico,Other Services (except Public Administration),2009,19194,11350,4075,1970,17395,1253,215,18863,331,20350,11350,4090,2005,17445,1530,510,19485,865,134128,20122,25605,24710,73154,39150,5420,122752,5121,3231949000,473153000,589171000,550057000,1634147000,930487000,170551000,2866660000,239153000
New Mexico,"Professional, Scientific, and Technical Services",2009,22407,15010,3075,1846,19931,1181,412,21524,883,24045,15010,3085,1900,19995,1310,515,21820,2225,190532,21517,19618,22325,66408,34995,18667,124418,65886,11111629000,990873000,836004000,1057305000,2940810000,2044097000,1223182000,6404222000,4940408000
New Mexico,Real Estate and Rental and Leasing,2009,9519,7185,1080,412,8677,326,159,9162,357,11620,7190,1120,470,8780,380,705,9865,1755,49724,9382,6531,4694,22296,6081,1282,33937,10722,1616046000,295608000,174800000,142446000,627573000,221586000,64287000,965046000,517971000
New Mexico,Retail Trade,2009,22750,11573,4369,2701,18643,1989,580,21212,1538,34740,11620,4500,2885,19005,3005,2225,24235,10505,395016,17788,26638,33212,81561,57596,27558,175033,155215,9256418000,473356000,629516000,828575000,1977257000,1631100000,825496000,4693251000,3948768000
New Mexico,Total,2009,36326,20365,6218,3992,30575,3352,859,34786,1540,44986,20389,6297,4158,30844,4289,2367,37500,7486,615879,35265,41082,53131,129478,119112,86090,334680,281199,21378606000,1064281000,1161404000,1569622000,3795307000,3769753000,2976443000,10541503000,10837103000
New Mexico,Transportation and Warehousing,2009,5629,3325,645,410,4380,445,204,5029,600,6680,3325,645,415,4385,490,265,5140,1540,78513,3043,3579,4347,14245,14006,4152,36059,24338,2576961000,129628000,99465000,129428000,379377000,396063000,148147000,1003196000,1070001000
New Mexico,Utilities,2009,737,455,70,45,570,70,15,655,82,1135,455,70,45,570,130,25,725,410,22494,913,403,420,1997,2810,0,5762,179,1535837000,19540000,8692000,23540000,56605000,154244000,0,256194000,8344000
New Mexico,Wholesale Trade,2009,8536,3295,1395,1000,5690,1071,451,7212,1324,9970,3295,1405,1040,5740,1245,620,7605,2365,102484,3444,7459,8691,23478,20913,8070,60281,36967,4621702000,218163000,306170000,356338000,980175000,831087000,354956000,2421436000,2076767000
New York,Accommodation and Food Services,2009,201414,107825,38675,27497,173997,23240,2843,200080,1334,229290,107865,38720,27690,174275,25260,7370,206905,22385,3018545,182894,255229,372495,812080,854651,445692,2113060,900242,60066730000,4279640000,3973111000,6069530000,14325390000,16290715000,9144359000,39773150000,20210006000
New York,Administrative and Support and Waste Management and Remediation Services,2009,114023,76510,13980,8432,98922,9205,3288,111415,2608,124565,76530,13995,8555,99080,9765,4230,113075,11490,2353206,104260,88895,110410,306721,356965,478313,1144587,1189560,95961089000,4922478000,3597116000,4642059000,13208059000,13779233000,14751105000,41817435000,53877068000
New York,"Agriculture, Forestry, Fishing and Hunting",2009,2910,2255,360,180,2795,75,20,2890,20,2920,2255,360,180,2795,80,25,2900,20,15461,3234,1957,2353,7951,3114,0,14349,445,476818000,88996000,57234000,69340000,221781000,108373000,0,431163000,17923000
New York,"Arts, Entertainment, and Recreation",2009,52891,36305,5965,4390,46660,4648,1047,52355,536,56055,36315,5980,4425,46720,4900,1410,53030,3025,763579,44528,38549,58477,142766,185985,159686,497073,250530,33262072000,4771621000,1562480000,2463044000,8808533000,6060151000,5738530000,20838092000,11957703000
New York,Construction,2009,228403,162810,31645,18459,212914,13248,1702,227864,539,229510,162810,31645,18490,212945,13415,1870,228230,1280,1598775,241372,205854,246330,694415,494137,261231,1458340,118072,93545050000,9571510000,8981515000,12573055000,31126080000,30797600000,19610126000,82134295000,10165095000
New York,Educational Services,2009,31985,15275,4052,3865,23192,6158,1663,31013,972,34935,15275,4065,3960,23300,6515,2485,32300,2635,1819025,22856,26844,52951,103650,247822,271028,623075,1188433,68407565000,884878000,621646000,1354684000,2869430000,7920615000,10246790000,21039220000,47176563000
New York,Finance and Insurance,2009,82663,51384,12393,6415,70192,6569,2818,79579,3084,145025,51480,12770,7240,71490,9385,8890,89765,55260,2710362,84696,78423,81436,246105,223096,314633,797401,1893781,417486279000,7668950000,7157210000,10068608000,24920435000,40523186000,56302516000,124104509000,292379858000
New York,Health Care and Social Assistance,2009,223782,122821,44595,24035,191451,18794,8382,218627,5155,275110,122990,45050,25125,193165,25055,25410,243630,31480,6823477,223285,291957,321411,841175,717722,1337279,2904399,3899753,298644684000,11276242000,12830275000,14866302000,38997615000,31102654000,44914260000,115129105000,182668274000
New York,Information,2009,37438,22048,4550,3540,30138,3966,1275,35379,2059,55200,22065,4565,3595,30225,4490,1690,36405,18795,1365189,26642,28188,44578,101286,137903,122683,375204,979575,117091730000,2175690000,1469100000,2260787000,6000533000,8724020000,8991873000,24232819000,92358073000
New York,Management of Companies and Enterprises,2009,9353,1090,290,291,1671,1588,2435,5694,3659,13935,1095,295,310,1700,1660,2645,6005,7930,860815,1128,54,2285,4248,25268,86167,116770,743787,101819260000,211245000,4516000,239193000,1788750000,2085496000,7692554000,12054570000,89730322000
New York,Manufacturing,2009,83925,37058,14382,11655,63095,14081,3727,80903,3022,86375,37060,14395,11720,63175,14440,4350,81965,4410,2199713,59176,89102,149242,312852,529387,422530,1340987,759782,102610821000,2356085000,3075463000,5487525000,11244718000,21775404000,18483620000,54329442000,42934744000
New York,"Mining, Quarrying, and Oil and Gas Extraction",2009,1458,730,265,140,1135,134,79,1348,110,1785,730,265,140,1135,160,155,1450,335,17584,1175,1342,1646,4208,2575,2558,11564,2155,1062416000,66231000,71696000,83137000,236127000,179826000,143174000,726183000,294253000
New York,Other,2009,934,885,37,10,932,2,0,934,0,934,885,37,10,932,2,0,934,0,0,0,0,112,0,0,0,0,0,30615000,22779000,6629000,1109000,30517000,0,0,30615000,0
New York,Other Services (except Public Administration),2009,249835,172630,41659,20597,234886,12082,1795,248763,1072,263545,172815,41920,21055,235790,14270,3960,254020,9525,1743265,298838,271739,268574,852908,424509,215040,1501083,178593,55320290000,7642422000,7382670000,7906382000,22968850000,14137700000,9131379000,46407630000,6784651000
New York,"Professional, Scientific, and Technical Services",2009,276009,199756,33860,19546,253162,15263,4037,272462,3547,290255,199825,33990,19875,253690,16945,5785,276420,13835,2900609,270884,217673,252345,764992,521690,417082,1708913,1149778,223498549000,15893145000,12262453000,15807834000,43999739000,37294141000,32724913000,114131509000,107346061000
New York,Real Estate and Rental and Leasing,2009,142253,109866,16630,8121,134617,5387,1222,141226,1027,157470,109975,16970,8800,135745,7525,3725,146995,10475,815047,164464,106103,105378,382378,178555,110343,675805,128292,40531760000,6023405000,4406647000,4624081000,15066696000,8978164000,6664323000,30801739000,9103673000
New York,Retail Trade,2009,286518,194651,46325,22814,263790,16570,2924,283284,3234,378890,194935,46950,24320,266205,22335,10535,299075,79815,4133227,297011,281960,270676,895996,548787,245874,1744360,2122443,109134400000,8595817000,7605590000,8066782000,24096324000,18705967000,8606232000,51884770000,52973054000
New York,Total,2009,441241,289137,67897,39595,396629,33026,7391,437046,4195,515819,289429,68468,40990,398887,39557,18864,457308,58511,7332392,472458,443164,527275,1442897,1236301,1114843,3794041,3538351,400789941000,19266018000,17298245000,21917203000,58481466000,59042248000,57541897000,175065611000,225724330000
New York,Transportation and Warehousing,2009,52724,32602,6897,4578,44077,4948,1836,50861,1863,59565,32635,6920,4650,44205,5440,2885,52530,7035,1121438,37939,43329,57769,150311,173229,158095,501004,600928,44727654000,1586911000,1525587000,2059009000,5276155000,6681698000,5599415000,18221365000,25782493000
New York,Utilities,2009,997,395,135,63,593,110,54,757,240,3040,395,135,70,600,135,275,1010,2030,199582,511,587,487,1986,3996,6108,12602,176537,18362222000,36179000,62587000,24581000,155780000,302628000,616187000,1146488000,16368231000
New York,Wholesale Trade,2009,154851,95570,23022,14300,132892,14281,4124,151297,3554,166955,95670,23165,14700,133535,16000,6625,156160,10795,1845951,155938,147723,183812,490216,476348,335489,1318445,437010,109161141000,7510275000,7290287000,9889262000,24700734000,27089769000,20531026000,72874990000,32497774000
North Carolina,Accommodation and Food Services,2009,66960,24880,13110,13495,51485,12734,1382,65601,1359,93315,24890,13160,13680,51730,14820,5650,72200,21115,1712949,39074,88395,183651,311781,443433,211719,968920,741964,23286942000,972730000,1097741000,2246897000,4318110000,5656760000,2782332000,12778885000,10477892000
North Carolina,Administrative and Support and Waste Management and Remediation Services,2009,49485,30091,7715,4380,42186,4123,1303,47612,1873,56585,30120,7735,4475,42330,4575,2010,48915,7670,1223056,48456,50271,56979,159087,152570,144685,466008,679644,33664359000,1448177000,1356885000,1594814000,4462581000,4082770000,3734912000,12529184000,19206161000
North Carolina,"Agriculture, Forestry, Fishing and Hunting",2009,3763,2370,815,390,3575,100,40,3715,48,3780,2370,815,390,3575,100,55,3730,50,20458,3984,4844,4849,14621,2432,449,19274,797,677204000,127054000,149468000,165260000,448269000,73720000,17568000,603931000,35020000
North Carolina,"Arts, Entertainment, and Recreation",2009,15680,8892,2360,1694,12946,2046,383,15375,305,16635,9010,2360,1720,13090,2185,535,15810,825,274693,11773,14947,22166,50777,76961,55398,188218,71964,7318682000,437596000,357109000,468397000,1283701000,1537970000,1605973000,4535024000,2490451000
North Carolina,Construction,2009,119839,79464,19210,11335,110009,8042,1015,119066,773,121480,79475,19215,11355,110045,8255,1300,119600,1880,986410,132979,124615,151245,410285,295620,130694,843590,130389,36501485000,3634205000,3547796000,4889790000,12072785000,10755010000,5837323000,28948215000,7224796000
North Carolina,Educational Services,2009,11099,5920,1575,1225,8720,1635,441,10796,303,11830,5920,1575,1225,8720,1705,665,11090,740,424720,8712,10084,16337,35762,66812,77425,181741,225623,14737225000,245201000,178699000,345103000,778361000,1590027000,2357926000,4759304000,9471778000
North Carolina,Finance and Insurance,2009,32320,21663,4242,1858,27763,1671,948,30382,1938,69875,21720,4445,2315,28480,4040,5175,37695,32180,831188,33672,24329,22868,83819,51375,65758,208699,567611,52716921000,1465975000,1111435000,1336277000,3976545000,2730148000,3757164000,10729613000,41036579000
North Carolina,Health Care and Social Assistance,2009,88230,37245,20448,13460,71153,12229,2919,86301,1929,112455,37295,20560,13800,71655,16010,9335,97000,15455,2692841,65167,136217,177272,379208,467621,430754,1283810,1365546,104701456000,3193220000,5576141000,6883653000,15661210000,15683829000,14279106000,45689592000,58247367000
North Carolina,Information,2009,8791,4505,1160,765,6430,939,438,7807,984,16935,4515,1165,775,6455,1280,890,8625,8310,383194,6223,6586,9944,24099,28183,32840,91195,264839,22117353000,257041000,261321000,391709000,927934000,1444594000,2108973000,4750218000,17207672000
North Carolina,Management of Companies and Enterprises,2009,5130,335,145,165,645,995,1392,3032,2098,7865,335,145,165,645,995,1495,3135,4730,379079,521,694,877,2227,11384,39290,52940,326409,32196943000,40121000,57556000,38745000,136422000,606999000,2320145000,3066745000,29141145000
North Carolina,Manufacturing,2009,42453,15350,6870,5544,27764,7525,2973,38262,4191,46510,15355,6875,5575,27805,7760,3665,39230,7280,2029714,23525,40019,66525,141033,279500,278944,753007,1185010,80871786000,867978000,1235366000,2175286000,4505045000,9572126000,9908438000,26052125000,50562251000
North Carolina,"Mining, Quarrying, and Oil and Gas Extraction",2009,570,255,65,85,405,47,36,488,82,1010,255,65,85,405,75,60,540,470,14020,133,167,885,1139,1478,1440,5265,8548,543033000,13018000,13279000,30070000,62593000,44503000,67340000,195276000,328566000
North Carolina,Other,2009,315,299,11,5,315,0,0,315,0,315,299,11,5,315,0,0,315,0,0,0,0,65,0,0,0,0,0,7297000,5677000,0,389000,7297000,0,0,7297000,0
North Carolina,Other Services (except Public Administration),2009,103226,66090,20876,9066,96032,5772,689,102493,733,110890,66125,21005,9490,96620,7550,2390,106560,4330,730346,123627,133835,116498,378481,198928,63790,651458,64751,16552864000,2635423000,2820467000,2655267000,8125505000,4384102000,1466961000,14220065000,1971276000
North Carolina,"Professional, Scientific, and Technical Services",2009,102641,72520,13281,7663,93464,5266,1595,100325,2316,111375,72550,13360,7875,93785,6535,2960,103280,8095,898073,104270,85567,98955,293626,160889,95865,561896,321523,55203741000,4538360000,3633601000,4567963000,12767245000,8979504000,6182262000,28342060000,26313727000
North Carolina,Real Estate and Rental and Leasing,2009,38359,30271,3585,1557,35413,1482,646,37541,818,51100,30370,3680,1870,35920,2830,3785,42535,8565,233502,40787,21727,18461,81947,40912,31978,164286,67488,8142289000,1323015000,687517000,595354000,2634465000,1473586000,1345722000,5653895000,2381873000
North Carolina,Retail Trade,2009,105746,61440,21022,10943,93405,7919,1670,102994,2752,173510,61600,21655,12745,96000,14320,7945,118265,55245,1900995,108076,130482,131780,373929,258863,116984,782308,1038580,43003354000,2503945000,3017038000,3496881000,9039165000,7665205000,3302212000,20427465000,21659485000
North Carolina,Total,2009,169798,100226,29242,18000,147468,15371,3547,166386,3412,218987,100402,29609,19005,149016,20388,10799,180203,38784,3353931,170059,191739,238880,600678,562116,422225,1585019,1768912,124323228000,5271361000,5553390000,7157606000,17982357000,17491512000,14977657000,50451526000,73871702000
North Carolina,Transportation and Warehousing,2009,22739,13703,2729,1805,18237,1837,907,20981,1758,26935,13720,2740,1915,18375,2025,1240,21640,5295,501950,16986,16350,22588,61224,52423,50065,171295,262866,18004697000,619835000,477407000,668518000,1797511000,1754227000,1765469000,5549851000,10088209000
North Carolina,Utilities,2009,747,265,95,75,435,115,75,625,122,2340,265,95,75,435,195,195,825,1515,82115,439,556,945,1993,6203,8585,16827,30600,6681103000,11442000,14417000,32204000,57631000,342826000,593867000,996578000,2616432000
North Carolina,Wholesale Trade,2009,48322,24568,7178,5151,36897,5459,2689,45045,3277,58935,24625,7340,5470,37435,6685,4645,48765,10170,841113,36625,44816,62050,150821,157595,128881,452462,343264,46324376000,1788961000,1968176000,2772262000,6600323000,7357727000,6632118000,20993151000,23735228000
North Dakota,Accommodation and Food Services,2009,7759,2880,1465,1345,5690,1613,307,7610,149,8945,2880,1470,1350,5700,1860,785,8345,600,157657,4661,9873,18653,33490,58457,37638,130120,5994,1936547000,79099000,85355000,187903000,354576000,688336000,501588000,1546212000,269257000
North Dakota,Administrative and Support and Waste Management and Remediation Services,2009,4171,2460,690,367,3517,255,105,3877,294,4585,2460,690,380,3530,285,210,4025,560,53113,2870,3748,3764,11702,5938,8109,29745,19088,1386802000,106136000,92785000,98757000,321119000,109279000,194701000,723926000,495372000
North Dakota,"Agriculture, Forestry, Fishing and Hunting",2009,615,490,55,40,585,20,0,605,10,625,490,55,40,585,20,0,605,20,2172,510,311,0,1202,0,0,179,0,75400000,24634000,10226000,0,48215000,0,0,60625000,0
North Dakota,"Arts, Entertainment, and Recreation",2009,1976,1225,285,175,1685,210,56,1951,25,2125,1225,285,175,1685,280,135,2100,25,20105,1037,1529,1394,4958,5681,6471,18229,0,311766000,39071000,22485000,16739000,97225000,70243000,70279000,275017000,0
North Dakota,Construction,2009,12323,8275,1995,1134,11404,760,79,12243,80,12425,8275,1995,1135,11405,795,115,12315,110,84307,11363,11978,14279,39882,27933,4343,77017,2741,4404390000,486195000,521953000,641302000,1669715000,1481211000,226332000,3688415000,309428000
North Dakota,Educational Services,2009,705,290,90,65,445,165,45,655,50,735,290,90,70,450,170,45,665,70,20932,61,323,694,1797,6698,5223,13754,0,417461000,9907000,6206000,8957000,27915000,134082000,118968000,280812000,43912000
North Dakota,Finance and Insurance,2009,5295,3475,470,380,4325,393,143,4861,434,8485,3480,495,560,4535,1190,930,6655,1830,78888,2959,2882,4478,13242,11669,12577,39881,35928,3647783000,183780000,106284000,184755000,494887000,484524000,614740000,1752726000,1829918000
North Dakota,Health Care and Social Assistance,2009,7519,3430,1430,990,5850,903,480,7233,286,8950,3435,1435,1030,5900,1170,1060,8130,820,262812,5097,8341,11568,25824,33941,56215,124212,106524,9723820000,220352000,293459000,408163000,968050000,880082000,1389568000,3472153000,4495619000
North Dakota,Information,2009,1120,290,195,198,683,200,67,950,170,1770,290,195,225,710,300,75,1085,685,36435,157,795,1671,3159,7599,3221,17445,10958,1689569000,9209000,26466000,60872000,108833000,317003000,154040000,650075000,632369000
North Dakota,Management of Companies and Enterprises,2009,467,25,15,30,70,115,125,310,157,495,25,15,30,70,115,135,320,175,42355,0,0,0,250,769,2250,3380,39077,1564080000,0,0,1154000,27565000,39207000,125831000,200205000,1304497000
North Dakota,Manufacturing,2009,3438,1255,590,470,2315,608,227,3150,288,3685,1255,590,470,2315,660,275,3250,435,86247,1027,2609,3560,9120,13427,10720,45104,22225,3240660000,46923000,80457000,122829000,303301000,470166000,386161000,1571967000,911089000
North Dakota,"Mining, Quarrying, and Oil and Gas Extraction",2009,1126,440,120,140,700,175,45,920,206,1225,440,120,140,700,175,70,945,280,31088,554,622,1517,2985,6420,624,12485,17061,2308759000,33197000,29064000,104432000,176529000,497203000,79158000,835629000,1357877000
North Dakota,Other,2009,32,31,1,0,32,0,0,32,0,32,31,1,0,32,0,0,32,0,0,0,0,0,0,0,0,0,0,672000,661000,0,0,672000,0,0,672000,0
North Dakota,Other Services (except Public Administration),2009,11429,7472,2160,1001,10633,573,50,11256,173,11885,7480,2175,1040,10695,795,70,11560,325,62760,12274,13057,11874,38820,16486,312,59429,1814,1286496000,268797000,276744000,231983000,806831000,294962000,9748000,1168419000,51704000
North Dakota,"Professional, Scientific, and Technical Services",2009,7079,4680,1015,620,6315,402,142,6859,220,7540,4680,1015,630,6325,595,215,7135,405,51288,6531,5340,7471,20799,10878,3983,38943,7651,2355855000,257647000,221232000,346269000,847654000,565797000,272736000,1813687000,368476000
North Dakota,Real Estate and Rental and Leasing,2009,3471,2535,355,190,3080,158,91,3329,142,3820,2535,355,195,3085,210,260,3555,265,18142,2814,1710,1744,6794,2278,1882,15066,230,535902000,92643000,49876000,49997000,211561000,99970000,40750000,417278000,58079000
North Dakota,Retail Trade,2009,12317,5389,2616,1711,9716,1342,401,11459,858,16160,5400,2695,1850,9945,1850,1090,12885,3275,213632,7961,14931,20232,46484,36542,23715,112692,67500,4758946000,213376000,344832000,508641000,1122335000,1024480000,594882000,2911693000,1338853000
North Dakota,Total,2009,17845,9994,3004,1956,14954,1734,449,17137,708,21445,10003,3044,2082,15129,2478,1290,18897,2548,296083,16520,19797,26045,62362,62782,53180,178324,117759,10045929000,490525000,545672000,767876000,1804073000,1933932000,1613941000,5351946000,4693983000
North Dakota,Transportation and Warehousing,2009,5061,3285,629,305,4219,342,161,4722,339,5595,3290,630,305,4225,385,245,4855,740,52888,2713,3321,3570,12358,10234,11155,35445,14972,2027849000,153368000,118674000,116774000,410960000,348308000,477310000,1303053000,621929000
North Dakota,Utilities,2009,189,45,5,15,65,70,15,150,39,575,45,5,20,70,105,50,225,350,4108,0,0,94,237,2670,0,6985,0,235089000,0,0,4262000,8203000,170755000,0,334428000,0
North Dakota,Wholesale Trade,2009,5516,1885,865,658,3408,979,399,4786,730,7440,1885,905,765,3555,1430,685,5670,1770,88569,2286,4543,6822,15267,21530,10289,54681,23785,4150519000,117611000,205570000,330313000,721122000,1065654000,479007000,2522251000,1412031000
Ohio,Accommodation and Food Services,2009,83109,32394,16200,15611,64205,15425,2031,81661,1448,115795,32490,16235,15885,64610,18595,8745,91950,23845,2156715,52620,108438,212140,374552,560782,295622,1232581,904907,26872035000,1014412000,1114936000,2278313000,4415440000,6805249000,3384677000,14617280000,12114208000
Ohio,Administrative and Support and Waste Management and Remediation Services,2009,57596,33650,8560,5877,48087,5459,1845,55391,2205,67965,33655,8580,5970,48205,5895,2700,56800,11165,1507414,46008,53155,78365,182111,206484,234988,633634,843295,42337950000,1767198000,1532933000,2220029000,5534182000,5705845000,5566709000,16940812000,24330656000
Ohio,"Agriculture, Forestry, Fishing and Hunting",2009,1185,830,180,75,1085,45,25,1155,30,1205,830,180,75,1085,45,25,1155,50,4970,790,1044,440,3048,980,0,4621,615,164959000,32859000,26523000,18396000,87899000,28065000,0,142170000,24886000
Ohio,"Arts, Entertainment, and Recreation",2009,18116,9900,3115,2205,15220,2113,473,17806,310,19375,9900,3125,2225,15250,2270,740,18260,1115,292793,14693,19823,28283,64482,81811,63524,213383,67105,8870725000,552719000,397503000,485027000,1483475000,1552459000,3538379000,6638526000,1750803000
Ohio,Construction,2009,106626,70920,17107,9943,97970,7090,941,106001,625,108030,70920,17110,9970,98000,7385,1240,106625,1405,894665,110856,110715,131408,354320,258019,124735,745220,145732,42634930000,4027230000,4062995000,5629375000,13724490000,12509505000,6944918000,33544695000,8923966000
Ohio,Educational Services,2009,12993,5360,2075,1702,9137,2777,611,12525,468,14505,5360,2100,1725,9185,3120,860,13165,1340,552835,8033,13889,23015,46313,115962,89069,255270,295162,14583527000,239150000,239779000,438051000,922889000,2926846000,2656421000,6611185000,7883952000
Ohio,Finance and Insurance,2009,44058,28920,6408,2946,38274,2783,879,41936,2122,90620,28955,6710,3735,39400,6325,3950,49675,40945,1233353,50511,39021,37388,130065,97957,75969,306359,910068,73398620000,1856775000,1742573000,1894784000,5526606000,4961041000,3418478000,14148860000,59106430000
Ohio,Health Care and Social Assistance,2009,104035,41255,25694,15478,82427,13815,5117,101359,2676,138405,41405,25985,16450,83840,19345,15085,118270,20135,3891940,82416,169600,204563,459239,538557,759893,1763761,2114320,152149818000,3598937000,6622837000,8542768000,18806162000,20196483000,22065219000,61246174000,90553740000
Ohio,Information,2009,9190,3805,1455,1089,6349,1269,430,8048,1142,19850,3805,1460,1115,6380,1425,820,8625,11225,468803,4488,8628,13746,29358,42965,34975,114202,310206,25876233000,240061000,307438000,539146000,1143973000,2144090000,1628544000,5266780000,18917114000
Ohio,Management of Companies and Enterprises,2009,6765,355,130,300,785,1325,1916,4026,2739,11370,360,130,300,790,1330,1960,4080,7290,718835,443,497,1860,2855,14005,51808,68985,649739,59541640000,39650000,54315000,108800000,202765000,776865000,3432255000,4411885000,55129755000
Ohio,Manufacturing,2009,70579,22029,12550,10899,45478,14501,5186,65165,5414,76060,22030,12560,10975,45565,15310,6525,67400,8660,3088579,38518,77966,138726,266524,540466,574450,1453391,1480872,143235226000,1401512000,2514399000,4986277000,9178001000,21553919000,24725534000,58126938000,76538173000
Ohio,"Mining, Quarrying, and Oil and Gas Extraction",2009,3183,1610,585,407,2602,289,117,3008,175,3840,1615,585,415,2615,320,245,3180,660,48350,2845,3780,5102,11895,7731,7176,28415,19359,2485596000,111545000,160177000,209369000,487636000,361654000,349803000,1246599000,1203041000
Ohio,Other,2009,271,248,19,4,271,0,0,271,0,271,248,19,4,271,0,0,271,0,0,0,118,55,0,0,0,0,0,6128000,4639000,1240000,249000,6128000,0,0,6128000,0
Ohio,Other Services (except Public Administration),2009,126281,72348,29695,13829,115872,8265,1119,125256,1025,142110,72440,30060,14505,117005,10875,3000,130880,11230,1041211,142694,192573,179599,518954,269697,99282,895964,114753,24399297000,2942089000,3766856000,3734526000,10460724000,6275051000,2713901000,19678084000,3770785000
Ohio,"Professional, Scientific, and Technical Services",2009,111597,73573,16485,9622,99680,7326,2183,109189,2408,121750,73625,16530,9945,100100,8600,3400,112100,9650,1149200,116748,106936,124589,350782,246233,172625,777791,354878,65052349000,4649333000,4604761000,5843919000,15139850000,13582437000,10699387000,39664708000,25095118000
Ohio,Real Estate and Rental and Leasing,2009,35451,24857,4686,2334,31877,1887,802,34566,885,50350,24885,4890,2825,32600,3075,3610,39285,11065,303075,37617,28569,29688,99291,55858,40358,202189,88408,10758355000,1129079000,865706000,1003200000,3000335000,2042067000,1532594000,6763050000,3525221000
Ohio,Retail Trade,2009,109736,58491,23138,12880,94509,10090,2244,106843,2893,187950,58665,23745,14500,96910,15895,9725,122530,65420,2755748,95538,142516,156859,403411,351391,192915,977500,1660644,62007949000,2268543000,3085768000,3856973000,9319744000,9739070000,5481089000,24820187000,35708461000
Ohio,Total,2009,192796,104867,36383,22898,164148,20163,4788,189099,3697,256551,105060,36877,24295,166232,26756,14170,207158,49393,4460553,185716,239798,306139,731653,758540,649999,2140192,2320361,171930795000,5824223000,6998812000,9573918000,22396953000,25624309000,23305870000,71327132000,100603663000
Ohio,Transportation and Warehousing,2009,29248,15690,4309,2949,22948,2854,1135,26937,2311,35815,15715,4350,3025,23090,3330,1640,28060,7755,755497,23345,26838,37655,89071,93185,65205,257131,492585,29408606000,814353000,820210000,1206416000,2876895000,3311086000,2185743000,8556301000,20678685000
Ohio,Utilities,2009,841,280,103,55,438,220,60,718,123,3285,280,105,55,440,300,115,855,2430,2894,276,403,162,1748,7245,1972,14373,0,1189717000,16208000,30036000,6684000,81488000,468436000,126570000,849767000,16162000
Ohio,Wholesale Trade,2009,59314,27050,9698,7334,44082,8034,3414,55530,3784,73120,27125,9850,7760,44735,10340,6465,61540,11580,1085663,43681,62779,93566,205624,253005,204857,678408,382831,55843575000,2079792000,2711105000,4300175000,9163125000,11872054000,10027847000,31529410000,23506975000
Oklahoma,Accommodation and Food Services,2009,25343,9455,4820,4379,18654,5247,681,24582,761,35215,9460,4830,4420,18710,6160,2680,27550,7665,666879,14867,32058,59751,107742,194081,96073,400903,265583,8164296000,304234000,329453000,631834000,1271051000,2232693000,1122992000,4657234000,3497749000
Oklahoma,Administrative and Support and Waste Management and Remediation Services,2009,19931,12035,3010,1825,16870,1438,555,18863,1068,22060,12035,3020,1860,16915,1575,865,19355,2705,442032,17909,17456,22023,60013,49026,69073,192490,231149,11393967000,552751000,463038000,582856000,1631294000,1471973000,1514821000,4829213000,6105593000
Oklahoma,"Agriculture, Forestry, Fishing and Hunting",2009,756,510,125,80,715,10,11,736,20,765,510,125,80,715,10,20,745,20,4151,565,757,902,2420,0,0,3869,0,129267000,18574000,18005000,29860000,69977000,0,0,114297000,0
Oklahoma,"Arts, Entertainment, and Recreation",2009,5051,2800,775,540,4115,593,232,4940,111,5390,2805,775,550,4130,640,320,5090,300,137259,4066,4466,6920,16315,21638,36720,77946,1176,3135096000,115237000,88126000,93352000,311954000,376732000,910234000,1732329000,26331000
Oklahoma,Construction,2009,41485,25790,7505,4520,37815,3005,338,41158,327,41740,25790,7505,4520,37815,3030,370,41215,525,362962,41967,47860,59650,151769,110308,40643,309372,50170,14189830000,1265470000,1400475000,2010935000,4680160000,4224826000,1840276000,10920595000,3123058000
Oklahoma,Educational Services,2009,3246,1535,495,420,2450,470,178,3098,148,3480,1535,495,425,2455,490,255,3200,280,94080,1656,3137,4517,10804,16152,19922,49022,42432,2316956000,51779000,61840000,87672000,210207000,402202000,547695000,1212080000,1012108000
Oklahoma,Finance and Insurance,2009,20058,13875,2200,1074,17149,1350,490,18989,1069,33680,13915,2295,1410,17620,3325,2865,23810,9870,307175,23081,12555,13438,50313,49206,48323,154186,139328,14223000000,794656000,499281000,595163000,1932544000,2191570000,2073213000,6534714000,7429033000
Oklahoma,Health Care and Social Assistance,2009,41442,20305,9270,4813,34388,4629,1425,40442,1000,52080,20340,9285,4890,34515,6175,5470,46160,5920,1031561,36325,59477,61874,160428,195673,194369,558280,449378,37887216000,2014873000,2358291000,2240212000,6652690000,6073718000,5856742000,18793653000,18464431000
Oklahoma,Information,2009,4118,1730,665,609,3004,414,188,3606,512,7850,1730,670,625,3025,510,465,4000,3850,150213,1735,3349,7707,13288,12574,4463,37338,96894,6695504000,104529000,129581000,271128000,524442000,610952000,291669000,1699378000,4350380000
Oklahoma,Management of Companies and Enterprises,2009,2239,175,55,90,320,465,611,1396,843,2880,180,55,90,325,470,655,1450,1430,144390,0,228,436,852,4794,12690,18645,125711,11387220000,405000,13452000,25885000,57891000,256151000,855455000,1188640000,10197296000
Oklahoma,Manufacturing,2009,17501,6390,3155,2633,12178,2826,931,15935,1566,18710,6390,3155,2635,12180,2985,1105,16270,2440,593887,8692,17103,29836,62404,92100,76746,260689,293688,24532560000,329362000,531113000,968887000,1983995000,3411844000,3234289000,9819482000,13291254000
Oklahoma,"Mining, Quarrying, and Oil and Gas Extraction",2009,12588,7880,1774,1044,10698,1078,311,12087,501,13975,7880,1775,1050,10705,1120,465,12290,1685,217812,8177,11535,13530,38646,37037,26363,102665,114500,14914519000,528696000,538857000,655233000,1726071000,1914571000,1652391000,5318680000,9571352000
Oklahoma,Other,2009,125,116,7,2,125,0,0,125,0,125,116,7,2,125,0,0,125,0,0,0,47,0,0,0,0,0,0,2319000,1589000,600000,0,2319000,0,0,2319000,0
Oklahoma,Other Services (except Public Administration),2009,41821,26081,8510,3868,38459,2528,397,41384,437,44470,26120,8575,4015,38710,3140,760,42610,1860,307626,48141,53537,49212,154274,85057,32805,282285,13909,6598590000,945698000,1101174000,1055811000,3133171000,1758510000,788981000,5900922000,462011000
Oklahoma,"Professional, Scientific, and Technical Services",2009,43294,30610,6130,3070,39810,1983,580,42373,921,45900,30635,6165,3175,39975,2320,805,43100,2800,318326,46200,37769,38881,121878,63551,48304,244891,67028,16216261000,1806435000,1478284000,1669551000,5023070000,3407942000,2887605000,11549872000,4529635000
Oklahoma,Real Estate and Rental and Leasing,2009,15936,12186,1585,763,14534,673,233,15440,496,19725,12220,1635,930,14785,1090,500,16375,3350,107799,8584,10092,9473,38366,20514,9355,72071,29410,3607011000,505781000,288543000,290275000,1091970000,612031000,282861000,2143467000,1154278000
Oklahoma,Retail Trade,2009,43279,22639,9296,5332,37267,3448,839,41554,1725,65345,22695,9545,5860,38100,5040,3345,46485,18860,705332,38959,58175,65406,169226,106946,50749,343313,315696,15827377000,901080000,1227689000,1565921000,3740123000,3103125000,1466147000,8678848000,6583461000
Oklahoma,Total,2009,72243,41831,12757,7619,62207,6467,1582,70256,1987,90347,41896,12897,8005,62798,8498,4714,76010,14337,1290278,73193,83229,101233,257655,243602,189759,691016,599262,45238063000,2272052000,2346667000,2953737000,7572456000,7554951000,6559276000,21686683000,23551380000
Oklahoma,Transportation and Warehousing,2009,11261,6480,1470,877,8827,969,374,10170,1091,13155,6480,1475,885,8840,1095,555,10490,2665,186727,8853,8950,8916,29436,29620,20620,83802,81223,7169442000,275600000,257379000,299529000,866623000,1050282000,744337000,2753185000,3780345000
Oklahoma,Utilities,2009,700,290,80,20,390,130,75,595,105,1735,290,80,20,390,180,190,760,975,45779,628,198,276,1312,7334,1404,15105,1879,3539446000,17633000,16669000,12539000,43223000,401322000,353081000,965694000,160956000
Oklahoma,Wholesale Trade,2009,18707,7880,2925,2426,13231,2475,1192,16898,1809,22955,7890,2990,2575,13455,3135,1880,18470,4485,288535,11769,17011,29666,61403,66944,40214,183687,87210,13596030000,550939000,711352000,1222393000,2549707000,2820731000,1900674000,7796673000,4680851000
Oregon,Accommodation and Food Services,2009,40806,14370,9866,9146,33382,6039,757,40178,628,51020,14380,9925,9400,33705,7970,3175,44850,6170,726065,23504,65396,122299,211679,202083,98089,519826,201001,11187225000,470725000,804177000,1655701000,2943487000,3094840000,1436331000,7515374000,3638839000
Oregon,Administrative and Support and Waste Management and Remediation Services,2009,23631,14700,3602,1952,20254,1921,538,22713,918,26345,14700,3620,2005,20325,2180,935,23440,2905,366993,21541,21976,24601,71656,66372,61327,208037,139519,10646956000,615631000,579519000,683259000,1903918000,2053029000,1596227000,5706505000,4386609000
Oregon,"Agriculture, Forestry, Fishing and Hunting",2009,6136,4095,775,575,5445,550,95,6090,46,6280,4105,775,575,5455,590,140,6185,95,51725,3041,5194,7606,18838,19441,6685,49125,2542,1754230000,225692000,192238000,240368000,665282000,597157000,210690000,1597623000,150414000
Oregon,"Arts, Entertainment, and Recreation",2009,7688,4425,1175,855,6455,944,152,7551,137,8130,4425,1185,855,6465,1095,215,7775,355,112588,3880,7180,11509,24605,34606,10303,83573,20596,2410359000,195888000,139439000,200952000,549136000,589428000,259611000,1638516000,443583000
Oregon,Construction,2009,62049,45285,8750,4204,58239,2976,407,61622,427,62560,45285,8750,4210,58245,3135,470,61850,710,381555,63730,54461,54599,181584,109509,34573,332046,37153,17223325000,2057274000,1765385000,2250066000,6080480000,5436611000,1901413000,13705565000,2574668000
Oregon,Educational Services,2009,6286,3110,1030,865,5005,860,245,6110,176,6900,3110,1035,885,5030,960,645,6635,265,204594,4296,5262,10924,22629,33430,40155,97088,105188,5377404000,122630000,124162000,211999000,466386000,748544000,948138000,2179073000,3120145000
Oregon,Finance and Insurance,2009,17473,11815,2017,854,14686,897,602,16185,1288,31170,11835,2110,1020,14965,1870,2275,19110,12060,306136,19406,11557,9091,42324,30040,38006,114611,184136,18399468000,701381000,479006000,537736000,1778586000,1732761000,1959638000,5650498000,12474097000
Oregon,Health Care and Social Assistance,2009,47159,25325,10100,5227,40652,4001,1551,46204,955,58360,25350,10135,5440,40925,5730,5645,52300,6060,1010086,43141,66129,67621,177948,154163,175712,523335,449205,43935901000,1944587000,2568205000,2685779000,7224265000,5710192000,6109818000,19517550000,23310309000
Oregon,Information,2009,6338,3235,921,656,4812,605,279,5696,642,9740,3250,940,685,4875,640,655,6170,3570,182227,3905,5456,7026,18403,20670,18395,64186,105234,9859859000,212168000,227805000,340074000,789999000,1106002000,1099004000,3265710000,6246694000
Oregon,Management of Companies and Enterprises,2009,2483,140,40,105,285,545,751,1581,902,3185,140,40,105,285,545,810,1640,1545,190453,200,145,428,800,5460,20631,26941,163512,15393075000,12030000,5015000,17834000,36170000,265148000,1137769000,1439087000,13953988000
Oregon,Manufacturing,2009,25592,11090,4356,3499,18945,3816,1283,24044,1548,26900,11090,4360,3535,18985,3985,1570,24540,2360,700917,15320,24166,41417,90722,127634,95337,367555,255820,31524976000,616481000,794406000,1436199000,3075303000,4910417000,4075472000,14120990000,13637559000
Oregon,"Mining, Quarrying, and Oil and Gas Extraction",2009,575,280,115,60,455,60,10,525,50,700,280,115,60,455,65,10,530,170,6289,342,753,659,1859,116,0,3614,581,344349000,17413000,31504000,25754000,75253000,4322000,0,149123000,118680000
Oregon,Other,2009,226,221,4,1,226,0,0,226,0,226,221,4,1,226,0,0,226,0,0,0,20,0,0,0,0,0,0,3163000,3052000,90000,0,3163000,0,0,3163000,0
Oregon,Other Services (except Public Administration),2009,42668,26470,8982,4030,39482,2396,360,42238,430,46800,26490,9030,4240,39760,3290,1900,44950,1850,306436,48890,57911,50217,159647,78782,24140,270693,21691,7443526000,1108413000,1268749000,1220772000,3614727000,1911492000,695158000,6453604000,731461000
Oregon,"Professional, Scientific, and Technical Services",2009,54895,39210,6970,3886,50066,2632,851,53549,1346,57600,39230,6985,3980,50195,2920,1195,54310,3290,398911,54966,44117,49933,154489,76211,41641,279897,90800,21341570000,2440958000,1842667000,2287664000,6603807000,4512767000,2654804000,13985965000,6683660000
Oregon,Real Estate and Rental and Leasing,2009,23269,18202,2290,1042,21534,827,391,22752,517,28610,18260,2345,1250,21855,1260,1835,24950,3660,135790,24780,14255,11727,53593,24287,20339,98986,26710,4170344000,698030000,409048000,350125000,1496543000,716650000,612409000,2915476000,976463000
Oregon,Retail Trade,2009,48108,25348,10082,5655,41085,3923,1176,46184,1924,70425,25450,10280,6335,42065,6730,4750,53545,16880,909875,41173,62526,65034,175364,125563,77834,399406,458478,22736427000,991449000,1343333000,1665196000,4009171000,3537915000,2341840000,10208556000,11520059000
Oregon,Total,2009,88753,53489,15169,9199,77857,7055,1769,86681,2072,108040,53562,15322,9689,78573,9556,5864,93993,14047,1363826,89214,99843,122167,311224,254595,201190,767009,596817,53367462000,2748232000,2809629000,3654383000,9212244000,8717104000,7262487000,25191835000,28175627000
Oregon,Transportation and Warehousing,2009,13021,7425,1717,1185,10327,1097,537,11961,1060,14960,7430,1740,1245,10415,1195,705,12315,2645,241779,7193,9576,14364,36557,31327,26900,101415,104870,9291121000,319922000,322720000,439479000,1111074000,1187181000,986614000,3440827000,4602905000
Oregon,Utilities,2009,612,340,45,25,410,85,35,530,82,1335,340,45,25,410,145,40,595,740,34967,621,0,238,1287,3823,0,6791,13188,2845033000,11122000,9960000,19096000,57553000,284054000,38369000,400993000,1134290000
Oregon,Wholesale Trade,2009,23614,11540,3111,2507,17158,2832,1448,21438,2176,28050,11555,3175,2590,17320,3475,2350,23145,4905,360866,16794,17593,25401,68379,76496,51751,214570,128544,19971680000,762937000,824641000,1391946000,3090152000,3542290000,2590978000,9964152000,9548683000
Pennsylvania,Accommodation and Food Services,2009,107999,50048,21901,16956,88905,15874,1951,106730,1269,136275,50110,21990,17135,89235,17805,5925,112965,23310,2097759,86625,144804,230133,462413,576187,257303,1297760,796772,29917382000,1597870000,1682412000,2652420000,5938965000,7408587000,3515209000,16877140000,12997139000
Pennsylvania,Administrative and Support and Waste Management and Remediation Services,2009,64419,38775,9608,6074,54457,5712,1981,62150,2269,73660,38780,9635,6150,54565,6230,3195,63990,9670,1341438,54789,61813,81662,201825,224031,258616,691476,603937,39340369000,2149270000,1980484000,2466108000,6601023000,7172306000,6207285000,20165221000,18491062000
Pennsylvania,"Agriculture, Forestry, Fishing and Hunting",2009,2460,1945,300,95,2340,75,25,2440,20,2465,1945,300,95,2340,75,25,2440,25,13730,1592,1825,659,5988,1839,804,10429,186,353787000,75364000,47308000,28432000,157749000,55752000,29557000,310067000,27499000
Pennsylvania,"Arts, Entertainment, and Recreation",2009,21501,11595,3535,2450,17580,2955,600,21135,366,22690,11600,3540,2470,17610,3225,820,21655,1035,414439,14686,22919,31516,71840,118480,79228,275254,117769,12194480000,573812000,494987000,672393000,1884145000,2215509000,2143520000,7020409000,4627404000
Pennsylvania,Construction,2009,136276,91795,21615,11958,125368,8892,1280,135540,736,137520,91795,21620,11980,125395,9080,1565,136040,1480,1168130,146102,140216,159075,445975,326479,181248,959850,182258,58681910000,5142980000,5317405000,7080675000,17541060000,17771705000,10547488000,46126925000,11629806000
Pennsylvania,Educational Services,2009,15426,6125,2340,1945,10410,3455,875,14740,686,17390,6125,2340,2040,10505,3775,1420,15700,1690,1205085,8819,15470,26497,51765,151604,132530,339720,864022,43361965000,283733000,320264000,560484000,1171152000,4263399000,4512491000,10050155000,33273682000
Pennsylvania,Finance and Insurance,2009,48033,29948,7882,3292,41122,3055,1426,45603,2430,93690,30025,8170,3875,42070,5875,6820,54765,38925,1349768,48937,48269,41755,144384,101999,126953,382333,927552,91246591000,2295819000,2474722000,2688338000,7493752000,6922242000,7699845000,22430951000,64837868000
Pennsylvania,Health Care and Social Assistance,2009,130029,58220,29067,18463,105750,15091,5457,126298,3731,179805,58460,29370,19515,107345,22165,19395,148905,30900,4584219,115095,191525,245721,553555,564577,819679,1943438,2638847,183860035000,4543359000,7213386000,10240818000,22026500000,22244650000,25989566000,70322486000,113439090000
Pennsylvania,Information,2009,13091,5825,2145,1540,9510,1692,633,11835,1256,25250,5825,2160,1625,9610,2035,1050,12695,12555,602080,7931,14095,19162,43806,58616,52513,163843,434256,39029545000,395822000,523485000,727013000,1683704000,2929234000,3041134000,7933016000,30879721000
Pennsylvania,Management of Companies and Enterprises,2009,6886,335,115,275,725,1177,1992,3894,2992,10985,335,125,275,735,1205,2235,4175,6810,715340,107,24,1971,3100,15900,64246,83345,631995,68813495000,58471000,3612000,168774000,504185000,1055753000,4340704000,5905815000,62907680000
Pennsylvania,Manufacturing,2009,68156,22365,11774,10547,44686,13889,4640,63215,4941,72595,22370,11775,10605,44750,14540,5670,64960,7635,2750439,38343,72667,133284,259126,525994,512144,1349920,1238821,127719449000,1467597000,2369830000,4984423000,9119844000,21414566000,21965198000,54678827000,64250024000
Pennsylvania,"Mining, Quarrying, and Oil and Gas Extraction",2009,4140,1905,730,470,3105,560,196,3861,279,5180,1905,730,470,3105,635,360,4100,1080,101848,2412,4606,5697,14245,19283,16057,50593,50349,6507968000,176326000,178796000,260537000,631439000,965580000,882436000,2516918000,3938529000
Pennsylvania,Other,2009,297,279,15,3,297,0,0,297,0,297,279,15,3,297,0,0,297,0,0,0,100,0,0,0,0,0,0,8153000,5422000,2190000,0,8153000,0,0,8153000,0
Pennsylvania,Other Services (except Public Administration),2009,164678,102807,35104,15422,153333,9164,1214,163711,967,176085,102920,35290,15975,154185,11090,2990,168265,7820,1203482,201592,225319,200199,630518,318256,114153,1074556,100572,28581080000,4231590000,4573256000,4405090000,13219066000,7587380000,3789435000,24769030000,3102770000
Pennsylvania,"Professional, Scientific, and Technical Services",2009,136519,90948,19007,11797,121752,9347,2408,133507,3012,147530,90995,19105,12090,122190,11295,3670,137155,10375,1567029,139000,122340,154023,422985,318850,207653,957062,583995,106775400000,6700508000,6132706000,8774007000,21633865000,20154158000,14815454000,56875390000,48939371000
Pennsylvania,Real Estate and Rental and Leasing,2009,35014,23447,5146,2650,31243,1977,834,34054,960,46345,23490,5390,3125,32005,3105,2275,37385,8960,306231,36248,32758,33475,106191,62203,46886,220183,75240,12372240000,1322880000,1141528000,1270347000,3753597000,2720905000,1996777000,8602435000,3365588000
Pennsylvania,Retail Trade,2009,138386,75593,27835,16033,119461,12775,2937,135173,3213,223675,75820,28435,17860,122115,18885,10730,151730,71945,3102429,121322,163024,189722,480457,441785,278940,1236524,1574219,71609940000,3081314000,3809481000,4887136000,11847892000,13303183000,7435532000,33129654000,36291279000
Pennsylvania,Total,2009,232755,132060,42623,26124,200807,22711,5282,228800,3955,298432,132279,43104,27461,202844,29083,15164,247091,51341,5044648,234792,279506,349102,863400,855877,725881,2445158,2599490,209778064000,7564665000,8639326000,11875676000,28079667000,31435680000,27871911000,87387258000,122390806000
Pennsylvania,Transportation and Warehousing,2009,32950,17120,4701,3579,25400,3880,1347,30627,2323,39405,17135,4710,3645,25490,4295,1740,31525,7880,927798,25109,29152,45212,103921,132939,106929,353006,553845,31657648000,798025000,848276000,1392757000,3073686000,3876287000,3207420000,10399092000,20675822000
Pennsylvania,Utilities,2009,951,325,115,85,525,127,45,697,254,3870,325,120,85,530,190,115,835,3035,153449,523,402,778,2165,4934,218,9866,141227,14713897000,24216000,15701000,42191000,95609000,338992000,15648000,609001000,13802790000
Pennsylvania,Wholesale Trade,2009,64163,30007,10537,7924,48468,8316,3440,60224,3939,76260,30040,10640,8275,48955,9910,5820,64685,11575,1192201,48406,66088,98728,220571,263584,208204,717407,444068,67902288000,2576054000,3298612000,5014490000,10948864000,13424042000,10244615000,35868857000,30900713000
Rhode Island,Accommodation and Food Services,2009,12656,5325,2324,2410,10059,2052,202,12313,343,14600,5330,2335,2430,10095,2330,595,13020,1580,206157,8299,15147,33250,57072,70781,25970,154692,51411,3230478000,233581000,208930000,432305000,880785000,1067618000,408070000,2379638000,850198000
Rhode Island,Administrative and Support and Waste Management and Remediation Services,2009,8147,5430,845,610,6885,595,198,7678,469,8500,5430,850,610,6890,605,210,7705,795,103837,4723,4430,7092,18468,19756,20518,63468,32902,2844203000,316884000,151814000,215622000,711905000,574797000,377662000,1841757000,847146000
Rhode Island,"Agriculture, Forestry, Fishing and Hunting",2009,215,195,10,5,210,5,0,215,0,215,195,10,5,210,5,0,215,0,199,42,0,0,66,0,0,199,0,14466000,8213000,0,0,8981000,0,0,14466000,0
Rhode Island,"Arts, Entertainment, and Recreation",2009,2529,1365,430,312,2107,297,60,2464,65,2710,1365,430,315,2110,300,165,2575,135,34040,1286,2550,3338,8460,8867,4184,23599,927,838302000,76336000,88996000,112961000,291962000,216909000,86503000,665707000,31453000
Rhode Island,Construction,2009,15854,11985,1920,1170,15075,620,95,15790,64,15870,11985,1920,1170,15075,625,95,15795,75,91560,15144,11548,15455,44239,21191,13152,86154,406,4784525000,676595000,515015000,752326000,1992459000,1136934000,726254000,4315180000,43500000
Rhode Island,Educational Services,2009,1931,980,205,195,1380,325,111,1816,115,2030,980,210,200,1390,345,140,1875,155,124983,566,734,2117,5235,11816,11668,29265,90093,4230119000,36096000,19485000,37697000,114687000,368102000,430380000,944863000,3072128000
Rhode Island,Finance and Insurance,2009,4595,2525,560,340,3425,273,212,3910,685,7215,2525,560,365,3450,360,745,4555,2660,88204,3675,3238,3678,11460,5566,12115,35011,48024,7710741000,217500000,165911000,199461000,660845000,581796000,687640000,2272255000,3433451000
Rhode Island,Health Care and Social Assistance,2009,12709,5095,2910,2020,10025,1354,787,12166,543,16260,5110,2930,2095,10135,1910,2485,14530,1730,400408,9446,18930,26146,55316,51956,95953,213706,173117,16306010000,436388000,770632000,1054640000,2275371000,2135984000,3325100000,8030753000,7946791000
Rhode Island,Information,2009,1304,535,180,145,860,140,70,1070,234,2015,535,180,145,860,150,85,1095,920,35889,409,774,591,1957,2910,2437,13043,15963,2070725000,37504000,36343000,26228000,128603000,150258000,78925000,506327000,1158969000
Rhode Island,Management of Companies and Enterprises,2009,627,45,15,20,80,75,181,336,291,810,45,15,20,80,75,200,355,455,55140,78,0,0,176,950,5445,6670,48470,5156005000,4128000,2164000,4555000,11465000,59391000,348770000,422655000,4733350000
Rhode Island,Manufacturing,2009,7979,3090,1325,1315,5730,1495,391,7616,363,8125,3090,1325,1315,5730,1545,440,7715,410,179922,3713,6580,12952,27309,45780,28843,128578,31881,7704290000,184915000,229209000,449775000,943360000,1885252000,1006405000,4852943000,1776669000
Rhode Island,"Mining, Quarrying, and Oil and Gas Extraction",2009,105,65,15,10,90,5,0,95,10,110,65,15,10,90,5,0,95,15,437,70,0,0,296,0,0,330,0,33709000,6368000,7816000,0,23419000,0,0,29223000,0
Rhode Island,Other,2009,45,44,1,0,45,0,0,45,0,45,44,1,0,45,0,0,45,0,42,37,0,0,42,0,0,42,0,940000,892000,0,0,940000,0,0,940000,0
Rhode Island,Other Services (except Public Administration),2009,13757,8720,2715,1356,12791,666,85,13542,215,14305,8725,2725,1375,12825,845,90,13760,545,86585,14380,16614,16363,50916,20306,163,78880,5411,2288608000,410987000,398347000,401562000,1235659000,617646000,2762000,2070208000,149735000
Rhode Island,"Professional, Scientific, and Technical Services",2009,14462,10020,1835,1158,13013,670,283,13966,496,15020,10020,1840,1160,13020,720,305,14045,975,113149,13734,10828,12923,41455,18904,12128,77879,29150,7311073000,668712000,538373000,740454000,2017510000,1187037000,789720000,4285049000,2862879000
Rhode Island,Real Estate and Rental and Leasing,2009,4569,3220,480,298,3998,235,131,4364,205,5485,3230,505,400,4135,290,235,4660,825,31753,4239,2508,2950,10949,5602,2394,20404,7668,1238866000,174536000,107974000,125208000,412028000,205630000,84496000,758197000,370222000
Rhode Island,Retail Trade,2009,14821,8405,2568,1507,12480,811,320,13611,1210,19245,8425,2650,1610,12685,925,680,14290,4955,223735,11259,13095,16308,45222,18417,11655,83746,81408,5706046000,370592000,368011000,446692000,1260389000,727306000,349818000,2483027000,2130464000
Rhode Island,Total,2009,24845,14447,3931,2768,21146,2083,608,23837,1008,28682,14460,3972,2851,21283,2435,1386,25104,3578,413584,23653,25640,37077,86370,75280,66832,228482,185102,16775718000,876271000,843019000,1221606000,2940896000,2772675000,2448612000,8162183000,8613535000
Rhode Island,Transportation and Warehousing,2009,3007,1855,325,270,2450,207,104,2761,246,3265,1855,325,275,2455,215,115,2785,480,38930,1619,1290,2120,6191,4553,1957,17240,8730,1504270000,88112000,55324000,93532000,281043000,167850000,65383000,631866000,407989000
Rhode Island,Utilities,2009,77,35,0,10,45,5,0,50,27,170,35,0,10,45,5,0,50,120,2314,14,0,0,116,0,0,158,2208,196238000,1028000,0,0,5645000,0,0,8207000,190660000
Rhode Island,Wholesale Trade,2009,6861,3130,1025,735,4890,840,333,6063,798,7235,3135,1030,745,4910,920,345,6175,1060,98981,4184,4549,7936,18824,19062,8101,59088,27324,4805857000,240350000,266020000,374385000,981315000,1024588000,370498000,2989045000,1498902000
South Carolina,Accommodation and Food Services,2009,35178,12993,6520,6570,26083,7005,1138,34226,952,47015,13045,6555,6695,26295,7905,3815,38015,9000,899005,20673,44587,89800,156491,260888,152719,571065,327394,12112920000,433543000,511517000,1093071000,2041141000,3471792000,1960790000,7488345000,4619165000
South Carolina,Administrative and Support and Waste Management and Remediation Services,2009,24143,14050,3960,2285,20295,1967,715,22977,1166,27055,14060,3960,2295,20315,2190,970,23475,3580,577810,22236,25491,28715,78443,67390,89295,242921,314430,14659626000,637415000,675502000,760154000,2104236000,1774668000,2175535000,6255188000,8194090000
South Carolina,"Agriculture, Forestry, Fishing and Hunting",2009,2635,1425,615,405,2445,115,35,2595,40,2655,1425,615,405,2445,125,35,2605,50,17470,2259,3949,4891,11445,3012,405,16829,394,632296000,78657000,138878000,162282000,399110000,111288000,5041000,561974000,22025000
South Carolina,"Arts, Entertainment, and Recreation",2009,7034,3705,1085,715,5505,1183,208,6896,138,7590,3715,1085,750,5550,1315,365,7230,360,112287,5367,6592,8330,22117,45225,22673,94811,14865,1988185000,149492000,112969000,144113000,427989000,804293000,364342000,1695139000,209115000
South Carolina,Construction,2009,52135,33400,9090,5235,47725,3611,395,51731,404,52720,33400,9095,5260,47755,3660,525,51940,780,441247,54909,59234,69393,186115,129611,40467,361510,41030,17222731000,1544300000,1630980000,2223911000,5400225000,4658873000,1729438000,11980135000,2262918000
South Carolina,Educational Services,2009,4830,2470,655,560,3685,800,150,4635,195,5175,2470,655,565,3690,850,240,4780,395,149713,3651,4036,7258,15837,30634,24603,72936,73543,3301100000,106289000,67449000,114321000,294576000,677782000,685382000,1675196000,1513314000
South Carolina,Finance and Insurance,2009,16852,10523,2477,1107,14107,976,528,15611,1241,38445,10605,2795,1540,14940,2745,3630,21315,17130,312924,17257,14995,13011,46618,30760,38771,122062,187106,15878535000,665106000,539377000,569357000,1812321000,1380578000,1814448000,5188436000,10573632000
South Carolina,Health Care and Social Assistance,2009,38499,16654,9200,5840,31694,4514,1148,37356,1143,47610,16680,9265,6060,32005,5570,3310,40885,6725,1061585,31142,61058,75217,169136,168434,147827,497260,559319,42824474000,1503204000,2319987000,2989345000,6850383000,6695369000,4621999000,18392685000,24381151000
South Carolina,Information,2009,3487,1635,390,320,2345,375,202,2922,565,6860,1635,395,340,2370,435,365,3170,3690,151911,1862,2155,3482,7481,10434,14310,38018,113195,7226080000,87371000,64459000,105444000,280352000,480142000,856628000,1761647000,5443966000
South Carolina,Management of Companies and Enterprises,2009,2078,180,30,85,295,300,578,1173,905,3015,180,30,90,300,300,625,1225,1790,119725,28,80,431,745,2990,14150,17885,101414,8838140000,24102000,12598000,19110000,56092000,143700000,783955000,983747000,7849813000
South Carolina,Manufacturing,2009,19071,6655,2875,2460,11990,2952,1537,16479,2592,20635,6660,2875,2460,11995,3085,1775,16855,3780,936008,8503,15171,27184,57210,97293,124343,324380,544255,39164283000,372979000,482913000,903623000,1947991000,3643170000,4827450000,11842783000,24076333000
South Carolina,"Mining, Quarrying, and Oil and Gas Extraction",2009,339,160,35,45,240,40,15,295,44,445,160,35,45,240,40,15,295,150,4489,51,49,516,898,679,0,1935,1151,217204000,6907000,1211000,22719000,34617000,28580000,0,85255000,118501000
South Carolina,Other,2009,149,141,6,2,149,0,0,149,0,149,141,6,2,149,0,0,149,0,174,0,33,0,174,0,0,174,0,3236000,2527000,546000,0,3236000,0,0,3236000,0
South Carolina,Other Services (except Public Administration),2009,52093,31480,11758,4615,47853,3294,444,51591,502,55235,31485,11815,4755,48055,4105,1025,53185,2050,382557,59157,74786,58846,195810,112744,34270,348068,28866,8398840000,1255934000,1493688000,1280436000,4046545000,2343697000,675828000,7197855000,1055624000
South Carolina,"Professional, Scientific, and Technical Services",2009,44837,31255,6285,3237,40777,2108,795,43680,1157,48330,31260,6295,3345,40900,2645,1330,44875,3455,382116,42278,38638,40778,132036,63852,46320,248709,120715,19913811000,1901930000,1572215000,1802105000,5302442000,3832549000,2757359000,12185871000,7289116000
South Carolina,Real Estate and Rental and Leasing,2009,18789,14275,1863,872,17010,708,433,18151,638,24280,14355,1950,1000,17305,1290,1270,19865,4415,131386,19317,11098,10073,43023,21681,20936,88165,34470,4125827000,606049000,355265000,353502000,1334310000,669878000,656949000,2733368000,1247444000
South Carolina,Retail Trade,2009,55203,32017,11013,5414,48444,3700,914,53058,2145,89590,32160,11345,6125,49630,6160,3675,59465,30125,1037123,53648,65209,61967,191980,115895,51081,371684,626386,22162314000,1264469000,1447185000,1645003000,4405070000,3415598000,1336426000,9508601000,12373153000
South Carolina,Total,2009,80107,45732,14448,8504,68684,7204,1893,77781,2326,103254,45847,14670,8979,69496,9312,5181,83989,19265,1542825,80114,94494,113017,287625,259403,203119,750147,792678,51720724000,2350243000,2548319000,3230456000,8129018000,7825150000,6404425000,22358593000,29362131000
South Carolina,Transportation and Warehousing,2009,10485,5558,1402,784,7744,954,591,9289,1196,12450,5565,1415,820,7800,1025,765,9590,2860,238869,6935,7898,9349,26186,21970,27106,81632,148319,8095695000,264275000,230944000,289180000,806535000,685496000,869380000,2536092000,5179532000
South Carolina,Utilities,2009,461,160,65,30,255,95,65,415,46,1645,160,65,30,255,125,190,570,1075,57288,258,359,355,972,3900,8051,13114,27978,4129434000,9532000,13742000,13036000,38079000,201175000,441884000,684929000,2182929000
South Carolina,Wholesale Trade,2009,20227,9486,3043,2183,14712,2460,1188,18360,1867,24775,9510,3075,2305,14890,2990,1980,19860,4915,304308,14051,17719,24868,62286,60530,37121,176973,104163,14345873000,668945000,787781000,1088140000,2662751000,2736025000,1708995000,7643707000,5663578000
South Dakota,Accommodation and Food Services,2009,10228,4070,1820,1969,7859,1828,331,10018,210,11660,4075,1845,2040,7960,2100,795,10855,805,180957,5624,12298,27449,45896,62258,38572,147137,30571,2442225000,148603000,131209000,294259000,581273000,757067000,580748000,1928475000,476892000
South Dakota,Administrative and Support and Waste Management and Remediation Services,2009,4982,3210,745,335,4290,288,140,4718,264,5265,3210,745,350,4305,330,180,4815,450,54291,4243,4029,3507,13175,7399,9994,33490,8587,1249887000,135020000,114514000,72724000,352867000,170176000,160567000,775181000,201819000
South Dakota,"Agriculture, Forestry, Fishing and Hunting",2009,590,480,45,35,560,15,10,585,5,590,480,45,35,560,15,10,585,5,797,192,72,128,980,0,0,761,0,76870000,20450000,3427000,14275000,43130000,0,0,76085000,0
South Dakota,"Arts, Entertainment, and Recreation",2009,3137,1790,570,400,2760,283,59,3102,35,3290,1790,570,405,2765,330,155,3250,40,30493,2116,3312,4732,10641,8180,2571,27585,807,481981000,67752000,43253000,87756000,212618000,160843000,30438000,465761000,5335000
South Dakota,Construction,2009,15886,11185,2500,1270,14955,735,126,15816,70,15970,11185,2500,1275,14960,735,180,15875,95,90432,17113,15440,15364,50461,23868,9299,88537,834,3609791000,614278000,538615000,628932000,1787446000,1127256000,393452000,3487546000,58104000
South Dakota,Educational Services,2009,1010,475,150,85,710,165,100,975,35,1055,475,150,85,710,165,115,990,65,37206,195,841,852,2462,6484,20312,29730,3180,799490000,16864000,14865000,10664000,47389000,132452000,466162000,652265000,63138000
South Dakota,Finance and Insurance,2009,6029,3872,652,403,4927,383,180,5490,539,9600,3875,700,555,5130,850,995,6975,2625,115858,5803,3513,4525,14504,9881,12148,39839,48983,5067340000,216716000,140938000,197018000,577828000,428551000,546693000,1636189000,3033955000
South Dakota,Health Care and Social Assistance,2009,9165,4160,1865,1205,7230,1120,549,8899,266,11390,4165,1875,1265,7305,1750,1475,10530,860,293710,6083,11789,15145,34862,42559,62330,146354,123219,11368656000,294375000,371528000,616112000,1301748000,1433699000,2186864000,5063123000,5937395000
South Dakota,Information,2009,1457,575,245,160,980,201,87,1268,189,2240,575,255,165,995,325,325,1645,595,34252,522,1287,964,3475,6633,3544,14633,8082,1256839000,31112000,29492000,32824000,107586000,194153000,129885000,558990000,285899000
South Dakota,Management of Companies and Enterprises,2009,648,15,26,15,56,145,255,456,192,750,15,30,15,60,145,265,470,280,26835,0,18,52,204,874,7492,8731,17061,1555290000,0,4421000,2108000,6679000,57901000,381693000,455593000,1062724000
South Dakota,Manufacturing,2009,4688,1815,815,590,3220,747,297,4264,424,4995,1815,815,595,3225,785,420,4430,565,153536,2056,3455,4907,12610,22442,12686,66102,59893,5644391000,78717000,105876000,163065000,414016000,828909000,483567000,2302046000,2207351000
South Dakota,"Mining, Quarrying, and Oil and Gas Extraction",2009,290,160,40,15,215,17,29,261,29,325,160,40,15,215,20,50,285,40,3079,54,0,29,88,0,739,2171,671,173548000,9283000,5584000,1156000,26439000,0,49489000,118511000,35084000
South Dakota,Other,2009,38,34,2,1,37,1,0,38,0,38,34,2,1,37,1,0,38,0,67,0,0,0,45,0,0,67,0,1041000,534000,0,0,879000,0,0,1041000,0
South Dakota,Other Services (except Public Administration),2009,12942,8535,2590,1060,12185,552,85,12822,120,13445,8540,2600,1090,12230,750,140,13120,325,71518,14378,14974,12016,45206,16014,61,63544,3386,1412666000,297991000,323175000,244936000,900958000,344227000,2234000,1310855000,45764000
South Dakota,"Professional, Scientific, and Technical Services",2009,8575,5710,1340,745,7795,385,113,8293,282,8950,5710,1380,765,7855,480,150,8485,465,53746,7815,8526,9008,26914,9205,3367,42002,7373,2082686000,284829000,281936000,343899000,942639000,415808000,152280000,1671405000,323564000
South Dakota,Real Estate and Rental and Leasing,2009,4021,3030,363,240,3633,148,85,3866,155,4325,3030,365,265,3660,195,125,3980,345,17366,3793,1871,2600,9197,2462,976,15176,1670,445952000,95455000,56991000,56760000,222822000,75321000,25129000,376955000,52746000
South Dakota,Retail Trade,2009,15615,7224,3348,2262,12834,1397,497,14728,887,20100,7245,3385,2385,13015,2005,1655,16675,3425,214107,11209,19527,26886,62940,40967,19671,133032,67486,4654268000,284929000,421577000,578917000,1326429000,1086019000,466549000,3044411000,1331032000
South Dakota,Total,2009,21573,12377,3725,2351,18453,1853,526,20832,741,25483,12387,3774,2495,18656,2552,1621,22829,2654,330517,20831,24523,30999,76353,66707,58576,201636,128881,10453529000,586399000,614174000,831570000,2032143000,1921122000,1836457000,5789722000,4663807000
South Dakota,Transportation and Warehousing,2009,5099,3375,700,359,4434,305,119,4858,241,5530,3375,700,365,4440,345,170,4955,575,42966,3470,3859,3920,13489,8543,1761,29135,11902,1450554000,141517000,119684000,121196000,407116000,275380000,68426000,906382000,465041000
South Dakota,Utilities,2009,341,50,60,70,180,95,10,285,56,755,50,60,75,185,160,50,395,360,10000,92,387,1005,1517,2826,0,5597,0,617446000,2491000,15384000,46870000,66300000,158205000,0,303130000,0
South Dakota,Wholesale Trade,2009,5522,1995,788,668,3451,939,416,4806,716,6990,1995,800,725,3520,1270,850,5640,1350,77633,2548,4054,6523,15278,24550,12139,57944,15107,3313692000,108768000,161457000,263128000,600260000,930489000,595082000,2348910000,782825000
Tennessee,Accommodation and Food Services,2009,39438,13645,7817,7681,29143,7985,1087,38215,1223,57940,13660,7855,7945,29460,9350,4375,43185,14755,1174500,22450,51973,105433,180440,285472,140849,608315,564831,15979560000,487965000,619834000,1288772000,2397720000,3729048000,1732321000,7878615000,8078082000
Tennessee,Administrative and Support and Waste Management and Remediation Services,2009,26807,14555,4205,2865,21625,2545,928,25098,1709,32685,14570,4215,2895,21680,2725,1390,25795,6890,875448,22078,25863,37506,88284,94072,105056,302208,566760,25198029000,861144000,769096000,1163636000,2854793000,3027183000,2888239000,9278189000,15777481000
Tennessee,"Agriculture, Forestry, Fishing and Hunting",2009,1215,900,180,55,1135,40,30,1205,10,1230,900,185,55,1140,40,30,1210,20,5973,1729,1089,543,3497,378,0,5866,0,181303000,42364000,31443000,15202000,93171000,21490000,0,171241000,0
Tennessee,"Arts, Entertainment, and Recreation",2009,10980,6190,2000,1222,9412,1113,219,10744,236,11540,6190,2005,1230,9425,1250,275,10950,590,148441,8081,13075,14982,38985,38900,21230,106569,33459,5350429000,497743000,438694000,543711000,1487525000,1156380000,846838000,4168080000,690699000
Tennessee,Construction,2009,51289,30665,9025,5744,45434,4700,703,50837,452,52065,30665,9025,5755,45445,4760,875,51080,985,521070,52306,58859,76054,188409,174781,96043,466375,46435,21005565000,1625679000,1764120000,2651785000,6064795000,7645711000,4508910000,18351170000,2391623000
Tennessee,Educational Services,2009,5542,2410,865,700,3975,820,448,5243,299,5925,2410,870,735,4015,825,535,5375,550,271295,3195,5576,9056,19305,33044,72077,130440,136137,8095674000,125413000,114938000,181114000,429413000,811702000,2283492000,3699814000,4254338000
Tennessee,Finance and Insurance,2009,24114,15168,3163,1420,19751,1668,915,22334,1780,51060,15225,3385,1900,20510,4485,5170,30165,20895,540169,26128,19774,16681,66272,60145,76748,210364,326179,32368935000,1093111000,885093000,881343000,3058681000,3416773000,3831027000,11585203000,20510099000
Tennessee,Health Care and Social Assistance,2009,55521,24615,13818,7745,46178,5635,2088,53901,1620,72965,24680,13885,8170,46735,7480,6545,60760,12205,1808166,48283,90345,101447,243085,211280,323162,784602,999106,75446536000,2299996000,3636725000,4395247000,10370843000,9596079000,11483311000,31608213000,43403238000
Tennessee,Information,2009,7201,3520,1060,751,5331,730,303,6364,837,12315,3520,1070,785,5375,830,595,6800,5515,221201,4862,5546,7916,20654,22375,11683,66206,134841,11515374000,233940000,203265000,310482000,777769000,929160000,661444000,2865886000,8360508000
Tennessee,Management of Companies and Enterprises,2009,3699,160,75,75,310,661,1041,2012,1687,6895,160,75,75,310,670,1065,2045,4850,356005,11,220,414,843,6350,26238,33945,322017,30883100000,28457000,14745000,31148000,78062000,483815000,1759594000,2340540000,28540050000
Tennessee,Manufacturing,2009,28911,10055,4740,3838,18633,4875,2172,25680,3231,31070,10055,4745,3855,18655,5120,2595,26370,4700,1359280,14652,26482,46106,95208,163894,164638,482515,790743,55932576000,577968000,830509000,1579674000,3205455000,6064080000,6418200000,17681776000,34938981000
Tennessee,"Mining, Quarrying, and Oil and Gas Extraction",2009,673,215,100,110,425,96,56,577,96,1100,215,100,110,425,105,145,675,425,10598,72,284,1182,2203,1513,3042,8558,2815,710112000,17013000,15170000,43363000,107298000,65885000,130527000,399838000,119696000
Tennessee,Other,2009,178,162,9,6,177,1,0,178,0,178,162,9,6,177,1,0,178,0,309,0,51,0,282,0,0,309,0,4073000,3194000,333000,0,3981000,0,0,4073000,0
Tennessee,Other Services (except Public Administration),2009,65442,40175,13265,6358,59798,4360,680,64838,604,70985,40195,13310,6645,60150,5645,1485,67280,3705,547943,76713,85344,81754,246457,157777,62041,474818,53330,12947939000,1618468000,1766065000,1888911000,5285311000,3515476000,1376897000,10305058000,2121739000
Tennessee,"Professional, Scientific, and Technical Services",2009,50831,33197,7630,4430,45257,3142,1035,49434,1397,55570,33205,7660,4550,45415,3780,1465,50660,4910,499339,53873,48931,57367,160959,96741,61611,327228,157013,26698788000,2235223000,2051114000,2735790000,7054562000,5361083000,3584550000,16207752000,9807433000
Tennessee,Real Estate and Rental and Leasing,2009,19924,13811,2625,1297,17733,906,522,19161,763,28345,13830,2785,1465,18080,1615,1845,21540,6805,161468,21864,16293,15336,53197,26085,18019,102783,57745,5629618000,652542000,502376000,530021000,1712465000,835085000,644397000,3429264000,2084517000
Tennessee,Retail Trade,2009,71141,40299,14130,7333,61762,5625,1270,68657,2484,114700,40430,14470,8120,63020,8135,5375,76530,38170,1364004,70281,89566,93058,255123,184652,86502,538529,759419,31303784000,1590709000,2023003000,2392774000,6046659000,5847217000,2239879000,14283763000,16387886000
Tennessee,Total,2009,99055,54058,18328,11225,83611,9751,2701,96063,2992,132901,54152,18576,11873,84601,12697,7580,104878,28023,2317986,98729,120858,149413,369000,355266,313704,1037970,1280016,86220358000,3116010000,3534801000,4744302000,11395113000,12537234000,11477067000,35409414000,50810944000
Tennessee,Transportation and Warehousing,2009,16036,7960,2317,1579,11856,1524,802,14182,1854,21090,7970,2325,1595,11890,1665,1115,14670,6420,490522,13079,13376,18710,48622,48182,49618,151753,322318,17945962000,402423000,417141000,595484000,1453692000,1690564000,1865067000,5156792000,12029676000
Tennessee,Utilities,2009,285,45,25,0,70,100,45,215,70,735,45,25,0,70,205,220,495,240,15208,14,152,0,219,5166,6176,11731,2860,896772000,1939000,2546000,0,5412000,287241000,378922000,678841000,181192000
Tennessee,Wholesale Trade,2009,28766,12015,4779,3291,20085,3989,1859,25933,2833,35400,12025,4845,3450,20320,4795,2800,27915,7485,560228,18036,28971,37286,90842,114529,78714,304642,237060,28903824000,973995000,1292790000,1740465000,4081964000,5735875000,4098010000,14791744000,13578291000
Texas,Accommodation and Food Services,2009,152032,57100,29897,27388,114385,31769,3764,149918,2114,223495,57170,30075,27850,115095,37615,16605,169315,54180,4560951,93059,199490,366657,664124,1181650,617633,2460361,2092804,65364759000,2174962000,2402345000,4523025000,9110844000,15791925000,8709394000,33641819000,31676886000
Texas,Administrative and Support and Waste Management and Remediation Services,2009,106688,59547,16807,11170,87524,11437,4092,103053,3635,127085,59565,16840,11410,87815,12335,5655,105805,21280,4179702,94452,107817,148092,347904,432864,595583,1393634,2693409,127320247000,3933244000,3598102000,4917788000,12481526000,14326886000,18137789000,45296275000,81060617000
Texas,"Agriculture, Forestry, Fishing and Hunting",2009,5060,3360,910,460,4730,230,65,5025,35,5400,3360,910,460,4730,290,325,5345,55,33153,4446,5444,5574,16217,6472,5635,29493,2058,1141115000,179374000,197238000,179128000,571735000,203817000,201197000,1010090000,71208000
Texas,"Arts, Entertainment, and Recreation",2009,27467,14833,4602,3609,23044,3266,724,27034,433,30330,14850,4630,3680,23160,3480,955,27595,2735,575889,19188,30514,42985,102642,122596,105151,339039,209483,15265568000,912799000,626328000,819542000,2400724000,2243220000,4315486000,9134123000,5730409000
Texas,Construction,2009,198068,114375,35760,22709,172844,20072,3564,196480,1588,202380,114375,35770,22735,172880,20675,4590,198145,4235,2960735,200338,235490,305450,742495,791165,580269,2118490,837799,134955045000,7469325000,7904460000,11244370000,26618155000,33021035000,26014216000,85826245000,48854636000
Texas,Educational Services,2009,24893,12215,3705,3383,19303,4088,946,24337,556,27555,12225,3710,3430,19365,4465,1725,25555,2000,727365,17764,23760,46199,91062,169737,137516,401149,315080,23486545000,574892000,471717000,891552000,1950370000,4377870000,4534943000,10914448000,12073373000
Texas,Finance and Insurance,2009,96224,65772,12899,5798,84469,5894,2555,92918,3306,192395,65935,13375,7035,86345,12810,13660,112815,79580,2288400,109321,80262,73980,271120,215135,249046,745994,1529707,141160003000,4946380000,3827251000,4363735000,13129426000,13244894000,14815889000,42126521000,98299725000
Texas,Health Care and Social Assistance,2009,235615,114407,55238,32098,201743,24229,6401,232373,3242,284250,114570,55450,33010,203030,31140,16260,250430,33820,6074550,204729,363129,423369,998879,939900,996706,2942673,3083602,243607714000,14319525000,15536301000,16943831000,46812981000,34001820000,30702610000,111566508000,131545135000
Texas,Information,2009,22318,11025,3423,2374,16822,2516,1086,20424,1894,44910,11040,3450,2435,16925,3100,2050,22075,22835,1177933,14220,21382,29234,71740,88623,90554,258286,917487,76661716000,829317000,900517000,1568266000,3751448000,4725394000,5808290000,14544596000,61748327000
Texas,Management of Companies and Enterprises,2009,12506,1000,301,462,1763,2532,3195,7490,5016,20810,1000,305,485,1790,2595,3450,7835,12975,1313960,0,1297,2824,5745,32815,103072,143995,1169965,135391040000,267221000,84463000,181555000,533087000,2319700000,7969472000,10974975000,124416065000
Texas,Manufacturing,2009,91346,34175,15980,13082,63237,16423,5436,85096,6250,100150,34225,16010,13135,63370,17065,6645,87080,13070,3810936,59531,99520,165720,340539,621045,589507,1627680,2039632,186425383000,2297581000,3289051000,5997988000,11912040000,24509286000,25038375000,64030320000,116907912000
Texas,"Mining, Quarrying, and Oil and Gas Extraction",2009,31472,17999,4653,3440,26092,3655,816,30563,909,37050,18005,4675,3460,26140,3955,1280,31375,5675,850095,29281,29904,45833,105544,135253,103149,345225,503788,67401128000,1802917000,1676428000,2570524000,6061578000,8691139000,8611725000,23430523000,43952380000
Texas,Other,2009,1522,1413,36,69,1518,4,0,1522,0,1522,1413,36,69,1518,4,0,1522,0,2164,0,213,811,2071,0,0,2164,0,31570000,24218000,3418000,3749000,31385000,185000,0,31570000,0
Texas,Other Services (except Public Administration),2009,215588,127787,44200,23714,195701,16092,2230,214023,1565,239245,127875,44490,24790,197155,20925,5420,223500,15745,2022730,242469,286682,314625,843877,589380,235325,1674916,299467,51855170000,5670250000,6326032000,7105227000,19101791000,13291537000,6912502000,39442383000,11282789000
Texas,"Professional, Scientific, and Technical Services",2009,269875,189225,37230,20118,246573,15137,3992,265702,4173,292120,189305,37395,20635,247335,17645,6700,271680,20440,2840305,263867,243033,264868,797956,512998,380306,1702510,1115412,196668635000,15819329000,12138218000,14430332000,42477265000,33161100000,27051067000,102999765000,93061132000
Texas,Real Estate and Rental and Leasing,2009,92901,68562,11429,5529,85520,4196,1615,91331,1570,129340,68705,11690,6140,86535,7460,7535,101530,27810,822464,106855,72567,70319,250342,136253,112406,509073,288542,34244358000,3645590000,2457975000,2636612000,8748753000,5451870000,4982636000,19462880000,14314524000
Texas,Retail Trade,2009,223273,131583,44764,23246,199593,16253,3804,219650,3623,383975,132030,46225,26330,204585,26730,16575,247890,136085,5148957,221132,276965,296784,796291,562859,372723,1779268,3204423,121907796000,5969296000,6542727000,7718432000,20314997000,17188541000,12708399000,50608969000,69725810000
Texas,Total,2009,392378,225599,70517,43826,339942,38385,8755,387082,5296,519028,225989,71382,46078,343449,49813,25245,418507,100521,8925096,393714,462776,585811,1442301,1455345,1209215,4106861,4818235,376646791000,15744833000,15367474000,19923930000,51036237000,51870422000,48726256000,151632915000,225013876000
Texas,Transportation and Warehousing,2009,61668,33345,9734,6441,49520,6063,2374,57957,3711,79740,33390,9790,6630,49810,6885,4480,61175,18565,1576162,53764,60489,80907,199496,200258,173859,586285,955091,66280195000,1906737000,2014850000,2837690000,6840096000,7761364000,7452601000,22300042000,42901806000
Texas,Utilities,2009,4715,2515,890,335,3740,405,228,4373,342,9525,2515,895,345,3755,600,590,4945,4580,235439,4871,5363,3552,14468,17987,29239,62279,172978,19279621000,218654000,186531000,243480000,649029000,1123805000,2103578000,3881606000,15342853000
Texas,Wholesale Trade,2009,124564,62483,20617,14989,98089,14814,5794,118697,5867,157775,62740,21045,16050,99835,19275,11725,130835,26940,2376398,106628,133089,190399,433703,459369,385977,1303281,1003812,139395422000,5458900000,6370288000,9356076000,21228166000,22566744000,20848062000,65251810000,70190470000
United States,Accommodation and Food Services,2009,2379106,995386,477357,433442,1906185,417074,44622,2367881,11225,3176195,997045,479435,440745,1917225,487590,193915,2598730,577465,57216465,1677265,3186926,5897167,10761590,15287100,7706403,33758425,23455848,897401420000,37615710000,40128256000,75214575000,152958745000,217731355000,114257852000,484958355000,412392951000
United States,Administrative and Support and Waste Management and Remediation Services,2009,1622288,1038093,238416,147865,1424374,139418,39290,1603082,19206,1918115,1038695,239645,150965,1429305,158605,71450,1659360,258755,45304935,1548454,1565910,1986774,5139505,5557670,6670169,17367785,27825899,1449130940000,57526890000,47664060000,63240097000,168433215000,176641320000,189807681000,534905215000,913191605000
United States,"Agriculture, Forestry, Fishing and Hunting",2009,104894,72744,17365,8230,98339,4948,1079,104366,528,108395,72780,17380,8255,98415,5595,2200,106210,2185,769145,104580,113750,108015,332086,177060,128677,647245,116884,25608975000,3774605000,3572555000,3603115000,10950275000,5918552000,4131589000,21198020000,4212867000
United States,"Arts, Entertainment, and Recreation",2009,569908,355555,78342,57171,491068,61586,12996,565650,4258,614285,355910,78745,58140,492795,67450,20360,580605,33680,10051695,423397,514455,769615,1764395,2460485,2117198,6353020,3674978,305893585000,38140535000,13457320000,17415750000,69013605000,52523830000,79006343000,201553790000,103374259000
United States,Construction,2009,3507832,2381256,541640,314063,3236959,234542,29629,3501130,6702,3564885,2381375,541890,314870,3238135,242150,41640,3521925,42960,29835640,3754585,3537905,4193465,11485955,8809685,4795715,25091355,4735641,1404716225000,129271025000,126360180000,172806050000,428437255000,422860025000,257381550000,1108678830000,295575891000
United States,Educational Services,2009,394880,193271,60742,50512,304525,67233,16597,388355,6525,443885,193435,61070,51960,306465,74435,28110,409010,34875,16002765,304265,404590,690550,1399405,2800055,2855985,7055445,8923905,525952705000,9387605000,8383810000,14408325000,32179740000,76225560000,93187555000,201592855000,324130700000
United States,Finance and Insurance,2009,1222958,867051,167326,77765,1112142,74548,23300,1209990,12968,2444545,869890,174620,95695,1140205,174965,179365,1494535,950010,30842652,1425799,1062593,1022917,3590414,2938625,3589207,10126875,20554715,2301408882000,67694582000,55425762000,66291172000,189944237000,211343260000,262536661000,664238415000,1635703015000
United States,Health Care and Social Assistance,2009,3173929,1591282,717420,410745,2719447,313165,102142,3134754,39175,3996355,1594165,722940,429625,2746730,433215,333035,3512980,483375,87568905,2920988,4748454,5446244,13155068,12205368,15930215,41292500,46235539,3677656075000,149814881000,193954285000,227849815000,571637645000,475082021000,523148730000,1569873965000,2107782110000
United States,Information,2009,356400,208353,52177,38631,299161,39567,10316,349044,7356,678630,208765,52820,40340,301925,51810,29965,383700,294930,16440545,309932,344066,517425,1176730,1535999,1617061,4334195,12083797,1125503335000,20571910000,14969192000,25158250000,60705300000,86500714000,101238274000,248484790000,875370763000
United States,Management of Companies and Enterprises,2009,138545,16183,4044,6198,26425,30867,44011,101303,37242,257870,16275,4105,6410,26790,31890,49555,108235,149635,14267250,20708,18256,38295,77745,377885,1355290,1810920,12456330,1323530095000,2704605000,3176475000,2665260000,8546340000,24227920000,92245245000,125019505000,1198510590000
United States,Manufacturing,2009,1364127,553225,248651,205486,1007362,248267,69770,1325399,38728,1544670,553430,248965,206860,1009255,265060,105920,1380235,164435,58100080,1039686,1654913,2794684,5506013,9960689,10525273,26032562,31872685,2746365819000,37285252000,53508792000,100139814000,191220387000,398116291000,448480026000,1039236020000,1697226685000
United States,"Mining, Quarrying, and Oil and Gas Extraction",2009,104720,58699,16411,11995,87105,12321,3115,102541,2179,134485,58805,16580,12375,87760,14770,7075,109605,24880,3020565,97970,108052,161264,367995,454023,429666,1252675,1760462,209115237000,5417233000,5143725000,8144295000,18729463000,25962200000,28692091000,73407322000,135160311000
United States,Other,2009,16885,16174,469,210,16853,32,0,16885,0,16885,16174,469,210,16853,32,0,16885,0,0,0,2908,2570,0,869,0,0,0,363504000,290482000,45283000,20437000,356202000,7302000,0,363504000,0
United States,Other Services (except Public Administration),2009,3304333,2095045,662987,320367,3078399,196440,21923,3296762,7571,3613505,2096990,668225,334295,3099510,254985,76695,3431190,182315,26287933,3958295,4298340,4204880,12458548,6988395,2976153,22428490,3621777,696732830000,90883475000,97747410000,102115095000,290745980000,180683245000,96371003000,567831790000,128115231000
United States,"Professional, Scientific, and Technical Services",2009,3815596,2780447,502047,283986,3566480,195325,35059,3796864,18732,4212830,2782240,505525,294850,3582615,251385,98285,3932285,280545,39199825,4153803,3273495,3764050,11228390,7204780,5356037,23790315,15143398,2635239140000,208286600000,159279620000,203391970000,570958190000,468675165000,378562109000,1418382555000,1213372445000
United States,Real Estate and Rental and Leasing,2009,1354402,1053883,153858,73868,1281609,52210,13428,1347247,7155,1755235,1056475,159945,84625,1301045,92790,81840,1475675,279560,9903783,1550208,983675,952935,3483239,1806890,1499737,6810555,3110058,402095031000,52369953000,33547885000,34898155000,120908030000,73003660000,62472713000,256447275000,140753948000
United States,Retail Trade,2009,3373376,2012643,682287,368013,3062943,253467,42419,3358829,14547,5383225,2020015,700340,412325,3132680,409720,247225,3789625,1593600,72141871,3508742,4407411,4793585,12786676,9103446,5384839,27426814,43748202,1733501350000,87250232000,100841310000,119837121000,307931344000,272146713000,163817220000,743976845000,983036053000
United States,Total,2009,5767306,3558708,1001313,610777,5170798,495673,83326,5749797,17509,7433465,3565433,1015178,646145,5226756,672753,353510,6253019,1180446,114509626,5966190,6580830,8191289,20738309,19389940,16153254,56281503,58228123,4855545239000,219913105000,212718822000,278321099000,710953026000,719054001000,654811946000,2084818973000,2770726266000
United States,Transportation and Warehousing,2009,823600,521445,118393,78250,718088,71059,19632,808779,14821,1050440,522200,119495,81550,723245,87510,49735,860490,189950,20732326,789733,764964,1041044,2589836,2592560,2384688,7602629,13057459,821076355000,26448804000,24367935000,34066640000,84919305000,92378806000,88670286000,266108090000,552519616000
United States,Utilities,2009,29232,14938,4648,2332,21918,4358,1610,27886,1346,86560,14955,4745,2575,22275,7120,6130,35525,51035,3207760,28998,29365,30920,89412,194636,256228,541053,2663061,271186850000,1045108000,1147495000,1580625000,3776405000,12043674000,18024158000,33903965000,237282885000
United States,Wholesale Trade,2009,1611784,909328,270459,188369,1368156,179643,43161,1590960,20824,2098790,912850,277075,203215,1393140,252560,145050,1790750,308040,29138845,1558073,1773975,2493190,5826640,6481315,5104152,17413855,11571462,1670791840000,71698910000,80628655000,118565965000,270893530000,322750420000,268182252000,861943450000,801452710000
Utah,Accommodation and Food Services,2009,17389,5850,2918,3750,12518,3768,573,16859,530,23675,5875,2925,3825,12625,4360,2250,19235,4440,464655,8234,19462,50834,79332,134824,81546,297845,165577,6147621000,234120000,212875000,535285000,987275000,1621883000,1086418000,3723641000,2408556000
Utah,Administrative and Support and Waste Management and Remediation Services,2009,17902,11385,2300,1523,15208,1218,500,16926,976,19550,11385,2305,1535,15225,1305,595,17125,2425,554390,11526,13892,18848,47454,41551,46682,143896,390878,14391548000,490580000,361241000,500616000,1379195000,1201526000,1258678000,4076166000,9858838000
Utah,"Agriculture, Forestry, Fishing and Hunting",2009,340,250,40,30,320,5,10,335,5,355,250,40,30,320,5,10,335,20,1308,143,179,0,786,0,0,964,0,54127000,7471000,5368000,12524000,26907000,0,0,37982000,0
Utah,"Arts, Entertainment, and Recreation",2009,4155,2500,550,415,3465,465,130,4060,95,4245,2500,550,415,3465,475,165,4105,140,83889,2058,2777,4180,10854,16787,13564,46222,28736,1707741000,117473000,56575000,66245000,261470000,290192000,197257000,815147000,446324000
Utah,Construction,2009,47365,33310,6949,3744,44003,2691,315,47009,356,47505,33315,6955,3750,44020,2715,325,47060,445,329167,51635,45051,48438,146514,99079,33476,287324,30903,13389640000,1496243000,1356249000,1685024000,4557250000,4245764000,1634590000,10731030000,1896629000
Utah,Educational Services,2009,4229,2220,600,561,3381,580,120,4081,148,4535,2220,600,610,3430,605,130,4165,370,110844,2266,3596,7182,14165,23058,12015,52702,532,2824426000,87951000,68472000,114631000,275806000,531282000,346682000,1257223000,1300420000
Utah,Finance and Insurance,2009,16558,11785,1600,720,14105,884,340,15329,1229,25745,11805,1650,800,14255,1835,1295,17385,8360,291558,15981,9560,8154,34849,28423,21805,97904,170664,13794698000,589558000,347979000,395579000,1373481000,1461274000,1206803000,4545850000,8499962000
Utah,Health Care and Social Assistance,2009,28673,15070,6405,3670,25145,2333,588,28066,607,33115,15095,6415,3810,25320,2995,1870,30185,2930,480087,17897,42347,45226,113688,90143,72933,288877,184831,17761422000,1432969000,1381223000,1305973000,4159884000,2997221000,2260266000,9772539000,7791134000
Utah,Information,2009,4875,2475,570,356,3401,618,221,4240,635,6795,2480,570,380,3430,630,370,4430,2365,159130,1435,2692,3725,8842,19373,19155,53567,57540,9670303000,140502000,106812000,142287000,437429000,1042361000,1017280000,2650550000,5386901000
Utah,Management of Companies and Enterprises,2009,1652,225,35,30,290,305,380,975,677,2250,225,35,40,300,310,380,990,1260,86790,0,0,0,523,4316,8237,13358,72804,6447035000,0,0,0,304102000,201208000,517639000,1034450000,5412135000
Utah,Manufacturing,2009,15544,6165,2600,2390,11155,2354,742,14251,1293,16050,6165,2605,2390,11160,2385,830,14375,1675,453842,6781,14135,26216,52306,74290,49904,206786,192158,20433498000,311402000,420002000,810749000,1723050000,2771652000,2164131000,7820294000,10063369000
Utah,"Mining, Quarrying, and Oil and Gas Extraction",2009,2132,1075,279,190,1544,230,56,1830,302,2235,1075,280,190,1545,230,65,1840,395,39426,1637,1338,2247,5881,5572,2647,16142,22747,2364367000,84374000,65628000,106587000,288831000,261054000,101225000,744814000,1591458000
Utah,Other,2009,81,80,0,0,80,1,0,81,0,81,80,0,0,80,1,0,81,0,0,0,0,0,0,0,0,0,0,1654000,1474000,0,0,1474000,0,0,1654000,0
Utah,Other Services (except Public Administration),2009,20534,12835,3985,1985,18805,1131,214,20150,384,22980,12865,4025,2085,18975,1970,565,21510,1470,235926,20295,25062,23180,71574,33443,9578,118688,31910,7153720000,525768000,588967000,597776000,1740038000,743127000,298981000,3118747000,1153567000
Utah,"Professional, Scientific, and Technical Services",2009,40313,29430,4255,2530,36215,2201,817,39233,1080,42425,29430,4270,2580,36280,2505,1040,39825,2600,330548,33500,26398,30145,95243,72393,56418,232235,89639,16916907000,1590772000,1074561000,1447993000,4161757000,3938100000,2863744000,11231203000,5446713000
Utah,Real Estate and Rental and Leasing,2009,19317,16270,1216,594,18080,566,260,18906,411,21945,16275,1280,640,18195,845,535,19575,2370,83072,11624,7117,6516,30910,16989,12610,62533,16858,3025263000,546937000,208456000,205015000,997079000,514619000,476249000,2015024000,689317000
Utah,Retail Trade,2009,29714,14515,6010,4028,24553,2693,797,28043,1671,44230,14555,6150,4430,25135,3955,2375,31465,12765,686144,18830,36387,48787,112530,88204,58764,271646,367404,16103731000,649800000,795826000,1145102000,2630028000,2303465000,1668491000,6811800000,8668027000
Utah,Total,2009,58115,35793,8700,5720,50213,4779,1260,56252,1863,69464,35837,8790,5968,50595,6039,2910,59544,9920,1059722,52929,57490,75860,186279,175740,134890,496909,562813,37848144000,1898474000,1604919000,2151028000,5654421000,5800709000,4810040000,16265170000,21582974000
Utah,Transportation and Warehousing,2009,9398,5670,1085,710,7465,769,307,8541,857,10375,5670,1085,710,7465,870,360,8695,1680,219462,5807,6103,7799,23179,24683,16596,70855,119780,8082957000,231445000,197194000,261725000,728097000,855557000,660154000,2409474000,5116611000
Utah,Utilities,2009,391,225,35,40,300,32,15,347,44,1095,225,35,40,300,85,25,410,685,14942,0,0,539,1154,1140,0,4440,0,1189843000,6162000,11151000,17923000,36235000,72421000,121804000,293135000,0
Utah,Wholesale Trade,2009,15715,7355,2150,1535,11040,1909,984,13933,1782,17810,7375,2175,1580,11130,2110,1365,14605,3205,251479,9781,12462,16174,42201,46093,33442,139523,86563,12590560000,454206000,489414000,783438000,1830543000,2226135000,1560856000,6219049000,5178602000
Vermont,Accommodation and Food Services,2009,8409,3470,1660,1620,6750,1283,162,8195,214,9395,3470,1675,1690,6835,1490,295,8620,775,145027,4500,11189,22257,38660,41006,19101,99356,41397,2284319000,127992000,146416000,313097000,593752000,648363000,287800000,1534759000,740958000
Vermont,Administrative and Support and Waste Management and Remediation Services,2009,5138,3640,605,315,4560,275,50,4885,253,5330,3640,605,315,4560,320,50,4930,400,33973,4084,3220,2619,12309,7141,1940,23662,8687,968931000,189970000,96530000,66401000,402662000,206996000,43482000,711912000,172297000
Vermont,"Agriculture, Forestry, Fishing and Hunting",2009,625,550,50,15,615,0,10,625,0,625,550,50,15,615,0,10,625,0,1432,567,254,0,1223,0,0,1432,0,46573000,18701000,7389000,0,33970000,0,0,46573000,0
Vermont,"Arts, Entertainment, and Recreation",2009,2184,1435,340,185,1960,155,39,2154,30,2230,1435,340,185,1960,170,65,2195,35,31779,1269,1847,1812,5821,4236,1570,18465,5518,544814000,80755000,43611000,55488000,217108000,78909000,18793000,408493000,54554000
Vermont,Construction,2009,14308,11110,1755,875,13740,455,73,14268,40,14320,11110,1755,880,13745,460,75,14280,40,61663,14751,10640,10248,38093,13025,5418,59963,0,2784742000,624472000,447188000,485531000,1587942000,692732000,306649000,2703778000,3883000
Vermont,Educational Services,2009,1738,895,235,223,1353,215,100,1668,70,1830,895,235,240,1370,230,145,1745,85,65620,1356,1206,1927,5842,8695,19439,34436,31041,1805937000,46249000,36432000,61054000,155150000,229036000,586462000,979149000,801303000
Vermont,Finance and Insurance,2009,2730,1425,345,180,1950,194,112,2256,474,4920,1430,365,240,2035,570,660,3265,1655,43965,1869,1899,2003,5950,6074,7924,21783,19709,2659937000,111759000,100331000,120778000,356312000,320288000,352409000,1274625000,1259942000
Vermont,Health Care and Social Assistance,2009,8939,4220,1865,1200,7285,1027,350,8662,277,10780,4225,1865,1220,7310,1365,1150,9825,955,240425,7563,11321,15091,35609,37314,45461,122199,103908,8143489000,331387000,403470000,484000000,1254834000,1113905000,1485944000,3900551000,3654431000
Vermont,Information,2009,1855,865,320,185,1370,245,72,1687,168,2475,865,320,190,1375,340,110,1825,650,26381,975,393,1958,5135,6214,922,16669,8238,1072014000,41653000,47356000,56030000,176845000,348669000,31860000,649670000,368519000
Vermont,Management of Companies and Enterprises,2009,370,20,10,25,55,80,85,220,150,415,20,10,25,55,80,90,225,190,14745,0,0,0,124,928,1848,3185,11527,943925000,0,0,0,12120000,57243000,90040000,164940000,778985000
Vermont,Manufacturing,2009,4814,2280,760,535,3575,740,270,4585,229,5005,2280,760,540,3580,800,320,4700,305,89813,2474,2669,5104,12920,21242,9176,64703,15973,4008629000,97342000,100779000,165689000,432994000,913423000,392970000,2671095000,865805000
Vermont,"Mining, Quarrying, and Oil and Gas Extraction",2009,211,135,25,10,170,20,0,190,21,235,135,25,10,170,40,0,210,25,212,0,0,0,88,536,0,1074,0,11596000,11508000,4029000,0,28347000,27332000,0,55679000,0
Vermont,Other,2009,42,39,1,2,42,0,0,42,0,42,39,1,2,42,0,0,42,0,0,0,0,0,0,0,0,0,0,1355000,662000,0,0,1355000,0,0,1355000,0
Vermont,Other Services (except Public Administration),2009,9724,6710,1815,670,9195,331,83,9609,115,10100,6715,1845,720,9280,485,155,9920,180,43693,11801,11016,7577,32350,6557,371,42442,506,1105268000,319275000,250629000,188845000,775835000,211596000,33699000,1066195000,20819000
Vermont,"Professional, Scientific, and Technical Services",2009,10356,7220,1495,790,9505,430,100,10035,321,10705,7225,1500,795,9520,540,120,10180,525,96342,10029,9346,9257,29338,11456,5103,51123,28838,4924334000,486415000,464699000,497121000,1496477000,754093000,323380000,2797158000,1614157000
Vermont,Real Estate and Rental and Leasing,2009,3318,2465,350,200,3015,115,40,3170,148,3715,2470,350,260,3080,195,85,3360,355,14327,3319,1727,1872,7920,2020,226,12098,1289,450770000,115390000,60076000,55873000,252588000,76872000,8888000,376343000,45550000
Vermont,Retail Trade,2009,14005,6495,2999,1997,11491,1258,361,13110,895,18565,6515,3025,2165,11705,2055,1455,15215,3350,185716,11065,17097,20419,53090,30599,15200,106486,34502,4573162000,299213000,402858000,586452000,1318721000,978783000,420591000,3001351000,680956000
Vermont,Total,2009,18695,11224,3087,1901,16212,1450,358,18020,675,21567,11237,3109,2012,16358,2008,1067,19433,2134,264766,18743,20152,25071,63966,50769,42829,157564,107202,9085060000,641945000,598431000,756918000,1997294000,1712719000,1528825000,5238838000,3846222000
Vermont,Transportation and Warehousing,2009,2203,1280,250,175,1705,243,85,2033,170,2470,1280,250,175,1705,260,125,2090,380,24650,1486,1088,1625,5319,5347,1465,14818,4536,854121000,63267000,38243000,55313000,175098000,192263000,47180000,508778000,167310000
Vermont,Utilities,2009,125,40,10,10,60,10,23,93,32,270,40,10,10,60,15,80,155,115,7502,15,0,0,91,0,2004,2883,0,691885000,1445000,0,0,7222000,0,174274000,239072000,0
Vermont,Wholesale Trade,2009,3895,1688,555,370,2613,515,263,3391,504,4240,1690,555,375,2620,625,345,3590,650,47930,1563,2376,2628,9258,10993,6935,35560,7657,2277324000,96945000,96248000,135330000,410999000,451572000,375260000,1669222000,439681000
Virginia,Accommodation and Food Services,2009,58044,22375,11658,11274,45307,10032,1328,56667,1377,79925,22405,11680,11400,45485,11380,5210,62075,17850,1513938,38526,76946,151825,268726,353127,195086,818509,693717,22695545000,870510000,1071842000,2017985000,3959092000,5207098000,2599934000,11790250000,10881630000
Virginia,Administrative and Support and Waste Management and Remediation Services,2009,44654,25770,6682,4320,36772,4325,1621,42718,1936,51705,25785,6700,4355,36840,4890,2365,44095,7610,1167360,38566,42437,56450,141485,155476,203808,505599,652332,45262264000,1287996000,1256479000,1823832000,4395594000,5342864000,5777159000,15682543000,29257655000
Virginia,"Agriculture, Forestry, Fishing and Hunting",2009,3250,2285,660,175,3120,75,25,3220,30,3265,2285,660,175,3120,75,40,3235,30,18574,3959,4246,1944,10724,1264,0,15163,729,762142000,111409000,115183000,53471000,287181000,58495000,0,498320000,55482000
Virginia,"Arts, Entertainment, and Recreation",2009,12648,7268,1715,1325,10308,1715,342,12365,283,13620,7270,1715,1330,10315,1810,480,12605,1015,226647,8902,10644,17168,37577,67861,38000,152282,66172,5040505000,366835000,218195000,317216000,955138000,1213121000,967930000,3523160000,1134141000
Virginia,Construction,2009,107175,70275,17735,9820,97830,7583,1117,106530,645,108415,70280,17740,9825,97845,7765,1410,107020,1395,928255,116851,114008,132025,365425,276831,149676,796525,126677,39661320000,3560700000,3834963000,5042840000,12446575000,12223456000,7205039000,32083380000,7404735000
Virginia,Educational Services,2009,11737,5842,1830,1360,9032,1845,485,11362,375,12805,5845,1850,1385,9080,2005,615,11700,1105,340157,8482,11870,18143,39039,74101,73966,190079,142337,10414746000,298522000,260411000,356835000,928345000,2073419000,2586838000,5695470000,4521108000
Virginia,Finance and Insurance,2009,29566,19606,3688,1727,25021,1709,955,27685,1881,60880,19665,3910,2105,25680,3550,5285,34515,26365,749458,31607,21673,21011,76967,51559,73110,216035,509963,47884086000,1399578000,1037935000,1279262000,3791881000,3354247000,4527781000,12145997000,33937969000
Virginia,Health Care and Social Assistance,2009,70381,31310,16573,10324,58207,8512,1924,68643,1738,89040,31405,16730,10945,59080,11825,6070,76975,12065,1917922,58832,108514,137453,305598,314419,288125,917290,972843,83766930000,2882870000,4735327000,6191245000,13826587000,13357710000,10552212000,37925431000,44598886000
Virginia,Information,2009,9903,4540,1205,1095,6840,1276,634,8750,1153,18905,4555,1205,1105,6865,1465,915,9245,9660,465534,5834,6752,12804,27892,41613,45586,120310,346377,35827021000,392535000,324811000,795090000,1580775000,2662328000,3129049000,7822257000,28119841000
Virginia,Management of Companies and Enterprises,2009,4123,290,80,155,525,680,1197,2402,1721,5970,290,80,155,525,685,1300,2510,3460,291025,303,0,801,1353,7688,31628,40841,250095,25704610000,51380000,25680000,82890000,174090000,480378000,2146896000,2801364000,22898015000
Virginia,Manufacturing,2009,25285,9425,4305,3425,17155,4144,1635,22934,2351,27100,9425,4305,3445,17175,4400,1965,23540,3560,1033590,14032,24825,40012,85588,141420,130611,404397,532985,45719213000,549754000,791389000,1401871000,2917142000,5457881000,5349439000,15552926000,25384853000
Virginia,"Mining, Quarrying, and Oil and Gas Extraction",2009,1025,260,105,155,520,208,130,858,167,1525,260,105,155,520,235,215,970,555,50328,115,438,1760,2873,7204,9221,20917,27298,2810640000,18074000,25843000,81134000,138017000,329185000,395930000,960098000,1786158000
Virginia,Other,2009,314,304,6,3,313,1,0,314,0,314,304,6,3,313,1,0,314,0,331,239,33,32,304,0,0,331,0,6831000,6072000,324000,235000,6631000,0,0,6831000,0
Virginia,Other Services (except Public Administration),2009,97553,59027,20072,10180,89279,6574,900,96753,800,105670,59080,20175,10595,89850,7955,2410,100215,5455,821065,111208,131051,132941,377593,229364,85018,698009,98073,25987695000,2719480000,3173581000,3885326000,9786485000,7558309000,3916649000,21489875000,3606830000
Virginia,"Professional, Scientific, and Technical Services",2009,122219,82983,14936,9290,107209,8837,3122,119168,3051,141275,82990,15005,9430,107425,10385,4815,122625,18650,2003145,104691,97628,121182,337618,308649,340342,1002434,967494,159122988000,7363715000,5710900000,7657890000,20756757000,22924356000,27167057000,71212725000,85880379000
Virginia,Real Estate and Rental and Leasing,2009,32844,24497,3381,1787,29665,1491,776,31932,912,44470,24575,3505,2055,30135,2780,3100,36015,8455,267031,34486,20840,21827,79687,41643,49174,178773,79041,11137316000,1257405000,758592000,862919000,2901271000,1837569000,2069639000,7020080000,3776530000
Virginia,Retail Trade,2009,83285,45221,17156,9721,72098,6419,1897,80414,2871,140435,45435,17535,10770,73740,9865,6425,90030,50405,1918446,76038,107881,119267,302037,210081,126404,665273,1162305,47031647000,1956646000,2446920000,3008820000,7410569000,6486346000,4205992000,18689978000,27019641000
Virginia,Total,2009,150125,87765,25737,16188,129690,13712,3461,146863,3262,194018,87908,26022,16936,130866,17530,9439,157835,36183,3061186,150280,168869,214991,534140,498750,426472,1459362,1601824,137138223000,5388113000,5589441000,7615918000,18593472000,19942380000,19131571000,57667423000,79470800000
Virginia,Transportation and Warehousing,2009,20698,11999,2789,1799,16587,1759,825,19171,1527,24305,12005,2790,1855,16650,1955,1160,19765,4540,437815,16335,17208,21710,58704,52954,42975,157943,236467,16984811000,535979000,516326000,726821000,1822236000,1968709000,1563078000,5430125000,9815528000
Virginia,Utilities,2009,468,135,35,15,185,62,60,307,161,1690,135,35,15,185,65,195,445,1245,34581,0,90,0,496,1679,6987,9208,5652,3143500000,7355000,5562000,2166000,16621000,101878000,460074000,579671000,2838354000
Virginia,Wholesale Trade,2009,30010,14310,4260,3449,22019,3722,1737,27478,2532,37520,14330,4355,3565,22250,4555,3220,30025,7495,521705,20605,25341,41189,93844,109273,89920,306630,196924,29500735000,1145670000,1293691000,1979136000,4544802000,5410897000,4896073000,15339299000,13088066000
Washington,Accommodation and Food Services,2009,63597,25916,14615,12006,52537,8979,1214,62730,867,79780,26020,14665,12320,53005,11080,4320,68405,11375,1152885,42288,94652,159222,296255,301616,156222,754203,376906,19180785000,930843000,1219534000,2306570000,4457185000,4979845000,2660364000,12192422000,6941767000
Washington,Administrative and Support and Waste Management and Remediation Services,2009,39525,25185,6073,3300,34558,2830,774,38162,1363,43855,25185,6120,3380,34685,3065,1140,38890,4965,623613,35992,38727,41864,119226,98840,77482,316099,299682,23139174000,1219111000,1110555000,1358347000,3746040000,3245560000,2355593000,10075969000,12829886000
Washington,"Agriculture, Forestry, Fishing and Hunting",2009,6921,5120,765,425,6310,394,140,6844,77,7035,5120,765,425,6310,415,175,6900,135,60881,4223,4691,5024,16059,14028,16428,48294,6308,2495246000,328163000,187901000,209491000,741018000,503461000,622419000,1932953000,312548000
Washington,"Arts, Entertainment, and Recreation",2009,12499,6970,1815,1350,10135,1553,585,12273,226,13345,6970,1815,1360,10145,1600,980,12725,620,299057,7622,10754,16997,37376,62692,85256,196760,91080,7648140000,395026000,221000000,345538000,998667000,1152264000,1644734000,4023030000,2898183000
Washington,Construction,2009,110958,79014,15868,8374,103256,6275,824,110355,603,111765,79025,15870,8385,103280,6475,960,110715,1050,791655,119120,102887,109880,335460,230860,109040,679131,94916,40294225000,4058185000,3814592000,4900080000,12784965000,12025295000,7158888000,32168411000,7154786000
Washington,Educational Services,2009,10943,5585,1825,1453,8863,1443,375,10681,262,11590,5585,1825,1485,8895,1600,485,10980,610,242771,8227,11778,19591,39947,54995,39467,139554,100614,6301423000,244853000,240366000,408674000,904379000,1414096000,1147664000,3606946000,2606673000
Washington,Finance and Insurance,2009,26954,18105,3240,1428,22773,1504,942,25219,1735,53425,18150,3375,1645,23170,2730,4725,30625,22800,502247,28303,19034,16557,64447,45234,77866,195666,305403,33459184000,1353540000,920639000,1055620000,3408551000,3044440000,4291158000,10997817000,21991048000
Washington,Health Care and Social Assistance,2009,79271,41045,18215,9624,68884,6527,2358,77769,1502,93865,41100,18295,10030,69425,8995,6515,84935,8930,1793406,70946,118975,123931,318914,239955,332932,895849,869915,80449550000,2922407000,4595945000,5044757000,12515044000,9058128000,12816355000,34634039000,45007739000
Washington,Information,2009,9963,4825,1317,1095,7237,1143,521,8901,1062,15815,4825,1330,1120,7275,1270,715,9260,6555,573202,5700,7175,12123,27223,38983,45693,117665,266472,57977977000,318551000,373355000,702428000,1456426000,2368522000,3712138000,7709765000,22210079000
Washington,Management of Companies and Enterprises,2009,3796,390,105,170,665,720,1047,2432,1364,5025,390,105,170,665,730,1115,2510,2515,399240,456,477,832,1846,7601,27644,37250,360651,37333065000,83821000,39450000,88490000,214111000,478686000,1719387000,2412184000,34716837000
Washington,Manufacturing,2009,34358,14840,5940,4487,25267,5327,1735,32329,2029,35790,14845,5940,4495,25280,5500,2050,32830,2960,891995,22220,33321,51554,118798,183357,166584,520330,305686,42956091000,838958000,1219074000,2077849000,4362178000,7884983000,8156793000,22556389000,17187591000
Washington,"Mining, Quarrying, and Oil and Gas Extraction",2009,770,325,145,95,565,67,56,688,82,935,325,145,105,575,85,110,770,165,11445,318,845,815,2242,1508,2327,6830,3361,769075000,18452000,31275000,31959000,114446000,84531000,154125000,378653000,267856000
Washington,Other,2009,408,391,11,6,408,0,0,408,0,408,391,11,6,408,0,0,408,0,0,0,67,0,0,0,0,0,0,9322000,7082000,1524000,716000,9322000,0,0,9322000,0
Washington,Other Services (except Public Administration),2009,73574,46192,14891,7026,68109,4156,704,72969,605,80995,46215,14990,7280,68485,6090,1935,76510,4485,536140,81813,95577,87841,269881,134701,54549,468512,35203,14500436000,2048651000,2288217000,2280697000,6631425000,3640552000,1549938000,12047092000,1451150000
Washington,"Professional, Scientific, and Technical Services",2009,93533,66580,11695,6658,84933,4949,1551,91433,2100,99250,66585,11740,6830,85155,5610,2365,93130,6120,813224,94427,74927,86953,259570,161484,113766,538150,256739,54866246000,4791082000,3748665000,4902938000,13478785000,11423081000,8000551000,33055420000,20875897000
Washington,Real Estate and Rental and Leasing,2009,37707,29167,4045,1849,35061,1387,580,37028,679,48265,29230,4210,2190,35630,2540,2050,40220,8045,236468,41865,25056,23360,91026,42195,29371,168356,61078,8921347000,1271675000,796231000,867832000,2944167000,1490514000,1154927000,5849624000,2504780000
Washington,Retail Trade,2009,74473,39904,15762,8303,63969,6756,1549,72274,2199,110220,40020,16100,9195,65315,10500,6195,82010,28210,1510820,61920,95841,104754,272437,230359,109327,630881,788127,40614881000,1647751000,2322216000,2769686000,6760773000,7478417000,3684676000,18479372000,20817180000
Washington,Total,2009,145612,88625,25010,14635,128270,11592,2992,142854,2758,177276,88743,25280,15374,129397,15258,8259,152914,24362,2385282,145188,163882,193865,502935,418311,351036,1272282,1113000,110389623000,5055302000,5205445000,6666886000,16927633000,16171066000,14920422000,48019121000,62370502000
Washington,Transportation and Warehousing,2009,20964,11760,2800,1917,16477,1794,1048,19319,1645,24470,11760,2830,2000,16590,2100,1660,20350,4120,408617,16363,17591,22725,57888,49388,46372,164963,224742,18847685000,662813000,640429000,827716000,2177319000,1838520000,2044183000,6369107000,11567750000
Washington,Utilities,2009,1017,645,125,60,830,72,27,929,88,1540,645,130,60,835,120,70,1025,515,18802,1150,681,514,2355,205,0,4073,0,2115297000,25425000,20572000,30240000,93935000,167421000,0,208581000,12738000
Washington,Wholesale Trade,2009,39320,19740,6004,4054,29798,4598,2150,36546,2774,47375,19765,6095,4365,30225,5785,3730,39740,7635,628070,30171,36219,48832,118225,138883,108800,379544,216604,35276887000,1626537000,1782906000,2469321000,5940909000,7029316000,5499882000,18891700000,14872376000
West Virginia,Accommodation and Food Services,2009,13535,5115,2735,2500,10350,2213,537,13100,435,18205,5120,2745,2585,10450,2855,2000,15305,2900,301906,8788,17657,33986,61363,77989,58956,199006,102533,3690744000,141474000,190308000,375318000,713345000,942501000,691380000,2358620000,1334270000
West Virginia,Administrative and Support and Waste Management and Remediation Services,2009,6480,3421,1055,655,5131,600,202,5933,547,7245,3425,1055,660,5140,660,325,6125,1120,143949,4744,6063,7886,20211,17282,23794,66364,55179,3481948000,154315000,160204000,230300000,561762000,512818000,524831000,1715767000,1292935000
West Virginia,"Agriculture, Forestry, Fishing and Hunting",2009,1285,995,200,40,1235,25,10,1270,15,1295,995,200,40,1235,25,15,1275,20,4315,1725,1118,535,3385,0,0,4215,23,94203000,34670000,22444000,14640000,74640000,0,0,87190000,1750000
West Virginia,"Arts, Entertainment, and Recreation",2009,3244,1715,640,490,2845,276,54,3175,69,3430,1715,655,520,2890,380,65,3335,95,55111,2152,3899,5850,13504,8685,5330,29935,24542,1046193000,72950000,59119000,104622000,249792000,149306000,44681000,470964000,568831000
West Virginia,Construction,2009,18895,12455,3310,1645,17410,1129,230,18769,126,19010,12455,3310,1645,17410,1140,285,18835,175,135919,20113,20991,20762,64821,38796,19084,127407,6316,5441174000,551874000,566333000,754547000,1921935000,1731099000,1108488000,5005406000,337379000
West Virginia,Educational Services,2009,1333,610,220,170,1000,213,65,1278,55,1400,610,220,170,1000,230,90,1320,80,33258,304,1309,2191,4778,5830,11658,25656,9120,800210000,18915000,22750000,36200000,80672000,108727000,279723000,523794000,181451000
West Virginia,Finance and Insurance,2009,5927,3368,945,380,4693,446,156,5295,632,11235,3370,965,515,4850,1210,730,6790,4445,96953,6404,5612,4410,16869,15707,9866,45145,24521,3770329000,194239000,182571000,185471000,571958000,560700000,334934000,1548545000,2007783000
West Virginia,Health Care and Social Assistance,2009,17855,6820,4720,2581,14121,2180,917,17218,637,24080,6825,4725,2670,14220,3110,2745,20075,4005,584563,13815,30368,32854,79417,85674,115365,285447,292377,21650636000,524520000,996552000,1201737000,2759480000,2794821000,3122256000,8876277000,12446898000
West Virginia,Information,2009,1433,490,240,185,915,187,59,1161,272,3400,490,250,185,925,260,110,1295,2105,50733,547,1168,1871,3952,4792,921,14035,33121,1981022000,25101000,29091000,36232000,100843000,144980000,41766000,404502000,1503794000
West Virginia,Management of Companies and Enterprises,2009,816,50,10,25,85,195,240,520,296,1055,50,10,25,85,195,245,525,530,22930,0,0,0,0,2244,4542,7325,15602,1587415000,3363000,0,0,9439000,95942000,348694000,465245000,1121421000
West Virginia,Manufacturing,2009,6241,1895,1045,1005,3945,1112,494,5551,690,6670,1895,1045,1010,3950,1205,635,5790,880,197452,2430,5169,10165,19974,30862,25404,92281,94597,8627794000,78576000,144913000,305565000,587598000,1101864000,994487000,3288652000,4982793000
West Virginia,"Mining, Quarrying, and Oil and Gas Extraction",2009,2583,995,425,325,1745,386,238,2369,214,3500,995,435,325,1755,410,290,2455,1045,157218,455,2591,4245,8878,16172,29121,55807,99871,10088631000,72274000,80261000,167785000,329562000,722458000,1879617000,2947520000,7069056000
West Virginia,Other,2009,29,25,4,0,29,0,0,29,0,29,25,4,0,29,0,0,29,0,51,0,0,0,51,0,0,51,0,876000,542000,0,0,876000,0,0,876000,0
West Virginia,Other Services (except Public Administration),2009,21747,13940,4526,1860,20326,964,194,21484,263,23190,13945,4555,1950,20450,1295,290,22035,1155,128799,24965,28445,23381,78784,28159,4531,119671,5434,2682647000,454301000,489516000,491363000,1448561000,599982000,118453000,2377061000,207309000
West Virginia,"Professional, Scientific, and Technical Services",2009,13374,8040,2385,1145,11570,921,343,12834,540,14770,8050,2395,1180,11625,1180,585,13390,1380,120181,13161,14870,14316,44487,29298,15790,96662,20009,5209102000,439519000,524717000,549070000,1538800000,1417780000,738069000,3991008000,1148297000
West Virginia,Real Estate and Rental and Leasing,2009,5980,4275,790,335,5400,207,98,5705,275,7285,4290,840,360,5490,330,315,6135,1150,29743,7337,4123,3865,15952,3013,403,22981,5564,857772000,185062000,118303000,109452000,427231000,91134000,20474000,623471000,223180000
West Virginia,Retail Trade,2009,20995,10150,4295,2796,17241,2085,455,19781,1214,33725,10170,4385,3035,17590,3275,1845,22710,11015,370116,15738,24590,27623,76834,62591,27391,177511,167514,7682510000,353550000,540262000,804852000,1722894000,1588483000,614962000,4057630000,3475684000
West Virginia,Total,2009,30054,16006,5857,3470,25333,2795,761,28889,1165,38990,16027,5926,3656,25609,3915,2263,31787,7203,572960,30161,38343,46130,114634,100944,90133,305711,267249,18864009000,741929000,917546000,1232135000,2891610000,2991578000,2867534000,8750722000,10113287000
West Virginia,Transportation and Warehousing,2009,5631,3225,749,575,4549,519,129,5197,434,6340,3225,750,580,4555,535,170,5260,1080,62670,5062,4041,6400,16841,13935,3893,38792,12380,2298766000,144583000,111221000,194913000,468757000,463227000,147797000,1209087000,536911000
West Virginia,Utilities,2009,315,105,35,45,185,35,20,240,75,1145,105,35,45,185,85,20,290,855,27334,0,88,31,200,740,0,1526,22466,2026553000,4503000,2466000,535000,19364000,26542000,7293000,54075000,1756905000
West Virginia,Wholesale Trade,2009,6365,2275,1016,730,4021,941,373,5335,1030,7825,2280,1035,780,4095,1195,555,5845,1980,89919,3228,4744,7112,17744,19864,11472,57470,24222,4153956000,143560000,185073000,274777000,670555000,811042000,536777000,2292617000,1403386000
Wisconsin,Accommodation and Food Services,2009,58356,24091,11040,11033,46164,10365,971,57500,856,70135,24130,11070,11165,46365,12095,3165,61625,8510,1087839,39494,73219,150750,264043,367858,119070,751756,326839,13162220000,782486000,750873000,1483802000,3020811000,4207968000,1472999000,8713649000,4297396000
Wisconsin,Administrative and Support and Waste Management and Remediation Services,2009,28923,17615,4110,2753,24478,2421,824,27723,1200,33960,17620,4140,2770,24530,2745,1365,28640,5320,575986,24151,25281,34728,88727,86111,100065,288425,253761,15052199000,887554000,742666000,1017643000,2698214000,2292969000,1961437000,7298472000,6477010000
Wisconsin,"Agriculture, Forestry, Fishing and Hunting",2009,2435,1870,335,115,2320,60,35,2415,20,2460,1870,335,115,2320,60,50,2430,30,14658,2543,2094,687,6224,577,300,11588,0,528445000,72632000,53046000,19691000,176541000,16714000,10203000,402635000,0
Wisconsin,"Arts, Entertainment, and Recreation",2009,13093,7540,2034,1563,11137,1493,294,12924,169,13520,7540,2045,1580,11165,1640,350,13155,365,190938,10711,12920,20561,45121,53084,38931,138509,37607,3945499000,372611000,266726000,324346000,983213000,890026000,864246000,2754152000,648785000
Wisconsin,Construction,2009,73275,52460,11048,5395,68903,3624,426,72953,322,74090,52460,11060,5445,68965,3840,580,73385,705,469293,80676,71387,70960,224765,129310,52419,419634,40600,24579754000,3108436000,2815173000,3423343000,9376280000,7204241000,3553859000,21268328000,2693188000
Wisconsin,Educational Services,2009,6998,2860,1160,1040,5060,1450,190,6700,298,7475,2860,1160,1055,5075,1570,265,6910,565,264096,4190,7501,13666,25994,55423,22734,104587,155058,7756767000,108820000,130601000,236781000,480460000,1253373000,617765000,2444504000,5263227000
Wisconsin,Finance and Insurance,2009,24778,15945,2945,1475,20365,2123,869,23357,1421,47625,16045,2990,1730,20765,5270,4820,30855,16770,724976,24882,17791,18113,63241,75532,93294,234689,463743,41946836000,1051447000,745529000,822676000,2645412000,3458651000,4658394000,10926718000,30967597000
Wisconsin,Health Care and Social Assistance,2009,51557,22082,11350,7564,40996,6439,2382,49817,1740,72515,22125,11560,8015,41700,9625,7000,58325,14190,1882719,40101,74729,101007,217656,242492,342137,807389,1051169,75737485000,2100633000,2831905000,3774136000,8706403000,9462393000,9499591000,27863924000,47038356000
Wisconsin,Information,2009,5754,2325,820,677,3822,877,291,4990,764,11320,2325,820,705,3850,1210,590,5650,5670,244496,3080,5077,8617,17960,28260,20632,70906,170294,12077314000,153331000,180052000,325125000,675656000,1151774000,859018000,2866048000,9177992000
Wisconsin,Management of Companies and Enterprises,2009,3515,230,90,145,465,685,1077,2227,1288,5100,230,90,150,470,695,1115,2280,2820,324500,0,0,950,1699,6820,30395,38935,285457,26050390000,30735000,24630000,43758000,99278000,315605000,1788705000,2203855000,23839158000
Wisconsin,Manufacturing,2009,42442,13629,6635,6446,26710,8846,3581,39137,3305,46090,13635,6635,6520,26790,9320,4580,40690,5400,2063194,21184,40556,79534,152818,343105,423499,977047,971113,91900148000,826069000,1319781000,2942633000,5326115000,13640487000,17907856000,39083288000,48138008000
Wisconsin,"Mining, Quarrying, and Oil and Gas Extraction",2009,644,280,115,70,465,80,52,597,47,750,280,115,80,475,85,115,675,75,10583,251,653,945,1923,1423,2925,6769,1959,780942000,21314000,38076000,62281000,128695000,96974000,152219000,412230000,357619000
Wisconsin,Other,2009,336,329,6,1,336,0,0,336,0,336,329,6,1,336,0,0,336,0,0,0,33,0,0,0,0,0,0,4160000,3979000,161000,0,4160000,0,0,4160000,0
Wisconsin,Other Services (except Public Administration),2009,69126,40190,15255,7925,63370,4631,545,68546,580,74515,40235,15400,8245,63880,6135,1375,71390,3125,543100,75566,98405,100901,278056,152789,37544,477415,60903,12388072000,1660155000,2003194000,2006764000,5683577000,3464116000,1086080000,10466715000,1809663000
Wisconsin,"Professional, Scientific, and Technical Services",2009,52695,34145,7860,4936,46941,3519,879,51339,1356,56730,34175,7955,5085,47215,4220,1505,52940,3790,506833,47087,49760,63770,166851,115577,61229,354738,133140,26702674000,2114251000,2125081000,2808447000,7111772000,6147797000,4144016000,17829719000,8335507000
Wisconsin,Real Estate and Rental and Leasing,2009,18877,13750,2340,1193,17283,767,423,18473,404,23385,13775,2415,1290,17480,1185,1890,20555,2830,127439,19459,14020,13515,51203,22334,18361,97869,24198,3886581000,613174000,412750000,435182000,1503741000,728181000,676368000,3095858000,659795000
Wisconsin,Retail Trade,2009,66686,32995,13916,8741,55652,7129,1663,64444,2242,99485,33140,14295,9725,57160,10710,6295,74165,25320,1422809,59163,88763,112651,263723,235625,148231,670480,699450,31672857000,1352394000,1906596000,2566272000,5849485000,6120139000,3590312000,15817154000,15182251000
Wisconsin,Total,2009,111758,62000,19717,13309,95026,11666,2655,109347,2411,140861,62119,19968,13995,96082,15700,7921,119703,21158,2355879,105652,129892,178720,414264,437723,369533,1221520,1134359,89374061000,3408535000,3680282000,5198735000,12287552000,14245010000,13486593000,40019155000,49354906000
Wisconsin,Transportation and Warehousing,2009,23414,13435,3209,2322,18966,2350,782,22098,1316,26470,13460,3210,2375,19045,2635,1150,22830,3640,478565,18328,20089,29274,70853,78869,60731,215023,250783,17387206000,670118000,639641000,948449000,2278206000,2586643000,2028612000,7092884000,9966454000
Wisconsin,Utilities,2009,362,80,20,25,125,125,10,260,102,1450,80,20,30,130,180,20,330,1120,68418,60,117,313,518,4324,0,5665,60127,5451963000,2608000,4598000,20858000,29390000,231793000,0,309373000,5119296000
Wisconsin,Wholesale Trade,2009,29400,12925,4407,3704,21036,4260,1900,27196,2204,35550,12965,4495,3890,21350,5280,3375,30005,5545,543687,19740,27195,44880,97587,130311,119175,359606,157747,26597975000,978978000,1186743000,2085408000,4356589000,6167430000,5581420000,16683239000,8634971000
Wyoming,Accommodation and Food Services,2009,7583,2835,1395,1560,5790,1332,258,7380,203,8615,2835,1400,1575,5810,1605,635,8050,565,136577,4274,9117,20623,34120,47823,31680,113928,11603,2200578000,118549000,122572000,267871000,510484000,678976000,518496000,1707117000,331496000
Wyoming,Administrative and Support and Waste Management and Remediation Services,2009,4444,2835,780,318,3933,205,65,4203,241,4695,2835,795,325,3955,235,65,4255,440,32258,3014,4435,3082,12656,4705,723,19439,3596,833916000,136608000,117455000,84522000,366958000,112271000,10660000,512632000,248396000
Wyoming,"Agriculture, Forestry, Fishing and Hunting",2009,405,325,55,15,395,5,0,400,5,405,325,55,15,395,5,0,400,5,487,151,139,140,611,0,0,683,0,28956000,10132000,8360000,4808000,25044000,0,0,27312000,0
Wyoming,"Arts, Entertainment, and Recreation",2009,2050,1455,200,185,1840,175,20,2035,15,2100,1455,200,185,1840,205,30,2075,25,17634,1597,979,2063,5597,5707,627,13768,0,358343000,81004000,15135000,31934000,140021000,100232000,16642000,316390000,0
Wyoming,Construction,2009,14432,9700,2405,1300,13405,817,129,14351,81,14475,9700,2405,1300,13405,825,145,14375,100,97857,15456,15311,16215,49553,26371,8969,89762,5377,4412604000,560754000,551476000,688117000,1824554000,1343096000,559568000,3872619000,344182000
Wyoming,Educational Services,2009,817,470,115,100,685,67,25,777,40,860,470,115,100,685,70,60,815,45,7962,476,542,990,2567,2161,850,7341,0,220181000,17123000,10065000,17251000,50831000,60591000,29572000,197094000,0
Wyoming,Finance and Insurance,2009,3124,1955,330,175,2460,258,59,2777,347,5050,1960,335,225,2520,745,175,3440,1610,34720,2751,1646,2008,7168,9238,1769,19919,13369,1546368000,103487000,68603000,56153000,241767000,419862000,77721000,830567000,649510000
Wyoming,Health Care and Social Assistance,2009,8076,4012,1748,1004,6764,787,289,7840,236,8800,4020,1755,1005,6780,1065,530,8375,425,151554,5283,10819,12435,30959,25543,42261,106747,40763,6057915000,357420000,418359000,473608000,1280120000,986009000,1703136000,4157834000,1796537000
Wyoming,Information,2009,1066,345,185,125,655,207,75,937,129,1565,350,195,125,670,285,140,1095,470,18278,86,463,992,2231,5199,1098,12419,3570,650041000,13546000,17351000,28071000,92335000,149773000,48884000,383927000,239969000
Wyoming,Management of Companies and Enterprises,2009,366,50,15,10,75,95,80,250,116,420,50,15,10,75,95,85,255,165,5910,96,0,0,210,1188,2260,3721,0,376985000,2873000,3740000,0,8940000,62573000,135563000,213316000,0
Wyoming,Manufacturing,2009,2632,1275,420,295,1990,310,112,2412,220,2705,1275,420,295,1990,330,140,2460,245,32960,1074,1385,1851,5781,5913,1609,20240,11025,1654419000,47906000,45867000,83093000,204274000,250750000,80675000,846000000,734482000
Wyoming,"Mining, Quarrying, and Oil and Gas Extraction",2009,3735,1740,685,400,2825,372,118,3315,420,4260,1740,685,400,2825,385,165,3375,885,122807,2125,3990,5059,11458,11552,6037,32305,81309,8279220000,136769000,208272000,259199000,612697000,719333000,377978000,1791642000,5911716000
Wyoming,Other,2009,53,47,3,1,51,2,0,53,0,53,47,3,1,51,2,0,53,0,124,0,0,0,78,0,0,124,0,1632000,1041000,0,0,1563000,0,0,1632000,0
Wyoming,Other Services (except Public Administration),2009,8716,5645,1775,815,8235,240,105,8580,136,8995,5645,1775,845,8265,310,120,8695,300,42607,9775,10383,9308,31054,5074,1012,39908,1297,1170284000,269864000,257708000,252349000,803175000,150789000,44431000,1059580000,62438000
Wyoming,"Professional, Scientific, and Technical Services",2009,9640,6900,1335,640,8875,370,135,9380,260,9925,6910,1335,650,8895,445,195,9535,390,44599,9164,7638,8280,26550,8840,2297,41537,2731,2074095000,434773000,333992000,389068000,1173922000,438925000,139020000,1915361000,129310000
Wyoming,Real Estate and Rental and Leasing,2009,4744,3705,455,210,4370,125,65,4560,184,5355,3705,455,210,4370,195,245,4810,545,20943,4032,2495,2219,9149,1477,279,14715,4962,770073000,161372000,75613000,80143000,328147000,67856000,31547000,463043000,298651000
Wyoming,Retail Trade,2009,10826,5220,2302,1313,8835,970,342,10147,679,13940,5220,2365,1435,9020,1340,880,11240,2700,130767,6288,12011,14578,38712,25219,7410,80535,41818,3315344000,203930000,315572000,377889000,946566000,745938000,290425000,2096667000,974141000
Wyoming,Total,2009,17716,10472,3048,1806,15326,1336,379,17041,675,20360,10485,3076,1876,15437,1799,844,18080,2280,214715,17849,19742,23792,61383,44893,32858,139134,75581,8244330000,593789000,588234000,726480000,1908503000,1529730000,1233167000,4671400000,3572930000
Wyoming,Transportation and Warehousing,2009,3977,2460,610,245,3315,255,92,3662,315,4640,2465,615,250,3330,275,195,3800,840,42042,2604,3511,846,10183,6803,1276,23379,11502,1840366000,122493000,124446000,74135000,360831000,271537000,85054000,873479000,750458000
Wyoming,Utilities,2009,242,75,20,10,105,50,10,165,77,620,75,20,20,115,75,45,235,385,11352,0,0,0,26,1484,0,2865,8689,880840000,227000,1670000,0,5687000,95073000,0,178980000,711452000
Wyoming,Wholesale Trade,2009,3167,1135,410,392,1937,398,242,2577,590,4110,1155,425,405,1985,495,370,2850,1260,40121,1271,1408,3514,7935,7653,3034,21509,16581,2077878000,65350000,93792000,158993000,365190000,315971000,156631000,915524000,1036340000
