state_name,industry_name,YEAR,firms_01: Total,firms_02: <5,firms_03: 5-9,firms_04: 10-19,firms_05: <20,firms_06: 20-99,firms_07: 100-499,firms_08: <500,firms_09: 500+,establishments_01: Total,establishments_02: <5,establishments_03: 5-9,establishments_04: 10-19,establishments_05: <20,establishments_06: 20-99,establishments_07: 100-499,establishments_08: <500,establishments_09: 500+,employment_01: Total,employment_02: <5,employment_03: 5-9,employment_04: 10-19,employment_05: <20,employment_06: 20-99,employment_07: 100-499,employment_08: <500,employment_09: 500+,annual_payroll_01: Total,annual_payroll_02: <5,annual_payroll_03: 5-9,annual_payroll_04: 10-19,annual_payroll_05: <20,annual_payroll_06: 20-99,annual_payroll_07: 100-499,annual_payroll_08: <500,annual_payroll_09: 500+
Alabama,Accommodation and Food Services,2007,27990,11053,4910,4990,20953,5488,768,27209,781,40410,11085,4920,5045,21050,6820,3270,31140,9270,762721,17502,32293,67753,117926,199970,110074,430098,331458,9094428000,366464000,342651000,676323000,1392812000,2182375000,1258465000,4848197000,4231388000
Alabama,Administrative and Support and Waste Management and Remediation Services,2007,18711,10035,3230,1779,15044,1663,746,17453,1258,21180,10040,3245,1805,15090,1845,980,17915,3265,685052,15767,19558,22312,60128,58143,91636,220652,447379,15303448000,535522000,480091000,628406000,1683285000,1526435000,2118390000,5534246000,9443402000
Alabama,"Agriculture, Forestry, Fishing and Hunting",2007,4556,2175,1365,660,4200,255,35,4490,66,4645,2175,1365,660,4200,270,50,4520,125,34032,4275,8316,8127,21215,7498,2710,32650,953,1064934000,118781000,250055000,251126000,622117000,252751000,38538000,960882000,55743000
Alabama,"Arts, Entertainment, and Recreation",2007,5351,2870,935,595,4400,724,132,5256,95,5640,2870,935,595,4400,790,205,5395,245,85951,3983,5676,7675,18478,23336,14354,61788,8438,1478675000,99008000,99300000,111807000,325576000,390673000,276394000,1083072000,183236000
Alabama,Construction,2007,51724,29785,9720,6175,45680,4986,631,51297,427,52295,29785,9720,6175,45680,5095,655,51430,865,571280,50055,64117,81919,198010,191425,87949,479278,74405,21389250000,1610770000,1728210000,2540370000,5879350000,7297475000,3767574000,17058390000,3660296000
Alabama,Educational Services,2007,4051,1825,645,535,3005,700,193,3898,153,4315,1825,645,545,3015,765,260,4040,275,135366,2437,3932,6447,13962,29118,30125,74606,57820,3329977000,61388000,68012000,76639000,214461000,608027000,706142000,1549561000,1682754000
Alabama,Finance and Insurance,2007,17419,11145,2222,1055,14422,1277,498,16197,1222,36305,11160,2340,1610,15110,3560,2900,21570,14735,348271,17722,12979,12363,43327,44580,35902,128800,150659,18972663000,738908000,486739000,575364000,1843282000,1872686000,1698959000,5538041000,13057878000
Alabama,Health Care and Social Assistance,2007,40874,16713,10405,6536,33654,4579,1525,39758,1116,51995,16720,10470,6855,34045,6320,5250,45615,6380,1172352,32550,68926,85782,188448,165271,205297,563920,595551,44367599000,1794193000,2832700000,3470410000,8114355000,6943606000,6402747000,21555741000,22360903000
Alabama,Information,2007,4223,1795,670,539,3004,412,235,3651,572,8445,1800,675,545,3020,485,515,4020,4425,183395,2322,3628,4871,12338,11548,1887,44401,124752,8352043000,91602000,112701000,195933000,472095000,488331000,255044000,1623956000,6776723000
Alabama,Management of Companies and Enterprises,2007,2268,90,50,55,195,491,662,1348,920,2885,90,50,55,195,505,710,1410,1475,93780,0,37,240,664,5447,16230,22469,71230,6764980000,17520000,2090000,9948000,57113000,289385000,761075000,1107910000,5657070000
Alabama,Manufacturing,2007,22611,7310,3575,3119,14004,4283,1723,20010,2601,24625,7310,3575,3125,14010,4350,1985,20345,4280,1269780,11280,19773,34968,73485,153637,160314,428841,742110,50849724000,422265000,577146000,1135876000,2305213000,5339105000,5864851000,14854632000,32039217000
Alabama,"Mining, Quarrying, and Oil and Gas Extraction",2007,1043,280,90,160,530,205,75,810,233,1290,280,90,160,530,215,100,845,445,37130,268,472,1921,2998,6069,3957,15883,20963,2163877000,38682000,13943000,64203000,130399000,267215000,222167000,764481000,1388317000
Alabama,Other,2007,102,90,6,4,100,2,0,102,0,102,90,6,4,100,2,0,102,0,214,55,0,54,147,0,0,214,0,3448000,2055000,328000,669000,3052000,0,0,3448000,0
Alabama,Other Services (except Public Administration),2007,53224,31895,11569,5148,48612,3642,476,52730,494,57785,31930,11685,5415,49030,4880,1200,55110,2675,429283,60678,74116,66419,203482,120971,39130,371799,40949,8880602000,1201801000,1335165000,1309139000,3864219000,2272693000,892409000,7190683000,1290902000
Alabama,"Professional, Scientific, and Technical Services",2007,44657,29315,6685,3850,39850,2841,917,43608,1049,48545,29330,6715,3895,39940,3455,1290,44685,3860,496462,42812,40900,46991,140448,93161,66184,313118,168741,26614043000,1816833000,1742460000,2293276000,5877531000,5347479000,4283143000,15944186000,10151194000
Alabama,Real Estate and Rental and Leasing,2007,17170,12622,1961,1050,15633,708,386,16727,443,22245,12625,2030,1225,15880,1365,1025,18270,3975,132385,19484,12240,12235,46054,19818,21866,91571,32780,4064345000,565740000,355095000,374457000,1320382000,655151000,719690000,2777553000,1125478000
Alabama,Retail Trade,2007,62955,34732,12838,7045,54615,5049,1132,60796,2159,98350,34805,13130,7975,55910,8455,4600,68965,29385,1132373,58659,78599,90088,232090,168049,89591,504459,582535,24994218000,1297249000,1731497000,2149410000,5204111000,4624298000,2540720000,12526099000,11579900000
Alabama,Total,2007,81565,44431,15297,9449,69177,8102,1985,79264,2301,105627,44488,15480,10028,69996,10998,5596,86590,19037,1722834,80341,100581,125752,306674,300811,241406,848891,873943,58263271000,2417475000,2735285000,3668059000,8820819000,9535422000,8035487000,26391728000,31871543000
Alabama,Transportation and Warehousing,2007,14170,8095,1870,1239,11204,1388,529,13121,1049,16380,8095,1880,1260,11235,1555,670,13460,2920,288051,12329,11018,15231,39554,44423,32013,123417,140800,10511901000,379885000,318538000,427140000,1159786000,1364126000,1243835000,3968168000,5652049000
Alabama,Utilities,2007,502,160,150,15,325,100,15,440,62,1945,160,150,15,325,205,60,590,1355,32435,357,894,190,1441,5659,2040,9182,0,2562274000,6881000,29612000,6165000,48301000,315442000,109390000,475447000,7184000
Alabama,Wholesale Trade,2007,23157,9875,3695,2975,16545,3160,1283,20988,2169,28345,9905,3750,3160,16815,4045,2255,23115,5230,390691,14779,22543,34448,75754,91877,60964,240017,125645,17712253000,736271000,909754000,1536514000,3251298000,4051996000,2851238000,10536708000,6424870000
Alaska,Accommodation and Food Services,2007,8780,4555,1703,1148,7406,1063,167,8636,144,10085,4555,1715,1160,7430,1320,685,9435,650,127248,5628,10514,15118,32490,37892,22474,93928,30266,2695940000,242294000,192679000,223479000,663262000,645860000,400112000,1756250000,899382000
Alaska,Administrative and Support and Waste Management and Remediation Services,2007,4719,2735,790,385,3910,303,163,4376,343,5370,2735,800,405,3940,395,280,4615,755,110139,2944,4290,3572,12566,6493,6018,33837,65404,4901397000,153331000,149001000,104632000,449245000,313013000,210176000,1302268000,3040889000
Alaska,"Agriculture, Forestry, Fishing and Hunting",2007,1700,1615,25,10,1650,40,0,1690,10,1715,1620,25,10,1655,45,0,1700,15,3196,155,35,0,260,1028,0,1605,0,199259000,66796000,758000,0,75921000,65030000,0,152449000,0
Alaska,"Arts, Entertainment, and Recreation",2007,2530,1800,280,210,2290,205,20,2515,15,2660,1800,280,230,2310,235,35,2580,80,19972,1422,1664,2418,5617,5142,0,15418,0,337696000,90148000,31470000,43639000,170132000,83933000,0,292581000,0
Alaska,Construction,2007,13226,9360,1900,1083,12343,657,82,13082,144,13565,9360,1900,1085,12345,700,120,13165,400,81000,8090,11528,13170,38150,17559,4576,66211,8970,6311102000,822163000,688164000,875469000,2459485000,1621222000,560240000,4866365000,936389000
Alaska,Educational Services,2007,1080,620,180,110,910,105,35,1050,30,1230,620,180,115,915,110,160,1185,45,12859,582,941,1273,3706,3256,1978,12263,228,315978000,23337000,17256000,37426000,93396000,63658000,46180000,293890000,8404000
Alaska,Finance and Insurance,2007,2337,1260,325,141,1726,140,104,1970,367,4000,1260,330,145,1735,285,340,2360,1640,31893,1845,1747,1222,5185,3135,0,12932,13473,1869128000,84942000,86064000,69320000,251136000,167516000,118267000,793519000,881398000
Alaska,Health Care and Social Assistance,2007,9141,4485,2045,1280,7810,805,335,8950,191,10595,4485,2050,1315,7850,1130,850,9830,765,186136,7686,12840,15257,36999,26469,41267,112972,58703,8607366000,457015000,603570000,846724000,1954590000,1143040000,1347136000,4749628000,2986364000
Alaska,Information,2007,1037,425,165,108,698,111,90,899,138,1960,425,170,130,725,205,190,1120,840,30577,266,444,485,1332,2115,1351,5242,7325,1824992000,16608000,23279000,26288000,74900000,101393000,60149000,232347000,933893000
Alaska,Management of Companies and Enterprises,2007,542,55,15,35,105,120,120,345,197,690,55,15,35,105,125,145,375,315,16255,47,0,128,208,1038,3048,5042,11023,1913135000,2960000,0,8024000,16490000,60404000,179340000,302780000,1597189000
Alaska,Manufacturing,2007,2288,1190,390,285,1865,238,25,2128,160,2530,1195,390,285,1870,250,40,2160,370,44026,627,1129,2513,5198,5321,0,16092,26848,1993395000,86797000,67701000,125804000,328833000,220688000,0,717979000,1229262000
Alaska,"Mining, Quarrying, and Oil and Gas Extraction",2007,515,205,35,30,270,70,46,386,129,590,205,40,30,275,70,55,400,190,39235,21,40,294,739,887,3563,7859,30652,3230289000,11614000,6710000,11837000,38188000,49210000,474215000,722739000,2467914000
Alaska,Other,2007,23,23,0,0,23,0,0,23,0,23,23,0,0,23,0,0,23,0,0,0,0,0,0,0,0,0,0,237000,237000,0,0,237000,0,0,237000,0
Alaska,Other Services (except Public Administration),2007,8401,5130,1795,830,7755,373,110,8238,163,8970,5130,1810,910,7850,490,270,8610,360,51915,8013,11098,8452,31928,10050,2948,48801,1282,1474636000,254448000,300041000,274311000,892097000,282980000,76271000,1368392000,44283000
Alaska,"Professional, Scientific, and Technical Services",2007,8622,5635,1170,720,7525,530,163,8218,404,9400,5635,1175,760,7570,690,205,8465,935,67177,7255,6884,8168,24175,12266,3581,45194,17429,4097017000,420836000,376757000,556596000,1380916000,954331000,277765000,2853992000,1084199000
Alaska,Real Estate and Rental and Leasing,2007,3893,2785,520,195,3500,210,78,3788,105,4355,2790,520,210,3520,360,110,3990,365,23398,3262,2480,1659,9108,4414,3751,19635,703,839401000,145677000,99407000,58868000,323783000,136996000,154448000,711364000,25477000
Alaska,Retail Trade,2007,10355,5267,2029,1379,8675,941,209,9825,530,13340,5325,2105,1605,9035,1400,550,10985,2355,153425,5005,11185,14306,36217,22888,11276,79514,32018,4349848000,261994000,307914000,444921000,1069215000,791923000,458852000,2542125000,965964000
Alaska,Total,2007,16786,10201,2854,1667,14722,1216,316,16254,532,20198,10225,2894,1833,14952,1790,989,17731,2467,244621,15376,18779,22004,56159,42888,35763,134810,109811,11400670000,710368000,681730000,882203000,2274301000,1817213000,1468049000,5559563000,5841107000
Alaska,Transportation and Warehousing,2007,4297,2580,538,275,3393,283,228,3904,393,5670,2585,540,305,3430,485,565,4480,1190,80608,1690,2187,2094,7083,7104,12718,32703,43198,5009310000,191089000,97975000,99694000,422566000,300317000,551676000,1561677000,2832065000
Alaska,Utilities,2007,281,85,50,53,188,55,33,276,5,445,85,50,115,250,60,115,425,20,8024,95,143,339,635,1587,3487,7656,0,586256000,5508000,4916000,26860000,39444000,144309000,272520000,555936000,0
Alaska,Wholesale Trade,2007,2912,1145,370,275,1790,459,146,2395,517,3705,1145,375,315,1835,595,230,2660,1045,37385,650,1446,2221,5698,8259,1544,18977,12635,2030200000,64040000,78477000,100361000,303450000,399926000,91770000,977165000,788138000
Arizona,Accommodation and Food Services,2007,40571,14448,7445,7503,29396,8765,1260,39421,1150,57635,14510,7475,7580,29565,10375,4035,43975,13660,1275149,22450,50108,101950,175104,330850,178611,689547,581459,19172415000,591984000,547206000,1222290000,2365854000,4262037000,2502114000,9167463000,9891450000
Arizona,Administrative and Support and Waste Management and Remediation Services,2007,37967,21570,5615,3665,30850,3825,1499,36174,1793,42485,21575,5625,3745,30945,4055,1850,36850,5635,1309983,28858,36286,47484,115702,146384,220807,500379,794474,35919484000,1145840000,947174000,1306136000,3393381000,3794170000,5382774000,13014570000,22310342000
Arizona,"Agriculture, Forestry, Fishing and Hunting",2007,980,660,160,65,885,65,25,975,5,1005,660,160,65,885,90,25,1000,5,6700,860,363,503,2675,1489,0,6550,0,168836000,31201000,19253000,10418000,73752000,46984000,31140000,165346000,0
Arizona,"Arts, Entertainment, and Recreation",2007,8230,4490,1145,825,6460,1110,424,7994,236,9250,4495,1150,865,6510,1145,765,8420,830,213450,3412,4228,9109,16852,43887,64578,139822,55285,6387270000,254821000,99207000,164073000,525555000,763480000,2797977000,4336660000,1541708000
Arizona,Construction,2007,83128,46490,14470,10130,71090,9453,1747,82290,838,83905,46490,14470,10135,71095,9505,1890,82490,1415,1186260,72222,95089,137330,306633,370945,258360,948795,205063,46519660000,2773897000,2913306000,4685620000,10385295000,13532071000,10283284000,34354488000,10679144000
Arizona,Educational Services,2007,8019,3810,1160,1035,6005,1445,308,7758,261,8955,3815,1160,1035,6010,1580,495,8085,870,223305,4787,7322,13269,25313,58667,37872,126694,93482,7409705000,206784000,162589000,290973000,670201000,1529685000,1246503000,3551312000,3733253000
Arizona,Finance and Insurance,2007,29630,20135,3470,1334,24939,1511,971,27421,2209,53025,20165,3560,1470,25195,2415,2485,30095,22930,708841,28418,19360,14632,63339,42524,52010,167243,512589,38883126000,1180914000,817167000,729511000,2776875000,2294140000,2411421000,8150983000,29069996000
Arizona,Health Care and Social Assistance,2007,62510,34335,12960,7064,54359,5082,1596,61037,1473,77480,34375,13060,7315,54750,7155,5185,67090,10390,1373271,54117,84549,89803,228795,187142,222080,633460,660384,59131852000,3551250000,3536235000,3921374000,11075837000,7819652000,8027241000,27279468000,30281556000
Arizona,Information,2007,7006,3635,970,525,5130,646,315,6091,915,11625,3635,975,540,5150,705,470,6325,5300,248791,3964,4947,4816,16270,18574,15373,60831,172552,13820802000,231506000,213069000,261195000,774942000,963033000,907243000,3119986000,10028031000
Arizona,Management of Companies and Enterprises,2007,3077,305,45,45,395,531,761,1687,1390,4240,305,45,45,395,550,830,1775,2465,308368,0,171,248,656,6829,22177,29695,278673,21609960000,36428000,8636000,17960000,74030000,321022000,1338515000,1734395000,19564611000
Arizona,Manufacturing,2007,23967,9425,4010,3400,16835,4125,1234,22194,1773,25190,9425,4010,3405,16840,4220,1420,22480,2710,797347,11139,22563,36233,77615,139210,98021,365748,368373,39588501000,557031000,726396000,1343502000,2822272000,5503350000,3634370000,13691656000,23151091000
Arizona,"Mining, Quarrying, and Oil and Gas Extraction",2007,912,370,110,130,610,160,32,802,110,1230,370,110,130,610,185,55,850,380,33791,273,453,1027,2371,7030,1132,11797,21585,1716867000,24327000,26223000,32532000,110243000,279747000,67124000,499230000,1196055000
Arizona,Other,2007,134,123,7,3,133,1,0,134,0,134,123,7,3,133,1,0,134,0,202,97,42,0,183,0,0,202,0,2963000,2375000,514000,0,2958000,0,0,2963000,0
Arizona,Other Services (except Public Administration),2007,49918,29805,9734,5355,44894,3643,733,49270,648,56120,29825,9785,5595,45205,4845,2255,52305,3815,459093,51470,62583,68224,184998,127658,60639,381599,54336,11118145000,1364642000,1455220000,1712720000,4540173000,2977722000,1470309000,9206924000,1424659000
Arizona,"Professional, Scientific, and Technical Services",2007,79450,57461,9290,5465,72216,3909,1426,77551,1899,85095,57475,9315,5565,72355,4330,2175,78860,6235,688096,71263,59052,69892,197309,117012,91254,431570,232028,38448710000,4153397000,2780009000,3554813000,10548729000,6675603000,5323057000,23634723000,14280850000
Arizona,Real Estate and Rental and Leasing,2007,38599,30585,3450,1760,35795,1471,516,37782,817,47150,30600,3545,1940,36085,2400,1310,39795,7355,267963,35527,21818,20640,81717,41769,33720,167198,96316,10821013000,1643481000,731901000,747844000,3164829000,1766708000,1342334000,6552324000,4168554000
Arizona,Retail Trade,2007,58033,31240,11285,6654,49179,4630,1592,55401,2632,96705,31345,11570,7530,50445,7650,5615,63710,32995,1658144,41936,62594,69620,179355,153297,131776,477641,1021090,40138046000,1342005000,1487176000,1826910000,4654512000,4649496000,5319215000,15500732000,23896031000
Arizona,Total,2007,113298,66541,18302,11840,96683,10740,2901,110324,2974,142925,66616,18479,12305,97400,13330,6833,117563,25362,2404089,103528,120860,157465,381853,403742,352371,1137966,1266123,90797015000,4262854000,3720985000,4998057000,12981896000,13176113000,12411391000,38569400000,52227615000
Arizona,Transportation and Warehousing,2007,14520,8070,1985,1361,11416,1216,608,13240,1280,16890,8070,1990,1380,11440,1340,745,13525,3365,331126,7801,10899,16114,35764,33236,33572,116127,200549,12095202000,381543000,338000000,517659000,1307727000,1187982000,1142894000,3734900000,7870073000
Arizona,Utilities,2007,788,435,115,55,605,57,50,712,76,1145,435,120,55,610,85,155,850,295,4137,870,288,553,2158,0,4368,10639,147,659754000,22408000,22884000,19104000,66905000,0,304426000,650442000,8138000
Arizona,Wholesale Trade,2007,29827,14880,4178,3035,22093,3510,1575,27178,2649,34825,14895,4235,3115,22245,4015,2405,28665,6160,493224,20249,22569,32700,79791,85668,72978,258245,214233,26124444000,1093680000,1034173000,1562415000,3732425000,4022917000,3393666000,11896074000,13636681000
Arkansas,Accommodation and Food Services,2007,20093,7235,3755,3675,14665,4283,563,19511,582,26025,7255,3780,3740,14775,5000,2040,21815,4210,451588,10815,25282,49586,86508,153945,66058,309963,141384,5073125000,223425000,255102000,507984000,990175000,1584678000,686677000,3321610000,1748998000
Arkansas,Administrative and Support and Waste Management and Remediation Services,2007,11126,6450,1670,985,9105,1017,325,10447,679,12485,6450,1690,995,9135,1180,495,10810,1675,292045,9029,10196,11022,32942,35474,38356,113982,163607,6336104000,266579000,236883000,278829000,814958000,781653000,773910000,2514591000,3429968000
Arkansas,"Agriculture, Forestry, Fishing and Hunting",2007,3746,2215,845,410,3470,165,20,3655,91,3885,2215,845,410,3470,180,20,3670,215,26230,3948,5247,4467,14641,4605,0,20375,3035,791471000,126844000,164158000,152815000,451517000,139539000,1700000,602287000,122135000
Arkansas,"Arts, Entertainment, and Recreation",2007,4014,2440,575,450,3465,412,82,3959,55,4125,2440,575,460,3475,465,110,4050,75,43320,2564,3474,5171,13062,13016,9235,37174,0,689757000,92841000,41216000,79224000,224615000,205927000,139272000,595991000,0
Arkansas,Construction,2007,31922,19915,5735,3345,28995,2453,270,31718,204,32190,19915,5735,3345,28995,2500,355,31850,340,262526,31793,36707,44341,114820,86001,27741,235779,20425,9163317000,928150000,977519000,1303190000,3217685000,3068827000,1325423000,7872814000,1002096000
Arkansas,Educational Services,2007,2370,1180,375,220,1775,380,110,2265,105,2680,1180,375,220,1775,405,330,2510,170,65309,1297,2239,2608,6826,14275,13546,35754,21942,1197153000,38812000,37024000,42381000,127056000,275818000,284284000,707908000,353254000
Arkansas,Finance and Insurance,2007,12798,8635,1630,507,10772,754,408,11934,864,23075,8635,1680,645,10960,2215,2230,15405,7670,188995,12908,9333,5518,31046,26093,26502,87982,92723,8377381000,413245000,349005000,205706000,1027224000,1063146000,1022358000,3317357000,4813794000
Arkansas,Health Care and Social Assistance,2007,28836,13845,6565,3640,24050,2699,1231,27980,856,36190,13845,6585,3730,24160,4220,3560,31940,4250,800542,22981,42427,46094,114358,114110,163348,397432,396784,28576885000,1330804000,1497640000,1727177000,4574648000,3501610000,4610827000,12861270000,15529253000
Arkansas,Information,2007,2780,1215,435,365,2015,305,75,2395,385,5170,1215,435,380,2030,375,135,2540,2630,79217,952,2070,3671,8448,8690,1746,20618,52028,3757281000,51861000,57804000,101585000,244448000,336119000,45321000,711979000,2851244000
Arkansas,Management of Companies and Enterprises,2007,1653,110,30,40,180,350,496,1026,627,5230,110,30,40,180,355,530,1065,4165,151665,0,144,224,560,3559,12210,16405,135260,12531615000,8535000,15470000,11655000,37300000,199835000,742835000,979970000,11551645000
Arkansas,Manufacturing,2007,14241,5000,2490,1710,9200,2298,984,12482,1759,15480,5005,2490,1715,9210,2450,1220,12880,2600,843875,6572,13133,18776,42053,74149,70619,219125,545314,28475425000,234168000,353500000,550938000,1232427000,2360133000,2462996000,7050161000,18799519000
Arkansas,"Mining, Quarrying, and Oil and Gas Extraction",2007,1534,705,195,170,1070,185,54,1309,225,1700,705,195,170,1070,185,85,1340,360,31242,949,1172,1427,4456,5682,4244,16069,14002,1638587000,47629000,42076000,81753000,175798000,257285000,237278000,741307000,829164000
Arkansas,Other,2007,50,50,0,0,50,0,0,50,0,50,50,0,0,50,0,0,50,0,46,46,0,0,46,0,0,46,0,739000,739000,0,0,739000,0,0,739000,0
Arkansas,Other Services (except Public Administration),2007,32291,20535,6540,2782,29857,1917,205,31979,312,34045,20540,6565,2915,30020,2595,395,33010,1035,228438,37157,41226,34709,114936,64845,11687,199779,22107,4899856000,747623000,767236000,695167000,2232833000,1163873000,297068000,3903592000,903901000
Arkansas,"Professional, Scientific, and Technical Services",2007,26793,18951,3925,1965,24841,1103,294,26238,555,28655,18955,3940,2055,24950,1460,625,27035,1620,171249,27450,24241,24785,79533,31889,15879,133892,22803,7221805000,1115131000,821673000,974099000,2953593000,1447065000,636609000,5268885000,1322019000
Arkansas,Real Estate and Rental and Leasing,2007,12888,10185,1230,545,11960,428,171,12559,329,15515,10195,1250,630,12075,915,455,13445,2070,68378,11386,7030,6186,29525,9829,6152,48837,10944,1825090000,378506000,160859000,182490000,749889000,306380000,158001000,1306281000,372275000
Arkansas,Retail Trade,2007,40294,21072,9047,4935,35054,3006,601,38661,1633,58975,21140,9235,5425,35800,5175,2600,43575,15400,598549,34153,58449,60565,156401,89212,42554,299027,276059,12796335000,773578000,1156078000,1372211000,3336490000,2430486000,953920000,6902075000,5566483000
Arkansas,Total,2007,53697,30714,9775,5699,46188,4740,1138,52066,1631,67648,30743,9864,5985,46592,6704,3440,56736,10912,1031307,52322,64009,75140,191471,173158,136603,501232,530075,33343923000,1532061000,1577049000,1974645000,5083755000,4716412000,4110713000,13910880000,19433043000
Arkansas,Transportation and Warehousing,2007,11372,6850,1585,1024,9459,842,295,10596,776,13075,6855,1585,1050,9490,900,395,10785,2290,265272,9255,9259,11476,32398,25424,20474,82576,163795,10018225000,323872000,260394000,360052000,976012000,797421000,702196000,2578336000,6613835000
Arkansas,Utilities,2007,807,445,155,25,625,65,58,748,59,1685,445,155,25,625,145,255,1025,660,30000,967,933,136,2135,2841,7599,12942,552,2202838000,26268000,22370000,6685000,57101000,137697000,393385000,602227000,48814000
Arkansas,Wholesale Trade,2007,14857,6355,2139,1861,10355,2117,823,13295,1562,17805,6365,2175,1975,10515,2800,1365,14680,3125,229306,8971,11515,21456,45593,55751,27240,143096,74072,9881003000,385250000,443402000,789160000,1699029000,2329458000,1273711000,5700106000,3760032000
California,Accommodation and Food Services,2007,286397,119130,57885,51392,228407,49876,5915,284198,2199,377485,119345,58260,52610,230215,60445,22995,313655,63830,6768805,194812,376575,685410,1256855,1854263,963976,4072177,2607826,113729865000,4432334000,4811966000,9037806000,18282570000,29405719000,16243429000,64163419000,48830434000
California,Administrative and Support and Waste Management and Remediation Services,2007,184364,108320,29030,18397,155747,18963,5806,180516,3848,213540,108410,29230,18710,156350,21170,9365,186885,26655,5632570,172102,188841,244327,609706,725535,901760,2284080,3307154,183127252000,7200587000,5975200000,7977183000,21658936000,25842573000,25324318000,73155585000,108859444000
California,"Agriculture, Forestry, Fishing and Hunting",2007,9973,6390,1405,866,8661,964,255,9880,93,10225,6390,1405,880,8675,1055,325,10055,170,134835,8720,8923,11225,29924,37911,34418,104185,27130,4331640000,520788000,356131000,437776000,1335210000,1374005000,817765000,3589340000,614575000
California,"Arts, Entertainment, and Recreation",2007,94056,68050,9860,6379,84289,7194,1757,93240,816,99490,68095,9900,6480,84475,7945,2360,94780,4710,1523015,52946,63432,84274,220899,294650,266892,794392,705354,64471875000,16163469000,3896389000,2564692000,22651595000,7062898000,11703837000,42176140000,21154914000
California,Construction,2007,396682,238510,68229,44360,351099,38385,5588,395072,1610,401220,238515,68240,44395,351150,38850,6705,396705,4515,4602710,387140,449102,596826,1432938,1503795,941653,3879720,697332,221259905000,16247280000,16823551000,25169688000,58266305000,72089415000,47488830000,177863340000,42313167000
California,Educational Services,2007,50249,24000,7945,6838,38783,8625,2010,49418,831,56800,24020,7975,6980,38975,9915,3340,52230,4570,1585465,36930,51736,93545,180344,336164,304111,832130,743118,52705735000,1405675000,1173109000,2101045000,4704135000,9993167000,10456949000,25349115000,26909996000
California,Finance and Insurance,2007,160599,114227,20330,9636,144193,9124,3337,156654,3945,273905,114580,20865,10955,146400,15255,15100,176755,97150,3403341,153268,125374,121092,428400,321536,376037,1149951,2237236,286645213000,9790029000,7743006000,8951386000,26607339000,26521196000,31414436000,85219562000,200289386000
California,Health Care and Social Assistance,2007,414804,240716,89943,43388,374047,29309,7856,411212,3592,486445,240975,90710,45890,377575,43375,27650,448600,37845,7973023,426867,589543,569604,1599811,1113320,1132790,3857904,4078886,366998800000,23656635000,23202172000,22685683000,69584682000,41176880000,38470626000,149476579000,216782463000
California,Information,2007,74805,48754,8490,6044,63288,6800,2179,72267,2538,108050,48805,8535,6175,63515,7735,3565,74815,33235,2552250,54962,50903,75465,185941,248523,251663,691805,1778379,211017074000,8900328000,3175756000,4816332000,17009987000,17787235000,20308130000,55006297000,154158638000
California,Management of Companies and Enterprises,2007,16652,1700,455,575,2730,3466,4815,11011,5641,24380,1700,460,580,2740,3565,5205,11510,12870,1485370,1933,1408,3620,7322,42012,178180,227640,1257730,157250280000,275754000,156446000,211285000,654785000,2734017000,12616280000,16016590000,141233690000
California,Manufacturing,2007,210728,80969,38599,32749,152317,39878,10293,202488,8240,221310,80995,38640,32855,152490,41010,12115,205615,15695,6800793,135853,250100,431554,833471,1566699,1295514,3800741,2805509,358061101000,6120968000,8598087000,15750788000,30854268000,64870487000,60642858000,160481664000,186164034000
California,"Mining, Quarrying, and Oil and Gas Extraction",2007,3391,1500,370,445,2315,519,203,3037,354,4195,1500,370,450,2320,560,265,3145,1050,147921,2062,2246,5723,10459,15999,19367,48771,67030,9090178000,154719000,125838000,320223000,612779000,920716000,1050104000,2700729000,6209959000
California,Other,2007,1360,1302,41,13,1356,4,0,1360,0,1360,1302,41,13,1356,4,0,1360,0,1501,0,245,166,1409,0,0,1501,0,31387000,25585000,4489000,1000000,31074000,0,0,31387000,0
California,Other Services (except Public Administration),2007,321447,203304,60037,30937,294278,22361,3272,319911,1536,357365,203420,60545,32355,296320,27895,9840,334055,23310,2904462,364317,388908,404935,1162635,782652,381526,2326146,522439,82438975000,9471899000,9788851000,10936669000,30196329000,21529255000,11797704000,63705582000,17071499000
California,"Professional, Scientific, and Technical Services",2007,538072,383266,71037,39994,494297,30394,7566,532257,5815,578025,383395,71350,41110,495855,35975,13510,545340,32685,6111686,559688,460435,525492,1548075,1065544,796985,3418044,2594645,447403705000,34860379000,25279051000,32880958000,92962993000,79095440000,64009278000,236245612000,208575769000
California,Real Estate and Rental and Leasing,2007,205304,155100,25424,11657,192181,9174,2173,203528,1776,253150,155365,26315,13330,195010,14830,9220,219060,34090,1568134,234201,160700,148438,545713,315595,219706,1093137,459803,70747577000,9980368000,5873852000,6389458000,22242236000,14188089000,9022410000,46007352000,24366457000
California,Retail Trade,2007,379771,220588,76065,42167,338820,30366,6432,375618,4153,570125,221225,78345,47415,346985,46775,24395,418155,151970,8231021,335794,449311,522525,1283402,1107250,752741,3238943,4603934,221608155000,9787492000,11219628000,13924133000,34517299000,35973872000,28641148000,101049561000,119434843000
California,Total,2007,730789,443868,124691,76710,645269,66560,13149,724978,5811,891997,444478,126251,80519,651248,84508,37214,772970,119027,13771650,728033,818915,1023854,2570802,2553956,1987364,7112122,6659528,653886933000,35196503000,29120550000,37686181000,102003234000,103469038000,89960610000,295432882000,358454051000
California,Transportation and Warehousing,2007,88487,48815,13600,9865,72280,9541,2780,84601,3886,107765,48855,13680,10170,72705,11185,5285,89175,18590,2295407,70905,85954,125778,286652,308697,214821,821793,1397751,98486024000,2782410000,2867878000,4431120000,10107280000,11644194000,9262342000,31296211000,65735951000
California,Utilities,2007,2596,1420,470,265,2155,154,75,2384,212,5685,1420,475,305,2200,190,180,2570,3115,20341,2411,2781,2995,8655,4303,8842,23824,9838,1456402000,97079000,118447000,194977000,423299000,262808000,664624000,1481505000,801191000
California,Wholesale Trade,2007,267266,148498,45116,29620,223234,28981,8059,260274,6992,304025,148870,45750,30885,225505,34790,14650,274945,29080,4102105,249988,289016,376862,922775,995971,696001,2639967,1417186,252956960000,12535444000,13214384000,18506980000,44306520000,53015158000,41431576000,139305970000,112110022000
Colorado,Accommodation and Food Services,2007,46268,16820,8585,9233,34638,9597,955,45190,1078,60625,16825,8615,9370,34810,11120,3950,49880,10745,1148200,24786,55871,122228,203962,340471,130987,678219,457855,17863260000,717190000,671167000,1531636000,2920586000,4819106000,1956252000,9779765000,8069036000
Colorado,Administrative and Support and Waste Management and Remediation Services,2007,37254,23245,5225,3224,31694,2982,1015,35691,1563,41085,23245,5230,3250,31725,3190,1385,36300,4785,965735,32156,32809,41636,108641,111271,120593,346053,606894,32618513000,1318778000,1008847000,1200518000,3564287000,3612755000,3583471000,10963898000,21347856000
Colorado,"Agriculture, Forestry, Fishing and Hunting",2007,1480,1215,115,90,1420,40,10,1470,10,1480,1215,115,90,1420,40,10,1470,10,6731,1213,565,871,3213,1489,0,6616,0,201214000,46459000,25717000,34067000,113654000,42906000,0,198044000,0
Colorado,"Arts, Entertainment, and Recreation",2007,11551,7290,1545,1050,9885,1071,333,11289,262,12170,7290,1550,1065,9905,1165,385,11455,715,231390,6605,9247,13686,33821,39929,47718,126253,92852,6283120000,403193000,220789000,266498000,926084000,745571000,1148184000,3022641000,1930899000
Colorado,Construction,2007,99900,69295,14132,8395,91822,6360,1036,99218,682,100580,69295,14135,8395,91825,6465,1170,99460,1120,846050,80645,92166,110996,304525,238210,135673,683890,144668,38454200000,3828890000,3357975000,4530470000,11721025000,10725668000,6956797000,29639540000,7861564000
Colorado,Educational Services,2007,9939,5870,1365,1040,8275,1168,255,9698,241,10395,5870,1365,1055,8290,1265,320,9875,520,194780,7402,8822,14264,31018,46816,23890,107305,86967,5326965000,297630000,247044000,345258000,894315000,1159079000,757672000,3054965000,2253368000
Colorado,Finance and Insurance,2007,34552,25189,3641,1190,30020,1512,848,32380,2172,55140,25215,3755,1460,30430,2805,2795,36030,19110,515812,34638,20150,12276,72048,44303,46413,174387,266673,33745849000,1604698000,980914000,787511000,3460040000,2981669000,2732887000,9589194000,21724818000
Colorado,Health Care and Social Assistance,2007,57326,31845,11740,6298,49883,4837,1413,56133,1193,68570,31860,11800,6535,50195,6865,4160,61220,7350,1169979,49192,75686,84115,210252,181316,211950,615974,492625,48475381000,2531974000,3023790000,3557822000,9134597000,7082556000,7183548000,23743621000,23280239000
Colorado,Information,2007,10329,5670,1390,833,7893,836,494,9223,1106,16350,5675,1395,860,7930,940,640,9510,6840,407990,2613,8588,7362,22379,24295,31366,91208,236315,29584865000,398367000,410696000,463605000,1330769000,1377675000,2127299000,5238526000,23712156000
Colorado,Management of Companies and Enterprises,2007,3392,315,80,95,490,585,822,1897,1495,4535,315,80,95,490,605,875,1970,2565,247039,296,435,651,1450,8251,22390,32245,215054,21543600000,52865000,26055000,36239000,116860000,628815000,1844290000,2589965000,18936816000
Colorado,Manufacturing,2007,25639,11845,4319,3448,19612,3371,1043,24026,1613,26365,11855,4320,3460,19635,3460,1175,24270,2095,622807,17068,23271,38614,87718,107913,61057,300139,270908,32531231000,771718000,833840000,1506923000,3421415000,4474897000,2921178000,12902896000,16662329000
Colorado,"Mining, Quarrying, and Oil and Gas Extraction",2007,5552,3050,720,495,4265,664,165,5094,458,5955,3050,720,500,4270,680,220,5170,785,138571,560,2885,5909,14117,20629,6099,52952,82751,8925913000,282626000,245788000,386326000,947291000,1403582000,373840000,3491811000,5259023000
Colorado,Other,2007,122,117,4,0,121,1,0,122,0,122,117,4,0,121,1,0,122,0,0,0,0,0,0,0,0,0,0,1990000,1764000,0,0,1950000,0,0,1990000,0
Colorado,Other Services (except Public Administration),2007,58917,37365,11193,5402,53960,3613,731,58304,613,64800,37385,11255,5690,54330,4735,1970,61035,3765,483211,62961,72036,70171,206825,119731,63147,396476,72164,12766639000,1708751000,1806085000,1764689000,5298838000,3066127000,1515900000,9999031000,2505770000
Colorado,"Professional, Scientific, and Technical Services",2007,110717,84123,11470,6240,101833,4812,1806,108451,2266,116820,84125,11540,6365,102030,5460,2425,109915,6905,880874,99349,73197,79239,263420,150226,96573,519207,342417,56913635000,5712374000,3753435000,4536161000,14042765000,10234214000,7625211000,32104415000,24129693000
Colorado,Real Estate and Rental and Leasing,2007,43704,35089,3980,1888,40957,1405,438,42800,904,50385,35120,4060,2050,41230,2030,945,44205,6180,229774,44142,24339,23257,93935,42685,18390,160601,65007,8751928000,1778095000,821356000,856513000,3470097000,1603101000,645981000,5842214000,2950338000
Colorado,Retail Trade,2007,65148,36571,13366,6817,56754,4554,1243,62551,2597,96840,36675,13645,7655,57975,7180,3795,68950,27890,1205566,53245,76260,80522,205009,142889,75339,453207,530754,32289024000,1504783000,1938523000,2195865000,5744371000,4991377000,2867276000,13948151000,14298917000
Colorado,Total,2007,131894,84522,19838,11913,116273,10047,2562,128882,3012,157882,84583,20026,12449,117058,12642,5901,135601,22281,2075821,127305,129787,158188,415280,361888,263926,1041094,1034727,87797087000,5060223000,4280988000,5407414000,14748625000,13402167000,11038805000,39189597000,48607490000
Colorado,Transportation and Warehousing,2007,15600,9835,1835,1030,12700,1101,550,14351,1249,17660,9845,1840,1030,12715,1175,780,14670,2990,306413,11665,11465,12047,37590,32909,16482,97357,195534,11744408000,465863000,380594000,412982000,1292714000,1164222000,806947000,3547290000,8053278000
Colorado,Utilities,2007,1059,600,150,45,795,130,45,970,89,1930,600,150,50,800,200,125,1125,805,41995,896,820,342,2326,5024,4917,12769,3738,3309429000,29832000,30369000,18978000,91535000,336857000,324568000,769596000,432678000
Colorado,Wholesale Trade,2007,32190,16850,4482,3158,24490,3153,1644,29287,2903,37115,16870,4540,3270,24680,3825,2380,30885,6230,488258,22263,26097,37050,89921,83959,55216,252676,209381,28863694000,1328037000,1278254000,1902297000,4598238000,4420640000,2915306000,12639731000,14999687000
Connecticut,Accommodation and Food Services,2007,32673,14260,6495,5673,26428,5213,467,32108,565,39355,14265,6520,5770,26555,5970,1515,34040,5315,627034,23975,42959,77469,144671,188714,55731,396002,228196,11397636000,599852000,602474000,1158705000,2366196000,3049666000,900980000,6400433000,4982998000
Connecticut,Administrative and Support and Waste Management and Remediation Services,2007,24447,15600,3315,1955,20870,1814,719,23403,1044,26710,15600,3325,1980,20905,1960,930,23795,2915,434685,20614,19834,24257,68177,63218,83883,222013,189252,14726481000,1159704000,848693000,945561000,3010167000,2403479000,2242632000,7989149000,6166305000
Connecticut,"Agriculture, Forestry, Fishing and Hunting",2007,415,305,70,25,400,10,0,410,5,415,305,70,25,400,10,0,410,5,1520,132,0,0,1083,0,0,1468,0,53597000,15354000,1527000,0,29581000,0,0,47361000,0
Connecticut,"Arts, Entertainment, and Recreation",2007,7922,4375,1145,979,6499,1094,208,7801,121,8310,4375,1145,985,6505,1145,300,7950,360,106346,5676,7239,12535,26072,44488,18157,96218,10489,3119570000,528220000,225028000,320326000,1073850000,1149964000,287271000,2666376000,413166000
Connecticut,Construction,2007,48224,33550,7315,4023,44888,2784,355,48027,197,48395,33555,7315,4030,44900,2805,380,48085,310,320497,50851,46996,52943,153900,95658,40307,295920,20744,18662912000,2507470000,2273741000,2841701000,7636880000,6104682000,2534125000,16659080000,1774724000
Connecticut,Educational Services,2007,5889,2735,950,800,4485,870,358,5713,176,6260,2735,970,800,4505,900,455,5860,400,310380,3555,6021,10147,20454,36421,59568,121606,172435,12363170000,165789000,133195000,229658000,558326000,1179373000,2321471000,4179620000,7644182000
Connecticut,Finance and Insurance,2007,19547,11379,2773,1452,15604,1495,752,17851,1696,32700,11400,2860,1580,15840,2420,2160,20420,12280,572145,18396,16790,16503,52870,46065,62976,166687,380397,75774371000,1475812000,1688595000,2703888000,6060843000,7865324000,14612504000,28947250000,45734445000
Connecticut,Health Care and Social Assistance,2007,38400,16050,8701,5739,30490,4668,2209,37367,1033,50120,16070,8795,6230,31095,7025,6435,44555,5565,1254019,32842,56986,76282,167125,171675,304654,648172,580766,52181317000,1410819000,2422859000,3564119000,7439014000,7255521000,10539292000,25371202000,26036003000
Connecticut,Information,2007,5486,2460,785,575,3820,649,357,4826,660,9150,2460,785,595,3840,705,530,5075,4075,166090,2694,4110,6456,14765,20910,24338,66926,91479,10428209000,228671000,223558000,365896000,884049000,1110565000,1415093000,3768626000,6598815000
Connecticut,Management of Companies and Enterprises,2007,2531,190,70,90,350,410,536,1296,1235,3610,190,70,90,350,415,575,1340,2270,213438,0,359,700,1273,5029,16093,22735,190769,26082622000,0,51116000,45110000,158190000,485186000,1318230000,2021825000,24069029000
Connecticut,Manufacturing,2007,23913,8260,4339,3655,16254,4750,1442,22446,1467,24620,8260,4340,3670,16270,4870,1545,22685,1935,723012,12089,23982,42457,85667,170801,125616,423307,237417,39404667000,615611000,1036088000,1996608000,3861246000,8715329000,6421342000,21162056000,15252530000
Connecticut,"Mining, Quarrying, and Oil and Gas Extraction",2007,278,95,45,60,200,35,15,250,28,380,95,45,60,200,35,30,265,115,6593,31,80,556,1055,890,355,2987,2962,268586000,2239000,9443000,28847000,48136000,31605000,22065000,135500000,109195000
Connecticut,Other,2007,81,78,3,0,81,0,0,81,0,81,78,3,0,81,0,0,81,0,86,68,18,0,86,0,0,86,0,2274000,2162000,112000,0,2274000,0,0,2274000,0
Connecticut,Other Services (except Public Administration),2007,44484,26660,10010,4400,41070,2586,402,44058,426,47345,26680,10070,4580,41330,3125,865,45320,2025,339901,49332,65107,55871,173907,83639,25291,292456,28131,9314395000,1339679000,1646726000,1496936000,4519133000,2240233000,772114000,7951781000,912088000
Connecticut,"Professional, Scientific, and Technical Services",2007,48343,31950,7240,4030,43220,2802,948,46970,1373,51165,31970,7285,4110,43365,3105,1230,47700,3465,505919,47566,44630,51177,147003,86905,62083,305039,191541,36631617000,2976968000,2768431000,3310409000,9196556000,6988084000,5369554000,22051062000,14221519000
Connecticut,Real Estate and Rental and Leasing,2007,14035,9750,2065,823,12638,698,260,13596,439,18190,9775,2145,915,12835,965,1360,15160,3030,124032,15572,12732,9958,38606,22052,12825,78221,26794,6145934000,689875000,518961000,431196000,1667416000,1149950000,521750000,3464134000,2395317000
Connecticut,Retail Trade,2007,48508,26564,9431,5269,41264,4159,996,46419,2089,68440,26680,9620,5610,41910,5420,2775,50105,18335,970767,39016,56141,58510,156429,121998,67764,365298,400019,26140604000,1256947000,1591031000,1900776000,4758175000,5252014000,2782657000,13053519000,8758532000
Connecticut,Total,2007,77128,43546,13782,8503,65831,7295,1961,75087,2041,93615,43605,13928,8847,66380,8929,4588,79897,13718,1539268,75270,90634,112987,278891,266400,236433,781724,757544,81460457000,3399841000,3604826000,4902147000,11906814000,12802267000,12732409000,37441490000,44018967000
Connecticut,Transportation and Warehousing,2007,7140,3350,1005,810,5165,905,305,6375,765,8565,3355,1005,825,5185,1000,390,6575,1990,201962,3574,5575,8513,17601,28489,7645,65144,128716,8691988000,284181000,315807000,447811000,1168638000,1406557000,394335000,3670763000,4572134000
Connecticut,Utilities,2007,329,105,20,35,160,35,40,235,94,720,105,20,35,160,40,95,295,425,23287,86,0,406,665,640,5011,7455,387,2583394000,9201000,15534000,22878000,78901000,68624000,379649000,631632000,39645000
Connecticut,Wholesale Trade,2007,20709,9745,3217,2291,15253,2526,1104,18883,1826,23220,9760,3240,2345,15345,2730,1370,19445,3775,369103,14781,17370,26039,61819,74618,53424,206652,128959,24429592000,1119051000,1162701000,1706663000,4082253000,4712969000,3182984000,12989740000,9853167000
Delaware,Accommodation and Food Services,2007,7528,3105,1285,1285,5675,1315,215,7205,323,9080,3110,1285,1310,5705,1455,645,7805,1275,162933,4396,8716,16011,30778,48950,24162,105415,57272,2527131000,184010000,121375000,241027000,550796000,745845000,292790000,1609134000,914564000
Delaware,Administrative and Support and Waste Management and Remediation Services,2007,6357,3455,945,625,5025,540,185,5750,607,6790,3455,945,630,5030,575,195,5800,990,114177,4595,5241,7609,17964,16743,16530,54092,50712,3408577000,213248000,153161000,219429000,603407000,545786000,379323000,1648839000,1496260000
Delaware,"Agriculture, Forestry, Fishing and Hunting",2007,215,175,20,15,210,0,0,210,5,215,175,20,15,210,0,0,210,5,592,22,0,0,132,0,0,132,0,22117000,7109000,0,0,17232000,0,0,17232000,0
Delaware,"Arts, Entertainment, and Recreation",2007,1873,1050,285,160,1495,253,60,1808,65,1955,1050,285,160,1495,275,85,1855,100,31083,617,1644,1659,4640,8097,3913,21194,2815,832998000,60852000,28362000,30345000,139466000,203519000,75560000,533479000,77818000
Delaware,Construction,2007,13614,8435,2155,1550,12140,1180,170,13490,124,13670,8435,2155,1555,12145,1195,175,13515,155,120578,11530,13130,19302,47545,44461,18500,113780,3138,5556440000,509968000,474535000,770934000,1771010000,2249665000,987945000,5172401000,183579000
Delaware,Educational Services,2007,1270,570,180,155,905,200,95,1200,70,1345,575,180,160,915,215,95,1225,120,28453,59,910,1815,3807,9011,12799,26137,159,862142000,22887000,16933000,30524000,82897000,216046000,469877000,783653000,5508000
Delaware,Finance and Insurance,2007,6703,3702,687,265,4654,333,338,5325,1378,11090,3715,715,325,4755,565,485,5805,5285,221164,4475,3774,1496,10989,7635,1846,26057,186939,17560977000,168849000,160003000,123521000,477874000,695837000,152012000,1746878000,15373573000
Delaware,Health Care and Social Assistance,2007,9254,3395,2285,1433,7113,1251,349,8713,541,11920,3395,2300,1490,7185,1775,1200,10160,1760,267753,6271,14686,18241,40111,38678,28894,118083,142031,11653610000,368627000,674721000,869873000,1926781000,1691757000,1083907000,5010697000,6557420000
Delaware,Information,2007,1075,515,90,90,695,93,50,838,237,1930,515,90,90,695,105,110,910,1020,20623,195,119,484,1049,1889,2041,9280,7346,1078784000,21382000,4999000,19849000,69709000,97261000,77056000,445502000,415689000
Delaware,Management of Companies and Enterprises,2007,6929,3400,70,61,3531,382,772,4685,2244,8450,3420,70,85,3575,420,925,4920,3530,81170,0,0,0,0,2208,180,8792,70612,6556895000,33380000,0,0,61692000,97000000,99430000,271110000,6281064000
Delaware,Manufacturing,2007,3082,990,505,455,1950,464,229,2643,439,3250,990,505,460,1955,500,235,2690,560,124985,811,1923,2923,7528,9024,11066,36122,77750,6092617000,41056000,68696000,126640000,299910000,394860000,536424000,1520198000,3904122000
Delaware,"Mining, Quarrying, and Oil and Gas Extraction",2007,87,55,5,10,70,10,0,80,7,110,55,5,10,70,10,0,80,30,242,24,0,0,0,0,0,213,0,34881000,2497000,0,0,2374000,0,0,31010000,0
Delaware,Other,2007,32,30,2,0,32,0,0,32,0,32,30,2,0,32,0,0,32,0,31,0,0,0,31,0,0,31,0,503000,397000,0,0,503000,0,0,503000,0
Delaware,Other Services (except Public Administration),2007,10400,6020,2166,1059,9245,775,144,10164,236,10970,6020,2200,1105,9325,905,215,10445,525,87791,10030,12815,11795,36387,24983,4873,69695,6544,2094771000,273475000,310838000,288909000,912059000,609852000,124716000,1799656000,147384000
Delaware,"Professional, Scientific, and Technical Services",2007,11635,7515,1380,955,9850,887,358,11095,540,12320,7515,1380,990,9885,1080,420,11385,935,127398,8604,8214,11623,30820,25942,15207,76027,30601,9677504000,565316000,420886000,653516000,1689430000,1715304000,1500549000,5103258000,2613077000
Delaware,Real Estate and Rental and Leasing,2007,4899,3220,530,230,3980,238,193,4411,488,5905,3225,540,265,4030,305,420,4755,1150,28155,4314,2940,2543,9761,4831,4770,22151,3824,1158378000,189580000,101139000,87779000,389091000,225208000,181766000,893717000,195243000
Delaware,Retail Trade,2007,14164,6945,2640,1359,10944,1244,437,12625,1539,19600,6960,2670,1455,11085,1925,785,13795,5805,275085,7866,13710,12790,38154,35062,21052,106669,147706,6829502000,299844000,336029000,383576000,1079886000,1182365000,842505000,3370420000,3275326000
Delaware,Total,2007,20743,11353,3222,2055,16630,1924,728,19282,1461,25521,11374,3260,2150,16784,2437,1326,20547,4974,396317,18003,21061,27197,66261,65718,49652,181631,214686,18607545000,680885000,686125000,927453000,2294463000,2548573000,2013326000,6856362000,11751183000
Delaware,Transportation and Warehousing,2007,3397,1965,373,275,2613,307,145,3065,332,3660,1965,375,275,2615,335,155,3105,555,64045,305,1823,2346,4443,7342,3754,24851,20953,2079355000,77243000,48933000,65341000,216598000,285962000,131587000,836190000,909869000
Delaware,Utilities,2007,162,90,10,0,100,0,20,120,42,265,90,20,0,110,0,40,150,115,11405,0,0,0,72,0,0,0,0,975136000,2134000,0,0,6205000,0,0,439000,0
Delaware,Wholesale Trade,2007,4436,2055,545,355,2955,475,355,3785,651,4920,2055,550,370,2975,545,445,3965,955,68430,1578,2177,3035,9247,7918,7156,30724,26154,4793440000,127269000,118435000,151911000,477382000,407567000,366170000,1554170000,2257171000
District of Columbia,Accommodation and Food Services,2007,8174,3120,1460,1205,5785,1565,341,7691,483,10730,3120,1465,1210,5795,1655,535,7985,2745,260750,5765,9264,15347,30537,57609,18032,114812,131575,6399954000,168949000,166904000,290572000,623165000,1231491000,677110000,2540590000,3497255000
District of Columbia,Administrative and Support and Waste Management and Remediation Services,2007,3815,1455,465,285,2205,550,491,3246,569,4760,1455,470,295,2220,555,570,3345,1415,166350,1489,2452,2292,7548,18042,46571,77910,80214,6385133000,147441000,147091000,119575000,488534000,710030000,1362142000,2873210000,3338983000
District of Columbia,"Agriculture, Forestry, Fishing and Hunting",2007,20,20,0,0,20,0,0,20,0,20,20,0,0,20,0,0,20,0,0,0,0,0,0,0,0,0,0,0,0,0,0,0,0,0,0,0
District of Columbia,"Arts, Entertainment, and Recreation",2007,1275,670,165,135,970,145,72,1187,88,1440,670,165,135,970,150,150,1270,170,34598,613,420,815,2526,4382,9722,18255,8344,1537682000,47455000,51385000,31161000,156031000,156472000,274948000,614527000,270135000
District of Columbia,Construction,2007,1989,1010,310,295,1615,235,75,1925,64,2005,1010,310,295,1615,235,80,1930,75,29875,939,1688,3541,7080,7808,4939,22460,0,1815390000,72547000,117853000,181764000,399184000,537837000,265248000,1367901000,0
District of Columbia,Educational Services,2007,2418,810,325,370,1505,485,250,2240,178,2680,810,325,380,1515,560,290,2365,315,231780,839,1349,3687,6510,18547,27608,56467,162257,9537810000,45241000,76319000,137581000,294461000,756114000,1127978000,2253709000,6608138000
District of Columbia,Finance and Insurance,2007,3131,1125,330,235,1690,436,191,2317,814,5360,1125,330,245,1700,570,320,2590,2770,62437,639,1097,1472,4474,7090,3602,18601,38675,7999194000,135517000,150915000,211997000,567556000,818273000,290673000,1963936000,5802428000
District of Columbia,Health Care and Social Assistance,2007,8975,4260,1675,1064,6999,1121,484,8604,371,10545,4265,1675,1075,7015,1500,1080,9595,950,301340,6881,10169,12718,30414,34209,44477,115332,159289,14846772000,439463000,539141000,652443000,1653471000,1352126000,1355033000,4524012000,9467934000
District of Columbia,Information,2007,2580,885,330,195,1410,350,219,1979,601,3785,885,335,195,1415,360,225,2000,1785,100545,692,1010,1136,3132,6112,8151,22427,70216,9507437000,88619000,70185000,141146000,376247000,477506000,670132000,1977424000,7129355000
District of Columbia,Management of Companies and Enterprises,2007,872,55,15,10,80,75,155,310,562,1005,55,15,10,80,75,190,345,660,21027,0,0,0,0,869,4775,5889,15044,2790330000,0,0,0,0,64064000,297561000,388918000,2384670000
District of Columbia,Manufacturing,2007,660,335,150,65,550,55,35,640,20,670,335,150,65,550,60,35,645,25,6390,338,750,360,1601,1024,796,5668,691,290157000,14672000,32513000,18433000,73006000,44873000,36364000,250754000,39277000
District of Columbia,"Mining, Quarrying, and Oil and Gas Extraction",2007,25,5,0,5,10,5,0,15,10,25,5,0,5,10,5,0,15,10,49,0,0,0,0,0,0,0,0,3975000,0,0,0,0,0,0,0,0
District of Columbia,Other,2007,36,34,2,0,36,0,0,36,0,36,34,2,0,36,0,0,36,0,33,22,0,0,33,0,0,33,0,749000,614000,0,0,749000,0,0,749000,0
District of Columbia,Other Services (except Public Administration),2007,17712,7785,3445,2416,13646,2739,1002,17387,325,19965,7785,3455,2445,13685,2985,1405,18075,1890,333284,12966,21945,30677,68341,92724,101259,262542,55729,20247234000,813482000,1109174000,1691235000,3626212000,5875419000,7188798000,16783342000,3008451000
District of Columbia,"Professional, Scientific, and Technical Services",2007,21011,11035,3008,1860,15903,2167,1224,19294,1717,23725,11035,3010,1865,15910,2190,1410,19510,4215,451318,14835,16991,19401,53116,60177,66328,186398,255641,46373593000,1945794000,1677703000,2080003000,5852423000,5825388000,5803300000,18260240000,27809559000
District of Columbia,Real Estate and Rental and Leasing,2007,3815,2243,490,300,3033,286,207,3526,289,5555,2255,515,335,3105,530,395,4030,1525,45937,3495,2545,3019,10233,6855,10830,30503,12125,3168114000,233264000,137539000,158531000,558714000,441846000,845626000,2021773000,911328000
District of Columbia,Retail Trade,2007,7588,4165,1300,590,6055,491,238,6784,804,9350,4185,1300,610,6095,650,390,7135,2215,86893,6972,6345,4913,19352,5301,2058,36185,44250,2581968000,205031000,174019000,157194000,572320000,234190000,72478000,1084379000,1181586000
District of Columbia,Total,2007,16925,8038,2756,1838,12632,2149,944,15725,1200,20994,8049,2768,1875,12692,2472,1459,16623,4371,454554,14292,17984,23784,56060,72784,83598,212442,242112,28804832000,977810000,999967000,1367802000,3345579000,4121032000,4608853000,12075464000,16729368000
District of Columbia,Transportation and Warehousing,2007,808,335,80,35,450,95,85,630,178,895,335,80,35,450,100,95,645,250,11595,128,198,98,410,1206,1370,6184,2663,518357000,23139000,17975000,3807000,50624000,25552000,52919000,211590000,102540000
District of Columbia,Utilities,2007,117,5,0,5,10,0,0,10,107,175,5,0,5,10,0,0,10,165,0,0,0,0,0,0,0,0,0,0,0,0,0,0,0,0,0,0
District of Columbia,Wholesale Trade,2007,1712,715,225,165,1105,170,125,1400,312,2100,720,230,170,1120,180,125,1425,675,22095,662,906,1108,3447,2955,651,10349,7907,1540055000,61358000,44481000,45699000,175844000,182404000,50465000,593801000,624900000
Florida,Accommodation and Food Services,2007,130331,58860,24083,19904,102847,22377,3209,128433,1898,174435,58985,24140,20135,103260,24940,9170,137370,37065,3740366,93600,161300,264634,517420,859740,501869,1889006,1838885,59948952000,2346890000,2035010000,3332085000,7713985000,11758516000,7748985000,27240830000,32562314000
Florida,Administrative and Support and Waste Management and Remediation Services,2007,148324,105400,17463,10300,133163,8964,2977,145104,3220,164180,105420,17585,10410,133415,9735,4325,147475,16705,6732323,145110,111444,137993,407290,344600,391358,1170571,5512286,211249166000,4785956000,3098774000,4097576000,12133414000,10284475000,10812769000,33756807000,176478057000
Florida,"Agriculture, Forestry, Fishing and Hunting",2007,5222,3335,875,495,4705,331,112,5148,74,5340,3335,875,495,4705,380,135,5220,120,72169,4466,5358,5814,17055,11093,17631,47997,0,1768723000,149540000,162141000,172259000,496166000,315584000,322134000,1189796000,521661000
Florida,"Arts, Entertainment, and Recreation",2007,36560,23835,4305,2869,31009,3778,1149,35936,624,38450,23835,4310,2900,31045,3970,1425,36440,2010,805780,30587,27812,37555,99161,163466,187284,454578,341436,21485721000,1236936000,757668000,742919000,2753554000,3147223000,7364757000,13320990000,7685200000
Florida,Construction,2007,294240,206160,37874,24665,268699,21194,3198,293091,1149,297305,206160,37890,24695,268745,21515,3945,294205,3100,2556400,265605,250300,330975,883500,811615,494684,2196365,341929,98960095000,9394000000,7540090000,11467135000,28401225000,31147935000,20720529000,80607290000,17678502000
Florida,Educational Services,2007,24735,14105,3200,2330,19635,3601,989,24225,510,27510,14115,3200,2345,19660,4095,1510,25265,2245,638410,17332,20760,31118,71519,143108,129780,349520,274037,19884360000,693070000,447712000,686288000,1832860000,3764015000,3982481000,9677095000,10018473000
Florida,Finance and Insurance,2007,106470,76877,14231,5538,96646,4574,1963,103183,3287,178580,76980,14480,6340,97800,7785,8885,114470,64110,1846789,105337,86286,66756,266312,149038,157096,583441,1095524,109338037000,5277932000,3787746000,3463870000,12759632000,9022759000,8481900000,30829208000,77952807000
Florida,Health Care and Social Assistance,2007,218309,121713,49573,24831,196117,14939,4466,215522,2787,258490,121910,49775,25795,197480,21250,14335,233065,25425,4507223,204815,325753,325575,862973,556214,655880,2082200,2384398,185979470000,11308022000,13613870000,13788215000,38730693000,24261230000,23340476000,86568510000,98345230000
Florida,Information,2007,26341,17364,2935,1885,22184,1810,803,24797,1544,42545,17370,2965,1935,22270,2090,1500,25860,16685,832707,19599,17704,23502,66064,58211,56846,195479,628636,47236825000,1211260000,766684000,1024099000,3030256000,2991655000,3091274000,9536240000,37417296000
Florida,Management of Companies and Enterprises,2007,8280,1320,255,310,1885,1365,1934,5184,3096,12545,1325,255,310,1890,1395,2085,5370,7175,717425,1788,1320,2527,5670,19600,67294,92610,624815,49619370000,365650000,83965000,171185000,621555000,1312250000,4094567000,6037170000,43582200000
Florida,Manufacturing,2007,67255,32937,11224,8328,52489,8616,2877,63982,3273,71325,32950,11225,8370,52545,8800,3215,64560,6765,1717051,49724,66572,101609,230357,306774,286939,899973,724895,72719691000,1973702000,2071394000,3478593000,7831775000,11307277000,11281067000,32697139000,36272247000
Florida,"Mining, Quarrying, and Oil and Gas Extraction",2007,1151,560,130,140,830,130,63,1023,128,1380,560,130,140,830,140,105,1075,305,24662,873,738,1558,3545,4549,2809,12274,12118,1326371000,44737000,27143000,62164000,146567000,177238000,132752000,498629000,771353000
Florida,Other,2007,501,481,14,3,498,3,0,501,0,501,481,14,3,498,3,0,501,0,589,0,0,0,514,75,0,589,0,10622000,8846000,0,0,10129000,493000,0,10622000,0
Florida,Other Services (except Public Administration),2007,208078,141090,35150,17886,194126,11320,1548,206994,1084,225415,141100,35310,18365,194775,13500,4385,212660,12755,1586540,238069,227038,235667,704800,401515,155568,1273445,273742,37042275000,5688175000,5023533000,5450811000,16168073000,9204288000,3741628000,29370560000,7200549000
Florida,"Professional, Scientific, and Technical Services",2007,332139,254743,38051,19479,312273,13139,3438,328850,3289,352295,254845,38155,19895,312895,15950,6205,335050,17245,2291104,323621,244629,252710,861906,434150,276526,1582743,669565,127370402000,17789982000,11210777000,13031085000,42067810000,25585757000,17654751000,85539330000,40744415000
Florida,Real Estate and Rental and Leasing,2007,139170,116028,12196,5022,133246,3146,1324,137716,1454,165970,116140,12460,5825,134425,4515,5060,144000,21970,881214,106389,74579,58711,287726,98825,107308,498256,341492,32402885000,5109666000,2413155000,2163396000,9765040000,3740364000,4132158000,18039418000,13791923000
Florida,Retail Trade,2007,237782,159335,40147,18733,218215,12574,3341,234130,3652,367645,159665,40955,21085,221705,19935,11550,253190,114455,4849422,212822,240529,210176,668403,427608,325720,1488788,2437257,117262709000,6595495000,5724163000,5820802000,17980698000,13868749000,12100146000,44924688000,58213690000
Florida,Total,2007,432275,294077,63436,35356,392869,28402,6566,427837,4438,523461,294354,63962,36900,395216,35261,17506,447983,75478,7425331,459153,414402,469269,1342824,1061250,870605,3274679,4150652,267523724000,16557097000,13122260000,15466951000,45146308000,36497492000,32044560000,113688360000,153835364000
Florida,Transportation and Warehousing,2007,58322,41775,6015,3500,51290,3161,1454,55905,2417,66880,41800,6040,3610,51450,3570,2125,57145,9735,1036701,53045,36867,43968,138930,96486,89044,331559,681322,40291596000,1883833000,1191054000,1319012000,4445268000,3402755000,3668841000,11891814000,27987896000
Florida,Utilities,2007,1564,770,295,102,1167,127,125,1419,145,3095,770,295,125,1190,200,365,1755,1340,148812,1299,1275,1117,4376,4228,19031,31084,111972,10815203000,44981000,61007000,42121000,158457000,226375000,1125055000,1670272000,9046201000
Florida,Wholesale Trade,2007,141305,91989,19497,11208,122694,10430,3763,136887,4418,161415,92100,19695,11710,123505,12525,7205,143235,18180,1591677,110930,123065,140456,409168,328064,233428,977240,534324,75481803000,6203145000,4982454000,6009722000,17184253000,14816422000,10483360000,42774327000,30185344000
Georgia,Accommodation and Food Services,2007,67577,27160,11933,11871,50964,13597,1606,66167,1410,93195,27210,11965,12060,51235,15355,6175,72765,20430,1799699,42046,79645,162576,284760,494462,236025,1015509,777780,24565955000,1067450000,899087000,1812316000,3781745000,5840158000,3000491000,12629350000,11926317000
Georgia,Administrative and Support and Waste Management and Remediation Services,2007,53193,32470,7230,4767,44467,4459,1884,50810,2383,60780,32475,7255,4815,44545,4685,2555,51785,8995,1807455,46071,46016,62043,155644,169838,237500,575112,1214218,48868239000,1799669000,1342378000,1916657000,5101693000,5128387000,6838117000,17328800000,31326000000
Georgia,"Agriculture, Forestry, Fishing and Hunting",2007,5080,2620,1155,750,4525,456,50,5031,49,5185,2625,1155,750,4530,465,100,5095,90,40023,4309,7011,9863,21900,14028,2058,38393,326,1302846000,150853000,216539000,315042000,693390000,449689000,50604000,1227096000,15150000
Georgia,"Arts, Entertainment, and Recreation",2007,13234,7817,1890,1435,11142,1584,265,12991,243,14120,7820,1895,1435,11150,1715,375,13240,880,211507,8607,11672,18315,41442,58835,31950,136257,54665,5916458000,394186000,225846000,346045000,989505000,1006838000,1055964000,3531374000,1208027000
Georgia,Construction,2007,115453,74350,18270,11844,104464,8973,1221,114658,795,116695,74350,18270,11860,104480,9085,1440,115005,1690,1115690,115681,120585,159321,398055,344315,178434,922780,180713,46236925000,4354965000,3915335000,5731040000,14008920000,14386705000,7751478000,36205875000,9575768000
Georgia,Educational Services,2007,11503,6315,1565,1230,9110,1573,500,11183,320,12545,6320,1580,1350,9250,1645,610,11505,1040,358480,7738,10490,16504,35674,66097,75793,180740,176169,12111075000,262784000,204381000,329681000,801410000,1673585000,2247256000,4803329000,7247900000
Georgia,Finance and Insurance,2007,43725,28941,5615,2459,37015,2739,1485,41239,2486,79300,29045,5825,3080,37950,5795,5655,49400,29900,860592,42754,33858,29486,104522,88457,104440,314094,472449,54706003000,2010480000,1565045000,1634123000,5281970000,4704182000,6717182000,17068306000,36876331000
Georgia,Health Care and Social Assistance,2007,86742,42349,19675,12158,74182,8944,1787,84913,1829,104365,42405,19805,12840,75050,11785,5640,92475,11890,2069242,70311,129840,161633,363739,332011,263301,968946,1036816,81578246000,3840751000,5319675000,6636169000,15816331000,13024713000,8923388000,37901721000,41270226000
Georgia,Information,2007,11928,6250,1530,1020,8800,1183,586,10569,1359,21860,6270,1530,1030,8830,1405,915,11150,10710,550865,6609,8210,10547,25167,31496,43557,120130,425932,37994044000,428449000,400550000,534514000,1447102000,1829829000,2971525000,6952053000,30857936000
Georgia,Management of Companies and Enterprises,2007,5566,475,135,180,790,820,1371,2981,2585,8150,475,135,180,790,830,1465,3085,5065,569500,8,524,1039,2081,11855,41703,56300,502114,50569340000,67116000,55209000,55225000,189320000,580780000,2666430000,3436530000,47132810000
Georgia,Manufacturing,2007,39630,14270,6405,5394,26069,6649,2718,35436,4194,43495,14270,6405,5410,26085,6880,3345,36310,7185,1964676,21562,37098,64618,133028,244892,242564,678635,1173246,78015709000,965450000,1177342000,2213465000,4589040000,8874382000,9168292000,24669154000,48852586000
Georgia,"Mining, Quarrying, and Oil and Gas Extraction",2007,649,175,150,100,425,80,37,542,107,1050,175,150,100,425,80,50,555,495,31069,116,801,1068,2346,2702,1240,9772,18030,1494133000,11780000,27997000,40348000,87292000,93962000,63037000,405190000,913024000
Georgia,Other,2007,259,244,12,1,257,2,0,259,0,259,244,12,1,257,2,0,259,0,366,216,0,0,300,0,0,366,0,7476000,5565000,1297000,0,6974000,0,0,7476000,0
Georgia,Other Services (except Public Administration),2007,99077,62271,19180,9221,90672,6481,1055,98208,869,106500,62310,19255,9480,91045,7975,1770,100790,5710,817570,108728,123586,118890,357376,224852,88942,678350,116369,20435234000,2611075000,2665744000,2742727000,8038824000,5016732000,2354753000,15556334000,4011567000
Georgia,"Professional, Scientific, and Technical Services",2007,134418,98925,14885,8603,122413,6987,2212,131612,2806,142140,98930,14950,8750,122630,7900,3055,133585,8555,1133786,108228,95450,111133,340883,228706,137944,720181,392356,68435650000,6902888000,4550460000,5879235000,17378195000,13680729000,8904762000,40318540000,27669621000
Georgia,Real Estate and Rental and Leasing,2007,48879,38783,4365,2148,45296,1761,741,47798,1081,62445,38835,4495,2345,45675,2905,2765,51345,11100,312552,48766,27382,27477,105337,53911,42125,207264,92323,13706445000,1801031000,977728000,1056703000,3859741000,2514315000,1810664000,8365354000,5165589000
Georgia,Retail Trade,2007,115522,70478,21522,10796,102796,7673,1903,112372,3150,179600,70620,21955,11965,104540,11765,6330,122635,56965,2278578,113617,134057,137043,380380,268066,145465,832018,1412456,52502974000,2841762000,2984900000,3399641000,9299310000,8333789000,5013117000,23026306000,29139301000
Georgia,Total,2007,184687,112403,29441,18474,160318,16210,4191,180719,3968,231810,112527,29751,19302,161580,20215,9842,191637,40173,3648418,180354,193191,245909,619454,591677,456203,1667334,1981084,142115204000,6635716000,6003619000,7997378000,20636713000,20213942000,17465480000,58316135000,83799069000
Georgia,Transportation and Warehousing,2007,27160,16100,2875,2220,21195,2372,1230,24797,2363,32145,16115,2895,2260,21270,2620,1785,25675,6470,822298,12582,17322,28089,70216,66197,61391,205704,607566,33537056000,828900000,576953000,896479000,2333365000,2215933000,2352015000,7131985000,26117625000
Georgia,Utilities,2007,654,180,70,40,290,150,125,565,89,2820,180,70,40,290,235,340,865,1955,56968,0,320,473,1202,6918,19707,28887,0,4111024000,11237000,13334000,15035000,45102000,357892000,1193911000,1676379000,5331000
Georgia,Wholesale Trade,2007,61054,30940,8957,6552,46449,6787,3413,56649,4405,71365,30985,9105,6755,46845,7940,4840,59625,11740,1029697,31537,56005,77149,185427,187048,162482,561662,433440,55982572000,2510376000,2537847000,3746807000,8872430000,9145437000,8161503000,27096060000,27632510000
Hawaii,Accommodation and Food Services,2007,13901,4970,2595,2521,10086,2929,476,13491,410,17660,4975,2605,2570,10150,3475,1210,14835,2825,489858,8306,16837,32739,58185,114167,76140,249208,234871,11506400000,258743000,233616000,513604000,1024095000,1894620000,1449541000,4424510000,6936231000
Hawaii,Administrative and Support and Waste Management and Remediation Services,2007,8146,4260,1342,880,6482,856,402,7740,406,9205,4260,1345,880,6485,985,800,8270,935,228674,5405,7404,10206,25009,26478,51005,111393,62502,6220705000,214432000,230174000,276236000,763653000,807232000,1224976000,2935476000,1734140000
Hawaii,"Agriculture, Forestry, Fishing and Hunting",2007,215,155,20,15,190,25,0,215,0,215,155,20,15,190,25,0,215,0,1229,27,28,0,451,705,0,1229,0,26622000,492000,1415000,0,8419000,13413000,0,26622000,0
Hawaii,"Arts, Entertainment, and Recreation",2007,2399,1140,355,270,1765,395,162,2322,77,2580,1140,355,280,1775,410,260,2445,135,52032,1240,1958,2648,6115,15123,19193,43579,4470,1141744000,62408000,45480000,56533000,173527000,281696000,464438000,992129000,89697000
Hawaii,Construction,2007,14853,8295,2750,1885,12930,1470,251,14651,202,15025,8295,2750,1885,12930,1500,305,14735,290,171104,11858,17371,24276,54962,51694,30918,147800,14333,9800945000,575788000,728957000,1124577000,2451568000,3020897000,2081027000,8078342000,1295609000
Hawaii,Educational Services,2007,2510,1100,400,345,1845,440,125,2410,100,2735,1100,400,350,1850,485,240,2575,160,90862,1314,2344,3690,8476,14599,14476,42952,47244,2821034000,41672000,46500000,86773000,180341000,362616000,612810000,1218254000,1588623000
Hawaii,Finance and Insurance,2007,4913,2895,503,385,3783,288,205,4276,637,8370,2895,540,440,3875,580,705,5160,3210,96505,3784,2837,4273,11465,9133,11655,34490,50539,5326653000,225974000,121757000,227285000,584208000,419247000,636026000,1763737000,3286888000
Hawaii,Health Care and Social Assistance,2007,14526,7710,3765,1339,12814,959,462,14235,291,17420,7710,3810,1465,12985,1585,1495,16065,1355,320649,14891,23661,16363,55737,37674,73527,173654,115204,13631937000,774868000,1010652000,733742000,2535652000,1354035000,2824599000,6925171000,5496107000
Hawaii,Information,2007,1818,865,300,140,1305,190,55,1550,268,3085,865,305,150,1320,285,75,1680,1405,38196,871,1057,943,3695,3971,581,10907,20161,1961314000,62612000,45344000,39928000,183133000,166832000,26301000,472845000,1151754000
Hawaii,Management of Companies and Enterprises,2007,912,25,5,60,90,215,236,541,371,1130,25,5,60,90,215,270,575,555,32425,0,0,211,44,2350,7285,9862,22520,2147425000,0,0,10127000,12576000,141177000,320835000,475405000,1672020000
Hawaii,Manufacturing,2007,4671,2160,925,690,3775,639,102,4516,155,4855,2160,925,695,3780,690,160,4630,225,61270,2173,3856,6736,15103,15995,3213,46704,5735,2036041000,89721000,111211000,212852000,460620000,484171000,97080000,1447380000,258889000
Hawaii,"Mining, Quarrying, and Oil and Gas Extraction",2007,41,5,5,5,15,10,5,30,11,45,5,5,5,15,10,5,30,15,562,0,0,0,22,0,0,0,0,36980000,0,0,0,955000,0,0,0,0
Hawaii,Other,2007,39,38,1,0,39,0,0,39,0,39,38,1,0,39,0,0,39,0,29,20,0,0,29,0,0,29,0,826000,729000,0,0,826000,0,0,826000,0
Hawaii,Other Services (except Public Administration),2007,15799,10252,2590,1511,14353,996,239,15588,211,17715,10280,2605,1550,14435,1485,610,16530,1185,128912,17050,15346,18258,54260,32450,15580,109530,7865,3346346000,458874000,436941000,508820000,1434144000,861017000,417592000,2933913000,184502000
Hawaii,"Professional, Scientific, and Technical Services",2007,15580,10205,2295,1295,13795,940,268,15003,577,16865,10205,2305,1325,13835,1065,395,15295,1570,121561,13160,13883,16074,42741,30288,8077,88077,23620,6525703000,797069000,655335000,862125000,2347786000,1838356000,549109000,5045174000,1168113000
Hawaii,Real Estate and Rental and Leasing,2007,8774,6175,1160,529,7864,364,226,8454,320,10365,6190,1245,545,7980,630,315,8925,1440,79266,7164,4565,4725,17398,9904,7806,44316,29179,3199024000,396317000,230099000,240102000,894121000,387086000,305047000,1810445000,1213701000
Hawaii,Retail Trade,2007,16979,8244,3782,2035,14061,1418,477,15956,1023,25255,8295,3865,2400,14560,2685,1960,19205,6050,340667,9656,19053,22125,53409,34232,23564,143252,157712,8606981000,329792000,495373000,518226000,1402763000,989140000,909997000,3724197000,4173972000
Hawaii,Total,2007,26889,14830,4953,3021,22804,2568,662,26034,855,33388,14855,5036,3226,23117,3609,1967,28693,4695,519060,25938,32474,40141,98553,98350,91047,287950,231110,18306259000,979804000,1022673000,1295462000,3297939000,3215712000,3112392000,9626043000,8680216000
Hawaii,Transportation and Warehousing,2007,3760,1505,540,439,2484,604,275,3363,397,4510,1505,540,460,2505,655,505,3665,845,131032,1543,2794,3731,9689,16347,13755,45042,65634,4845501000,73795000,76177000,135027000,308244000,635888000,516611000,1599006000,2458096000
Hawaii,Utilities,2007,138,45,15,15,75,7,15,97,41,280,45,15,15,75,50,60,185,95,6076,1,0,78,295,0,0,90,67,462246000,3508000,0,1974000,11081000,0,0,11677000,3320000
Hawaii,Wholesale Trade,2007,8350,3980,1456,977,6413,951,289,7653,697,9430,3980,1535,1040,6555,1230,465,8250,1180,102229,5328,7269,10199,25429,25137,11650,72810,19919,4191432000,245769000,296819000,402577000,1007730000,977409000,464743000,2834501000,1045447000
Idaho,Accommodation and Food Services,2007,14331,5320,2820,2875,11015,2603,339,13957,374,17475,5320,2820,2910,11050,3435,1180,15665,1810,279586,7880,18196,38045,64796,88716,36004,192160,86564,3356599000,184783000,177657000,376385000,744351000,975428000,400628000,2128245000,1214301000
Idaho,Administrative and Support and Waste Management and Remediation Services,2007,10254,6550,1440,855,8845,732,249,9826,428,10980,6550,1445,875,8870,810,325,10005,975,189515,8359,8152,9753,28016,22583,25312,83411,100731,4361507000,261545000,223852000,238774000,796986000,558761000,444210000,1948323000,2195859000
Idaho,"Agriculture, Forestry, Fishing and Hunting",2007,2610,1835,375,215,2425,130,25,2580,30,2610,1835,375,215,2425,130,25,2580,30,17644,2519,2464,2829,8070,5230,1564,16904,456,589369000,103140000,76882000,115365000,301497000,178360000,27568000,545379000,18646000
Idaho,"Arts, Entertainment, and Recreation",2007,3487,2185,495,340,3020,367,45,3432,55,3560,2190,495,350,3035,395,55,3485,75,37833,2644,2901,3834,10027,11918,3055,31012,3402,617576000,85204000,41145000,64679000,209003000,214809000,47732000,551378000,31896000
Idaho,Construction,2007,43802,29930,7690,3880,41500,2000,190,43690,112,43925,29930,7690,3880,41500,2055,205,43760,165,251465,43877,49509,50677,147814,69752,20411,244945,2890,8602693000,1467180000,1301486000,1651217000,4433290000,2663841000,904282000,8342383000,137680000
Idaho,Educational Services,2007,1935,985,265,295,1545,275,50,1870,65,2045,985,265,295,1545,290,130,1965,80,47586,1172,1449,3570,6711,9601,1618,19548,11109,896713000,40860000,24287000,58760000,133728000,210144000,29186000,396475000,207666000
Idaho,Finance and Insurance,2007,8992,6130,988,425,7543,363,294,8200,792,15025,6135,1035,570,7740,730,1270,9740,5285,108331,8623,5462,4781,19493,8877,9781,45512,27020,4740221000,295223000,211889000,225215000,761755000,429969000,690411000,1985086000,2491339000
Idaho,Health Care and Social Assistance,2007,20209,9990,4715,2504,17209,1994,532,19735,474,22650,9995,4725,2550,17270,2965,1275,21510,1140,362150,16039,30003,31933,80005,74065,69019,227730,126819,12233496000,781666000,977101000,1068614000,2864589000,2346758000,1816116000,7113664000,4907505000
Idaho,Information,2007,2301,1035,325,230,1590,291,72,1953,348,3565,1035,330,240,1605,410,145,2160,1405,49452,963,1079,2000,5202,7944,2220,17144,27758,2168171000,42366000,36180000,61151000,160718000,283969000,92727000,621492000,1345192000
Idaho,Management of Companies and Enterprises,2007,928,65,20,40,125,190,271,586,342,1135,65,20,40,125,215,280,620,515,47814,0,0,25,0,2095,5616,8002,39758,4290648000,12990000,0,6768000,24120000,92260000,381928000,499540000,3789466000
Idaho,Manufacturing,2007,9477,4120,1770,1320,7210,1349,443,9002,475,9800,4120,1775,1325,7220,1385,515,9120,680,241662,4762,8814,12397,29985,42575,31267,126854,98854,9455128000,205190000,251480000,415343000,993199000,1498357000,1042328000,4260284000,4658277000
Idaho,"Mining, Quarrying, and Oil and Gas Extraction",2007,676,310,85,95,490,90,56,636,40,720,310,85,95,490,95,70,655,65,12413,295,113,1163,2052,2536,3349,10329,0,584584000,14344000,15728000,55237000,93104000,116491000,226031000,530740000,0
Idaho,Other,2007,34,31,3,0,34,0,0,34,0,34,31,3,0,34,0,0,34,0,49,0,0,0,49,0,0,49,0,922000,490000,0,0,922000,0,0,922000,0
Idaho,Other Services (except Public Administration),2007,15665,10105,3000,1399,14504,758,167,15429,236,16700,10110,3005,1495,14610,1050,320,15980,720,102109,16795,18557,16083,54126,20753,5765,84684,5909,2215683000,397165000,422553000,382573000,1228078000,399522000,149807000,1856397000,153416000
Idaho,"Professional, Scientific, and Technical Services",2007,20348,14405,2705,1405,18515,960,330,19805,543,21705,14405,2725,1425,18555,1260,535,20350,1355,149072,17853,16998,16196,55397,27596,8972,98242,28817,6812140000,786011000,633660000,700602000,2151382000,1314824000,440372000,4123870000,2501398000
Idaho,Real Estate and Rental and Leasing,2007,11760,9662,1043,430,11135,286,110,11531,229,12925,9665,1060,545,11270,460,445,12175,750,45586,8661,6070,4895,24929,6904,983,38703,3417,1305348000,372748000,149363000,140520000,692656000,273318000,26644000,1158357000,95275000
Idaho,Retail Trade,2007,22886,10920,4773,3039,18732,2290,552,21574,1312,31895,10950,4845,3265,19060,3560,2435,25055,6840,401600,15089,28930,38181,86817,68974,36938,199642,178983,9458174000,418384000,608071000,872366000,1936725000,1860239000,1106199000,5044263000,3920110000
Idaho,Total,2007,40749,24681,6918,4138,35737,3157,750,39644,1105,47411,24696,6964,4320,35980,4327,2082,42389,5022,544541,39154,45437,54417,139008,111468,75041,325517,219024,17542930000,1227293000,1154359000,1485820000,3867472000,3249599000,2283556000,9400627000,8142303000
Idaho,Transportation and Warehousing,2007,8156,5560,890,555,7005,612,168,7785,371,8840,5560,890,560,7010,700,215,7925,915,81393,7118,5007,5202,19947,18828,6874,50850,26865,2643136000,226669000,150092000,208710000,609901000,591034000,249057000,1559729000,978793000
Idaho,Utilities,2007,591,345,55,65,465,60,10,535,56,950,345,55,65,465,95,65,625,325,16177,415,287,761,1488,2100,0,4305,0,1129292000,8081000,7573000,25402000,41843000,116051000,0,200379000,9249000
Idaho,Wholesale Trade,2007,8520,3820,1155,800,5775,1168,531,7474,1046,10380,3820,1165,900,5885,1595,920,8400,1980,113965,4023,6310,6816,18357,29479,18082,76231,28672,4962063000,216411000,247315000,270879000,836729000,1132836000,694590000,2960357000,1621133000
Illinois,Accommodation and Food Services,2007,103867,44365,19833,17559,81757,18523,2091,102371,1496,133595,44430,19895,17720,82045,20975,6370,109390,24205,2350835,75062,131902,232444,438725,690359,298925,1433865,899741,35783820000,1660676000,1530508000,2725836000,5963486000,9234156000,4346581000,19532718000,16131730000
Illinois,Administrative and Support and Waste Management and Remediation Services,2007,71707,44350,9575,6035,59960,6419,2558,68937,2770,80945,44360,9610,6115,60085,6875,3450,70410,10535,2317250,56570,61915,78367,200954,252027,372486,832927,1456557,64013784000,3182219000,2143462000,2739804000,8070624000,8810511000,10155887000,27483972000,35849617000
Illinois,"Agriculture, Forestry, Fishing and Hunting",2007,1490,1115,205,90,1410,30,25,1465,25,1555,1115,205,90,1410,30,50,1490,65,7218,1379,891,932,3625,290,982,5528,0,290388000,48202000,41175000,19406000,114232000,9241000,46264000,193882000,0
Illinois,"Arts, Entertainment, and Recreation",2007,21813,12825,3185,2235,18245,2735,487,21467,346,23035,12835,3190,2240,18265,2830,815,21910,1125,363696,16072,19048,29255,67167,106880,71241,249869,94845,11124380000,652237000,407760000,636603000,1711427000,2223966000,3183802000,7282791000,2627377000
Illinois,Construction,2007,163568,112303,24805,14159,151267,10218,1421,162906,662,164595,112310,24805,14175,151290,10365,1705,163360,1235,1260465,164928,162380,187969,517121,383923,214821,1120405,129755,74232330000,7313920000,7039390000,9721870000,24081020000,24306867000,14857419000,63542465000,10315726000
Illinois,Educational Services,2007,16058,7510,2290,1900,11700,3144,713,15557,501,17845,7510,2290,1965,11765,3505,915,16185,1660,707344,9109,14908,25495,51618,131540,100520,288900,394670,23519072000,345804000,321124000,512875000,1191989000,3221444000,3000439000,7454550000,15259443000
Illinois,Finance and Insurance,2007,72641,47432,9521,4750,61703,5421,2309,69433,3208,121960,47480,9710,5460,62650,9580,9280,81510,40450,1735219,77783,58047,57710,198298,181062,192778,593790,1117012,146927897000,4147091000,2882931000,3987582000,11037231000,12505952000,14680344000,39672147000,103828936000
Illinois,Health Care and Social Assistance,2007,125914,63655,26669,16178,106502,12219,4659,123380,2534,154750,63715,27030,17135,107880,16510,13475,137865,16885,3520434,109352,172513,212368,500665,474679,655504,1647399,1853400,140544310000,5869864000,7620559000,10050687000,23657968000,18774498000,19538334000,62316304000,77264610000
Illinois,Information,2007,16746,8720,2172,1566,12458,1735,882,15075,1671,28830,8720,2195,1605,12520,1935,1190,15645,13185,623536,8235,11483,17785,38566,54806,62381,172125,421433,40038635000,619481000,525197000,845964000,2004199000,3770518000,3983726000,10095368000,29641088000
Illinois,Management of Companies and Enterprises,2007,7585,575,190,260,1025,1310,1977,4312,3273,11020,575,190,260,1025,1325,2170,4520,6500,916905,0,683,6,38,16175,64935,83905,833000,93535625000,98807000,66970000,99259000,278040000,1225325000,4145455000,5648820000,87886805000
Illinois,Manufacturing,2007,74150,25037,12220,11166,48423,15242,5403,69068,5082,78460,25055,12235,11215,48505,15830,6140,70475,7985,3137253,39668,75650,142176,264991,597711,643299,1588601,1386935,152652825000,1931378000,2757517000,5749962000,10805441000,26234465000,29360028000,69865297000,74404951000
Illinois,"Mining, Quarrying, and Oil and Gas Extraction",2007,2470,1335,355,261,1951,268,112,2331,139,2880,1335,355,265,1955,320,270,2545,335,51454,2287,2197,2561,7901,7357,7680,25694,17238,2546910000,79199000,88552000,142069000,312468000,326814000,438058000,1162390000,933125000
Illinois,Other,2007,209,197,8,3,208,1,0,209,0,209,197,8,3,208,1,0,209,0,259,0,52,0,0,0,0,259,0,5173000,3632000,1372000,84000,5088000,0,0,5173000,0
Illinois,Other Services (except Public Administration),2007,149098,89877,30493,16077,136447,10104,1517,148068,1030,162305,89970,30835,16835,137640,12430,3190,153260,9045,1301370,167663,198236,207115,575486,341406,145595,1071574,206915,36269320000,4021412000,4621225000,5151848000,13823800000,9048292000,5492989000,28613137000,7226104000
Illinois,"Professional, Scientific, and Technical Services",2007,188540,136198,22440,13394,172032,10097,3111,185240,3300,199145,136265,22545,13710,172520,11780,4165,188465,10680,1966596,160718,138549,169495,501036,321727,248677,1083906,845480,132494168000,12063241000,7480009000,10171066000,29804699000,22513926000,17986879000,70688370000,60607186000
Illinois,Real Estate and Rental and Leasing,2007,55995,41474,6888,3008,51370,2561,921,54852,1143,68765,41500,6985,3435,51920,3680,2610,58210,10555,439016,50724,42294,36516,136934,79628,59888,285826,144063,20964351000,2260796000,1491288000,1474788000,5296157000,3590054000,3211804000,12509260000,8238726000
Illinois,Retail Trade,2007,136894,75099,26744,15991,117834,12802,2925,133561,3333,214460,75300,27295,17580,120175,19090,10735,150000,64460,3279729,120454,148845,196557,470279,450274,245102,1212838,1913790,79948783000,3161749000,3716080000,4703352000,11724165000,14514496000,7720531000,34420445000,42569586000
Illinois,Total,2007,264289,158172,43300,27447,228919,24768,6183,259870,4419,325206,158344,43770,28734,230848,31031,15112,276991,48215,5398634,253902,283891,364172,901965,929847,782792,2614604,2784030,243268927000,10751359000,9847372000,13614593000,34213324000,37491635000,33439157000,105144116000,138124811000
Illinois,Transportation and Warehousing,2007,52027,34060,5805,3752,43617,4064,1741,49422,2605,58475,34065,5820,3785,43670,4380,2330,50380,8095,1140992,35062,37467,47211,132392,125457,105628,375878,751474,48586428000,1551865000,1281940000,1798206000,4690591000,4962803000,4377292000,14502710000,33263150000
Illinois,Utilities,2007,892,345,95,90,530,167,44,741,151,2250,345,95,110,550,285,75,910,1340,74366,483,617,783,1910,6334,2140,11619,53887,6725217000,22828000,17589000,65191000,112452000,390826000,170055000,724113000,5286855000
Illinois,Wholesale Trade,2007,86740,43759,13317,9521,66597,11002,4204,81803,4937,100115,43850,13525,9955,67330,13425,6625,87380,12735,1514855,66509,81402,117897,267894,347217,225986,861934,615946,88321020000,3939917000,4408527000,6285914000,14771124000,18955631000,12669675000,46899090000,39833876000
Indiana,Accommodation and Food Services,2007,47141,17755,8835,8988,35578,9203,1279,46060,1081,64560,17775,8850,9125,35750,10745,4930,51425,13135,1268625,27610,58941,123397,211220,340827,179007,734787,529891,16163490000,608595000,591985000,1206121000,2408460000,3624334000,1970426000,8023418000,8121007000
Indiana,Administrative and Support and Waste Management and Remediation Services,2007,31564,18380,4883,2985,26248,2829,1053,30130,1434,36190,18390,4890,3025,26305,3130,1600,31035,5155,864615,24618,29804,37536,95629,103938,120493,332979,504755,23285190000,845239000,797180000,990993000,2682777000,2809893000,2834827000,8648337000,13841718000
Indiana,"Agriculture, Forestry, Fishing and Hunting",2007,1290,1025,130,55,1210,30,20,1260,30,1330,1025,130,55,1210,30,25,1265,65,7630,630,503,456,2886,685,0,4187,0,260181000,39266000,11030000,14089000,76225000,19698000,0,112974000,0
Indiana,"Arts, Entertainment, and Recreation",2007,10467,5640,1510,1440,8590,1487,225,10302,165,10875,5640,1510,1460,8610,1625,370,10605,270,151260,6761,9710,18634,37462,52869,27816,126194,11808,3892539000,258687000,168344000,319107000,758115000,934422000,619981000,2985642000,314908000
Indiana,Construction,2007,80200,50145,15059,8230,73434,5438,847,79719,481,80900,50150,15065,8235,73450,5545,1035,80030,870,715790,83788,97500,109713,293755,200632,116174,616682,82017,33012935000,2890067000,3150195000,4159700000,10204420000,9496228000,6774060000,26855000000,5217263000
Indiana,Educational Services,2007,7150,3385,1330,810,5525,1145,210,6880,270,7725,3385,1330,850,5565,1290,330,7185,540,281991,4540,8526,10455,24776,43644,25474,96669,180913,7099894000,140411000,149734000,163669000,459115000,963721000,680015000,2192275000,4753129000
Indiana,Finance and Insurance,2007,27224,18150,3575,1251,22976,1631,881,25488,1736,52955,18165,3720,1555,23440,3725,4820,31985,20970,528809,29489,21469,15637,67226,53311,70658,197080,319877,28220495000,1079877000,836792000,701955000,2651279000,2329928000,3297761000,8478586000,19260936000
Indiana,Health Care and Social Assistance,2007,54370,24140,12680,7480,44300,5817,2584,52701,1669,74685,24170,12780,7880,44830,8755,8245,61830,12855,1824670,44891,84235,98488,229814,220007,396624,851887,953617,66133938000,1916321000,3130242000,4079197000,9137002000,8426936000,12518266000,30367156000,35424366000
Indiana,Information,2007,5984,2635,901,655,4191,764,303,5258,726,11530,2635,910,665,4210,970,525,5705,5825,215244,2912,5100,7665,17139,22155,19522,67539,146369,9582499000,142558000,186449000,276022000,647936000,841668000,678033000,2505911000,6992058000
Indiana,Management of Companies and Enterprises,2007,3465,190,50,110,350,651,1041,2042,1423,4740,190,50,110,350,660,1130,2140,2600,300770,216,0,494,943,7479,37920,46460,254310,23862615000,16425000,0,26325000,50350000,480331000,1945950000,2485205000,21377410000
Indiana,Manufacturing,2007,41156,11744,6535,5900,24179,9020,3590,36789,4367,44780,11745,6535,5920,24200,9450,4255,37905,6875,2613453,17697,38650,72506,139204,348107,389855,943213,1582495,118407094000,716342000,1248607000,2559330000,4780098000,12788249000,14714785000,34720533000,79959178000
Indiana,"Mining, Quarrying, and Oil and Gas Extraction",2007,1052,380,170,155,705,149,82,936,116,1620,380,180,155,715,245,135,1095,525,30178,526,853,1481,3439,3134,4246,12893,16643,1624605000,20799000,38402000,54674000,118088000,143915000,224720000,597523000,984623000
Indiana,Other,2007,86,82,4,0,86,0,0,86,0,86,82,4,0,86,0,0,86,0,85,61,24,0,85,0,0,85,0,2053000,1696000,357000,0,2053000,0,0,2053000,0
Indiana,Other Services (except Public Administration),2007,79005,46609,16868,8968,72445,5052,801,78298,707,86365,46675,16990,9440,73105,6875,2320,82300,4065,659482,88115,108124,116581,315282,168933,56820,553362,67795,14583767000,1846051000,2083962000,2331621000,6278915000,3691275000,1607988000,11892793000,1977204000
Indiana,"Professional, Scientific, and Technical Services",2007,61587,41745,8970,5043,55758,3596,1024,60378,1209,66240,41745,9000,5195,55940,4460,1560,61960,4280,521637,63225,57511,64451,188281,114990,61859,370171,133827,25632329000,2395967000,2174555000,2598303000,7183244000,5621781000,4091686000,17133774000,8067299000
Indiana,Real Estate and Rental and Leasing,2007,24104,17720,2825,1363,21908,1106,482,23496,608,31545,17730,2940,1505,22175,2215,1590,25980,5565,176495,22370,17557,16621,61367,34525,22618,122528,44018,5586330000,759963000,477541000,462414000,1697016000,1075910000,813234000,3722538000,1579444000
Indiana,Retail Trade,2007,71387,35540,15500,8957,59997,7106,1652,68755,2632,117230,35665,15895,10145,61705,11695,7200,80600,36630,1666547,55854,99026,115510,270899,240066,114557,662085,922242,36367274000,1416113000,1999758000,2517296000,5977614000,6799316000,3299805000,16471801000,19454496000
Indiana,Total,2007,118218,64866,21698,13690,100254,11972,3058,115284,2934,152858,64935,21938,14412,101285,15978,8890,126153,26705,2648219,112133,142724,182748,437605,444737,395402,1277744,1370475,94807149000,3429792000,3858584000,5216978000,12505354000,14129512000,13971758000,40606624000,54200525000
Indiana,Transportation and Warehousing,2007,23213,12935,3135,2345,18415,2333,794,21542,1671,26320,12935,3140,2370,18445,2535,1050,22030,4290,552397,15023,19635,29988,70336,76179,57081,209377,330589,19151059000,676687000,611274000,1055652000,2359986000,2759706000,2127557000,7457400000,11523739000
Indiana,Utilities,2007,989,335,210,90,635,215,35,885,104,2855,335,210,105,650,255,95,1000,1855,74791,715,684,126,2960,8382,0,13846,55016,5288814000,19527000,37025000,28217000,97462000,470530000,0,778099000,4173542000
Indiana,Wholesale Trade,2007,34299,15490,5460,4038,24988,4576,2104,31668,2631,41415,15530,5545,4265,25340,5685,3235,34260,7155,569659,18962,32981,47440,109788,134644,93548,353082,196211,26403263000,1101232000,1344728000,2031065000,4555165000,5936926000,4234906000,15267469000,10327492000
Iowa,Accommodation and Food Services,2007,28468,10975,5575,5205,21755,5362,799,27916,552,34980,10980,5580,5250,21810,6565,2650,31025,3955,568225,17975,36972,72004,127748,191340,88025,408280,158339,6241163000,320924000,320933000,610815000,1258982000,1826215000,950809000,4042949000,2163771000
Iowa,Administrative and Support and Waste Management and Remediation Services,2007,15144,9075,2290,1325,12690,1131,510,14331,813,17380,9080,2315,1345,12740,1300,860,14900,2480,343824,12342,14568,15864,43741,38562,48599,142279,189013,8038253000,391603000,344074000,408862000,1167383000,942126000,1059582000,3497101000,4284481000
Iowa,"Agriculture, Forestry, Fishing and Hunting",2007,1195,885,135,60,1080,65,40,1185,10,1350,885,135,60,1080,85,115,1280,70,7942,360,750,521,2541,1615,473,5507,0,337715000,37311000,23910000,22160000,92512000,53183000,21514000,206880000,0
Iowa,"Arts, Entertainment, and Recreation",2007,7060,4130,1240,745,6115,740,111,6966,94,7210,4130,1240,760,6130,765,145,7040,170,103343,4496,7809,9672,23013,25830,10465,63409,26473,1872749000,147069000,109282000,126806000,395730000,365553000,142736000,993295000,595312000
Iowa,Construction,2007,44538,29950,7600,3740,41290,2643,400,44333,205,45050,29950,7600,3745,41295,2790,535,44620,430,317445,43934,47917,48616,143309,98387,43495,292869,20145,14485658000,1633735000,1645340000,1964296000,5253039000,4802962000,2439359000,12855846000,1309678000
Iowa,Educational Services,2007,3206,1410,560,365,2335,550,165,3050,156,3660,1415,560,400,2375,600,350,3325,335,167282,1753,3407,4389,10808,20756,26277,58763,106917,3444254000,60911000,54062000,58071000,185597000,356344000,698987000,1279850000,2128677000
Iowa,Finance and Insurance,2007,19277,12365,2486,1332,16183,1388,624,18195,1082,31415,12395,2585,1890,16870,3815,3450,24135,7280,461182,19446,15053,16683,52869,46060,61010,164155,249904,24278770000,634214000,508920000,725638000,1907647000,2031049000,3046127000,7228499000,14942579000
Iowa,Health Care and Social Assistance,2007,28670,12695,5515,3689,21899,3931,1835,27665,1005,39290,12700,5575,3905,22180,5930,5680,33790,5500,991468,22509,35107,47894,107970,163106,250492,532303,415782,32492321000,992362000,1328845000,1911508000,4282374000,4598471000,6932450000,15985356000,16349997000
Iowa,Information,2007,4649,1905,838,648,3391,529,220,4140,509,7950,1905,840,655,3400,745,545,4690,3260,161046,2614,4658,7923,16997,15291,12381,47814,85898,6943177000,106248000,134205000,255637000,544470000,578072000,439824000,1676842000,3824613000
Iowa,Management of Companies and Enterprises,2007,1934,85,20,105,210,421,647,1278,656,2310,85,20,105,210,430,670,1310,1000,98780,0,0,304,436,4565,19345,24455,73961,6698780000,7272000,0,14789000,29240000,225745000,1069370000,1324355000,5290698000
Iowa,Manufacturing,2007,16985,5410,2885,2210,10505,3140,1517,15162,1823,18980,5410,2890,2240,10540,3375,2210,16125,2855,955900,7040,16022,24839,53775,115339,145753,344775,508190,39652920000,297159000,477069000,832599000,1724406000,4264456000,5715710000,12806590000,22020296000
Iowa,"Mining, Quarrying, and Oil and Gas Extraction",2007,337,95,35,40,170,86,48,304,33,905,95,35,40,170,205,320,695,210,9303,32,138,610,946,2931,2859,7040,2092,410291000,4073000,7780000,22565000,35249000,140978000,124444000,304785000,99075000
Iowa,Other,2007,139,136,3,0,139,0,0,139,0,139,136,3,0,139,0,0,139,0,69,50,0,0,69,0,0,69,0,983000,833000,150000,0,983000,0,0,983000,0
Iowa,Other Services (except Public Administration),2007,44082,28585,9100,3761,41446,1935,323,43704,378,47060,28645,9265,4205,42115,2670,750,45535,1525,275575,52819,57293,47474,159436,60465,20657,249105,16197,5603394000,984607000,1047566000,881114000,2944198000,1326010000,322804000,4822745000,526714000
Iowa,"Professional, Scientific, and Technical Services",2007,29962,20045,4855,2305,27205,1714,376,29295,667,32020,20050,4875,2425,27350,2260,535,30145,1875,221390,29237,30371,28417,92510,53815,16578,169922,30213,10157091000,1097529000,1014739000,1124938000,3268691000,2963473000,988658000,7498120000,1659907000
Iowa,Real Estate and Rental and Leasing,2007,11675,8973,1170,458,10601,480,266,11347,328,14345,8980,1170,575,10725,1135,510,12370,1975,67072,12034,6808,5183,26057,12649,8523,50743,13218,2082160000,341162000,171636000,130568000,676681000,391533000,368480000,1595211000,378357000
Iowa,Retail Trade,2007,44040,21328,9783,6170,37281,3992,1016,42289,1751,66425,21350,9905,6890,38145,6645,3395,48185,18240,821255,35633,60779,74507,177485,120631,52066,368250,353726,17029624000,834040000,1202023000,1694222000,3748902000,3184549000,1672175000,8859455000,6624536000
Iowa,Total,2007,65859,37476,11814,7122,56412,6113,1598,64123,1736,83158,37512,11946,7687,57145,9103,5338,71586,11572,1303436,62845,77477,94458,234780,229263,204460,668503,634933,43417218000,1783513000,1931890000,2587542000,6302945000,6930661000,6767314000,20000920000,23416298000
Iowa,Transportation and Warehousing,2007,17057,11210,2150,1285,14645,1183,400,16228,829,18940,11210,2160,1285,14655,1355,600,16610,2330,256068,13848,13416,16390,45988,34495,25628,111351,139301,8833526000,424860000,376905000,521039000,1332022000,1188924000,1003679000,3617334000,5011295000
Iowa,Utilities,2007,431,75,50,70,195,162,17,374,57,1270,75,50,70,195,325,40,560,710,1137,130,286,795,1344,6518,0,8579,0,97553000,3158000,11290000,39258000,57922000,336666000,0,440764000,0
Iowa,Wholesale Trade,2007,18694,7535,2861,2402,12798,3058,1230,17086,1608,24555,7540,2915,2590,13045,4520,3330,20895,3660,314213,10426,16910,27480,58278,87116,63280,221461,75625,13334557000,453311000,622911000,1057409000,2223379000,3658530000,2639312000,9056232000,3776963000
Kansas,Accommodation and Food Services,2007,21760,8170,3854,3900,15924,4403,586,20913,847,29385,8170,3860,3955,15985,5065,1885,22935,6450,531864,11806,26142,53930,92156,155887,71163,320334,209818,7141968000,1019395000,236147000,475004000,1932961000,1642465000,809843000,4403987000,2718904000
Kansas,Administrative and Support and Waste Management and Remediation Services,2007,15753,9295,2430,1240,12965,1313,544,14822,931,17610,9295,2435,1300,13030,1395,665,15090,2520,354063,12205,15114,14767,45372,42637,58831,156544,179906,9561412000,449698000,395165000,411118000,1302919000,1181656000,1421898000,4246322000,4884125000
Kansas,"Agriculture, Forestry, Fishing and Hunting",2007,1056,825,140,40,1005,40,6,1051,5,1060,825,140,40,1005,40,10,1055,5,3828,733,797,382,2492,1054,0,3708,0,110157000,36955000,21792000,13184000,76822000,24643000,0,108477000,0
Kansas,"Arts, Entertainment, and Recreation",2007,5250,2745,920,640,4305,725,98,5128,122,5460,2745,920,655,4320,820,115,5255,205,70556,3126,5622,8227,18287,28976,10130,59216,7468,1045620000,77445000,78238000,119393000,285693000,409385000,158495000,888672000,131827000
Kansas,Construction,2007,39931,25340,7115,3938,36393,2842,391,39626,305,40285,25340,7115,3940,36395,2885,430,39710,575,335830,42362,45410,52242,140445,103471,44066,295360,28794,13860840000,1297938000,1423853000,1847933000,4582164000,4822144000,2235491000,11937560000,1610956000
Kansas,Educational Services,2007,3210,1495,465,365,2325,600,160,3085,125,3455,1495,465,365,2325,640,265,3230,225,88251,1946,2771,4418,9771,22838,25208,59826,26570,1937988000,60042000,46071000,75546000,198930000,536384000,491793000,1268958000,639382000
Kansas,Finance and Insurance,2007,19234,12530,2088,1226,15844,1439,540,17823,1411,30085,12535,2200,1720,16455,3540,2345,22340,7745,293683,19335,12155,15527,49029,48563,42535,146208,135572,15213266000,679509000,514263000,661969000,1931235000,2324840000,2023278000,6573240000,8108763000
Kansas,Health Care and Social Assistance,2007,29355,13390,5910,3866,23166,3700,1470,28336,1019,38305,13400,5970,4050,23420,5150,4410,32980,5325,892064,23048,38390,49854,113604,147421,223353,490647,376048,30908217000,1077725000,1401443000,2087001000,4609557000,5492998000,6002412000,16296063000,14083049000
Kansas,Information,2007,3964,1595,606,391,2592,510,255,3357,607,7520,1595,610,405,2610,585,605,3800,3720,219890,777,3459,3902,11104,10996,17030,48280,121853,12768760000,72732000,96008000,140737000,350175000,403792000,761123000,1883774000,7736507000
Kansas,Management of Companies and Enterprises,2007,2106,180,40,75,295,450,546,1291,815,2750,180,40,85,305,465,595,1365,1385,133810,0,0,0,0,4561,13338,18260,115049,11168270000,0,0,24388000,3368000,243432000,822525000,1104029000,10027118000
Kansas,Manufacturing,2007,14922,4815,2480,2090,9385,2737,1265,13387,1535,15920,4815,2480,2115,9410,2905,1580,13895,2025,779154,5584,12530,21193,46675,89373,128498,296393,416808,34241870000,262005000,414466000,778935000,1625009000,3299538000,4979941000,10925788000,20813240000
Kansas,"Mining, Quarrying, and Oil and Gas Extraction",2007,4697,2715,695,502,3912,453,134,4499,198,5000,2715,695,540,3950,545,190,4685,315,58940,4434,4439,6576,15489,16170,8983,43773,13697,2707400000,156447000,160286000,294837000,609778000,694124000,397556000,1838383000,796242000
Kansas,Other,2007,73,71,0,0,71,2,0,73,0,73,71,0,0,71,2,0,73,0,0,0,0,0,0,0,0,0,0,1093000,801000,0,0,801000,0,0,1093000,0
Kansas,Other Services (except Public Administration),2007,39271,25495,7510,3529,36534,2032,359,38925,346,41775,25525,7565,3660,36750,2460,890,40100,1675,268569,44545,46548,43289,139903,63492,24148,236115,19450,5682803000,912674000,897683000,923254000,2768733000,1293262000,625178000,4960541000,498927000
Kansas,"Professional, Scientific, and Technical Services",2007,34299,23368,4840,2620,30828,1772,774,33374,925,36645,23370,4870,2720,30960,2200,1155,34315,2330,296011,28839,30427,32557,99339,55933,48847,213707,61627,14471340000,1457557000,1145716000,1352522000,4014338000,2803790000,2708888000,9796239000,3503865000
Kansas,Real Estate and Rental and Leasing,2007,13313,10003,1513,653,12169,464,258,12891,422,16430,10015,1545,765,12325,825,1065,14215,2215,73723,13725,9044,7791,31038,11573,9866,55589,14549,2263913000,439037000,260825000,257597000,970101000,379881000,277512000,1714280000,457130000
Kansas,Retail Trade,2007,40029,19747,9016,4861,33624,3725,909,38258,1771,56530,19780,9210,5310,34300,5825,2740,42865,13665,686040,32898,56722,53978,154522,111045,56263,329633,308183,14696651000,709802000,1100228000,1312674000,3138708000,3081518000,1595395000,8019668000,6208472000
Kansas,Total,2007,62092,35317,10775,6552,52644,5886,1617,60147,1945,77157,35343,10906,6990,53239,8131,4392,65762,11395,1169099,60497,70380,87094,217971,214699,191314,623984,545115,42022753000,2000662000,1887165000,2582319000,6470146000,6898630000,6459447000,19828223000,22194530000
Kansas,Transportation and Warehousing,2007,11504,7005,1450,920,9375,905,349,10629,875,13320,7005,1450,935,9390,960,585,10935,2385,220805,9380,8702,10779,29918,23981,15846,78477,104878,8933356000,312756000,257231000,335779000,943204000,807430000,630705000,2672578000,4722446000
Kansas,Utilities,2007,368,95,30,55,180,105,20,305,63,1110,95,30,55,180,190,170,540,570,28279,0,0,724,973,3819,0,6743,15959,2252848000,3673000,0,35874000,46135000,276414000,0,479631000,1342850000
Kansas,Wholesale Trade,2007,18003,7440,2880,2130,12450,2743,1126,16319,1684,22775,7460,2930,2335,12725,4150,2260,19135,3640,276144,10405,17122,23511,53609,72047,41411,185038,79980,13108590000,558037000,737110000,1061236000,2478080000,3057571000,2064630000,8255461000,4515115000
Kentucky,Accommodation and Food Services,2007,26431,8895,4385,5188,18468,5878,1150,25496,935,36400,8930,4400,5230,18560,6865,3770,29195,7205,760746,13291,29589,70829,114169,215830,130714,470657,288593,9122456000,303974000,296890000,723472000,1328591000,2253057000,1433159000,5165246000,3938467000
Kentucky,Administrative and Support and Waste Management and Remediation Services,2007,16661,9345,2660,1575,13580,1415,580,15575,1086,19070,9345,2665,1575,13585,1495,845,15925,3145,457230,12799,16067,19415,50583,48894,64820,174485,266076,9723312000,417633000,409594000,524834000,1378241000,1340539000,1288283000,4232982000,5150273000
Kentucky,"Agriculture, Forestry, Fishing and Hunting",2007,1395,975,215,105,1295,50,40,1385,10,1410,975,215,105,1295,50,55,1400,10,8968,1496,1289,781,4101,1822,2645,8771,0,284875000,38049000,27671000,33333000,102161000,51854000,124761000,281526000,0
Kentucky,"Arts, Entertainment, and Recreation",2007,6459,3330,1195,854,5379,855,116,6350,109,6690,3335,1195,875,5405,925,140,6470,220,82010,3831,7095,10683,23579,34477,9027,72166,7645,1688211000,136557000,127306000,176434000,461045000,661530000,209979000,1431422000,141016000
Kentucky,Construction,2007,45710,28015,8420,4760,41195,3709,523,45427,283,46105,28015,8420,4775,41210,3810,570,45590,515,416450,45845,54470,62298,165650,141160,61023,379655,28792,16166995000,1425385000,1536670000,2063944000,5040170000,5983077000,2971068000,14438420000,1372752000
Kentucky,Educational Services,2007,3891,1630,665,570,2865,605,273,3743,148,4565,1630,665,580,2875,700,480,4055,510,143070,2173,4350,7240,14711,22209,42498,81825,47557,2942380000,65975000,57440000,109271000,240395000,456517000,962821000,1714308000,1000536000
Kentucky,Finance and Insurance,2007,16673,9865,2648,1099,13612,1222,558,15392,1281,33310,9880,2725,1420,14025,3400,3190,20615,12695,313948,16850,14743,13398,47574,42374,43641,137584,159793,15072537000,582507000,524699000,597744000,1777585000,1767865000,1694511000,5477489000,9216470000
Kentucky,Health Care and Social Assistance,2007,40976,17695,10088,5861,33644,4547,1463,39654,1322,52850,17695,10150,6095,33940,6250,4005,44195,8655,1166188,32568,66496,76582,175718,161345,189681,540322,619528,42114851000,1538976000,2364522000,2881540000,6826033000,6429056000,5392274000,18903969000,23093966000
Kentucky,Information,2007,4537,2070,645,445,3160,557,246,3963,574,8155,2070,655,455,3180,715,425,4320,3835,169875,960,3528,4750,12485,17247,9431,43882,123873,6166284000,125545000,102225000,150336000,416433000,575892000,363055000,1571723000,4573716000
Kentucky,Management of Companies and Enterprises,2007,2372,210,45,35,290,482,616,1388,984,3405,220,45,35,300,490,725,1515,1890,164135,0,0,200,74,5559,12403,18925,145128,13049260000,23405000,11648000,9724000,49855000,264863000,593619000,922655000,12121652000
Kentucky,Manufacturing,2007,18971,5440,2970,2570,10980,3803,1613,16396,2575,20715,5440,2970,2575,10985,4110,1970,17065,3650,1129120,6839,15563,28751,58552,130878,162132,393783,672854,48490909000,298247000,472665000,899505000,1840080000,4547981000,6055876000,13828746000,32050225000
Kentucky,"Mining, Quarrying, and Oil and Gas Extraction",2007,2769,950,375,400,1725,635,205,2565,204,3300,950,375,400,1725,665,290,2680,620,109606,1469,2301,5055,9007,22224,15721,52312,55219,5930398000,68660000,66240000,183907000,325838000,993512000,849204000,2384114000,3421653000
Kentucky,Other,2007,83,79,3,1,83,0,0,83,0,83,79,3,1,83,0,0,83,0,106,0,0,0,106,0,0,106,0,1219000,1080000,111000,0,1219000,0,0,1219000,0
Kentucky,Other Services (except Public Administration),2007,45265,28200,9023,4291,41514,2758,484,44756,509,49200,28205,9100,4485,41790,3935,995,46720,2480,349310,52242,56414,54190,167102,90040,26014,292214,40825,7562205000,1054566000,1130110000,1093275000,3319550000,1901645000,686908000,6049621000,1190082000
Kentucky,"Professional, Scientific, and Technical Services",2007,38501,26035,5695,3050,34780,2071,639,37490,1011,41210,26050,5705,3105,34860,2540,945,38345,2865,321992,41273,36136,38386,117562,66296,40538,231446,69440,13989380000,1450943000,1258969000,1427144000,4177043000,3103652000,2135994000,9585706000,4050831000
Kentucky,Real Estate and Rental and Leasing,2007,15426,11115,1960,898,13973,589,339,14901,525,19340,11120,1985,1045,14150,830,1055,16035,3305,97048,16516,12054,10381,40441,14767,9462,70433,22215,2798483000,437836000,308111000,296240000,1061509000,387064000,313614000,1893475000,794403000
Kentucky,Retail Trade,2007,53925,27115,11495,7149,45759,5019,1016,51794,2131,81270,27165,11680,7885,46730,7665,3435,57830,23440,1000012,43004,74925,91103,209203,159525,60084,452176,434519,21202114000,997295000,1465390000,1925126000,4403015000,4232610000,1642536000,10464365000,8877123000
Kentucky,Total,2007,72848,39407,13468,8453,61328,7313,1921,70562,2286,93539,39442,13583,8872,61897,9808,5171,76876,16663,1550192,69804,88611,112152,270567,266855,225134,762556,787636,52397804000,1998752000,2284389000,3030705000,7313846000,8179099000,7126028000,22618973000,29778831000
Kentucky,Transportation and Warehousing,2007,13838,7710,1965,1205,10880,1154,537,12571,1267,16020,7710,1970,1215,10895,1290,635,12820,3200,348484,10968,11890,14617,40115,30992,25392,105597,230728,13369261000,337024000,327113000,441245000,1124497000,1048763000,957615000,3370790000,9465378000
Kentucky,Utilities,2007,508,165,65,60,290,92,60,442,66,1660,165,65,60,290,165,250,705,955,42146,327,232,595,1213,4822,7002,13868,26246,2842055000,11404000,10580000,17570000,45637000,263175000,377453000,716604000,2007612000
Kentucky,Wholesale Trade,2007,18956,7900,2890,2367,13157,2574,1211,16942,2014,22605,7915,2915,2440,13270,3140,2075,18485,4120,332028,11144,16450,27315,58565,65957,57343,204805,116304,14495038000,503573000,624684000,1133480000,2347220000,2946735000,2467286000,8341780000,5709226000
Louisiana,Accommodation and Food Services,2007,30109,11015,5325,5465,21805,6655,897,29357,752,40110,11040,5330,5610,21980,7445,3250,32675,7435,853832,16432,35916,74895,128581,250464,133650,516351,335726,12191860000,410918000,411550000,788308000,1614143000,2998303000,1864849000,6507148000,5660819000
Louisiana,Administrative and Support and Waste Management and Remediation Services,2007,20134,10925,2885,2123,15933,2233,866,19032,1102,22475,10935,2900,2145,15980,2430,1115,19525,2950,583754,16252,18303,27609,65293,85933,106033,265936,311203,15942541000,559559000,470559000,804331000,1863254000,2670778000,2587915000,7454009000,8307347000
Louisiana,"Agriculture, Forestry, Fishing and Hunting",2007,3414,1781,915,485,3181,170,15,3366,48,3450,1785,915,485,3185,180,15,3380,70,21052,2735,5646,5837,15290,4644,24,20106,157,720585000,98550000,185825000,194372000,484087000,174740000,958000,677672000,16924000
Louisiana,"Arts, Entertainment, and Recreation",2007,6576,3650,985,800,5435,877,130,6442,134,6885,3655,985,815,5455,1005,180,6640,245,108170,4238,6393,9903,21524,33362,7454,66019,30576,3009958000,133304000,118812000,140014000,406145000,581371000,134521000,1371388000,674513000
Louisiana,Construction,2007,46908,26810,9285,5277,41372,4360,693,46425,483,47355,26810,9285,5280,41375,4370,845,46590,765,628743,44840,61313,70374,178151,162449,93568,438165,122689,26873437000,1589544000,1755993000,2409465000,5763140000,6956349000,4505627000,17375000000,8769758000
Louisiana,Educational Services,2007,4847,2120,675,450,3245,1203,265,4713,134,5305,2120,680,460,3260,1325,380,4965,340,149310,2332,3947,5745,13947,55323,30268,102663,39810,4681552000,125919000,81696000,113016000,340781000,1274869000,809614000,2491601000,1975944000
Louisiana,Finance and Insurance,2007,21397,13403,3596,1212,18211,1385,621,20217,1180,39555,13445,3705,1570,18720,4590,3935,27245,12310,318395,20059,21902,13951,59872,49584,57039,176322,129841,15410958000,903855000,843139000,656693000,2442418000,2189569000,2492683000,7521620000,7683802000
Louisiana,Health Care and Social Assistance,2007,48498,21952,11909,6371,40232,5360,1838,47430,1068,57525,21990,11990,6565,40545,6960,4190,51695,5830,1271781,39182,77332,83543,203760,216024,274759,705758,542509,43758704000,2265717000,2839249000,2849165000,7986387000,6186030000,7158868000,21626108000,21012924000
Louisiana,Information,2007,3459,1465,490,413,2368,402,215,2985,474,7360,1470,500,420,2390,490,420,3300,4060,120152,1294,2146,4627,9132,11256,8782,36330,73904,5060052000,84143000,80175000,167376000,374382000,400018000,401239000,1333548000,3754786000
Louisiana,Management of Companies and Enterprises,2007,2270,125,70,105,300,516,616,1432,838,2915,125,70,105,300,520,630,1450,1465,80045,0,390,580,1267,6462,19489,27295,52335,6587785000,0,14900000,53796000,105290000,382500000,1298111000,1788225000,4799560000
Louisiana,Manufacturing,2007,15870,5595,2720,2270,10585,2893,901,14379,1491,16995,5600,2720,2270,10590,3005,1245,14840,2155,593029,7703,14908,24545,52864,97588,66401,247397,308857,28692814000,404325000,469604000,891705000,1932158000,3984144000,2992720000,10050481000,17458759000
Louisiana,"Mining, Quarrying, and Oil and Gas Extraction",2007,6189,2820,740,679,4239,1012,350,5601,588,7540,2820,745,685,4250,1155,465,5870,1670,290625,4052,4820,8945,17975,37391,43836,99515,190677,17757070000,195796000,213678000,442993000,853530000,1942632000,2255095000,5068369000,12678055000
Louisiana,Other,2007,96,87,6,2,95,1,0,96,0,96,87,6,2,95,1,0,96,0,166,85,0,0,148,0,0,166,0,2535000,1964000,463000,0,2492000,0,0,2535000,0
Louisiana,Other Services (except Public Administration),2007,46088,26760,10057,4810,41627,3352,542,45521,567,49990,26765,10140,5050,41955,4320,1050,47325,2665,386706,48419,64635,61889,177005,117202,42598,345597,32627,8968588000,1089710000,1307140000,1365735000,3774414000,2606308000,1118701000,7630955000,1190326000
Louisiana,"Professional, Scientific, and Technical Services",2007,53698,36715,7835,4350,48900,3174,690,52764,934,56965,36725,7845,4440,49010,3915,1025,53950,3015,449160,57298,49897,55618,166165,106269,51287,333293,104355,21911725000,2669391000,1970467000,2608017000,7275824000,5791643000,2931167000,16468660000,5157290000
Louisiana,Real Estate and Rental and Leasing,2007,18531,13076,2298,1142,16516,988,419,17923,608,23070,13090,2330,1250,16670,1595,1135,19400,3670,167800,18733,13980,13524,49026,30179,30862,114546,50107,6602908000,649630000,425667000,468740000,1569897000,1193083000,1343260000,4209130000,2299898000
Louisiana,Retail Trade,2007,57299,29391,11850,7680,48921,5486,985,55392,1907,85185,29455,12120,8435,50010,8105,3100,61215,23970,1000882,50254,69908,97330,225209,196591,79356,512064,396738,22665057000,1161828000,1566674000,2196524000,4998377000,5401496000,2426200000,13054516000,9053847000
Louisiana,Total,2007,83159,45199,15552,9606,70357,8713,1994,81064,2095,104622,45257,15701,10117,71075,11546,5204,87825,16797,1646151,78964,102536,128332,309832,332571,255967,898370,747781,59189702000,2754127000,2908318000,3812360000,9474805000,10542694000,9135008000,29152507000,30037195000
Louisiana,Transportation and Warehousing,2007,15487,8150,2260,1489,11899,1739,604,14242,1245,19190,8155,2260,1530,11945,1935,795,14675,4515,332946,9643,14300,17034,44186,59476,53047,162652,143310,15326707000,497019000,474540000,674057000,1738443000,2460906000,3277929000,7568073000,6476755000
Louisiana,Utilities,2007,1206,715,210,55,980,70,48,1098,108,2655,715,210,60,985,105,185,1275,1380,4197,0,1298,451,3441,1657,5500,12527,0,255331000,31295000,30796000,11813000,77786000,63976000,267264000,486496000,0
Louisiana,Wholesale Trade,2007,22339,9132,3725,3165,16022,3262,1147,20431,1908,28105,9150,3745,3400,16295,4275,2060,22630,5475,359014,13886,22782,37315,79481,96856,50430,244510,100209,16785358000,677457000,996277000,1712817000,3483162000,4195999000,2366293000,10654955000,5791890000
Maine,Accommodation and Food Services,2007,17788,8890,3180,2796,14866,2373,277,17516,272,19910,8890,3190,2820,14900,2775,1040,18715,1195,233057,8796,21458,37783,68915,83203,35627,189312,42708,3916030000,499584000,384081000,576779000,1465865000,1244390000,495726000,3228235000,638850000
Maine,Administrative and Support and Waste Management and Remediation Services,2007,9160,5900,1305,740,7945,600,216,8761,399,9650,5900,1315,755,7970,715,370,9055,595,116087,7258,7782,8545,24553,19466,20055,72103,36898,3465489000,285525000,210006000,257979000,786429000,574207000,510308000,2124093000,1083130000
Maine,"Agriculture, Forestry, Fishing and Hunting",2007,3773,2940,370,205,3515,225,20,3760,13,3815,2940,370,205,3515,260,20,3795,20,17664,3640,2260,2424,7836,6699,412,17485,0,622232000,115081000,67847000,80926000,275266000,226263000,23386000,610232000,0
Maine,"Arts, Entertainment, and Recreation",2007,4432,3015,620,390,4025,300,57,4382,50,4495,3015,620,390,4025,320,95,4440,55,29350,885,3531,4278,11779,8859,4374,28054,186,636567000,147418000,101834000,95363000,388868000,140815000,36750000,601468000,32438000
Maine,Construction,2007,28085,20990,4035,1875,26900,1014,98,28012,73,28180,20990,4035,1895,26920,1050,110,28080,100,139764,29481,25563,23987,81499,32937,4227,128592,3071,5786750000,1071595000,842647000,933202000,2880380000,1686841000,247373000,5170812000,175632000
Maine,Educational Services,2007,2408,1285,385,225,1895,310,105,2310,98,2535,1285,385,225,1895,355,125,2375,160,70616,1710,1819,2798,6890,12429,14481,35857,33530,1840093000,51623000,47638000,49757000,155703000,309321000,363485000,888228000,927520000
Maine,Finance and Insurance,2007,5337,2890,740,350,3980,514,214,4708,629,10265,2890,785,420,4095,1295,1285,6675,3590,119905,3716,4135,3905,12485,18203,15375,51078,58679,6683968000,166088000,190083000,192351000,566041000,820131000,746108000,2246420000,3953160000
Maine,Health Care and Social Assistance,2007,17121,8090,3550,1890,13530,1870,1024,16424,697,24160,8090,3570,1945,13605,2935,4100,20640,3520,512225,14190,21921,24293,62438,72459,133251,271122,227105,18300933000,523335000,836041000,984515000,2395028000,2071693000,4185991000,8698372000,9200776000
Maine,Information,2007,2506,1245,350,270,1865,244,152,2261,245,3870,1245,350,275,1870,300,285,2455,1415,56191,1509,1822,2879,7173,6236,7258,24703,20594,2528937000,54004000,59364000,89671000,218330000,223239000,282327000,883375000,915686000
Maine,Management of Companies and Enterprises,2007,828,60,15,40,115,130,280,525,303,985,60,15,40,115,130,315,560,425,37509,0,0,144,248,1230,9290,10860,26649,2402370000,0,0,5502000,10981000,48477000,365512000,426842000,1973744000
Maine,Manufacturing,2007,8698,3910,1430,1075,6415,1416,380,8211,487,9065,3910,1445,1090,6445,1505,455,8405,660,217625,4600,6708,9680,24777,41286,20200,111434,52762,9171405000,182779000,240904000,337022000,875125000,1596693000,820084000,4084431000,2648468000
Maine,"Mining, Quarrying, and Oil and Gas Extraction",2007,141,85,35,0,120,10,0,130,11,145,85,35,0,120,10,0,130,15,536,137,138,0,365,0,0,511,0,20475000,5321000,2787000,0,10113000,0,0,18028000,0
Maine,Other,2007,43,40,2,1,43,0,0,43,0,43,40,2,1,43,0,0,43,0,0,25,0,0,0,0,0,0,0,1501000,1334000,0,0,1501000,0,0,1501000,0
Maine,Other Services (except Public Administration),2007,17858,12260,3345,1297,16902,602,157,17661,197,18705,12270,3380,1355,17005,960,290,18255,450,94007,21526,20391,15186,58639,15634,7500,86148,2874,2122346000,514448000,450213000,363995000,1359504000,375603000,118670000,1926615000,144296000
Maine,"Professional, Scientific, and Technical Services",2007,17227,11810,2393,1430,15633,892,245,16770,457,17980,11810,2420,1480,15710,1085,290,17085,895,118284,14575,14655,17168,47880,27813,7858,89185,21778,5883655000,719574000,622312000,823520000,2189801000,1527110000,548902000,4464182000,1135889000
Maine,Real Estate and Rental and Leasing,2007,7804,6110,810,343,7263,226,81,7570,234,8870,6125,815,410,7350,315,145,7810,1060,34516,7249,4500,3542,17138,5561,1774,26545,3516,1100271000,286270000,148603000,103666000,561500000,194680000,59165000,862731000,176022000
Maine,Retail Trade,2007,25827,13153,5394,3451,21998,2097,495,24590,1237,34755,13200,5485,3735,22420,3185,1640,27245,7510,378573,16469,31673,39071,92810,55968,30670,190189,100392,8843222000,531545000,662464000,856988000,2108310000,1733670000,1054525000,5260036000,2126671000
Maine,Total,2007,35776,22090,5927,3501,31518,2661,659,34838,938,42506,22108,5990,3685,31783,3703,2293,37779,4727,503789,34832,39024,46295,120151,96690,83782,300623,203166,17049254000,1137017000,1088376000,1346070000,3571463000,3023779000,2796216000,9391458000,7657796000
Maine,Transportation and Warehousing,2007,5901,3770,710,515,4995,411,158,5564,337,6370,3770,715,520,5005,485,215,5705,665,58813,4315,3458,5607,15412,10950,8952,39670,11644,2136044000,155343000,98528000,183712000,491959000,376246000,334976000,1366533000,468818000
Maine,Utilities,2007,226,85,25,20,130,25,28,183,43,400,85,25,30,140,35,60,235,165,696,88,0,126,388,236,0,1368,135,48503000,8986000,1882000,7650000,24330000,19913000,0,127507000,8380000
Maine,Wholesale Trade,2007,7386,3775,980,765,5520,718,418,6656,730,8160,3780,985,830,5595,800,625,7020,1140,81566,4728,5031,7765,19976,14786,12398,55803,17136,3662458000,216747000,183862000,304661000,769800000,627521000,553262000,2350060000,915660000
Maryland,Accommodation and Food Services,2007,42058,17935,7905,6595,32435,7797,918,41150,908,53400,17950,7930,6685,32565,8405,2710,43680,9720,958648,30071,51107,89740,172180,302062,119087,595768,355988,15181709000,794208000,718039000,1251278000,2772485000,4507253000,1702898000,9047162000,6055302000
Maryland,Administrative and Support and Waste Management and Remediation Services,2007,36294,20120,5445,3898,29463,3885,1376,34724,1570,40200,20130,5455,3925,29510,4020,1705,35235,4965,890717,29440,34689,50852,116909,141157,154899,425024,447072,28451102000,1209434000,1074860000,1704290000,4024803000,4747553000,4235285000,13411552000,14518273000
Maryland,"Agriculture, Forestry, Fishing and Hunting",2007,1063,855,120,40,1015,25,0,1040,23,1075,855,120,40,1015,25,0,1040,35,4882,1063,438,458,2386,188,0,3217,646,157513000,30747000,18559000,12589000,66969000,5497000,0,94454000,24687000
Maryland,"Arts, Entertainment, and Recreation",2007,10060,5405,1665,1165,8235,1345,257,9837,223,10780,5410,1670,1205,8285,1430,370,10085,695,178181,6095,10386,15182,33939,50943,35944,121751,28772,4483754000,319631000,223394000,334509000,888305000,977465000,1043939000,2930792000,382232000
Maryland,Construction,2007,84648,51840,14505,8775,75120,7658,1310,84088,560,85275,51840,14505,8775,75120,7715,1445,84280,995,932676,85820,94957,118013,301229,296944,191378,795645,116820,45594178000,3381515000,3539053000,5112123000,12034975000,14576436000,10477534000,37417630000,7084323000
Maryland,Educational Services,2007,9057,4215,1305,1070,6590,1565,598,8753,304,9800,4215,1305,1095,6615,1755,715,9085,715,362359,5225,7954,13976,27842,61983,83833,178991,180403,13210716000,209699000,199528000,324412000,742625000,1637845000,2822877000,5365083000,7593791000
Maryland,Finance and Insurance,2007,24816,14883,3635,1806,20324,1738,935,22997,1819,43395,14905,3695,1995,20595,3470,2510,26575,16820,599155,23874,21826,22236,67978,62911,71991,213255,342312,45186202000,1290404000,1196156000,1412918000,4025313000,4070090000,5094239000,13915179000,26910975000
Maryland,Health Care and Social Assistance,2007,61270,30500,13735,7635,51870,5933,1974,59777,1493,76390,30525,13920,8210,52655,9040,6145,67840,8550,1539187,57647,89344,98161,246400,221026,263107,747787,768104,64695237000,2739819000,3735294000,4388513000,10862120000,9560124000,8251451000,29428466000,35106447000
Maryland,Information,2007,7397,3780,885,685,5350,805,437,6592,805,13035,3780,885,695,5360,890,575,6825,6210,222660,3706,4694,8038,17010,26103,30715,82983,121379,16422089000,312694000,222623000,456300000,1027092000,1310310000,2136597000,4905011000,7670228000
Maryland,Management of Companies and Enterprises,2007,3185,255,35,125,415,631,841,1887,1298,5090,255,35,125,415,645,900,1960,3130,279057,267,0,913,1354,8451,31096,41010,238047,25878735000,64662000,9795000,113285000,190650000,503921000,1706461000,2406880000,23463725000
Maryland,Manufacturing,2007,17327,6645,2945,2390,11980,2874,1049,15903,1424,18130,6645,2955,2400,12000,2980,1260,16240,1890,553969,8342,16048,26897,57383,95706,65560,261147,249682,29556224000,403423000,598236000,1059447000,2277206000,4293370000,3015746000,11609295000,15995654000
Maryland,"Mining, Quarrying, and Oil and Gas Extraction",2007,373,120,55,30,205,80,25,310,63,440,120,55,30,205,80,50,335,105,7285,32,236,238,765,2731,0,4252,2491,398695000,8966000,8150000,14046000,36398000,128302000,17512000,210826000,144405000
Maryland,Other,2007,139,131,6,2,139,0,0,139,0,139,131,6,2,139,0,0,139,0,0,107,0,0,0,0,0,0,0,3149000,2525000,0,0,3149000,0,0,3149000,0
Maryland,Other Services (except Public Administration),2007,64039,37097,13504,7227,57828,4868,703,63399,640,69540,37125,13555,7445,58125,5880,1300,65305,4235,605624,69196,87247,94313,253366,166513,59984,490634,86859,17858335000,1912360000,2270034000,2530472000,6751344000,5105155000,2339929000,14375332000,2844070000
Maryland,"Professional, Scientific, and Technical Services",2007,92504,62885,11418,7343,81646,6746,2037,90429,2075,99480,62920,11465,7395,81780,7385,2830,91995,7485,1215721,82032,74009,95254,263636,235657,180634,686125,513420,85167167000,5581660000,4140591000,5833265000,15595664000,16239485000,12595898000,44673218000,39346240000
Maryland,Real Estate and Rental and Leasing,2007,25957,18825,2841,1523,23189,1408,576,25173,784,33065,18825,2945,1705,23475,1855,1585,26915,6150,245696,25336,17306,18226,63567,40422,45600,155532,80239,11457572000,1096234000,618520000,789041000,2498236000,1998304000,2382328000,7117830000,3596596000
Maryland,Retail Trade,2007,64490,34142,13043,7786,54971,5367,1568,61906,2584,97830,34210,13255,8455,55920,7645,4320,67885,29945,1452713,49530,78838,91405,228616,181494,130247,564279,801059,36827855000,1526101000,1971084000,2340863000,5920973000,5972441000,4988840000,17496012000,18032998000
Maryland,Total,2007,115301,66382,19794,12410,98586,11247,2809,112642,2659,141332,66445,19977,12896,99318,13780,6309,119407,21925,2239181,112150,130036,165080,407266,420928,344153,1172347,1066834,99467512000,4557723000,4518336000,6174448000,15250507000,16957801000,15103802000,47312110000,52155402000
Maryland,Transportation and Warehousing,2007,16810,9638,2265,1435,13338,1691,565,15594,1216,18600,9645,2285,1445,13375,1810,720,15905,2695,310168,13484,13137,17537,44753,50372,25262,129099,156645,11388477000,448275000,390649000,512926000,1393792000,1719385000,1011420000,4351609000,6513994000
Maryland,Utilities,2007,262,90,10,25,125,20,20,165,97,590,90,10,25,125,20,75,220,370,45687,143,0,212,418,0,0,321,27921,5357244000,4438000,0,10360000,19344000,4998000,0,15863000,3367255000
Maryland,Wholesale Trade,2007,25679,12115,3775,2776,18666,3438,1366,23470,2209,29850,12125,3810,2820,18755,3850,2330,24935,4915,470098,15913,22537,33953,77347,110208,68457,281971,160443,27381956000,1097225000,1220259000,1928220000,4345548000,5783861000,4078766000,15256092000,11016041000
Massachusetts,Accommodation and Food Services,2007,63741,28620,12320,10385,51325,10444,1146,62915,826,79770,28675,12365,10515,51555,12075,4030,67660,12110,1267543,47531,81758,142652,272905,376109,157061,807568,457150,22450185000,1490863000,1183389000,2053481000,4727311000,6011297000,2670333000,13438485000,8939454000
Massachusetts,Administrative and Support and Waste Management and Remediation Services,2007,42773,27335,5310,3448,36093,3703,1305,41101,1672,47450,27345,5330,3495,36170,3895,1720,41785,5665,1008254,33661,34074,45023,114861,139320,170380,442599,486348,36163741000,2104629000,1384101000,1823562000,5363469000,5533455000,5519068000,17238448000,18470008000
Massachusetts,"Agriculture, Forestry, Fishing and Hunting",2007,1985,1630,220,100,1950,30,0,1980,5,1990,1630,220,100,1950,30,0,1980,10,5137,1886,805,729,4510,162,0,5069,0,153368000,68970000,17105000,21448000,126543000,7832000,0,146760000,0
Massachusetts,"Arts, Entertainment, and Recreation",2007,14598,7920,2350,1755,12025,1980,403,14408,190,15680,7920,2350,1780,12050,2220,665,14935,745,251039,10153,15050,22476,49808,71396,54269,183515,52792,8210921000,655400000,458521000,626833000,1770803000,1623420000,1591169000,5410090000,1092790000
Massachusetts,Construction,2007,97574,68555,15115,7460,91130,5411,601,97142,432,97870,68555,15130,7460,91145,5450,640,97235,635,647645,105442,98615,99510,306760,195091,82914,594275,36875,38429945000,5040538000,4461710000,5550690000,15117810000,12666115000,5799961000,34149740000,3429120000
Massachusetts,Educational Services,2007,11797,5105,1815,1445,8365,2090,875,11330,467,12825,5105,1840,1465,8410,2270,1180,11860,965,927330,7761,11470,19242,39129,78905,134299,257950,662891,33621040000,315395000,322865000,518225000,1171654000,2502273000,4903425000,8662025000,24751869000
Massachusetts,Finance and Insurance,2007,29616,15908,4909,2609,23426,2645,1300,27371,2245,50365,15935,5055,3130,24120,4875,5005,34000,16365,1063391,26156,30611,30698,88742,88310,119734,307913,739042,107798036000,1747812000,2350880000,2761527000,7326166000,7986205000,10530706000,27120360000,79906445000
Massachusetts,Health Care and Social Assistance,2007,65363,29010,14575,9133,52718,7273,3269,63260,2103,88985,29035,14675,9585,53295,10355,11145,74795,14190,2535892,54126,94559,120620,274336,271333,466450,1018065,1501448,112598825000,2644516000,4235301000,5671898000,12603474000,11544055000,15188458000,39511715000,72456089000
Massachusetts,Information,2007,11856,5705,1655,1195,8555,1447,598,10600,1256,19040,5710,1655,1215,8580,1505,650,10735,8305,427039,7334,9390,13133,33191,52140,52391,145878,276394,37494259000,631447000,592052000,893665000,2136576000,4061160000,5386709000,12113721000,25218863000
Massachusetts,Management of Companies and Enterprises,2007,4144,360,135,120,615,711,1081,2407,1737,5845,360,135,120,615,720,1130,2465,3380,560387,0,641,65,2002,9174,41237,53038,508618,45306572000,66010000,39746000,4082000,224730000,1054955000,3143802000,4569925000,40945318000
Massachusetts,Manufacturing,2007,37123,12575,6650,5790,25015,7580,2170,34765,2358,38280,12575,6655,5820,25050,7750,2410,35210,3070,1272883,19453,37633,69706,135780,278741,221917,697672,488983,75174011000,1085873000,1647512000,3134315000,6227690000,13589362000,12052958000,34680061000,36016504000
Massachusetts,"Mining, Quarrying, and Oil and Gas Extraction",2007,393,140,65,65,270,84,17,371,22,450,140,65,65,270,100,45,415,35,5215,42,0,581,1256,1855,0,4467,509,312758000,12061000,4124000,36954000,69540000,99602000,0,232635000,18582000
Massachusetts,Other,2007,365,330,20,12,362,3,0,365,0,365,330,20,12,362,3,0,365,0,702,0,118,156,631,71,0,702,0,15418000,9189000,3121000,1747000,14057000,1361000,0,15418000,0
Massachusetts,Other Services (except Public Administration),2007,78297,47355,16820,8231,72406,4543,754,77703,594,84340,47390,16965,8680,73035,5595,2185,80815,3525,616632,88578,109033,105713,306031,148562,61186,532154,60500,17550650000,2532485000,2747886000,2653203000,7974339000,4269089000,1999163000,14585800000,2583248000
Massachusetts,"Professional, Scientific, and Technical Services",2007,106761,71760,15135,8195,95090,6692,2323,104105,2656,112105,71775,15185,8330,95290,7195,2935,105420,6685,1294606,92649,97590,105472,314758,224087,202879,749724,522219,109673022000,6789598000,5667264000,7202358000,19699608000,19878075000,18188090000,58419190000,50267149000
Massachusetts,Real Estate and Rental and Leasing,2007,27080,19130,3396,1913,24439,1437,527,26403,677,34815,19175,3630,2145,24950,2060,1165,28175,6640,244720,28580,20365,23954,74026,45738,45918,171833,63899,11835404000,1317082000,841651000,1100520000,3307180000,2226735000,2348793000,8454263000,3051239000
Massachusetts,Retail Trade,2007,88336,49624,17593,9767,76984,7233,1565,85782,2554,128330,49810,18075,10670,78555,10545,5265,94365,33965,1808947,78375,103392,111662,298101,230553,103389,662939,773023,45808370000,2544525000,2711918000,3337042000,8606296000,8601231000,4267825000,22501293000,17446278000
Massachusetts,Total,2007,144767,83810,25366,15508,124684,13608,3491,141783,2984,176701,83908,25669,16195,125772,16886,8788,151446,25255,3073941,142745,166588,207104,516437,504106,448892,1469435,1604506,157235733000,6657717000,6417320000,8633276000,21708313000,23402360000,22506997000,67617670000,89618063000
Massachusetts,Transportation and Warehousing,2007,16430,8650,2398,1644,12692,1728,839,15259,1171,18685,8655,2410,1650,12715,1840,1025,15580,3105,388475,10528,14320,20972,47608,61345,53167,169812,207046,14675279000,517043000,480237000,759091000,1800348000,2046521000,1784697000,5876578000,8312211000
Massachusetts,Utilities,2007,512,205,35,25,265,65,50,380,132,1255,205,35,25,265,65,95,425,830,53777,7,112,0,37,0,4710,7257,43785,5539285000,17699000,7681000,0,39274000,116695000,493902000,755959000,4624093000
Massachusetts,Wholesale Trade,2007,38781,17880,6392,4565,28837,5192,1937,35966,2815,43600,17895,6470,4665,29030,5870,2650,37550,6050,714621,29127,40272,56805,131349,170045,98928,425768,259479,50105143000,2996603000,2368887000,3531055000,9035627000,10492506000,7150682000,27981335000,20855777000
Michigan,Accommodation and Food Services,2007,75868,29850,15040,14400,59290,14170,1342,74802,1066,98135,29880,15075,14610,59565,16780,5505,81850,16285,1672330,45948,100604,196744,344670,520426,196840,1063558,606904,20914516000,1031045000,1035070000,2008089000,4077550000,6094611000,2336441000,12513439000,8378017000
Michigan,Administrative and Support and Waste Management and Remediation Services,2007,54073,31845,6810,4479,43134,6397,2879,52410,1663,60980,31845,6850,4570,43265,6900,3440,53605,7375,1554141,38457,44240,58283,141484,277304,445033,877901,584838,49381238000,2035814000,1420943000,1889429000,5362941000,11180740000,12094441000,28962532000,17609013000
Michigan,"Agriculture, Forestry, Fishing and Hunting",2007,2934,2090,460,220,2770,100,39,2909,25,2940,2090,460,220,2770,100,40,2910,30,15362,3188,2813,2586,9107,2587,1025,14732,126,489489000,97322000,76373000,73781000,258618000,85331000,35752000,439554000,9987000
Michigan,"Arts, Entertainment, and Recreation",2007,17623,10345,2555,2130,15030,2055,305,17390,233,18420,10350,2565,2145,15060,2225,415,17700,720,270243,11542,15767,27840,55559,79470,35868,185055,59391,8125604000,609148000,400101000,502670000,1535602000,1543066000,2246274000,5551274000,2049251000
Michigan,Construction,2007,117810,84649,17702,8729,111080,5718,630,117428,382,118565,84650,17710,8730,111090,5780,920,117790,775,701294,120146,114420,114567,353741,202170,82633,644398,51118,36532290000,5200865000,4357922000,5313550000,14875055000,11540830000,5543853000,32285455000,3952183000
Michigan,Educational Services,2007,9833,4820,1645,1262,7727,1398,429,9554,279,10915,4820,1650,1290,7760,1585,800,10145,770,329789,5818,10750,16315,34996,57859,57611,155210,159343,8001631000,209215000,207867000,313360000,750085000,1439916000,1735951000,4014321000,3602444000
Michigan,Finance and Insurance,2007,39032,25118,5742,2746,33606,2670,979,37255,1777,76515,25130,5860,3305,34295,5720,5445,45460,31055,835620,42522,34822,33066,112079,95778,94413,309502,513839,45610809000,1683324000,1539366000,1644661000,4956108000,4393233000,4255877000,14061488000,31078991000
Michigan,Health Care and Social Assistance,2007,104391,48245,26193,15167,89605,9939,3032,102576,1815,129780,48265,26435,15780,90480,15290,11655,117425,12355,2742388,87623,174229,199874,466123,378095,464425,1312536,1410390,107581655000,4137273000,6918802000,8419389000,19486810000,15483290000,14294202000,49376430000,57817773000
Michigan,Information,2007,9724,4875,1375,1011,7261,998,365,8624,1100,19535,4875,1380,1065,7320,1305,555,9180,10355,364640,5222,6469,12070,25568,27614,18406,85906,175573,20741132000,266453000,317887000,427458000,1097330000,1137866000,925394000,3645803000,13299024000
Michigan,Management of Companies and Enterprises,2007,5695,565,185,245,995,1137,1541,3673,2022,8055,565,185,245,995,1170,1700,3865,4190,633755,704,736,1707,3315,15495,54215,73025,560730,57645645000,70641000,53077000,96158000,230620000,855905000,3035120000,4121645000,53524000000
Michigan,Manufacturing,2007,63675,21578,11289,9934,42801,12690,4349,59840,3835,68015,21595,11300,9960,42855,13355,5485,61695,6320,2816375,35695,68905,127755,243558,483588,534123,1312274,1422465,146204430000,1623643000,2552437000,5310911000,9817972000,21572140000,23481021000,56826612000,85348391000
Michigan,"Mining, Quarrying, and Oil and Gas Extraction",2007,1879,970,285,175,1430,256,70,1756,123,2050,970,285,180,1435,285,70,1790,260,27513,1422,1787,2262,5572,8204,1804,16170,7904,1518146000,62686000,81175000,99750000,251050000,525532000,106860000,919818000,548826000
Michigan,Other,2007,413,367,26,15,408,5,0,413,0,413,367,26,15,408,5,0,413,0,827,342,168,197,707,0,0,827,0,14273000,8375000,1969000,2110000,12454000,1819000,0,14273000,0
Michigan,Other Services (except Public Administration),2007,114153,68659,25614,11718,105991,6604,840,113435,718,122740,68740,25825,12430,106995,8730,1985,117710,5030,850942,132066,164135,151164,449003,218983,75122,752031,65635,20383225000,2930098000,3374489000,3263351000,9580566000,5322373000,2176193000,17327610000,2279355000
Michigan,"Professional, Scientific, and Technical Services",2007,106824,72920,14530,8222,95672,6589,2147,104408,2416,115025,72955,14585,8430,95970,7850,3370,107190,7835,1340009,103463,92680,108112,311635,234334,214573,767317,555109,85706030000,5168708000,4409990000,5689103000,15286827000,13480641000,11621659000,40531760000,44704874000
Michigan,Real Estate and Rental and Leasing,2007,34491,24708,4695,2047,31450,1710,598,33758,733,43910,24750,4945,2305,32000,2760,1865,36625,7285,284626,36326,28012,24813,91403,55833,41826,193421,76856,8873280000,1166545000,810263000,796408000,2780834000,1811541000,1146958000,5874470000,2606963000
Michigan,Retail Trade,2007,126770,73539,25897,13298,112734,9601,1713,124048,2722,188545,73725,26605,14880,115210,15575,7560,138345,50200,2296292,116333,162974,150072,439529,333741,144039,964578,1234371,50724200000,2953088000,3365725000,3906060000,10316453000,9358156000,3744961000,23982551000,24603127000
Michigan,Total,2007,188485,109377,34161,20607,164145,17327,3948,185420,3065,235422,109489,34594,21696,165779,23144,11328,200251,35171,3687441,181388,224474,275161,681023,660245,561380,1902648,1784793,150946992000,6683339000,6853666000,8986885000,22523890000,24001798000,20706810000,67232498000,83714494000
Michigan,Transportation and Warehousing,2007,24912,15330,3015,2052,20397,2147,837,23381,1531,29025,15335,3065,2105,20505,2420,1235,24160,4865,489175,18473,18771,25811,63651,70502,54036,198452,261825,20293139000,770922000,627840000,933939000,2371701000,2573825000,2205453000,7471815000,11497285000
Michigan,Utilities,2007,499,195,35,40,270,65,42,377,122,2035,195,35,70,300,90,120,510,1525,101419,26,147,189,207,2636,1747,993,94245,8960779000,4470000,5148000,12718000,13256000,165265000,123036000,71199000,7375552000
Michigan,Wholesale Trade,2007,50303,24855,7951,5772,38578,6054,2372,47004,3299,59860,24875,8025,6085,38985,7775,4475,51235,8625,831546,35940,48410,68508,155943,187823,132461,506915,297612,46486102000,2102645000,2409592000,3539465000,8124374000,9839504000,6681660000,25452736000,19746775000
Minnesota,Accommodation and Food Services,2007,42866,15317,7573,8426,31316,9677,980,41973,893,56455,15345,7580,8510,31435,11245,3140,45820,10635,1099625,21526,51525,118529,192441,360423,130014,685864,405176,15293480000,588509000,514480000,1104750000,2211014000,4273691000,1644506000,8183143000,6978599000
Minnesota,Administrative and Support and Waste Management and Remediation Services,2007,31917,20365,4375,2550,27290,2408,970,30668,1249,35475,20365,4400,2635,27400,2705,1225,31330,4145,749943,24543,26462,31661,87199,95487,125408,323275,412224,22709514000,1157680000,798630000,1020333000,3021572000,2883815000,3184238000,9447592000,12585501000
Minnesota,"Agriculture, Forestry, Fishing and Hunting",2007,2180,1450,475,125,2050,80,20,2150,30,2195,1450,475,125,2050,90,20,2160,35,9617,1556,3154,1281,6738,2076,0,9153,330,299493000,57838000,88661000,39228000,190806000,68524000,2328000,278123000,18085000
Minnesota,"Arts, Entertainment, and Recreation",2007,13152,8110,2024,1372,11506,1183,263,12952,200,13730,8125,2030,1415,11570,1240,300,13110,620,201080,8514,11278,16866,37033,41541,47209,133842,37820,5287373000,363528000,237752000,250752000,880284000,654713000,2207438000,3849629000,755174000
Minnesota,Construction,2007,89210,65970,12005,5955,83930,4279,547,88756,454,89745,65970,12005,5960,83935,4365,645,88945,800,601208,90066,76475,77130,248841,152575,75259,491195,88568,33862888000,4191680000,3363094000,3899918000,11492930000,9523877000,4598050000,26003140000,6509190000
Minnesota,Educational Services,2007,8495,3960,1165,1205,6330,1610,300,8240,255,9175,3960,1165,1210,6335,1775,415,8525,650,299731,4848,7405,16321,28299,63248,42806,140590,151499,7382834000,184900000,142813000,329808000,659564000,1482889000,1294307000,3505810000,3745970000
Minnesota,Finance and Insurance,2007,34307,23180,4016,2056,29252,2397,910,32559,1748,50900,23195,4160,2550,29905,4855,3585,38345,12555,737856,32704,24165,24569,84112,81952,71789,249009,315071,52530453000,1499286000,1091681000,1359530000,4032427000,4344538000,3984666000,12934823000,30793333000
Minnesota,Health Care and Social Assistance,2007,48298,22083,9545,6091,37719,6223,2874,46816,1482,69725,22095,9640,6485,38220,9865,10210,58295,11430,1952217,33159,62790,81972,182283,262038,445361,898740,1002645,74165694000,1550223000,2304809000,2954010000,6837759000,8698327000,12814992000,28601460000,42611858000
Minnesota,Information,2007,8838,4350,1095,1013,6458,1008,378,7844,994,14020,4350,1105,1050,6505,1320,835,8660,5360,326235,5412,6271,11244,24120,36930,35168,105598,182203,20097133000,313015000,257389000,545256000,1186794000,1734221000,1633127000,5136528000,12486026000
Minnesota,Management of Companies and Enterprises,2007,3995,230,110,125,465,706,1236,2407,1588,5575,230,110,130,470,710,1265,2445,3130,608315,0,437,965,1617,7170,34040,43090,565225,50512780000,26503000,19931000,47427000,102915000,378315000,2332755000,2813985000,47698795000
Minnesota,Manufacturing,2007,37303,13975,6160,5162,25297,6993,2409,34699,2604,39700,13975,6160,5195,25330,7325,2950,35605,4095,1518618,18648,35865,62447,127725,264718,281768,725653,694998,74238526000,881583000,1362459000,2476458000,4932594000,11562207000,13047388000,31832212000,37827945000
Minnesota,"Mining, Quarrying, and Oil and Gas Extraction",2007,623,255,120,90,465,70,26,561,62,735,255,120,90,465,75,30,570,165,27861,235,440,885,1916,2409,1195,6333,20040,1836997000,14157000,28496000,41598000,103540000,105667000,52918000,290104000,1476830000
Minnesota,Other,2007,141,130,7,2,139,2,0,141,0,141,130,7,2,139,2,0,141,0,216,0,44,0,178,0,0,216,0,4086000,2177000,397000,0,2739000,0,0,4086000,0
Minnesota,Other Services (except Public Administration),2007,71784,41847,15260,8120,65227,5338,682,71247,537,77930,41915,15425,8505,65845,6755,2000,74600,3330,586305,74921,99067,106263,283508,171753,61854,522609,43318,12906925000,1696380000,1937355000,2138847000,5791647000,3627465000,1609599000,11186726000,1277312000
Minnesota,"Professional, Scientific, and Technical Services",2007,81450,59440,9310,5463,74213,4277,1262,79752,1698,85435,59450,9360,5685,74495,4960,1735,81190,4245,705980,70499,59469,71008,204244,141051,101079,464214,228620,43874115000,3900108000,2770768000,3622988000,10345435000,9119313000,7353816000,27420345000,16228830000
Minnesota,Real Estate and Rental and Leasing,2007,28585,22301,2757,1251,26309,1148,499,27956,629,34320,22330,2805,1415,26550,1985,1645,30180,4140,201953,27971,16038,14843,61822,33814,39276,140138,42490,6862063000,963711000,520300000,452981000,1978727000,1033030000,1201500000,4302533000,1758139000
Minnesota,Retail Trade,2007,70460,34167,15529,9624,59320,7078,1613,68011,2449,103705,34270,15795,10550,60615,10960,6020,77595,26110,1519408,55413,97880,120832,276703,232931,127169,672643,707551,34212892000,1413716000,1927108000,2632182000,6016719000,5971126000,4019734000,16279431000,15694550000
Minnesota,Total,2007,123736,73928,19838,12852,106618,11766,2813,121197,2539,151526,74002,20062,13558,107622,15627,7965,131214,20312,2525900,114180,130699,172357,417236,445349,387492,1250077,1275823,107167906000,4265577000,3995896000,5436808000,13698281000,15537457000,14977151000,44212889000,62955017000
Minnesota,Transportation and Warehousing,2007,21426,13610,2345,1778,17733,1865,710,20308,1118,23655,13610,2360,1800,17770,2015,975,20760,2895,340050,3595,13416,22111,52895,60859,47336,179848,126395,12367422000,626137000,459101000,701642000,1830199000,1943282000,1628036000,5840716000,5664982000
Minnesota,Utilities,2007,549,100,35,85,220,155,55,430,119,1360,100,40,90,230,205,105,540,820,603,81,90,1181,1496,5672,5542,12655,112,3948112000,4792000,6262000,75652000,97159000,346186000,379193000,819729000,7109000
Minnesota,Wholesale Trade,2007,37355,18339,5436,4163,27938,4771,1807,34516,2839,43090,18370,5540,4380,28290,5675,2725,36690,6400,680749,25915,32976,48480,114175,151025,89552,373625,273408,41978261000,1592894000,1737869000,2827093000,6255598000,8283899000,4821123000,19932154000,20409205000
Mississippi,Accommodation and Food Services,2007,17392,6460,3150,3275,12885,3423,454,16762,630,24055,6475,3160,3305,12940,3995,1585,18520,5535,575374,9718,20911,44664,75933,121028,55560,254494,319142,8776051000,212360000,226640000,439660000,884632000,1220133000,615256000,2775421000,5984581000
Mississippi,Administrative and Support and Waste Management and Remediation Services,2007,10354,5820,1690,960,8470,857,390,9717,637,11475,5820,1695,965,8480,935,515,9930,1545,246580,8791,10626,12296,33109,31669,42016,111952,129218,5360427000,235507000,235419000,273349000,766844000,711610000,823661000,2450049000,2842988000
Mississippi,"Agriculture, Forestry, Fishing and Hunting",2007,3757,1990,985,550,3525,150,20,3695,62,3840,1990,985,555,3530,155,35,3720,120,23371,3343,6293,6339,16954,3838,138,21811,566,718889000,110784000,172064000,181755000,493560000,111083000,4977000,635235000,38917000
Mississippi,"Arts, Entertainment, and Recreation",2007,3275,1910,550,390,2850,335,35,3220,55,3335,1910,555,390,2855,355,45,3255,80,49331,2443,3225,4677,10984,11009,0,27842,21180,1017757000,79928000,40684000,65010000,199068000,173967000,0,463547000,549038000
Mississippi,Construction,2007,26277,15685,4855,2935,23475,2327,300,26102,175,26475,15685,4855,2935,23475,2350,330,26155,320,277185,25483,31454,38998,97198,84402,36175,222639,28912,10072015000,786730000,817344000,1166033000,2786545000,3082731000,1702538000,7689512000,1300004000
Mississippi,Educational Services,2007,2433,1055,310,260,1625,570,133,2328,105,2940,1055,310,260,1625,580,270,2475,465,85542,1429,1838,2851,6521,23185,16077,47032,38081,1704214000,42507000,22145000,50582000,119157000,442277000,405975000,985269000,707849000
Mississippi,Finance and Insurance,2007,12707,8525,1585,596,10706,745,390,11841,866,24660,8550,1705,890,11145,2555,2945,16645,8015,173037,15730,9475,6485,32900,24770,26431,87157,52278,7498326000,478139000,318303000,289315000,1118006000,1044692000,1020010000,3269433000,4153784000
Mississippi,Health Care and Social Assistance,2007,24017,10505,6110,3410,20025,2393,858,23276,741,29390,10510,6120,3510,20140,3210,2310,25660,3730,724361,19009,39619,43913,105134,85715,119680,317381,377179,27167089000,1004783000,1462410000,1693616000,4189849000,3142245000,3439281000,10961082000,15942042000
Mississippi,Information,2007,2228,850,420,285,1555,210,122,1887,341,5060,850,420,305,1575,320,240,2135,2925,58591,1183,1998,2763,6944,6403,3482,21391,27378,3011412000,38556000,50349000,88447000,196310000,205991000,138836000,666705000,2213793000
Mississippi,Management of Companies and Enterprises,2007,1195,65,25,65,155,200,408,763,432,1540,65,25,65,155,200,455,810,730,40685,0,16,166,369,1624,8930,10880,29684,2407199000,9964000,575000,8618000,24383000,66266000,517320000,610746000,1796453000
Mississippi,Manufacturing,2007,11922,3744,1905,1545,7194,2078,1084,10356,1566,13065,3745,1905,1545,7195,2145,1305,10645,2420,709880,3777,9609,17130,35093,70765,97863,228693,434062,23987268000,198332000,261033000,463513000,1008904000,2141615000,2887288000,6972097000,15523126000
Mississippi,"Mining, Quarrying, and Oil and Gas Extraction",2007,1589,865,130,159,1154,215,70,1439,150,1715,865,130,165,1160,235,80,1475,240,27237,1040,599,1676,3092,7207,3268,16274,7719,1363954000,50672000,27917000,73271000,153750000,361939000,180291000,802266000,428359000
Mississippi,Other,2007,68,66,2,0,68,0,0,68,0,68,66,2,0,68,0,0,68,0,65,0,0,0,65,0,0,65,0,914000,829000,0,0,914000,0,0,914000,0
Mississippi,Other Services (except Public Administration),2007,31870,20040,6695,2900,29635,1658,277,31570,300,33560,20055,6715,3055,29825,2110,580,32515,1045,206791,36863,42584,37393,120151,53232,11976,192895,9037,4123696000,736489000,778443000,750111000,2282870000,952867000,269336000,3674603000,330621000
Mississippi,"Professional, Scientific, and Technical Services",2007,22434,15165,3315,1895,20375,1151,401,21927,507,24330,15170,3330,1935,20435,1595,610,22640,1690,166686,23687,20432,23614,70596,33377,21260,128308,25670,7302233000,867549000,699192000,901038000,2503732000,1695401000,1111568000,5420303000,1270453000
Mississippi,Real Estate and Rental and Leasing,2007,10206,7880,1090,411,9381,351,181,9913,293,12465,7895,1135,450,9480,460,705,10645,1820,54782,12350,6566,4475,24243,7677,5822,41473,7241,1474016000,329171000,166728000,124982000,630973000,221849000,175081000,1110549000,294252000
Mississippi,Retail Trade,2007,41963,22655,8585,4995,36235,3517,612,40364,1599,61895,22680,8750,5385,36815,5225,3130,45170,16725,640885,36549,53379,61110,159078,114913,46814,333122,243987,13383758000,822109000,1069896000,1418420000,3344323000,3080802000,945017000,7652130000,4883003000
Mississippi,Total,2007,48675,27152,9043,5385,41580,4392,1132,47104,1571,61874,27180,9139,5661,41980,5912,3376,51268,10606,941328,48808,59119,71523,179450,158861,129626,467937,473391,28572483000,1350899000,1453147000,1870924000,4674970000,4506928000,3834027000,13015925000,15556558000
Mississippi,Transportation and Warehousing,2007,10383,6000,1570,895,8465,780,297,9542,841,11810,6000,1570,915,8485,830,435,9750,2060,153566,8979,9713,10961,30749,24292,11593,73197,74158,5638591000,261175000,279954000,330475000,897254000,772571000,379535000,2212382000,3059978000
Mississippi,Utilities,2007,1843,1225,350,50,1625,85,55,1765,78,2855,1230,350,50,1630,180,205,2015,840,41426,2935,2073,536,5576,4621,8436,18799,0,2885290000,50957000,51213000,19510000,123236000,209723000,421233000,764377000,81477000
Mississippi,Wholesale Trade,2007,12240,5020,1930,1545,8495,1669,769,10933,1307,14565,5020,1970,1625,8615,2125,1100,11840,2725,175767,7374,11242,17207,39840,40401,24030,119034,45955,7003266000,299698000,394582000,613263000,1372046000,1632386000,1024794000,4476477000,2221533000
Missouri,Accommodation and Food Services,2007,45337,17609,7010,8253,32872,10033,1334,44239,1098,61365,17645,7025,8305,32975,11810,4365,49150,12215,1209008,26790,46911,113072,187377,368476,175544,733848,474773,15549484000,585677000,498301000,1140358000,2224134000,4157567000,2099856000,8524692000,7018624000
Missouri,Administrative and Support and Waste Management and Remediation Services,2007,32864,20085,4815,2855,27755,2642,945,31342,1522,36965,20085,4825,2875,27785,2825,1250,31860,5105,787901,28532,30235,36247,98160,93590,113708,324629,421600,20662488000,915960000,780762000,979769000,2702498000,2626521000,2637164000,8248956000,11368245000
Missouri,"Agriculture, Forestry, Fishing and Hunting",2007,1280,925,190,70,1185,45,25,1255,25,1285,925,190,70,1185,50,25,1260,25,7035,736,1133,709,3461,1193,752,6128,0,189417000,32408000,23817000,17703000,83027000,32845000,25564000,170574000,0
Missouri,"Arts, Entertainment, and Recreation",2007,10182,5877,1425,1150,8452,1227,239,9918,264,10730,5885,1430,1150,8465,1330,345,10140,590,167366,7072,8733,14654,31745,43324,25026,104786,33188,6074805000,237522000,154740000,232124000,641396000,794439000,2354368000,3865535000,582356000
Missouri,Construction,2007,83216,52495,15105,8264,75864,6148,739,82751,465,83880,52500,15110,8265,75875,6280,915,83070,810,741195,86241,98192,110282,297508,221537,90156,619037,96239,34300985000,2755050000,3098445000,4118108000,9973475000,10746325000,5434527000,26554665000,6388994000
Missouri,Educational Services,2007,7007,3090,1020,925,5035,1335,398,6768,239,7700,3090,1020,935,5045,1460,490,6995,705,337593,3995,6185,11784,23657,58900,65954,151428,179816,10775077000,132401000,116901000,205858000,469258000,1315094000,1700827000,3530752000,7146554000
Missouri,Finance and Insurance,2007,31913,21690,3530,1644,26864,2265,898,30027,1886,56005,21750,3635,2070,27455,5580,4480,37515,18490,657202,33259,21527,19890,77576,75435,77938,233927,395129,36720609000,1258417000,774296000,892088000,2975229000,3548139000,3671475000,10517667000,25422655000
Missouri,Health Care and Social Assistance,2007,62241,31338,12340,7805,51483,6829,2266,60578,1663,79675,31380,12440,8110,51930,9205,7360,68495,11180,1786608,48164,79828,101547,234693,281010,296907,834789,936645,64110350000,2067478000,3123622000,4124787000,9370217000,8705411000,8484695000,26771302000,36847012000
Missouri,Information,2007,7006,3185,1046,779,5010,829,349,6188,818,13385,3190,1050,830,5070,1015,660,6745,6640,308241,4102,5851,9388,21694,26271,24756,78191,224011,15771575000,222848000,214133000,339610000,811259000,1037797000,935411000,2963553000,12565885000
Missouri,Management of Companies and Enterprises,2007,4246,290,85,165,540,886,1147,2573,1673,6675,290,85,165,540,900,1220,2660,4015,358420,345,20,988,1713,9080,38305,49110,309310,33010420000,38775000,31970000,99746000,171110000,566655000,2365890000,3103655000,29906765000
Missouri,Manufacturing,2007,32180,11540,5560,4823,21923,5534,2013,29470,2710,34340,11540,5565,4870,21975,5960,2430,30365,3975,1349260,17067,32221,57983,116565,194382,181630,545839,714241,57811240000,629734000,962062000,1974420000,3788957000,7282174000,6997286000,19987422000,34148227000
Missouri,"Mining, Quarrying, and Oil and Gas Extraction",2007,866,310,155,90,555,169,67,791,75,1325,310,155,90,555,330,180,1065,260,16897,411,884,1112,2700,5365,2754,11318,5481,717997000,18619000,30354000,37459000,92340000,201927000,138437000,465202000,252117000
Missouri,Other,2007,1607,1599,7,1,1607,0,0,1607,0,1607,1599,7,1,1607,0,0,1607,0,0,0,46,0,0,0,0,0,0,10882000,10529000,320000,0,10882000,0,0,10882000,0
Missouri,Other Services (except Public Administration),2007,75403,47040,15112,7036,69188,4771,773,74732,671,81480,47045,15270,7405,69720,5995,1965,77680,3800,594523,87670,97396,91085,276742,162956,52846,499878,70776,13836857000,1806835000,1954906000,1974933000,5751635000,3699907000,1418084000,11087462000,2144170000
Missouri,"Professional, Scientific, and Technical Services",2007,65020,43315,9710,5255,58280,4007,1204,63491,1529,69660,43350,9730,5440,58520,4765,1690,64975,4685,723531,61300,61233,65471,194862,126952,86195,418850,264812,40643742000,2830532000,2434470000,3158131000,8438331000,7198009000,5326677000,21255919000,16883540000
Missouri,Real Estate and Rental and Leasing,2007,28027,21277,2836,1368,25481,1247,561,27289,738,34790,21300,2915,1555,25770,1900,1580,29250,5540,211167,31563,17394,16609,67509,36880,32428,140580,64394,6802235000,877793000,538257000,486956000,1941280000,1238336000,979858000,4321747000,2252439000
Missouri,Retail Trade,2007,74803,38869,15073,9274,63216,7323,1560,72099,2704,115740,39010,15375,10180,64565,11855,6205,82625,33115,1472447,63127,92666,116261,274841,245304,99785,654808,762175,32892976000,1446861000,1938413000,2771776000,6190304000,7041642000,3335459000,16718707000,15542176000
Missouri,Total,2007,122573,71403,20654,13080,105137,11854,2787,119778,2795,154483,71503,20862,13727,106092,15862,7956,129910,24573,2457827,120845,135345,173957,430147,441536,335395,1207078,1250749,91285825000,3606728000,3812002000,5227512000,12646242000,14119115000,11782418000,38547775000,52738050000
Missouri,Transportation and Warehousing,2007,22549,13890,2837,1955,18682,1761,704,21147,1402,25555,13890,2850,1965,18705,1910,960,21575,3980,414353,17889,17513,24028,65474,56873,44803,176698,216714,14830227000,623854000,541723000,762985000,1977971000,1827398000,1571395000,5591732000,8764272000
Missouri,Utilities,2007,610,180,45,50,275,180,64,519,91,1860,180,45,50,275,285,260,820,1040,80722,0,0,508,1094,9087,5372,15126,49210,6059136000,9714000,6925000,22503000,42018000,524647000,334940000,948283000,3767525000
Missouri,Wholesale Trade,2007,35068,16125,5505,4065,25695,4672,1925,32292,2776,41965,16155,5560,4300,26015,5855,3400,35270,6695,626225,23538,33648,49658,112843,135567,93119,357757,251955,28474948000,1243731000,1497457000,2202922000,4993106000,6468870000,4328378000,16427090000,11283993000
Montana,Accommodation and Food Services,2007,15175,5850,3220,2900,11970,2758,243,14971,204,16820,5860,3230,2955,12045,3155,630,15830,990,225515,8648,21324,39511,69889,96020,23827,191117,27394,2785105000,216506000,202454000,428149000,852680000,1142170000,315504000,2341755000,386395000
Montana,Administrative and Support and Waste Management and Remediation Services,2007,7878,5350,1175,620,7145,372,95,7612,266,8340,5350,1175,635,7160,440,140,7740,600,78038,6492,6572,6660,21438,11226,8834,46581,7345,1834050000,205920000,152049000,160268000,543699000,232756000,112844000,993736000,213225000
Montana,"Agriculture, Forestry, Fishing and Hunting",2007,2104,1680,265,75,2020,30,26,2076,28,2140,1680,265,75,2020,30,45,2095,45,7238,1818,1676,825,4670,1080,384,6855,0,272494000,86363000,45637000,26725000,163959000,43650000,17699000,249730000,3009000
Montana,"Arts, Entertainment, and Recreation",2007,5249,3035,910,710,4655,477,70,5202,47,5825,3035,920,730,4685,585,95,5365,460,52357,2376,5777,8353,19324,16046,8597,46587,0,795862000,110035000,94100000,122926000,350602000,217507000,83140000,697240000,0
Montana,Construction,2007,30704,22720,4735,1965,29420,1045,123,30588,116,30815,22720,4735,1965,29420,1045,175,30640,175,145350,31104,30370,24468,88969,33715,9081,137908,3977,5894535000,1117114000,960870000,915954000,3005086000,1521140000,526224000,5492691000,230415000
Montana,Educational Services,2007,1560,840,260,170,1270,200,55,1525,35,1605,840,260,170,1270,205,80,1555,50,24908,1028,1078,2126,5272,6413,6056,18359,4647,518015000,27501000,22752000,30193000,85614000,129123000,206622000,439115000,78501000
Montana,Finance and Insurance,2007,6816,4455,815,424,5694,433,178,6305,511,10580,4455,830,570,5855,1220,605,7680,2900,83774,6709,4316,5073,17300,12800,9398,43729,35511,3656706000,218442000,167668000,177333000,588002000,475464000,374532000,1606011000,1842972000
Montana,Health Care and Social Assistance,2007,14337,7495,3065,1630,12190,1176,590,13956,381,16695,7500,3075,1685,12260,1565,1510,15335,1360,288894,12525,18994,19627,53371,44203,74581,178113,97039,9891318000,462835000,683632000,686079000,1848583000,1344818000,2068413000,5352481000,3989690000
Montana,Information,2007,2108,1080,345,235,1660,109,110,1879,229,3185,1080,345,240,1665,160,405,2230,955,35014,1420,1622,1971,6711,1822,6905,18574,15017,1383431000,45482000,40516000,63776000,187847000,50076000,336814000,722799000,573479000
Montana,Management of Companies and Enterprises,2007,585,50,10,30,90,150,130,370,215,630,50,10,30,90,155,130,375,255,14960,6,0,0,0,996,3182,4476,10431,808180000,2402000,0,0,0,38117000,181360000,237330000,567435000
Montana,Manufacturing,2007,6346,3220,1145,810,5175,780,169,6124,222,6505,3220,1145,810,5175,835,205,6215,290,79568,3659,4778,7219,19784,20741,7907,56813,14952,3086851000,113866000,149626000,222903000,540032000,722617000,274477000,1828395000,953815000
Montana,"Mining, Quarrying, and Oil and Gas Extraction",2007,1478,725,175,155,1055,140,79,1274,204,1540,725,175,155,1055,140,90,1285,255,24310,508,737,1645,3472,2822,4713,12495,9095,1346353000,40571000,41812000,60251000,157956000,128464000,245554000,570563000,744349000
Montana,Other,2007,41,37,3,1,41,0,0,41,0,41,37,3,1,41,0,0,41,0,0,21,0,0,0,0,0,0,0,1063000,885000,108000,0,1063000,0,0,1063000,0
Montana,Other Services (except Public Administration),2007,14791,9710,2995,1279,13984,582,60,14626,165,15485,9720,3005,1315,14040,830,100,14970,515,74860,16317,18379,15050,52696,16293,132,71214,1946,1576940000,361346000,377888000,325631000,1084555000,318963000,11840000,1474059000,61407000
Montana,"Professional, Scientific, and Technical Services",2007,16605,12045,2340,980,15365,740,151,16256,349,17480,12045,2355,1015,15415,1005,395,16815,665,88158,15038,14310,11639,45199,17797,7256,78230,6894,3659421000,604980000,479009000,484611000,1621089000,902079000,366281000,3181369000,405696000
Montana,Real Estate and Rental and Leasing,2007,8723,7295,710,338,8343,175,67,8585,138,9430,7305,740,410,8455,385,175,9015,415,29105,8824,3721,3460,17486,3370,812,24189,1750,789369000,264530000,95516000,84773000,496929000,83985000,15767000,654684000,73473000
Montana,Retail Trade,2007,20534,10295,4556,2676,17527,1784,374,19685,849,26120,10365,4605,2990,17960,2490,1095,21545,4575,272423,15150,27191,31934,80846,51960,23078,168440,81956,6387032000,382078000,580219000,786103000,1759050000,1367964000,602180000,3989776000,2206023000
Montana,Total,2007,33036,20653,5679,3178,29510,2306,469,32285,751,37755,20684,5720,3375,29779,3149,1335,34263,3492,353807,32710,37204,42038,111952,80482,52814,245248,108559,10646436000,942386000,916534000,1068927000,2927847000,2145108000,1677240000,6750195000,3896241000
Montana,Transportation and Warehousing,2007,5947,4060,670,410,5140,313,165,5618,329,6800,4060,675,425,5160,320,235,5715,1085,48210,4167,3609,4273,13737,7852,3601,32469,7883,1635299000,168825000,110328000,138720000,429659000,269954000,129912000,1013341000,346668000
Montana,Utilities,2007,398,180,45,40,265,80,20,365,33,965,180,45,45,270,110,40,420,545,12706,108,122,372,967,2040,0,4270,3722,863101000,6531000,5042000,16842000,36235000,117060000,0,232998000,278522000
Montana,Wholesale Trade,2007,6295,3025,980,607,4612,732,283,5627,668,7610,3045,995,650,4690,1070,525,6285,1325,68086,3514,5068,6204,17220,18072,6146,47601,15043,2709401000,153236000,194217000,236913000,650672000,670249000,255963000,1776158000,757521000
Nebraska,Accommodation and Food Services,2007,16824,6340,3232,3218,12790,3057,461,16308,516,21240,6340,3250,3260,12850,3650,1850,18350,2890,347599,9467,21586,42923,74468,107756,58753,241473,105426,3817005000,169119000,182331000,365964000,725582000,1095046000,643730000,2472020000,1342969000
Nebraska,Administrative and Support and Waste Management and Remediation Services,2007,11481,7140,1710,920,9770,710,303,10783,698,12730,7140,1725,920,9785,800,485,11070,1660,327142,9393,9987,10670,31665,20074,36904,98532,219532,9087593000,337304000,244081000,249599000,872444000,503063000,867449000,2512057000,6303255000
Nebraska,"Agriculture, Forestry, Fishing and Hunting",2007,840,680,60,35,775,30,20,825,15,870,680,60,35,775,30,45,850,20,3797,697,284,443,1551,472,162,2767,1030,178030000,35714000,9324000,9407000,56563000,18684000,13438000,101575000,76455000
Nebraska,"Arts, Entertainment, and Recreation",2007,4101,2455,575,395,3425,485,92,4002,99,4235,2455,575,395,3425,530,120,4075,160,51377,2680,3322,4988,11526,17577,10938,43085,5905,802449000,78408000,57369000,60360000,211139000,287834000,136738000,684605000,83760000
Nebraska,Construction,2007,29911,19980,5115,2674,27769,1689,238,29696,215,30165,19980,5115,2685,27780,1740,315,29835,330,209695,31224,32508,34834,100440,62442,20871,190045,13188,8436895000,977910000,981484000,1277626000,3251805000,2788710000,1065098000,7369910000,723429000
Nebraska,Educational Services,2007,2383,1050,365,330,1745,475,90,2310,73,2615,1050,365,330,1745,535,230,2510,105,84841,1206,1933,3990,7614,18960,14628,43807,16766,2200546000,29285000,30784000,53631000,125474000,402029000,324335000,910172000,527336000
Nebraska,Finance and Insurance,2007,13284,8680,1608,906,11194,810,319,12323,961,20815,8690,1680,1200,11570,2230,1275,15075,5740,288293,14024,9634,10116,34914,27217,16157,82644,178796,14245357000,426461000,360176000,435279000,1288771000,1129136000,694584000,3339240000,10123735000
Nebraska,Health Care and Social Assistance,2007,19836,9465,3950,2565,15980,2337,856,19173,663,24470,9475,3965,2680,16120,3415,2185,21720,2750,563073,13897,25269,34078,66197,92171,101590,278202,238073,21628476000,773939000,937371000,1492176000,3242466000,3336655000,2981730000,9704744000,9209569000
Nebraska,Information,2007,2908,1230,435,330,1995,341,152,2488,420,4805,1235,435,355,2025,455,185,2665,2140,73424,1028,2420,3549,8134,7169,6097,26013,43537,4101230000,44650000,69188000,120880000,259915000,399081000,234554000,1081368000,2366870000
Nebraska,Management of Companies and Enterprises,2007,1520,120,65,60,245,345,375,965,555,1860,120,65,60,245,350,380,975,885,81525,132,339,9,652,4473,10213,15406,65879,6671718000,8472000,21911000,1930000,68005000,189404000,517656000,776398000,5876759000
Nebraska,Manufacturing,2007,9252,3530,1560,1110,6200,1414,740,8354,898,9950,3530,1560,1115,6205,1600,855,8660,1290,422689,4835,7951,10494,26480,41425,58901,149553,222929,16017231000,165964000,212888000,352536000,870198000,1573834000,2171643000,5326363000,8354051000
Nebraska,"Mining, Quarrying, and Oil and Gas Extraction",2007,569,285,90,80,455,47,15,517,52,615,285,90,80,455,50,20,525,90,4747,394,556,570,1771,286,0,2900,629,205716000,14062000,21152000,17488000,63074000,24742000,0,131075000,28243000
Nebraska,Other,2007,60,60,0,0,60,0,0,60,0,60,60,0,0,60,0,0,60,0,0,0,0,0,0,0,0,0,0,659000,659000,0,0,659000,0,0,659000,0
Nebraska,Other Services (except Public Administration),2007,26778,17175,5075,2313,24563,1630,317,26510,268,29020,17210,5130,2465,24805,2150,1115,28070,950,184960,28743,31613,28999,93632,52406,15680,170186,8423,3836488000,606513000,612148000,547712000,1798016000,1085816000,371023000,3452743000,276917000
Nebraska,"Professional, Scientific, and Technical Services",2007,20375,13720,2860,1605,18185,1173,309,19667,708,21750,13720,2865,1660,18245,1440,515,20200,1550,226621,16389,16289,18557,55290,36865,15900,119439,78625,11207391000,722496000,684641000,762570000,2204893000,2066043000,988779000,5599297000,4867432000
Nebraska,Real Estate and Rental and Leasing,2007,8879,6892,743,405,8040,344,178,8562,317,10200,6900,770,475,8145,425,325,8895,1305,51757,6530,3548,4177,14802,8466,8302,39852,7410,1535244000,245303000,105768000,129587000,505030000,219660000,283634000,1194931000,215726000
Nebraska,Retail Trade,2007,27588,13186,5906,3702,22794,2559,752,26105,1483,39325,13230,6050,4050,23330,3975,2715,30020,9305,488324,20457,35783,44476,108075,79893,39040,241053,213907,10244299000,487992000,649797000,920357000,2092673000,2136888000,1133563000,5617254000,3902538000
Nebraska,Total,2007,42791,24933,7225,4511,36669,3783,953,41405,1386,52517,24965,7319,4816,37100,5341,2957,45398,7119,795545,41446,47179,59859,148484,139436,111193,399113,396432,27219151000,1175749000,1199046000,1653618000,4028413000,4235878000,3532530000,11796821000,15422330000
Nebraska,Transportation and Warehousing,2007,11010,7510,1200,754,9464,667,223,10354,656,11785,7510,1200,755,9465,700,305,10470,1315,165135,8730,6870,8484,25980,20687,16299,70983,77570,6390358000,265755000,199387000,254962000,735343000,756278000,582881000,2275040000,3516297000
Nebraska,Utilities,2007,175,75,15,5,95,25,5,125,50,650,75,15,5,95,50,5,150,500,5247,74,0,0,140,502,0,696,4418,386179000,4313000,0,0,12246000,23249000,0,37340000,348460000
Nebraska,Wholesale Trade,2007,11769,4885,1655,1405,7945,1841,777,10563,1206,15185,4900,1680,1555,8135,2580,1860,12575,2610,186580,6551,8616,14458,32521,48298,30721,122025,50964,8658386000,265741000,350142000,571935000,1256558000,1863050000,1324885000,4828982000,3186561000
Nevada,Accommodation and Food Services,2007,19746,7155,3813,3558,14526,3491,732,18749,997,28075,7165,3850,3660,14675,4245,2505,21425,6650,1597270,9085,23773,43821,77281,124710,108126,313396,1268528,44591997000,344827000,316661000,557792000,1242757000,2059569000,2058159000,5477618000,39038991000
Nevada,Administrative and Support and Waste Management and Remediation Services,2007,19429,10953,2730,1820,15503,2100,718,18321,1108,20920,10955,2735,1845,15535,2155,885,18575,2345,538272,14939,16622,22122,55190,70910,63288,196204,307013,14416040000,637347000,476364000,638830000,1816500000,1938463000,1697928000,5636893000,7876975000
Nevada,"Agriculture, Forestry, Fishing and Hunting",2007,245,195,30,10,235,0,10,245,0,245,195,30,10,235,0,10,245,0,555,184,0,0,252,0,0,555,0,19625000,12062000,488000,0,16873000,0,0,19625000,0
Nevada,"Arts, Entertainment, and Recreation",2007,5731,3245,680,490,4415,770,324,5509,222,6525,3245,680,490,4415,815,675,5905,620,148033,2051,3562,6041,13043,32209,48166,95573,41830,4065100000,268628000,202323000,171556000,753730000,865081000,1096386000,2799318000,933109000
Nevada,Construction,2007,30605,14475,5580,4200,24255,4554,1222,30031,574,30910,14475,5580,4205,24260,4595,1275,30130,780,648251,22012,36828,57106,117885,182411,191932,497309,144384,29794027000,1251670000,1434300000,2299638000,4992895000,7820619000,8543130000,21514704000,8055426000
Nevada,Educational Services,2007,2914,1640,375,330,2345,340,75,2760,154,3105,1640,375,340,2355,345,95,2795,310,42520,1606,2450,4153,8765,12612,5622,28768,10796,1317501000,78530000,49760000,102035000,240848000,380860000,200025000,862121000,374641000
Nevada,Finance and Insurance,2007,15861,10687,1578,699,12964,717,711,14392,1469,24010,10755,1630,845,13230,1135,1780,16145,7865,204082,12580,8659,6400,29359,13719,15145,62698,126682,10296103000,657839000,389453000,363069000,1459050000,834768000,732316000,3438053000,6455206000
Nevada,Health Care and Social Assistance,2007,25305,13508,5335,3010,21853,2118,583,24554,751,29160,13510,5365,3145,22020,2735,1520,26275,2885,465673,20465,34275,38607,94521,70978,63460,245524,188203,21074858000,1683194000,1451438000,1670887000,4830466000,3025928000,2379702000,10575360000,9514919000
Nevada,Information,2007,3894,2300,425,340,3065,255,130,3450,444,5585,2300,430,340,3070,270,180,3520,2065,69903,2328,1409,2955,8083,3361,2330,19596,41907,3598663000,177193000,67705000,158284000,449030000,164422000,61603000,1005240000,2362753000
Nevada,Management of Companies and Enterprises,2007,2754,960,55,115,1130,300,441,1871,883,3155,975,55,120,1150,305,475,1930,1225,82960,0,200,723,1793,2425,9808,14180,68753,9250200000,76383000,17688000,33843000,132336000,111240000,610656000,856225000,8390023000
Nevada,Manufacturing,2007,9785,3955,1765,1275,6995,1479,613,9087,698,10110,3955,1765,1280,7000,1495,695,9190,920,209777,4529,8770,12646,29203,43692,31649,127338,53526,9459610000,224984000,317989000,455263000,1129582000,1667568000,1366531000,4989715000,2901902000
Nevada,"Mining, Quarrying, and Oil and Gas Extraction",2007,1018,450,130,115,695,140,90,925,93,1100,450,130,115,695,140,95,930,170,72580,172,581,745,2239,2602,7211,16659,48751,4175943000,27584000,42700000,73853000,193091000,138987000,503075000,1155956000,2760530000
Nevada,Other,2007,107,100,6,1,107,0,0,107,0,107,100,6,1,107,0,0,107,0,124,74,0,0,124,0,0,124,0,3577000,1753000,0,0,3577000,0,0,3577000,0
Nevada,Other Services (except Public Administration),2007,19095,11680,3585,1885,17150,1222,334,18706,389,21410,11710,3600,1965,17275,1745,700,19720,1690,172436,18238,22552,21872,66121,42154,16865,136264,20639,4552718000,576341000,581662000,619346000,1797243000,1071060000,474744000,3566762000,840499000
Nevada,"Professional, Scientific, and Technical Services",2007,38385,27245,4465,2510,34220,2325,837,37382,1003,40785,27255,4485,2570,34310,2540,1185,38035,2750,301445,30488,26936,31986,94455,67434,41213,211242,66593,16898770000,2129954000,1402404000,1784938000,5339829000,3972293000,2439680000,12036469000,3856049000
Nevada,Real Estate and Rental and Leasing,2007,18985,14105,2153,1057,17315,724,372,18411,574,22300,14105,2185,1190,17480,885,715,19080,3220,155720,17840,13844,12991,46522,20098,13450,83767,59346,5711305000,767086000,451626000,498353000,1723388000,918177000,521354000,3240408000,2206489000
Nevada,Retail Trade,2007,27347,12987,4894,3562,21443,2245,1111,24799,2548,42850,13065,4995,3840,21900,3135,2275,27310,15540,682853,17060,27462,40191,89668,63722,48753,221787,424483,18366053000,588410000,724164000,1101971000,2485233000,1994651000,2199749000,7124776000,10641607000
Nevada,Total,2007,51342,29200,8012,5334,42546,4918,1738,49202,2140,62839,29252,8084,5578,42914,5843,3329,52086,10753,1195806,43967,52681,70924,167572,175040,169626,512238,683568,44422686000,2133087000,1802095000,2411126000,6346308000,6311401000,6185172000,18842881000,25579805000
Nevada,Transportation and Warehousing,2007,6864,3540,675,560,4775,670,404,5849,1015,7850,3540,690,575,4805,695,450,5950,1900,210081,3287,3075,4543,12461,17152,25409,62370,132053,6769337000,247903000,95825000,205047000,584708000,611704000,862303000,2297706000,3918316000
Nevada,Utilities,2007,256,115,20,5,140,40,25,205,51,560,115,20,5,140,70,55,265,295,1689,157,69,0,268,0,1036,2185,961,114899000,9401000,2649000,0,12792000,0,74150000,142465000,62915000
Nevada,Wholesale Trade,2007,13662,6335,1787,1305,9427,1702,947,12076,1586,15005,6350,1790,1345,9485,1910,1075,12470,2535,196450,7223,9053,12809,33213,37120,29529,113046,61861,10247105000,486014000,458092000,613552000,1670186000,1744305000,1422482000,5434058000,3431926000
New Hampshire,Accommodation and Food Services,2007,14605,5860,2770,2560,11190,2706,379,14275,330,17485,5870,2795,2625,11290,2960,1200,15450,2035,280166,8051,18641,34900,61913,90250,36170,197225,55083,4281090000,301059000,262064000,468594000,1033105000,1299512000,557864000,2988641000,1279671000
New Hampshire,Administrative and Support and Waste Management and Remediation Services,2007,10082,6515,1335,865,8715,742,237,9694,388,10725,6515,1340,875,8730,830,315,9875,850,156482,7923,7433,10528,28411,26908,19765,79219,71155,5997577000,387120000,228692000,347733000,1070216000,976420000,624438000,2786368000,2866593000
New Hampshire,"Agriculture, Forestry, Fishing and Hunting",2007,725,505,150,45,700,20,0,720,5,725,505,150,45,700,20,0,720,5,2707,24,832,119,2068,312,0,2641,0,100042000,20418000,21924000,4680000,65742000,22214000,0,99098000,0
New Hampshire,"Arts, Entertainment, and Recreation",2007,3625,2080,535,410,3025,445,95,3565,60,3750,2080,535,410,3025,505,130,3660,90,53597,2507,2776,5168,11350,13352,7761,37837,13948,1107650000,149735000,82774000,125367000,376081000,373559000,101226000,991180000,93208000
New Hampshire,Construction,2007,23943,17145,3580,1750,22475,1261,145,23881,62,24005,17145,3580,1750,22475,1290,160,23925,80,140495,24537,22623,22257,73228,42415,14000,135440,1128,6961305000,1108382000,941618000,1035781000,3167583000,2575579000,788268000,6798820000,99494000
New Hampshire,Educational Services,2007,2619,1190,435,310,1935,443,123,2501,118,2880,1190,440,310,1940,555,175,2670,210,147597,1194,2320,3655,8320,15759,16313,41432,100976,3618027000,49011000,59007000,76584000,208916000,356849000,527337000,1103499000,2341321000
New Hampshire,Finance and Insurance,2007,5900,3060,783,440,4283,490,290,5063,837,10580,3065,805,525,4395,960,1055,6410,4170,135847,4673,4350,4118,14470,15858,15857,50528,80508,7860878000,272442000,238175000,220152000,783195000,917305000,781189000,2787133000,4893098000
New Hampshire,Health Care and Social Assistance,2007,13857,5590,3430,1968,10988,1689,647,13324,533,17465,5590,3430,2035,11055,2295,1600,14950,2515,397519,10338,22674,25405,59454,59398,86608,209113,181417,15935510000,408744000,954959000,1162441000,2632038000,2267899000,2687521000,7712720000,7931763000
New Hampshire,Information,2007,2470,1110,340,275,1725,244,155,2124,346,3905,1110,345,275,1730,330,205,2265,1640,49735,627,1433,1911,5091,4761,11034,28353,15034,3786765000,136905000,102167000,136659000,447634000,236865000,733616000,1764687000,1087068000
New Hampshire,Management of Companies and Enterprises,2007,838,70,15,35,120,135,175,430,408,1050,75,15,35,125,135,185,445,605,45800,0,105,0,412,1780,7335,9735,36065,4446860000,0,9590000,7636000,23899000,305501000,463435000,810460000,3636400000
New Hampshire,Manufacturing,2007,10050,3705,1670,1394,6769,1960,553,9282,768,10400,3705,1670,1395,6770,2005,620,9395,1005,309548,4025,7282,13835,30189,62600,41883,160726,111793,16080745000,237252000,339825000,639671000,1369542000,3103824000,2093816000,7551763000,6972502000
New Hampshire,"Mining, Quarrying, and Oil and Gas Extraction",2007,209,120,35,10,165,15,17,197,12,230,120,35,10,165,15,25,205,25,2000,198,47,0,508,75,597,1686,0,82880000,9820000,2305000,0,22814000,2860000,22065000,76073000,0
New Hampshire,Other,2007,30,29,1,0,30,0,0,30,0,30,29,1,0,30,0,0,30,0,0,13,0,0,0,0,0,0,0,417000,364000,0,0,417000,0,0,417000,0
New Hampshire,Other Services (except Public Administration),2007,17180,10590,3905,1470,15965,808,185,16958,222,18250,10595,3920,1510,16025,975,540,17540,710,109865,18998,24458,18067,63554,22588,6412,100495,6877,2936765000,494293000,567577000,451123000,1539037000,662211000,192246000,2579809000,278980000
New Hampshire,"Professional, Scientific, and Technical Services",2007,19627,13050,2960,1595,17605,1140,305,19050,577,20610,13050,2960,1655,17665,1330,420,19415,1195,152335,17863,18273,20027,59614,27783,11763,106752,42349,8821610000,1171435000,1021783000,1166922000,3438277000,2045759000,881082000,6707177000,1882704000
New Hampshire,Real Estate and Rental and Leasing,2007,6560,4700,885,325,5910,265,123,6298,262,7750,4730,935,390,6055,465,285,6805,945,35723,6838,5178,3942,16010,6634,3461,28327,4947,1269686000,274764000,176723000,133301000,594402000,250578000,133289000,1035702000,208166000
New Hampshire,Retail Trade,2007,22768,10770,4805,2888,18463,2274,573,21310,1458,32845,10800,4845,3205,18850,3020,1710,23580,9265,472936,14256,25225,29542,73736,59055,31612,185259,161889,11508227000,508590000,673680000,938812000,2222634000,2055217000,1406203000,6055632000,3469304000
New Hampshire,Total,2007,33001,18555,5900,3500,27955,3125,785,31865,1136,39453,18577,5942,3669,28188,3842,1903,33933,5520,573209,31539,38700,46693,116932,109604,83244,309780,263429,22791071000,1276370000,1356078000,1681422000,4313870000,4276145000,3263402000,11853417000,10937654000
New Hampshire,Transportation and Warehousing,2007,3805,2175,575,325,3075,310,135,3520,285,4185,2175,575,335,3085,330,145,3560,625,60648,1790,2910,3148,8730,7436,3047,26189,15496,2122573000,110923000,98503000,119024000,365868000,237723000,114921000,964619000,555398000
New Hampshire,Utilities,2007,242,118,10,15,143,15,28,186,56,520,120,10,15,145,15,105,265,255,10335,29,0,0,0,192,944,2306,7341,830435000,11763000,0,5298000,22035000,23360000,58296000,163244000,595486000
New Hampshire,Wholesale Trade,2007,9019,4300,1305,919,6524,1088,489,8101,918,9755,4300,1320,945,6565,1175,640,8380,1375,116462,4107,6832,10297,25305,27652,13081,75360,32117,7050800000,439468000,417044000,581316000,1538194000,1652247000,673233000,4266222000,2227754000
New Jersey,Accommodation and Food Services,2007,83794,44735,15748,11511,71994,9925,1032,82951,843,96725,44770,15785,11590,72145,10565,2395,85105,11620,1355425,75325,102964,155519,334043,360576,134313,832253,517451,24276870000,1876545000,1516601000,2237073000,5624698000,5780467000,2062257000,13534284000,10672392000
New Jersey,Administrative and Support and Waste Management and Remediation Services,2007,61279,39175,8300,5015,52490,5063,1739,59292,1987,67135,39200,8320,5050,52570,5275,2210,60055,7080,1453868,50887,52990,67070,173557,196837,244905,622958,813137,46321927000,2753951000,1996365000,2625346000,7469701000,7234870000,6815746000,21842645000,24108120000
New Jersey,"Agriculture, Forestry, Fishing and Hunting",2007,1225,965,105,95,1165,50,0,1215,10,1225,965,105,95,1165,50,0,1215,10,4867,33,504,857,2693,1046,0,3852,0,194340000,40145000,11914000,22016000,86239000,38940000,0,134145000,0
New Jersey,"Arts, Entertainment, and Recreation",2007,16963,10230,2315,1703,14248,2122,413,16783,180,17935,10240,2320,1725,14285,2165,555,17005,930,238239,11722,13998,21276,51171,85493,52484,196269,36110,7070535000,715768000,361640000,487341000,1613183000,1974524000,2683551000,6482604000,505403000
New Jersey,Construction,2007,127039,88805,19440,10595,118840,6836,893,126569,470,127500,88810,19440,10605,118855,6885,940,126680,820,885475,140109,125219,140825,406280,248505,129891,797890,70381,50749460000,6125661000,5504995000,7284110000,18926950000,15660985000,8597923000,43807300000,5535287000
New Jersey,Educational Services,2007,15033,6725,2555,2025,11305,2770,620,14695,338,16310,6725,2555,2045,11325,2905,900,15130,1180,458080,10268,17054,27202,54735,112585,87178,262925,176988,15095920000,317173000,370108000,600054000,1293295000,3284765000,3177922000,7962315000,6343556000
New Jersey,Finance and Insurance,2007,35352,21435,4955,2726,29116,2777,1185,33078,2274,67215,21465,5055,2975,29495,4570,3260,37325,29890,1077423,32487,30701,32704,99901,91000,84967,284416,780819,94000904000,2148666000,2155274000,2620284000,7093254000,7476334000,5558136000,20709023000,72564828000
New Jersey,Health Care and Social Assistance,2007,109270,53908,25263,14478,93649,10918,2948,107515,1755,128855,53960,25405,15215,94580,14620,8720,117920,10935,2531731,107186,164944,191684,467868,398795,419145,1293206,1207946,109050200000,5066476000,6878165000,9428977000,21409153000,17282772000,13536377000,52510268000,55182762000
New Jersey,Information,2007,12046,6525,1550,1110,9185,1290,486,10961,1085,20885,6525,1550,1115,9190,1400,655,11245,9640,564655,7156,9274,11206,33565,42541,36847,119638,420548,43069510000,665597000,494887000,682638000,2041847000,2742388000,2735647000,7806787000,33057334000
New Jersey,Management of Companies and Enterprises,2007,5011,380,120,150,650,785,1159,2594,2417,7025,390,120,150,660,795,1235,2690,4335,860200,528,620,1210,2367,12480,45582,61590,798483,97998305000,172270000,40620000,87135000,300025000,896330000,4174317000,5619710000,92378595000
New Jersey,Manufacturing,2007,44798,16390,8100,6544,31034,8555,2608,42197,2601,46080,16390,8115,6585,31090,8730,2870,42690,3390,1393776,27334,47082,77189,163482,320756,283848,822898,484219,78171618000,1330600000,1942100000,3559397000,7126129000,15146120000,14393845000,38969255000,34566715000
New Jersey,"Mining, Quarrying, and Oil and Gas Extraction",2007,447,180,65,35,280,56,27,363,84,535,180,65,35,280,70,30,380,155,8361,16,395,92,481,1540,0,3292,4180,489108000,13811000,18929000,4244000,56539000,60796000,0,154914000,250561000
New Jersey,Other,2007,279,274,4,1,279,0,0,279,0,279,274,4,1,279,0,0,279,0,0,0,0,0,0,0,0,0,0,6176000,6085000,0,0,6176000,0,0,6176000,0
New Jersey,Other Services (except Public Administration),2007,115011,76540,20817,9880,107237,6173,847,114257,754,119540,76575,20910,10200,107685,6970,1435,116090,3450,778800,139175,134043,128846,405898,212206,74755,705470,57388,21197137000,3386500000,3229471000,3469281000,10098540000,5651571000,1961529000,18185269000,2448846000
New Jersey,"Professional, Scientific, and Technical Services",2007,152661,108358,19424,10818,138600,8679,2636,149915,2746,159740,108405,19510,10985,138900,9535,3370,151805,7935,1549255,161622,126326,140316,435705,296490,234602,975894,555241,111898450000,9102345000,7053704000,8970060000,25158595000,21764902000,17419110000,64725172000,46143257000
New Jersey,Real Estate and Rental and Leasing,2007,40120,28373,6040,2677,37090,1757,476,39323,797,47155,28410,6235,3000,37645,2270,985,40900,6255,303102,43992,38633,34275,118629,55929,27945,208453,67063,14654876000,1941496000,1464490000,1364982000,4802715000,2605072000,1339789000,8944040000,4015997000
New Jersey,Retail Trade,2007,126992,81194,21344,11646,114184,8218,1749,124151,2841,172720,81340,21730,12390,115460,10650,4545,130655,42065,2285944,122687,125041,126753,381139,259328,109857,778000,1201231,59742847000,3638139000,3365849000,3822930000,10779956000,10464479000,5112354000,26820903000,29415969000
New Jersey,Total,2007,208002,128741,34476,20321,183538,17222,4020,204780,3222,243350,128850,34743,20984,184577,20104,7999,212680,30670,3661679,218308,225397,270291,713996,637974,506947,1858917,1802762,184164748000,8928342000,8441139000,11194947000,28564428000,28461176000,23189147000,80214751000,103949997000
New Jersey,Transportation and Warehousing,2007,33320,18845,4602,3000,26447,3590,1441,31478,1842,37040,18845,4615,3015,26475,3865,1860,32200,4840,812717,27589,29553,38636,96271,123907,128356,362700,422664,33312369000,1152904000,1107794000,1476633000,3765474000,4605644000,4433872000,13316530000,18667895000
New Jersey,Utilities,2007,468,160,50,50,260,45,27,332,136,1710,165,50,50,265,55,55,375,1335,52700,132,172,520,917,1490,814,4578,44109,6735885000,17382000,12831000,37773000,84419000,114395000,57136000,359402000,6049920000
New Jersey,Wholesale Trade,2007,74415,39505,11759,7960,59224,8578,3047,70849,3566,80025,39520,11810,8090,59420,9145,3975,72540,7485,1346539,59561,73709,100430,238184,288325,245240,791417,522809,90389836000,3688748000,4216921000,6016903000,13978951000,17133614000,13985823000,45576136000,43514728000
New Mexico,Accommodation and Food Services,2007,15430,5485,2473,3000,10958,3360,498,14816,614,20610,5490,2480,3065,11035,4075,1510,16620,3990,403260,7696,16811,41739,66853,123491,65891,257112,142832,5367699000,199956000,175202000,462561000,841459000,1553209000,925550000,3331782000,2003421000
New Mexico,Administrative and Support and Waste Management and Remediation Services,2007,8924,4910,1540,770,7220,785,248,8253,671,9775,4910,1545,780,7235,875,275,8385,1390,204697,6357,8820,8140,26425,24472,22183,78637,121557,5217423000,201993000,237809000,247548000,710794000,674864000,591212000,2147881000,2942609000
New Mexico,"Agriculture, Forestry, Fishing and Hunting",2007,496,340,65,45,450,16,10,476,20,510,340,70,45,455,25,10,490,20,2470,332,198,0,1069,0,0,2235,0,75344000,15045000,6748000,6636000,41135000,0,0,69744000,0
New Mexico,"Arts, Entertainment, and Recreation",2007,3293,1975,445,280,2700,415,85,3200,93,3495,1975,450,295,2720,470,165,3355,140,70389,1663,2710,2695,8948,15948,7660,38325,23783,1547629000,84993000,42521000,57060000,192624000,242709000,165711000,682514000,631131000
New Mexico,Construction,2007,29341,17435,5385,3315,26135,2592,394,29121,220,29480,17435,5385,3315,26135,2635,435,29205,275,276545,26762,34949,43008,107048,95348,53168,262175,11544,10059945000,903755000,917037000,1351249000,3180391000,3564995000,2203049000,9221125000,730103000
New Mexico,Educational Services,2007,2916,1500,385,400,2285,375,130,2790,126,3020,1500,385,400,2285,375,150,2810,210,49505,1362,2271,5000,9642,14246,13000,40886,3197,1264549000,63058000,43540000,103926000,220364000,338906000,399815000,1068078000,127803000
New Mexico,Finance and Insurance,2007,8708,5540,1090,400,7030,502,362,7894,814,14890,5550,1195,515,7260,1235,1525,10020,4870,122706,7943,6401,4120,19623,14679,24339,62331,54011,6855367000,302645000,231560000,196880000,751984000,707007000,1231811000,3020810000,3828998000
New Mexico,Health Care and Social Assistance,2007,18975,8895,3970,2525,15390,2137,697,18224,751,23710,8895,4005,2565,15465,2790,1775,20030,3680,516797,13904,25726,33074,75704,81981,86586,250830,236903,19197409000,669902000,969056000,1260963000,2924170000,2582522000,2561820000,8239662000,10030142000
New Mexico,Information,2007,2602,1240,390,230,1860,243,119,2222,380,4105,1240,395,230,1865,300,215,2380,1725,51875,1034,898,2449,6601,6028,2618,17396,28356,2245263000,47525000,56433000,69195000,206937000,237360000,121129000,654788000,1095811000
New Mexico,Management of Companies and Enterprises,2007,932,50,21,50,121,185,240,546,386,1180,50,25,55,130,190,270,590,590,54318,4,0,38,414,2347,6634,9456,44854,3518910000,506000,0,12829000,28418000,73464000,367881000,476695000,3041549000
New Mexico,Manufacturing,2007,7522,3500,1410,945,5855,934,285,7074,448,7700,3500,1410,950,5860,975,320,7155,545,134564,3790,6807,8374,22283,24115,10388,69587,50560,5813175000,151601000,200847000,293471000,767266000,828713000,348741000,2427280000,2683823000
New Mexico,"Mining, Quarrying, and Oil and Gas Extraction",2007,3093,1265,360,360,1985,554,153,2692,401,3415,1265,360,360,1985,565,195,2745,670,89810,1600,2449,4436,9055,19014,11043,40578,49683,5152697000,101285000,94465000,193224000,392220000,864259000,654025000,2008143000,3156395000
New Mexico,Other,2007,45,42,1,2,45,0,0,45,0,45,42,1,2,45,0,0,45,0,53,25,0,0,53,0,0,53,0,867000,701000,0,0,867000,0,0,867000,0
New Mexico,Other Services (except Public Administration),2007,19488,11415,4225,2105,17745,1192,227,19164,324,20770,11425,4225,2150,17800,1485,570,19855,915,137405,20064,26720,27047,76327,37663,5429,125971,7416,3165515000,470014000,593825000,580658000,1661232000,853952000,153078000,2791687000,299964000
New Mexico,"Professional, Scientific, and Technical Services",2007,23209,15785,3233,1813,20831,1168,438,22437,772,24615,15785,3250,1845,20880,1365,580,22825,1790,197600,22682,19868,21938,66609,33352,18059,126157,54046,10961934000,1046457000,881554000,1063641000,3047646000,1825593000,1164909000,6328854000,3650844000
New Mexico,Real Estate and Rental and Leasing,2007,10684,7995,1275,559,9829,358,163,10350,334,12580,8005,1300,615,9920,490,495,10905,1675,53628,10890,7508,6481,26296,7703,1736,39405,10808,1751430000,365704000,196486000,182596000,760802000,249927000,73879000,1166297000,524501000
New Mexico,Retail Trade,2007,24237,11825,4854,3054,19733,2314,589,22636,1601,36210,11845,4950,3370,20165,3440,2100,25705,10505,424499,15362,29465,35704,86815,64849,26538,202867,167222,10283601000,460775000,674242000,902754000,2123254000,2027623000,1042009000,5479934000,3560455000
New Mexico,Total,2007,38291,21424,6645,4232,32301,3607,903,36811,1480,46869,21436,6722,4408,32566,4634,2310,39510,7359,642183,35877,43838,55999,135714,128364,92303,356381,285802,21889467000,1123819000,1197217000,1591142000,3912178000,3816527000,3061633000,10790338000,11099129000
New Mexico,Transportation and Warehousing,2007,5939,3660,665,425,4750,480,193,5423,516,6895,3660,665,430,4755,530,255,5540,1355,71811,4704,3679,4762,14456,12627,5293,37602,19190,2604315000,148818000,93704000,135070000,411742000,444328000,158833000,1100132000,814519000
New Mexico,Utilities,2007,715,435,80,50,565,60,30,655,60,1105,435,80,50,565,110,50,725,380,18536,864,455,396,1903,2354,0,5700,219,1139410000,15369000,13631000,14838000,51072000,117336000,0,244640000,9869000
New Mexico,Wholesale Trade,2007,8836,3665,1425,958,6048,1106,465,7619,1217,10055,3665,1430,995,6090,1240,655,7985,2070,107219,1375,7416,8638,20938,21480,9597,60284,34551,4483803000,225544000,308660000,316743000,921707000,806910000,388044000,2423115000,1784377000
New York,Accommodation and Food Services,2007,189782,98634,37483,26943,163060,22625,2804,188489,1293,217090,98695,37525,27095,163315,24895,7550,195760,21330,2901665,170301,245573,364725,782215,830329,434017,2049080,839190,56654950000,3939085000,3730761000,5806282000,13480115000,15253925000,9117018000,37895890000,18503892000
New York,Administrative and Support and Waste Management and Remediation Services,2007,111347,74125,13585,8510,96220,9062,3380,108662,2685,121290,74140,13630,8590,96360,9655,4535,110550,10740,2495389,96249,87063,109430,298803,356105,508835,1172716,1298945,100404243000,4996112000,3411543000,4622676000,13040068000,14282902000,16223657000,43716923000,55769677000
New York,"Agriculture, Forestry, Fishing and Hunting",2007,3075,2380,370,175,2925,105,20,3050,25,3090,2380,370,175,2925,110,25,3060,30,20052,1221,2173,1637,8362,3044,0,15401,0,608106000,96306000,63849000,56147000,226527000,114158000,0,468105000,0
New York,"Arts, Entertainment, and Recreation",2007,52673,36130,6229,4215,46574,4639,962,52175,498,55625,36130,6265,4250,46645,4945,1350,52940,2685,749650,43896,40374,56595,142181,182016,142639,475905,251748,31982625000,4926505000,2208975000,1939378000,9085414000,5666282000,5010134000,20086588000,11512697000
New York,Construction,2007,239116,169285,34024,19650,222959,13868,1766,238593,523,240060,169285,34035,19675,222995,13975,1925,238895,1165,1644665,250669,222910,262800,737035,517770,265298,1525995,103146,93793765000,10602426000,9393175000,12946135000,32942730000,30806315000,19994026000,84078785000,8272110000
New York,Educational Services,2007,30293,14145,3855,3730,21730,6017,1642,29389,904,33210,14145,3870,3805,21820,6370,2615,30805,2405,1748420,20367,24785,51011,97032,237089,253285,591135,1147787,61382715000,741300000,633835000,1310626000,2690575000,7043895000,9129678000,18876655000,42143705000
New York,Finance and Insurance,2007,86443,53476,13401,6561,73438,6873,2880,83191,3252,145230,53580,13735,7530,74845,9980,9185,94010,51220,2863506,84542,79814,78999,248848,223380,320596,795820,2016830,534841133000,7141342000,8698094000,11262746000,28082961000,39782800000,57364108000,127687774000,401744051000
New York,Health Care and Social Assistance,2007,219917,120249,44115,24184,188548,18539,7968,215055,4862,269705,120435,44430,25375,190240,25805,24730,240775,28930,6592587,212744,286980,322940,835433,717539,1302605,2860170,3714654,273762568000,10846380000,12042282000,14426507000,37320151000,29220401000,42216396000,108858181000,164492438000
New York,Information,2007,39497,23700,4829,3608,32137,4004,1346,37487,2010,58025,23720,4850,3675,32245,4515,1800,38560,19465,1319200,22653,26849,43220,101106,131101,124596,382152,920808,115527350000,2386656000,1492438000,2468776000,6701207000,8194147000,9610801000,25792550000,77726831000
New York,Management of Companies and Enterprises,2007,9411,1331,285,240,1856,1526,2451,5833,3578,13455,1335,290,240,1865,1575,2615,6055,7400,938290,16,52,1277,197,23393,99591,127246,810283,126902150000,174710000,137581000,125155000,424042000,2334263000,8529065000,11367943000,115339950000
New York,Manufacturing,2007,90982,38998,15565,13018,67581,16122,3935,87638,3344,93635,39005,15575,13095,67675,16520,4535,88730,4905,2564133,63924,98479,168300,343597,618218,489835,1526892,843449,118463434000,2621293000,3347982000,6259445000,12574928000,24729877000,21139587000,61448677000,47017927000
New York,"Mining, Quarrying, and Oil and Gas Extraction",2007,1520,745,235,145,1125,192,93,1410,110,1870,745,235,145,1125,215,165,1505,365,23196,1231,1306,1763,4676,5411,5776,17107,6052,1191263000,61059000,67265000,71385000,207033000,275786000,302078000,821432000,298942000
New York,Other,2007,666,640,15,7,662,3,1,666,0,666,640,15,7,662,3,1,666,0,0,0,0,85,0,72,0,0,0,0,16766000,2201000,1926000,20893000,780000,0,0,0
New York,Other Services (except Public Administration),2007,247800,170260,41565,20538,232363,12413,1926,246702,1098,262825,170385,41805,21055,233245,14685,4715,252645,10180,1811367,307175,270706,267038,847698,430616,253018,1541652,244293,54849980000,7619772000,6933045000,7630151000,22213245000,13600607000,9112139000,45194095000,9047950000
New York,"Professional, Scientific, and Technical Services",2007,284848,204596,36726,19722,261044,16066,4092,281202,3646,298780,204665,36815,20065,261545,18060,5740,285345,13435,2990262,295954,237214,256829,793654,549837,393551,1745608,1192974,228531905000,17727317000,13522329000,16883375000,48183056000,40329642000,31682135000,120510314000,107037373000
New York,Real Estate and Rental and Leasing,2007,146404,113405,17016,8149,138570,5593,1151,145314,1090,161320,113490,17375,8780,139645,8060,3485,151190,10130,852075,167873,109304,106494,388307,192126,106443,692174,157124,41757270000,6340046000,4251491000,4849931000,15463205000,9525380000,6850631000,31974314000,9585528000
New York,Retail Trade,2007,289685,193389,47962,24079,265430,17917,2888,286235,3450,382580,193595,48585,25760,267940,24075,10490,302505,80075,4380440,303108,297670,285554,915845,590500,265984,1823228,2163382,112433195000,8817336000,7774476000,8593868000,25005830000,20596083000,9607500000,55983581000,52532183000
New York,Total,2007,446021,289959,69657,40561,400177,34046,7509,441732,4289,519489,290188,70228,42013,402429,41150,19083,462662,56827,7529882,473742,455052,539997,1468791,1274760,1134756,3878307,3651575,429074494000,19950530000,17822759000,22789096000,60562385000,59999483000,58582676000,179144544000,249929950000
New York,Transportation and Warehousing,2007,53771,33165,6933,4804,44902,5141,1841,51884,1887,60405,33175,6960,4885,45020,5625,2950,53595,6810,1183244,36893,43747,60323,153227,178941,175249,513656,640181,46541499000,1640276000,1542560000,2176990000,5399915000,6805921000,6189425000,18974349000,26831718000
New York,Utilities,2007,968,420,115,83,618,90,41,749,219,2875,420,115,95,630,125,195,950,1925,196031,63,498,619,1812,2777,3595,10020,174553,17855693000,29539000,49551000,39891000,136956000,189808000,327921000,814896000,16037924000
New York,Wholesale Trade,2007,160559,98341,24372,15289,138002,14605,4228,156835,3724,173045,98415,24600,15740,138755,16545,6805,162105,10940,1951812,159757,157337,197786,515900,487263,354990,1368344,530093,114803195000,8143274000,7821235000,10610139000,26630720000,28079455000,20927294000,75788587000,36040277000
North Carolina,Accommodation and Food Services,2007,66214,24520,12213,13105,49838,13528,1523,64889,1325,91160,24530,12235,13265,50030,15780,5745,71555,19605,1698171,37085,82333,179193,298770,474581,222396,997895,691786,22544175000,960725000,963725000,2082047000,4007065000,5766176000,2807559000,12610440000,9849528000
North Carolina,Administrative and Support and Waste Management and Remediation Services,2007,50391,30035,7925,4770,42730,4284,1429,48443,1948,57080,30060,7935,4825,42820,4750,2070,49640,7440,1390529,47389,51493,63075,164738,152986,183962,512752,815547,36734580000,1477530000,1329436000,1682652000,4518824000,4053878000,4297547000,13135752000,21838040000
North Carolina,"Agriculture, Forestry, Fishing and Hunting",2007,4348,2725,930,460,4115,155,35,4305,43,4370,2725,930,460,4115,155,50,4320,50,24096,4978,5947,5866,17129,4175,763,22582,379,722311000,140757000,171051000,177693000,493540000,125925000,26417000,658112000,19224000
North Carolina,"Arts, Entertainment, and Recreation",2007,16273,9150,2465,1885,13500,2083,435,16018,255,17170,9150,2475,1890,13515,2265,620,16400,770,261926,8939,15327,25044,53289,80800,62513,200846,47115,7264437000,455110000,337241000,472610000,1256247000,1709765000,2487371000,5532496000,1234488000
North Carolina,Construction,2007,142075,89314,25885,14475,129674,10447,1229,141350,725,143585,89320,25895,14480,129695,10565,1535,141795,1790,1237480,149154,169021,192034,510934,386420,167892,1070035,145162,47796670000,4956370000,5046468000,6405252000,16412970000,14895255000,7721118000,39225755000,7804017000
North Carolina,Educational Services,2007,10656,5565,1545,1200,8310,1580,431,10321,335,11380,5565,1545,1215,8325,1635,680,10640,740,397268,6541,9228,14930,31764,63001,67723,168248,212639,13227605000,234389000,174387000,330909000,757134000,1398030000,1882936000,4144026000,8587157000
North Carolina,Finance and Insurance,2007,34709,23155,4735,2063,29953,1727,959,32639,2070,69375,23210,4895,2650,30755,4350,5275,40380,28995,889105,36677,28090,24744,92714,52150,62523,214625,650546,61793273000,1547630000,1164972000,1434748000,4207755000,3080581000,3335444000,11005306000,50494782000
North Carolina,Health Care and Social Assistance,2007,84691,35088,20084,13088,68260,11795,2747,82802,1889,108630,35150,20185,13410,68745,15620,8975,93340,15290,2582736,58983,134632,171352,367958,452882,412555,1244887,1254925,95491988000,2969278000,5437288000,6590291000,15015800000,15080874000,12834098000,43386740000,48142397000
North Carolina,Information,2007,9154,4880,1230,740,6850,901,410,8161,993,17715,4880,1235,760,6875,1280,750,8905,8810,378507,6029,4995,8494,22749,27115,26529,81207,290884,20556065000,307505000,256531000,363025000,977500000,1254290000,1315249000,3728484000,16505823000
North Carolina,Management of Companies and Enterprises,2007,5009,370,85,175,630,975,1348,2953,2056,7250,370,85,175,630,980,1435,3045,4205,396249,507,364,1010,1881,11198,37083,50324,345925,31689772000,35295000,28917000,109085000,192810000,648637000,2017364000,2857117000,28832655000
North Carolina,Manufacturing,2007,45961,15813,7480,5983,29276,8614,3385,41275,4686,50525,15820,7480,5990,29290,8840,4175,42305,8220,2401459,22759,43810,72092,150651,317091,357489,883117,1435905,94876853000,944396000,1384110000,2403753000,5031674000,10927442000,12606164000,30443340000,61015184000
North Carolina,"Mining, Quarrying, and Oil and Gas Extraction",2007,579,230,95,65,390,70,27,487,92,1005,230,95,65,390,90,55,535,470,15728,388,168,724,1555,1922,1341,6305,8892,727330000,12855000,15473000,24460000,63819000,78163000,67710000,270888000,437531000
North Carolina,Other,2007,246,235,8,2,245,1,0,246,0,246,235,8,2,245,1,0,246,0,329,216,0,0,293,0,0,329,0,4179000,3347000,701000,0,4166000,0,0,4179000,0
North Carolina,Other Services (except Public Administration),2007,104935,66175,21594,9618,97387,6128,684,104199,736,113475,66200,21750,10065,98015,8175,2415,108605,4870,770769,120703,138559,124794,389352,212056,67478,678702,70678,17205690000,2652225000,2850849000,2689294000,8208007000,4560659000,1420748000,14428295000,2425629000
North Carolina,"Professional, Scientific, and Technical Services",2007,107091,75115,14185,8053,97353,5658,1872,104883,2208,115610,75130,14255,8330,97715,6895,3285,107895,7715,1002476,99406,90928,105603,309164,174206,116058,607389,378725,59495350000,5081311000,3927551000,4901777000,13941015000,9629564000,7454108000,31205632000,27384282000
North Carolina,Real Estate and Rental and Leasing,2007,43962,34982,4168,1768,40918,1592,638,43148,814,55570,35030,4350,2070,41450,2810,3030,47290,8280,278980,45725,25666,20988,97655,48252,43889,196303,68855,10109470000,1749305000,829032000,758033000,3352503000,1746651000,1726767000,7048488000,2763395000
North Carolina,Retail Trade,2007,113008,63926,23049,12090,99065,9176,1848,110089,2919,181645,64110,23665,13835,101610,16510,7920,126040,55605,2139205,109139,145197,141410,392487,307572,138889,885525,1040928,49100049000,2582274000,3248750000,3847037000,9698039000,9771817000,4541652000,24471311000,21169460000
North Carolina,Total,2007,179773,104738,31677,19369,155784,16750,3782,176316,3457,227906,104856,32033,20380,157269,22105,10780,190154,37752,3586552,175521,207966,256723,640210,613816,464294,1718320,1868232,131960671000,5811611000,6023344000,7748343000,19583298000,19398648000,16266952000,55248898000,76711773000
North Carolina,Transportation and Warehousing,2007,25711,15540,3230,2158,20928,2145,973,24046,1665,29780,15560,3235,2255,21050,2380,1275,24705,5075,536120,22158,20303,25866,69343,63212,56384,200636,280158,19815399000,734302000,560302000,811270000,2143148000,2075533000,2007300000,6494168000,11212443000
North Carolina,Utilities,2007,734,265,125,50,440,105,85,630,104,1975,265,125,50,440,170,230,840,1135,90741,234,731,615,1848,5352,9709,17228,72671,6914416000,10876000,21591000,20845000,54509000,267017000,606195000,943800000,5922342000
North Carolina,Wholesale Trade,2007,50952,25771,7588,5715,39074,5867,2667,47608,3344,61000,25800,7755,6100,39655,7270,4380,51305,9695,868921,37786,46747,70822,160667,171614,134389,488948,349243,44773704000,1967425000,2073962000,3156546000,7279681000,8019811000,6852981000,22729276000,20734482000
North Dakota,Accommodation and Food Services,2007,8017,3205,1415,1459,6079,1495,272,7846,171,9260,3205,1420,1475,6100,1765,630,8495,765,152573,4914,9349,19859,34390,53487,32923,121655,23287,1722747000,93905000,69400000,190433000,356240000,557209000,381187000,1303930000,291061000
North Dakota,Administrative and Support and Waste Management and Remediation Services,2007,4053,2500,560,347,3407,262,95,3764,289,4450,2500,560,355,3415,295,195,3905,545,61741,3411,3026,3493,11421,7208,8553,32407,24864,1393913000,104283000,70497000,77521000,285911000,153831000,173606000,728059000,604822000
North Dakota,"Agriculture, Forestry, Fishing and Hunting",2007,665,540,70,20,630,25,0,655,10,685,540,70,30,640,25,0,665,20,2482,603,439,0,1149,849,0,1998,0,81618000,26210000,10470000,0,41498000,26678000,0,65838000,0
North Dakota,"Arts, Entertainment, and Recreation",2007,1854,1185,245,190,1620,170,54,1844,10,2035,1185,245,190,1620,255,150,2025,10,18016,972,1229,2082,4733,5568,1604,17996,0,248469000,37026000,15777000,23239000,87624000,59685000,71302000,247874000,0
North Dakota,Construction,2007,12071,8050,1970,1129,11149,739,108,11996,75,12185,8050,1970,1135,11155,765,145,12065,120,83082,10735,12284,14584,39741,24652,6876,78517,2342,3922840000,444633000,454685000,620574000,1546652000,1248567000,391374000,3631690000,159425000
North Dakota,Educational Services,2007,715,295,75,95,465,160,40,665,50,745,295,75,105,475,165,40,680,65,21674,402,418,1244,2158,6638,5197,14428,0,389264000,9161000,6124000,13623000,32942000,121047000,109314000,266921000,40032000
North Dakota,Finance and Insurance,2007,5226,3505,485,345,4335,370,163,4868,358,8355,3510,525,550,4585,1115,990,6690,1665,79862,5296,2874,3935,12434,11075,10912,38065,27242,3285205000,170957000,92935000,161338000,441458000,456768000,503351000,1553069000,1192780000
North Dakota,Health Care and Social Assistance,2007,7254,3323,1425,960,5708,773,478,6959,295,8755,3330,1425,975,5730,1090,1045,7865,890,252629,4345,8386,11021,25449,30581,59450,123187,108742,8403060000,168526000,285791000,328050000,806906000,710020000,1242848000,3066186000,4144939000
North Dakota,Information,2007,1181,305,280,180,765,185,72,1022,159,1825,310,280,205,795,270,125,1190,635,33411,236,1379,1285,4053,5968,5156,17037,10170,1670967000,7986000,33503000,29977000,92125000,257224000,200678000,604760000,552611000
North Dakota,Management of Companies and Enterprises,2007,432,20,0,20,40,140,125,305,127,475,20,0,20,40,140,140,320,155,35496,0,0,120,0,1262,2025,3471,32025,1097361000,0,0,8816000,52760000,96491000,92425000,243933000,853428000
North Dakota,Manufacturing,2007,3545,1320,620,510,2450,570,234,3254,291,3790,1320,620,510,2450,620,295,3365,425,97641,897,2635,3906,9918,12788,10484,45903,27059,3745805000,48318000,69527000,141428000,304688000,479345000,355721000,1609780000,1121669000
North Dakota,"Mining, Quarrying, and Oil and Gas Extraction",2007,1002,395,105,135,635,135,35,805,197,1080,395,105,140,640,135,50,825,255,31400,544,616,1416,2705,4895,448,9901,15539,1893551000,36482000,24914000,73473000,141746000,337152000,27572000,597062000,1053298000
North Dakota,Other,2007,32,32,0,0,32,0,0,32,0,32,32,0,0,32,0,0,32,0,0,0,0,0,0,0,0,0,0,338000,338000,0,0,338000,0,0,338000,0
North Dakota,Other Services (except Public Administration),2007,11696,7637,2315,917,10869,586,62,11517,179,12190,7640,2340,990,10970,780,75,11825,365,67186,12047,14030,11015,38221,17071,377,59514,2947,1305337000,250236000,278894000,194064000,745373000,306870000,10484000,1115448000,108712000
North Dakota,"Professional, Scientific, and Technical Services",2007,7052,4775,950,590,6315,403,138,6856,196,7560,4775,950,600,6325,600,220,7145,415,60848,5761,4564,6839,19601,10434,3994,37098,14368,2484439000,251813000,199659000,321763000,795314000,490588000,268257000,1654938000,499978000
North Dakota,Real Estate and Rental and Leasing,2007,3491,2585,345,170,3100,160,98,3358,133,3875,2585,355,180,3120,220,260,3600,275,17432,297,2054,1401,6510,2810,1853,15820,78,444206000,86322000,47452000,41459000,187513000,71573000,76863000,388661000,8087000
North Dakota,Retail Trade,2007,12909,5555,2929,1727,10211,1422,400,12033,876,16880,5565,3025,1870,10460,2085,1060,13605,3275,206510,7815,17981,19897,49447,38106,23484,120673,59504,4415052000,208753000,357671000,467422000,1069106000,949816000,613804000,2913547000,1187130000
North Dakota,Total,2007,17881,10091,3049,1964,15104,1665,437,17206,675,21518,10100,3094,2109,15303,2426,1254,18983,2535,292879,16606,20102,26212,62920,60026,51378,174324,118555,9111928000,472382000,505636000,712994000,1691012000,1730343000,1485143000,4906498000,4205430000
North Dakota,Transportation and Warehousing,2007,4767,3100,559,324,3983,305,166,4454,313,5300,3105,560,325,3990,345,280,4615,685,47254,3137,3289,3911,11530,9553,8070,31316,13746,1630794000,115705000,98245000,124418000,350011000,321628000,302915000,1020119000,564312000
North Dakota,Utilities,2007,186,30,20,10,60,80,12,152,34,570,30,20,15,65,120,40,225,345,2578,0,0,0,142,2855,0,5080,0,172480000,1060000,0,0,5480000,176885000,0,332721000,0
North Dakota,Wholesale Trade,2007,5565,1980,895,756,3631,918,342,4891,674,7415,1980,925,875,3780,1340,530,5650,1765,82208,2941,4943,7537,17340,21756,6560,51250,22845,3478413000,114129000,196575000,331102000,703071000,897652000,274221000,2084879000,1089639000
Ohio,Accommodation and Food Services,2007,86478,34611,16220,15981,66812,16124,2061,84997,1481,119755,34645,16235,16250,67130,19530,9170,95830,23925,2184720,54159,108405,218176,381776,590541,299383,1274910,906576,26320130000,1086713000,1076889000,2155856000,4322694000,6688068000,3314089000,14344299000,11921856000
Ohio,Administrative and Support and Waste Management and Remediation Services,2007,59774,34685,8995,6112,49792,5651,2068,57511,2263,68795,34695,9015,6185,49895,6125,2880,58900,9895,1715280,46739,58251,79959,188317,217219,268249,684661,1020895,46444302000,1965694000,1594179000,2274920000,5851369000,6197125000,6017804000,18229359000,27811386000
Ohio,"Agriculture, Forestry, Fishing and Hunting",2007,1370,1010,200,65,1275,50,20,1345,25,1370,1010,200,65,1275,50,20,1345,25,6192,1493,1184,810,3554,843,0,4840,686,161436000,31051000,32274000,18602000,87194000,27682000,0,140734000,23300000
Ohio,"Arts, Entertainment, and Recreation",2007,19044,10350,3265,2335,15950,2319,481,18750,294,20295,10350,3275,2360,15985,2495,845,19325,970,288918,13323,20541,30864,66234,89755,70911,228968,43943,8820432000,518876000,411492000,524198000,1484431000,1664597000,4046769000,7231935000,864234000
Ohio,Construction,2007,122621,78944,21180,11884,112008,8783,1181,121972,649,123965,78945,21180,11900,112025,8995,1505,122525,1440,1066355,123257,138500,158580,423555,322355,156991,907225,136166,50497050000,4637960000,4947160000,6646670000,16231790000,15641315000,8656149000,40726670000,8790674000
Ohio,Educational Services,2007,13140,5280,2110,1910,9300,2809,615,12724,416,14550,5280,2125,1940,9345,3115,870,13330,1220,537989,8074,13535,24936,48245,115873,88408,258070,276705,13383379000,217354000,248600000,438050000,936558000,2808088000,2558658000,6358325000,6916510000
Ohio,Finance and Insurance,2007,48372,31245,7573,3124,41942,3104,986,46032,2340,96390,31280,7870,3955,43105,7215,4580,54900,41490,1280524,54886,47353,37972,141302,106822,87217,344272,930918,72860720000,2005248000,1918863000,1848132000,5828270000,5384820000,3605752000,15343780000,57538178000
Ohio,Health Care and Social Assistance,2007,105721,43450,25631,15617,84698,13306,5125,103129,2592,139715,43520,26015,16490,86025,19345,15635,121005,18710,3772363,85385,170621,205695,464827,522837,773721,1765454,1985344,139097502000,3929775000,6469282000,8532620000,18938578000,18809845000,21204487000,59065590000,79898272000
Ohio,Information,2007,9795,4316,1440,1125,6881,1372,420,8673,1122,21245,4320,1455,1150,6925,1560,750,9235,12010,463535,5790,7396,13413,27058,45574,36610,119921,323816,25118345000,293649000,326138000,487046000,1148305000,2099837000,1720464000,5317791000,18493239000
Ohio,Management of Companies and Enterprises,2007,7077,455,155,260,870,1316,2074,4260,2817,11060,455,160,260,875,1330,2185,4390,6670,774700,0,755,1462,2855,14969,61582,79545,694730,61265510000,1846000,36555000,80789000,177902000,763615000,3727838000,4673510000,56592000000
Ohio,Manufacturing,2007,74928,22660,13035,11525,47220,16174,5604,68998,5930,80870,22660,13050,11605,47315,16935,7105,71355,9515,3632775,38978,81295,146753,277634,638023,662864,1642475,1811372,171143466000,1638799000,2680671000,5353327000,9955022000,25679128000,28701219000,66836594000,94086031000
Ohio,"Mining, Quarrying, and Oil and Gas Extraction",2007,3281,1635,540,450,2625,350,153,3128,153,3910,1635,540,455,2630,400,310,3340,570,50294,2782,3317,5736,12205,10553,10711,36193,13007,2357315000,104706000,135309000,231734000,480397000,431336000,553491000,1581072000,728670000
Ohio,Other,2007,192,174,12,2,188,4,0,192,0,192,174,12,2,188,4,0,192,0,368,0,0,0,245,123,0,368,0,6355000,3228000,760000,0,4043000,2312000,0,6355000,0
Ohio,Other Services (except Public Administration),2007,132086,75928,30249,14595,120772,9124,1140,131036,1050,148980,76010,30540,15250,121800,11965,3300,137065,11915,1123845,150826,197669,187926,538786,305080,99690,955505,134384,24886064000,3108459000,3767283000,3904738000,10823520000,6581755000,2670031000,20341307000,3869129000
Ohio,"Professional, Scientific, and Technical Services",2007,117416,77081,17995,10210,105286,7428,2250,114964,2452,127925,77120,18015,10505,105640,8890,3455,117985,9940,1225322,120642,116534,134279,374124,251279,173387,808855,394154,68747110000,5137310000,4870442000,6423743000,16452400000,14044732000,10441671000,41152100000,26937135000
Ohio,Real Estate and Rental and Leasing,2007,38850,27320,5180,2633,35133,2047,778,37958,892,54225,27385,5290,3245,35920,3205,3565,42690,11535,335473,41462,31383,33033,109553,61054,45595,221175,97011,11646920000,1267482000,934427000,1100053000,3330085000,2061275000,1628365000,7279388000,3997070000
Ohio,Retail Trade,2007,119232,62649,24962,14603,102214,11620,2287,116121,3111,199160,62845,25580,16405,104830,17920,9800,132550,66610,2868483,92708,154287,177010,425119,410578,199002,1086349,1660028,62477919000,2309059000,3184164000,4183588000,9680746000,11548543000,5919002000,27548542000,33653854000
Ohio,Total,2007,205494,111691,38707,24501,174899,21803,5002,201704,3790,270299,111842,39165,25926,176933,28860,14821,220614,49685,4782141,194908,255940,327500,778348,828408,695630,2302386,2479755,180992383000,6369259000,7373945000,10139214000,23882418000,27857652000,24735414000,76475484000,104516899000
Ohio,Transportation and Warehousing,2007,31663,17230,4390,3306,24926,3264,1229,29419,2244,38270,17245,4410,3385,25040,3715,1835,30590,7680,871826,24286,27059,42340,95626,106736,84633,295971,561773,33784873000,864319000,867375000,1378292000,3130166000,3739996000,3141157000,10248598000,23183680000
Ohio,Utilities,2007,861,310,100,80,490,205,60,755,106,3075,310,100,85,495,285,110,890,2185,112758,554,425,848,1834,6567,2078,12714,89604,9169366000,24882000,16766000,48630000,101472000,347578000,118672000,660685000,7892100000
Ohio,Wholesale Trade,2007,62665,28565,10548,7637,46750,8714,3337,58801,3864,76980,28630,10710,8130,47470,11205,6185,64860,12120,1153862,44456,66413,94553,210667,275756,195427,705622,395293,58192899000,2269299000,2982772000,4451080000,9819750000,13184126000,9852645000,33248315000,22255019000
Oklahoma,Accommodation and Food Services,2007,24821,9770,4365,4242,18377,4981,759,24117,704,34590,9785,4365,4280,18430,5905,2750,27085,7505,645813,15695,28681,57791,101797,183022,100387,387769,255313,7280754000,298965000,268806000,573232000,1146852000,1926126000,1063053000,4165004000,3084450000
Oklahoma,Administrative and Support and Waste Management and Remediation Services,2007,19430,11815,3000,1620,16435,1376,611,18422,1008,21575,11815,3010,1640,16465,1545,935,18945,2630,488159,16481,18376,19825,58070,49665,69401,184635,291006,12161944000,505375000,462524000,490869000,1519258000,1233273000,1497653000,4428636000,7378587000
Oklahoma,"Agriculture, Forestry, Fishing and Hunting",2007,826,580,135,70,785,10,6,801,25,835,580,135,70,785,10,15,810,25,4175,249,834,613,2326,0,0,3728,0,119746000,20202000,20084000,27599000,70008000,0,0,103930000,0
Oklahoma,"Arts, Entertainment, and Recreation",2007,5150,2885,840,515,4240,638,175,5053,97,5450,2890,840,515,4245,705,255,5205,245,119554,3389,5091,6113,15891,23844,27363,71973,1103,2389589000,106782000,94737000,81243000,294125000,503831000,607017000,1536242000,196197000
Oklahoma,Construction,2007,43243,27190,7775,4545,39510,3120,353,42983,260,43500,27190,7775,4545,39510,3145,380,43035,465,356444,43770,50369,60126,156405,113338,42321,317276,36133,13315049000,1334807000,1397810000,1899450000,4636355000,4211207000,1833855000,10901641000,2278791000
Oklahoma,Educational Services,2007,3300,1565,500,465,2530,470,160,3160,140,3535,1565,500,470,2535,505,235,3275,260,92208,1558,3313,5420,11742,16019,18694,48961,42321,2113437000,50569000,63840000,89165000,213178000,405839000,431936000,1117022000,959695000
Oklahoma,Finance and Insurance,2007,20655,14200,2395,1173,17768,1338,467,19573,1082,33795,14210,2530,1585,18325,3500,2505,24330,9465,313396,23593,14553,14732,53007,50405,44001,153965,144519,14012960000,737859000,531572000,636477000,1951158000,2047639000,1802344000,6083730000,7435821000
Oklahoma,Health Care and Social Assistance,2007,41002,20248,9425,4645,34318,4335,1381,40034,968,51510,20280,9440,4720,34440,6015,5095,45550,5960,996525,36320,61216,59654,158868,183298,190416,545670,433510,34066933000,1931481000,2312069000,2093162000,6349933000,5157406000,5600794000,17272584000,16266252000
Oklahoma,Information,2007,4341,2000,670,494,3164,489,161,3814,527,8080,2000,675,530,3205,585,410,4200,3880,155501,1608,3418,5591,11937,12367,2854,34125,102752,7237080000,110080000,137442000,194000000,478379000,550867000,113963000,1534948000,4901269000
Oklahoma,Management of Companies and Enterprises,2007,2187,135,90,90,315,430,608,1353,834,2750,135,90,90,315,430,660,1405,1345,134731,0,9,372,997,4390,15048,20553,114706,12605534000,16015000,370000,30521000,70391000,226635000,910288000,1218507000,11432046000
Oklahoma,Manufacturing,2007,18549,6855,3220,2759,12834,3089,998,16921,1628,19805,6855,3225,2760,12840,3265,1225,17330,2475,642941,7460,16705,30294,64515,102352,80913,282479,315908,27099115000,384469000,534094000,993267000,2090270000,3826253000,3286783000,10584464000,15036534000
Oklahoma,"Mining, Quarrying, and Oil and Gas Extraction",2007,12047,7295,1770,1004,10069,1119,366,11554,493,13110,7300,1775,1005,10080,1170,505,11755,1355,244939,6966,11905,13189,36907,38167,37176,112759,131825,14983557000,479852000,530998000,600413000,1615825000,1842047000,1830610000,5321767000,9667405000
Oklahoma,Other,2007,82,77,3,2,82,0,0,82,0,82,77,3,2,82,0,0,82,0,109,0,0,0,109,0,0,109,0,1316000,1163000,0,0,1316000,0,0,1316000,0
Oklahoma,Other Services (except Public Administration),2007,42707,26546,8555,4020,39121,2731,421,42273,434,45325,26585,8620,4170,39375,3435,885,43695,1630,320095,47045,55461,51074,155884,95385,32731,293831,18091,6547682000,942058000,1038948000,1043217000,3049523000,1799014000,708738000,5825817000,572115000
Oklahoma,"Professional, Scientific, and Technical Services",2007,43851,31145,6285,3020,40450,2036,531,43017,834,46510,31155,6310,3085,40550,2450,805,43805,2705,352686,45480,39868,37210,124540,64907,41980,246044,101635,16118596000,1823382000,1407431000,1569310000,4954431000,3489552000,2480911000,11291754000,4675352000
Oklahoma,Real Estate and Rental and Leasing,2007,16263,12440,1668,838,14946,651,181,15778,485,19695,12500,1750,975,15225,1115,325,16665,3030,115437,14695,9851,9420,37918,18750,5713,65387,42997,4091911000,537757000,292296000,276929000,1134263000,621009000,156323000,2024350000,1834983000
Oklahoma,Retail Trade,2007,45293,23921,9838,5131,38890,3787,797,43474,1819,67230,23990,10080,5615,39685,5765,2890,48340,18890,789098,38901,61292,64152,166823,118555,52234,359232,391095,16980788000,889924000,1241418000,1428415000,3578167000,3345287000,1482181000,8608930000,8173598000
Oklahoma,Total,2007,73564,42910,13020,7525,63455,6585,1583,71623,1941,91235,42978,13171,7900,64049,8808,4486,77343,13892,1307858,73102,85612,100335,259049,245614,193625,698288,609570,44607658000,2262547000,2329359000,2819393000,7411299000,7378136000,6395075000,21184510000,23423148000
Oklahoma,Transportation and Warehousing,2007,11838,7070,1530,872,9472,904,408,10784,1054,13705,7070,1535,875,9480,990,600,11070,2635,198614,10006,9622,9944,30809,26471,20998,82364,93758,7701899000,323559000,288543000,329667000,972015000,988260000,833333000,2951468000,4053681000
Oklahoma,Utilities,2007,767,310,105,30,445,140,75,660,107,1680,310,105,30,445,185,195,825,855,33987,342,610,129,1453,6797,5107,14870,165,2167836000,18305000,18056000,3129000,63690000,352831000,307818000,833135000,7011000
Oklahoma,Wholesale Trade,2007,19077,8260,3012,2333,13605,2645,1101,17351,1726,23085,8290,3080,2530,13900,3320,1760,18980,4105,291133,12598,17187,27283,61926,66528,44862,196195,76977,13588237000,600321000,741439000,1139070000,2587545000,2847206000,2067804000,8343983000,4437125000
Oregon,Accommodation and Food Services,2007,41317,15005,9020,9089,33114,6741,793,40648,669,51785,15020,9055,9320,33395,8870,3585,45850,5935,757925,21966,59129,121475,203615,226053,105528,544372,208597,11231625000,529494000,689467000,1528369000,2730383000,3169441000,1482893000,7453136000,3697639000
Oregon,Administrative and Support and Waste Management and Remediation Services,2007,24357,14730,3820,2279,20829,1975,641,23445,912,26855,14730,3830,2340,20900,2145,1030,24075,2780,465213,21875,22716,29519,77339,70493,69436,221686,220069,12647075000,631108000,559345000,796233000,2010933000,2026296000,1502755000,5703075000,6304845000
Oregon,"Agriculture, Forestry, Fishing and Hunting",2007,7124,4760,805,725,6290,660,115,7065,59,7250,4760,805,725,6290,715,140,7145,105,64261,5967,5231,9671,21804,23627,9712,60580,2777,2212706000,259715000,172767000,371522000,817446000,822367000,216151000,1997303000,180443000
Oregon,"Arts, Entertainment, and Recreation",2007,7681,4310,1240,915,6465,921,173,7559,122,8100,4310,1240,930,6480,1045,240,7765,335,118240,4677,7415,11264,25766,33197,15608,85916,24246,2465851000,189340000,132976000,195180000,537381000,556304000,478258000,1746268000,404431000
Oregon,Construction,2007,74552,50870,12205,6430,69505,4230,440,74175,377,75025,50870,12205,6430,69505,4375,510,74390,635,503765,76600,78677,85505,243573,157363,40886,448001,45667,22266065000,2672233000,2471045000,3166093000,8315295000,7490117000,2456924000,18567098000,3217486000
Oregon,Educational Services,2007,5958,3010,980,735,4725,810,260,5795,163,6485,3010,980,760,4750,930,565,6245,240,187881,3557,5726,9528,19376,28583,37844,87956,97720,4569685000,136904000,117300000,189738000,451919000,580508000,883243000,1949410000,2581113000
Oregon,Finance and Insurance,2007,19724,13165,2575,882,16622,1017,660,18299,1425,33750,13185,2665,1080,16930,2145,2625,21700,12050,323046,21084,15431,10123,47237,31243,37024,121660,194775,17710270000,757314000,680408000,593729000,2066352000,1940987000,1937795000,6304718000,11315773000
Oregon,Health Care and Social Assistance,2007,45420,24000,10175,5177,39352,3858,1279,44489,931,56410,24000,10220,5415,39635,6080,4825,50540,5870,961758,40312,67169,67475,178759,154096,151802,494400,452377,39848619000,1784000000,2448714000,2617872000,6869242000,5564752000,5153632000,17890785000,21688883000
Oregon,Information,2007,6556,3420,1045,642,5107,611,263,5981,575,10100,3425,1055,690,5170,690,595,6455,3645,170619,2835,6064,6893,18661,20028,19268,66143,98103,10233580000,210877000,244360000,287072000,792947000,1078116000,1058118000,3291328000,6579529000
Oregon,Management of Companies and Enterprises,2007,2522,205,40,95,340,585,731,1656,866,3125,205,40,95,340,585,765,1690,1435,213780,10,0,530,991,5965,20948,28025,184239,18462615000,27773000,18682000,26525000,74123000,318256000,1213900000,1622500000,16717456000
Oregon,Manufacturing,2007,27145,10870,4870,3750,19490,4484,1502,25476,1669,28500,10870,4875,3750,19495,4650,1825,25970,2530,861225,15763,28536,44350,95773,158153,135187,442105,356170,39691401000,614448000,879087000,1537807000,3256703000,5964503000,5907260000,16936198000,19736745000
Oregon,"Mining, Quarrying, and Oil and Gas Extraction",2007,625,255,90,110,455,110,15,580,45,755,255,90,110,455,115,15,585,170,10798,66,534,1104,2080,2588,62,5410,1930,467865000,15928000,20009000,45540000,79383000,100947000,3987000,222017000,174951000
Oregon,Other,2007,131,125,3,2,130,1,0,131,0,131,125,3,2,130,1,0,131,0,164,101,0,0,137,0,0,164,0,1986000,1804000,146000,0,1963000,0,0,1986000,0
Oregon,Other Services (except Public Administration),2007,43442,26450,9307,4385,40142,2470,383,42995,447,47820,26470,9340,4635,40445,3465,1875,45785,2035,320843,47553,58846,56084,165194,81808,29092,283975,20082,7959328000,1179436000,1288117000,1260096000,3747262000,1904246000,865591000,6749770000,937831000
Oregon,"Professional, Scientific, and Technical Services",2007,55771,39610,7260,3980,50850,2768,959,54577,1194,58485,39630,7275,4100,51005,3080,1315,55400,3085,405262,52282,45916,50946,155602,81304,45750,294704,73166,21609240000,2437960000,1862709000,2382989000,6717230000,4936021000,2833388000,15026723000,5337966000
Oregon,Real Estate and Rental and Leasing,2007,27013,21148,2722,1242,25112,1002,391,26505,508,31810,21185,2785,1480,25450,1565,1350,28365,3445,157608,28322,16777,14565,63032,32357,25855,123717,31537,4926421000,898340000,461218000,434143000,1824713000,1014776000,674499000,3601222000,1134666000
Oregon,Retail Trade,2007,51614,26152,11004,6347,43503,4870,1256,49629,1985,73495,26210,11230,7060,44500,7585,4610,56695,16800,980887,37196,65530,74642,187986,156066,93157,460271,469704,24222364000,1027080000,1358079000,1784310000,4196619000,4654977000,3099816000,12297889000,10962080000
Oregon,Total,2007,94264,55820,16503,10067,82390,7945,1867,92202,2062,113389,55867,16646,10580,83093,10671,5762,99526,13863,1477553,91378,108185,134152,333715,289221,217212,840148,637405,56033374000,2960986000,3014390000,3956431000,9931807000,9930871000,8031006000,27893684000,28139690000
Oregon,Transportation and Warehousing,2007,14345,8445,1872,1240,11557,1270,480,13307,1038,16330,8450,1890,1280,11620,1400,635,13655,2675,252031,7316,11982,13470,38908,37877,25165,108700,124131,9584795000,391860000,390951000,455084000,1290657000,1413943000,994241000,3880475000,5179707000
Oregon,Utilities,2007,632,360,65,35,460,85,15,560,72,1375,360,65,40,465,140,20,625,750,34595,0,0,349,205,3851,0,6442,12818,2937737000,14393000,3886000,23514000,51614000,278061000,0,532950000,1049554000
Oregon,Wholesale Trade,2007,24556,11740,3534,2578,17852,3073,1448,22373,2183,28835,11765,3570,2650,17985,3770,2285,24040,4795,388605,17171,20270,27549,69398,87413,67796,241849,126167,19869565000,843636000,946277000,1471715000,3354884000,4181291000,3184124000,11298575000,7443492000
Pennsylvania,Accommodation and Food Services,2007,109002,51060,21320,16977,89357,16391,2028,107776,1226,134075,51095,21400,17205,89700,18320,6030,114050,20025,2100025,87382,141824,228892,458782,598717,263485,1323675,766587,28226955000,1573595000,1621980000,2476720000,5667065000,7289368000,3556193000,16539120000,11636271000
Pennsylvania,Administrative and Support and Waste Management and Remediation Services,2007,63907,38150,9380,6099,53629,5787,2136,61552,2355,72625,38150,9380,6200,53730,6405,3535,63670,8955,1475586,50708,60709,79745,196783,223967,287445,714046,739840,41571061000,2401019000,1832664000,2487316000,6744055000,6872663000,7153816000,20916396000,20108720000
Pennsylvania,"Agriculture, Forestry, Fishing and Hunting",2007,2680,2120,300,130,2550,80,35,2665,15,2685,2120,300,130,2550,80,35,2665,20,14164,3368,1798,1348,6833,1893,2649,13199,965,378213000,77181000,47280000,36287000,169864000,56368000,62920000,346838000,31375000
Pennsylvania,"Arts, Entertainment, and Recreation",2007,22358,12465,3550,2525,18540,2897,623,22060,298,23410,12470,3575,2555,18600,3085,825,22510,900,386167,16674,22574,33467,74520,115748,81572,275877,98252,10799660000,604935000,464549000,619388000,1697143000,2221511000,2935770000,6937576000,3632460000
Pennsylvania,Construction,2007,147502,96460,25100,13525,135085,10299,1467,146851,651,148765,96460,25100,13540,135100,10490,1775,147365,1400,1294160,156508,163435,181195,501350,381940,221007,1108140,158716,64358530000,5761660000,5906705000,7897045000,19565410000,20396285000,12714400000,52864390000,9930680000
Pennsylvania,Educational Services,2007,15195,6080,2270,1895,10245,3454,825,14524,671,17240,6080,2270,1940,10290,3815,1595,15700,1540,1165630,8500,14456,26064,51272,146752,130077,333425,830437,37572200000,348525000,313022000,538317000,1208355000,3775511000,4040329000,9113250000,28422534000
Pennsylvania,Finance and Insurance,2007,51408,32009,8349,3704,44062,3178,1486,48726,2682,96190,32040,8615,4345,45000,6745,7010,58755,37435,1405172,53315,51635,46233,156198,104863,117466,389735,1006752,92868416000,2402182000,2753052000,2857570000,8241484000,7232290000,6975026000,23183606000,67390743000
Pennsylvania,Health Care and Social Assistance,2007,128486,57643,28727,18257,104627,15063,5216,124906,3580,176215,57850,29015,19450,106315,22900,19095,148310,27905,4406737,114806,188810,243769,548881,555641,806386,1914533,2489254,167486586000,4493213000,6800509000,9737552000,21046259000,21265185000,23881258000,66335140000,101114519000
Pennsylvania,Information,2007,14016,6495,2225,1585,10305,1760,634,12699,1317,26830,6495,2245,1625,10365,2125,1070,13560,13270,537106,7859,14173,20076,45090,59050,42101,151639,347102,35620311000,470850000,481741000,722818000,1732801000,2765628000,2083860000,7040897000,24021158000
Pennsylvania,Management of Companies and Enterprises,2007,6874,410,100,185,695,1196,2023,3914,2960,10455,410,100,185,695,1230,2180,4105,6350,702115,532,51,1215,2204,15052,66942,84415,617917,68731408000,126705000,33057000,72420000,238210000,928479000,4281393000,5464150000,63283326000
Pennsylvania,Manufacturing,2007,72168,22630,12838,11029,46497,15501,5034,67032,5136,76905,22630,12845,11050,46525,16150,6215,68890,8015,3097200,35605,79173,139126,269712,594603,572483,1511307,1417551,140461310000,1449205000,2580487000,5327310000,9720746000,24140700000,24676652000,61330752000,71490544000
Pennsylvania,"Mining, Quarrying, and Oil and Gas Extraction",2007,3896,1785,640,520,2945,542,210,3697,199,4690,1785,640,520,2945,640,400,3985,705,104908,2054,3594,6568,13704,20699,19544,55322,44186,5578037000,135151000,148555000,265324000,562816000,970904000,989111000,2561300000,2684557000
Pennsylvania,Other,2007,183,171,9,2,182,1,0,183,0,183,171,9,2,182,1,0,183,0,240,144,53,0,222,0,0,240,0,2926000,2289000,475000,0,2898000,0,0,2926000,0
Pennsylvania,Other Services (except Public Administration),2007,167112,104003,35531,15881,155415,9430,1273,166118,994,179745,104040,35770,16510,156320,11565,3070,170955,8790,1247811,202462,228304,206748,638817,326678,123411,1104024,112148,28653154000,4144427000,4444727000,4393996000,12991922000,7543007000,3637495000,24422725000,3469246000
Pennsylvania,"Professional, Scientific, and Technical Services",2007,141062,93570,19841,12185,125596,9866,2660,138122,2940,152085,93600,19930,12560,126090,12135,3940,142165,9920,1600001,145187,128308,156887,434731,333502,229186,1010036,569602,101515965000,7311115000,6450470000,8759237000,22549985000,21431671000,15610546000,59957255000,40962970000
Pennsylvania,Real Estate and Rental and Leasing,2007,37368,25030,5682,2691,33403,2143,827,36373,995,49220,25060,5925,3120,34105,3255,2560,39920,9300,352945,39515,35898,34267,111338,65382,52003,235662,93015,13726340000,1433396000,1185572000,1211180000,3843238000,2852676000,2328575000,9275142000,3935651000
Pennsylvania,Retail Trade,2007,145220,76993,30168,17312,124473,14310,3026,141809,3411,231640,77160,30920,19260,127340,21010,10565,158915,72725,3255872,121617,173483,203339,506418,503307,285475,1331850,1675297,73238837000,3199059000,3938277000,5109593000,12216712000,14936801000,7583238000,35421510000,36393237000
Pennsylvania,Total,2007,240573,135605,44371,27112,207088,24080,5462,236630,3943,305345,135760,44865,28509,209134,31070,15514,255718,49627,5195818,238539,291720,361852,892111,907388,760768,2560267,2635551,208045992000,8010452000,8813546000,11965523000,28789521000,32999187000,28705795000,90494503000,117551489000
Pennsylvania,Transportation and Warehousing,2007,34375,18534,4610,3620,26764,4116,1351,32231,2144,40515,18535,4615,3690,26840,4650,1835,33325,7190,950892,26762,29466,45130,103997,142382,115065,372269,569838,33983666000,876704000,870062000,1348864000,3144892000,4392428000,3518712000,11338154000,21722092000
Pennsylvania,Utilities,2007,1014,355,147,85,587,139,53,779,235,3145,355,150,90,595,200,110,905,2240,147548,552,577,540,2303,5082,1489,11035,131114,14301222000,18779000,36566000,31888000,96788000,413005000,115737000,759285000,13217885000
Pennsylvania,Wholesale Trade,2007,67073,31557,11360,8189,51106,8745,3318,63169,3904,79375,31610,11485,8560,51655,10545,5725,67925,11450,1184041,50508,70381,103016,233600,286368,206887,745177,384972,64064155000,2782609000,3447164000,5036593000,11389120000,14221214000,10317924000,36623530000,22919391000
Rhode Island,Accommodation and Food Services,2007,12835,5634,2240,2297,10171,2085,231,12487,348,14795,5640,2245,2330,10215,2280,600,13095,1700,221656,7813,14522,31673,54223,72397,27551,155649,65791,3300633000,251414000,192968000,398849000,846368000,1064668000,435633000,2367971000,926551000
Rhode Island,Administrative and Support and Waste Management and Remediation Services,2007,8269,5475,1015,535,7025,595,203,7823,446,8605,5475,1030,535,7040,605,235,7880,725,113651,4677,5533,5626,18384,19649,21786,65930,40526,3140317000,333811000,180455000,219805000,784923000,593187000,403645000,1925194000,985964000
Rhode Island,"Agriculture, Forestry, Fishing and Hunting",2007,225,185,15,20,220,5,0,225,0,225,185,15,20,220,5,0,225,0,584,46,0,0,394,0,0,584,0,24288000,6159000,813000,2092000,17708000,0,0,24288000,0
Rhode Island,"Arts, Entertainment, and Recreation",2007,2589,1395,485,302,2182,292,55,2529,60,2710,1395,485,310,2190,300,120,2610,100,36076,1383,2521,3521,8122,9493,2177,23532,1109,809167000,91068000,89235000,114309000,302401000,222941000,46845000,645122000,74651000
Rhode Island,Construction,2007,18199,13475,2495,1275,17245,800,95,18140,59,18215,13475,2495,1275,17245,805,95,18145,70,105772,19108,15644,15668,52393,24374,9092,95020,242,5495960000,801684000,632847000,766079000,2253147000,1385159000,592663000,4770690000,47106000
Rhode Island,Educational Services,2007,1918,1010,205,140,1355,365,88,1808,110,2035,1010,210,140,1360,390,110,1860,175,119465,302,1268,1647,4457,14313,9415,29568,84096,3803365000,31865000,25317000,36438000,105088000,400151000,333978000,879396000,2719668000
Rhode Island,Finance and Insurance,2007,5369,2865,700,475,4040,396,218,4654,715,8050,2865,705,500,4070,490,740,5300,2750,111748,4498,4074,5831,14840,7632,15462,42155,51631,6662769000,223366000,177078000,308186000,742488000,462521000,843342000,2175744000,3521022000
Rhode Island,Health Care and Social Assistance,2007,12713,5130,2950,1800,9880,1554,799,12233,480,16300,5135,2960,1875,9970,2225,2670,14865,1435,395378,10002,19067,22665,52189,61570,107939,224640,162370,14765209000,435842000,746176000,891902000,2100120000,2273033000,3584404000,8039679000,6467650000
Rhode Island,Information,2007,1317,575,200,140,915,135,75,1125,192,2025,575,200,140,915,140,105,1160,865,28231,331,840,545,2284,2007,4622,14777,9287,1362268000,33800000,35565000,32767000,116431000,106308000,178334000,646885000,519341000
Rhode Island,Management of Companies and Enterprises,2007,563,35,5,25,65,75,155,295,268,670,35,5,25,65,75,170,310,360,49884,74,0,21,235,775,6635,7709,42175,5169978000,3588000,0,5750000,10263000,48474000,390625000,451883000,4718095000
Rhode Island,Manufacturing,2007,8884,3340,1630,1329,6299,1707,454,8460,424,9035,3340,1630,1335,6305,1755,505,8565,470,214651,4485,8371,14184,29352,53423,38533,153928,37469,9386071000,185819000,282037000,485423000,1070635000,2189843000,1502042000,5913047000,2196507000
Rhode Island,"Mining, Quarrying, and Oil and Gas Extraction",2007,120,45,35,10,90,20,0,110,10,125,45,35,10,90,20,0,110,15,1277,0,148,0,393,584,0,1054,0,58587000,2201000,9474000,0,19882000,23236000,0,46337000,0
Rhode Island,Other,2007,24,22,1,1,24,0,0,24,0,24,22,1,1,24,0,0,24,0,45,28,0,0,45,0,0,45,0,698000,663000,0,0,698000,0,0,698000,0
Rhode Island,Other Services (except Public Administration),2007,14269,9105,2870,1255,13230,744,100,14074,195,14935,9110,2890,1265,13265,945,125,14335,600,96665,16645,17416,14776,50270,23107,268,82265,7909,2459793000,433149000,429615000,400788000,1289248000,646456000,10693000,2132897000,202398000
Rhode Island,"Professional, Scientific, and Technical Services",2007,15358,10490,2310,1070,13870,823,280,14973,385,16005,10490,2310,1075,13875,885,300,15060,945,114292,12077,13095,11642,42056,23571,13264,85970,15290,5649042000,716356000,672457000,646284000,2079652000,1432208000,728807000,4444597000,969989000
Rhode Island,Real Estate and Rental and Leasing,2007,5087,3625,575,270,4470,263,139,4872,215,6095,3625,590,350,4565,310,385,5260,835,32265,5200,3091,2628,11528,5899,3136,24277,5029,1189758000,199038000,104866000,120114000,439962000,230261000,89384000,853867000,252539000
Rhode Island,Retail Trade,2007,16135,9055,2983,1544,13582,1061,289,14932,1203,20840,9070,3100,1630,13800,1185,640,15625,5215,253554,10853,16857,15950,47440,25100,12918,92421,88696,6623810000,375982000,421981000,417002000,1306824000,950212000,440075000,2889460000,1950816000
Rhode Island,Total,2007,26417,15354,4442,2686,22482,2353,623,25458,959,30359,15362,4486,2766,22614,2732,1456,26802,3557,441353,25638,29056,35878,90572,85742,70602,246916,194437,16976081000,945376000,936622000,1187748000,3069746000,3080189000,2588265000,8738200000,8237881000
Rhode Island,Transportation and Warehousing,2007,3253,2030,365,265,2660,254,94,3008,245,3520,2030,365,270,2665,260,100,3025,495,45800,1567,1883,2351,6529,6999,885,17881,16810,1551102000,107332000,65162000,81756000,286518000,259313000,39162000,700665000,709567000
Rhode Island,Utilities,2007,70,25,5,10,40,5,5,50,20,150,25,5,10,40,5,5,50,100,154,0,0,0,104,0,0,331,0,11198000,0,0,0,3594000,0,0,15134000,0
Rhode Island,Wholesale Trade,2007,6997,3170,1145,725,5040,883,344,6267,730,7340,3175,1150,730,5055,980,375,6410,930,99112,3953,5661,7142,19257,21418,7918,60503,28082,5044836000,268798000,302630000,382309000,1040784000,1131012000,408359000,3109204000,1406425000
South Carolina,Accommodation and Food Services,2007,34721,12410,6190,6744,25344,7376,1116,33836,885,46245,12430,6210,6835,25475,8460,3665,37600,8645,926695,19058,41947,91804,152909,278810,148940,581810,342975,12467192000,464218000,488166000,1018635000,1978152000,3448188000,1935186000,7372702000,5087940000
South Carolina,Administrative and Support and Waste Management and Remediation Services,2007,25003,14120,4160,2605,20885,2220,765,23870,1133,27560,14120,4170,2620,20910,2490,950,24350,3210,701083,21018,26417,33455,84198,81917,108064,281642,404754,16392295000,649367000,680077000,830564000,2213799000,2037220000,2168247000,6634370000,9507494000
South Carolina,"Agriculture, Forestry, Fishing and Hunting",2007,2948,1530,690,475,2695,185,25,2905,43,2965,1530,690,475,2695,185,30,2910,55,20059,2165,4308,5745,13355,4610,0,19608,353,672382000,84325000,132475000,170452000,406271000,151470000,0,608912000,15554000
South Carolina,"Arts, Entertainment, and Recreation",2007,7308,3803,1055,875,5733,1203,211,7147,161,7850,3810,1055,900,5765,1375,310,7450,400,123590,5164,6636,11424,23754,48275,21336,97589,20092,2194442000,151415000,116621000,177463000,459608000,792087000,358077000,1697651000,401827000
South Carolina,Construction,2007,64341,39300,11945,7049,58294,5028,610,63932,409,64960,39300,11945,7050,58295,5085,750,64130,830,550810,66573,78400,92107,240026,179655,67825,495210,38406,19436104000,2066200000,2191926000,2894660000,7154810000,6506750000,2637326000,16583575000,2342893000
South Carolina,Educational Services,2007,4783,2370,745,545,3660,800,150,4610,173,5105,2370,745,545,3660,845,240,4745,360,142963,3009,4510,7012,14884,29902,26020,75103,65274,3002259000,97344000,70862000,118400000,292397000,615412000,713498000,1722976000,1226968000
South Carolina,Finance and Insurance,2007,17422,10870,2672,1132,14674,1032,503,16209,1213,37980,10880,2900,1650,15430,3275,3610,22315,15665,302965,16830,16386,13502,49040,29717,38723,119822,155344,14353574000,667084000,594407000,585211000,1884781000,1337915000,1616900000,4979960000,9263898000
South Carolina,Health Care and Social Assistance,2007,37641,16240,9285,5838,31363,4144,1023,36530,1111,46525,16250,9360,6105,31715,5355,3135,40205,6320,989608,29571,60957,77609,169417,152437,142171,471764,505956,38707136000,1494307000,2266025000,2969908000,6751352000,6100561000,4276002000,17282132000,21231012000
South Carolina,Information,2007,3672,1885,430,265,2580,340,203,3123,549,7145,1890,430,275,2595,385,330,3310,3835,151755,1725,1883,2618,6732,8681,12501,31846,111859,7055932000,103199000,79656000,97410000,313125000,346801000,560682000,1353806000,5433639000
South Carolina,Management of Companies and Enterprises,2007,2120,170,35,110,315,355,545,1215,905,2750,170,35,110,315,360,555,1230,1520,122230,5,185,532,881,3339,14796,19164,102352,8108555000,19972000,7653000,35561000,67710000,204821000,806822000,1085440000,7021331000
South Carolina,Manufacturing,2007,20064,6650,2960,2764,12374,3278,1626,17278,2786,21725,6655,2960,2765,12380,3390,1870,17640,4085,1130820,8289,16556,31432,61977,112046,152040,365537,664237,47242284000,371717000,492246000,1060663000,2067036000,3998918000,5822698000,13128726000,29849870000
South Carolina,"Mining, Quarrying, and Oil and Gas Extraction",2007,348,120,70,35,225,65,10,300,48,470,120,70,35,225,75,10,310,160,5443,40,94,94,565,1249,0,2402,1242,277279000,6670000,10239000,12136000,34454000,49929000,0,106020000,152103000
South Carolina,Other,2007,99,92,5,2,99,0,0,99,0,99,92,5,2,99,0,0,99,0,130,75,0,0,130,0,0,130,0,2044000,1270000,0,0,2044000,0,0,2044000,0
South Carolina,Other Services (except Public Administration),2007,53119,32000,11593,5094,48687,3491,422,52600,519,56625,32000,11660,5340,49000,4410,745,54155,2470,401901,59458,74073,65398,203151,120131,36397,364837,31226,8635097000,1278105000,1436124000,1405234000,4128927000,2392711000,813510000,7444890000,1048143000
South Carolina,"Professional, Scientific, and Technical Services",2007,45724,31135,6860,3507,41502,2340,822,44664,1060,48995,31135,6870,3580,41585,3020,1310,45915,3080,390376,45335,41770,44940,134064,71898,50181,266585,109053,20421030000,1964807000,1698865000,1934443000,5644937000,4352927000,3725753000,13878526000,6001904000
South Carolina,Real Estate and Rental and Leasing,2007,21883,16927,2081,1097,20105,733,423,21261,622,27085,16965,2170,1315,20450,1205,1085,22740,4345,147294,13460,12177,12727,49523,23188,19488,94985,43456,4769070000,818421000,397013000,421386000,1664489000,762928000,639028000,3121259000,1478541000
South Carolina,Retail Trade,2007,59019,33383,11910,6180,51473,4371,940,56784,2235,94465,33490,12245,6880,52615,7590,3315,63520,30945,1079553,52865,71982,69338,196537,139284,58718,414236,622944,23858200000,1308864000,1531452000,1857704000,4719524000,4305445000,1718505000,11211469000,12217287000
South Carolina,Total,2007,85056,47956,15507,9468,72931,7897,1916,82744,2312,107893,48006,15707,9992,73705,10381,4952,89038,18855,1648146,83242,101999,125725,310966,287024,216908,814898,833248,53866256000,2549548000,2731914000,3529795000,8811257000,8564257000,6965178000,24340692000,29525564000
South Carolina,Transportation and Warehousing,2007,11921,6645,1510,914,9069,1064,601,10734,1187,13940,6655,1515,935,9105,1165,760,11030,2910,278044,8751,8533,10030,28574,23329,30052,86826,149391,10333527000,299894000,272402000,326925000,945818000,810464000,1123426000,2985215000,5728392000
South Carolina,Utilities,2007,501,170,80,65,315,80,60,455,46,1680,170,80,65,315,110,185,610,1070,60108,332,466,791,1681,3930,7703,13461,29231,3724084000,8543000,14838000,29883000,54316000,188375000,409359000,661350000,1927260000
South Carolina,Wholesale Trade,2007,20867,9625,3360,2343,15328,2588,1126,19042,1825,24900,9630,3400,2470,15500,3125,1905,20530,4370,315266,13503,19597,25233,65068,66854,44729,190202,101629,14829783000,711765000,822343000,1187945000,2822809000,2929000000,2093195000,8250305000,5846643000
South Dakota,Accommodation and Food Services,2007,10553,4430,1795,1975,8200,1812,324,10336,217,12075,4430,1800,2035,8265,2115,995,11375,700,178369,6263,11969,27340,46098,63744,39186,149429,21983,2127583000,151424000,109946000,275539000,543328000,677882000,532629000,1762378000,263888000
South Dakota,Administrative and Support and Waste Management and Remediation Services,2007,4656,2960,670,365,3995,273,120,4388,268,4905,2960,670,395,4025,290,160,4475,430,49621,3741,3816,3841,12579,8113,6260,30147,10845,1134464000,117731000,88660000,77000000,308313000,176249000,113882000,733775000,236868000
South Dakota,"Agriculture, Forestry, Fishing and Hunting",2007,600,485,55,45,585,5,10,600,0,600,485,55,45,585,5,10,600,0,885,176,188,247,999,0,0,885,0,81281000,30612000,4610000,13673000,55068000,0,0,81281000,0
South Dakota,"Arts, Entertainment, and Recreation",2007,3286,1940,580,380,2900,287,69,3256,30,3390,1940,580,380,2900,345,115,3360,30,32328,2142,3366,4487,10697,8873,6487,30410,386,549821000,69597000,47391000,81387000,208630000,146198000,110341000,532881000,3388000
South Dakota,Construction,2007,16678,11560,2785,1370,15715,785,108,16608,70,16760,11560,2785,1370,15715,785,165,16665,95,94981,16831,17654,16798,53673,28003,7567,92751,1411,3748772000,599406000,556771000,593626000,1770931000,1311539000,383031000,3626357000,79002000
South Dakota,Educational Services,2007,1005,505,130,85,720,150,95,965,40,1040,505,130,85,720,150,95,965,75,35499,375,659,315,2559,5048,18781,26915,8545,733621000,21874000,6984000,12358000,56091000,98656000,406020000,572510000,159482000
South Dakota,Finance and Insurance,2007,5983,3882,707,365,4954,363,192,5509,474,9545,3885,750,515,5150,850,1125,7125,2420,116114,6027,3768,4055,14816,10080,14853,41937,39447,4704001000,194994000,140657000,167366000,528699000,426603000,603000000,1650822000,1680525000
South Dakota,Health Care and Social Assistance,2007,9115,4195,1885,1160,7240,1012,587,8839,276,11255,4205,1900,1195,7300,1690,1495,10485,770,279881,5938,12199,14254,34409,39105,67258,147332,114022,10186375000,273251000,385349000,543625000,1229617000,1320774000,2142385000,4748852000,5224516000
South Dakota,Information,2007,1425,540,263,155,958,190,62,1210,215,2095,540,265,160,965,290,185,1440,655,31037,642,1294,1101,3393,5431,1849,13985,5141,1137933000,20014000,30062000,27189000,95249000,194532000,56044000,416962000,175700000
South Dakota,Management of Companies and Enterprises,2007,668,50,15,15,80,167,235,482,186,790,50,15,15,80,175,255,510,280,22718,56,80,0,182,1900,5825,8010,14764,1392025000,3844000,2808000,950000,9087000,88077000,292895000,396875000,984288000
South Dakota,Manufacturing,2007,4999,1980,855,610,3445,768,350,4563,436,5285,1980,855,610,3445,800,460,4705,580,151644,1694,3535,5132,12848,20314,15212,70973,51601,5736666000,78570000,103833000,160184000,408346000,773608000,586901000,2510867000,2031677000
South Dakota,"Mining, Quarrying, and Oil and Gas Extraction",2007,302,135,50,25,210,27,25,262,40,355,135,50,25,210,30,50,290,65,4551,0,178,225,621,0,824,2802,1109,188840000,5559000,6613000,7723000,25513000,0,40117000,121981000,41084000
South Dakota,Other,2007,32,31,1,0,32,0,0,32,0,32,31,1,0,32,0,0,32,0,0,0,0,0,0,0,0,0,0,190000,188000,0,0,190000,0,0,190000,0
South Dakota,Other Services (except Public Administration),2007,13020,8490,2625,1085,12200,585,110,12895,125,13555,8490,2640,1110,12240,760,185,13185,370,71782,13573,15949,12935,44273,16801,1065,67971,176,1389361000,284883000,302841000,243032000,853457000,323042000,23830000,1306948000,38525000
South Dakota,"Professional, Scientific, and Technical Services",2007,8664,5865,1365,725,7955,396,121,8472,192,9020,5865,1390,760,8015,510,160,8685,335,52007,7524,8107,8099,25314,10072,2756,40755,6338,2147814000,285648000,275234000,289608000,883073000,468398000,151592000,1631401000,381128000
South Dakota,Real Estate and Rental and Leasing,2007,4134,3110,355,248,3713,178,85,3976,158,4430,3110,355,250,3715,265,110,4090,340,19142,3781,1541,1954,9101,3261,1071,16251,2056,482474000,106387000,44511000,65587000,243496000,53629000,35104000,409141000,63134000
South Dakota,Retail Trade,2007,16352,7648,3460,2342,13450,1498,491,15439,913,20860,7670,3505,2500,13675,2235,1545,17455,3405,218827,10078,20166,26352,62528,45872,23494,143855,65928,4658273000,284251000,405594000,594440000,1321156000,1139667000,617652000,3240327000,1287753000
South Dakota,Total,2007,22043,12735,3812,2397,18944,1857,527,21328,715,25869,12748,3849,2540,19137,2597,1611,23345,2524,330169,21006,25054,31460,77520,67180,59585,204285,125884,10144637000,576848000,594037000,792131000,1963016000,1899336000,1784854000,5647206000,4497431000
South Dakota,Transportation and Warehousing,2007,5121,3415,680,359,4454,298,138,4890,231,5535,3415,680,370,4465,330,205,5000,535,42324,3358,3895,3836,13567,7515,3852,28145,12365,1464583000,136469000,119747000,125247000,410969000,247151000,122779000,874676000,491161000
South Dakota,Utilities,2007,344,75,55,60,190,100,10,300,44,745,75,55,65,195,165,50,410,335,9011,40,0,865,1382,2989,0,5462,0,499973000,4436000,13968000,39190000,58806000,150356000,0,271871000,58686000
South Dakota,Wholesale Trade,2007,5658,2270,758,761,3789,901,368,5058,600,6945,2285,760,815,3860,1195,690,5745,1200,73962,2308,3312,7357,16307,22200,10339,54167,11930,2950233000,123260000,145764000,261980000,586100000,837268000,495125000,2099385000,678322000
Tennessee,Accommodation and Food Services,2007,40012,14780,7282,7151,29213,8547,1072,38832,1180,57955,14810,7310,7260,29380,10010,4250,43640,14315,1209381,22116,48676,97898,169822,312440,141912,625641,580241,15747400000,549831000,564624000,1114622000,2231425000,3773142000,1608250000,7629265000,8072441000
Tennessee,Administrative and Support and Waste Management and Remediation Services,2007,27027,14160,4445,2910,21515,2818,949,25282,1745,32035,14165,4445,2945,21555,3035,1325,25915,6120,956194,20961,27757,37103,85725,104989,108686,316666,630455,25382594000,805648000,845534000,1160988000,2866145000,3215461000,2652522000,9012596000,15311363000
Tennessee,"Agriculture, Forestry, Fishing and Hunting",2007,1335,890,305,65,1260,40,25,1325,10,1350,890,310,65,1265,40,25,1330,20,6504,1316,1873,873,4518,698,0,6294,0,186116000,38375000,48846000,28626000,122252000,24960000,1620000,175815000,0
Tennessee,"Arts, Entertainment, and Recreation",2007,11338,6320,2037,1375,9732,1153,244,11129,209,11875,6325,2045,1375,9745,1290,310,11345,530,160143,8728,12746,17527,41344,41314,23732,113736,36702,5339625000,494620000,388950000,624086000,1553122000,1115249000,948970000,4081767000,487727000
Tennessee,Construction,2007,59970,34525,11135,7200,52860,5860,798,59518,452,60665,34525,11135,7205,52865,5940,960,59765,900,646820,58037,72021,95592,227472,221585,112106,569880,62806,27199205000,2082173000,2313572000,3352835000,7808630000,9785705000,5319934000,23230085000,3258468000
Tennessee,Educational Services,2007,5611,2495,870,800,4165,740,413,5318,293,5965,2495,875,825,4195,755,540,5490,475,254279,3242,5417,10768,20319,30677,64213,117190,134254,7185056000,120075000,95464000,200203000,428266000,811585000,1823333000,3129165000,3979464000
Tennessee,Finance and Insurance,2007,25893,16205,3461,1616,21282,1816,961,24059,1834,51580,16265,3685,2160,22110,4915,5095,32120,19460,561481,26186,20500,19164,70325,63420,73399,214303,338005,33366414000,1143388000,855586000,1100968000,3255522000,3808777000,3537287000,12120028000,21064494000
Tennessee,Health Care and Social Assistance,2007,55216,24465,13608,7788,45861,5790,1936,53587,1629,71725,24485,13695,8155,46335,8290,6010,60635,11090,1766784,47591,89036,101371,239183,217229,293066,759031,998337,70785390000,2207230000,3464741000,4201189000,9932744000,9602157000,9855589000,29620066000,40999208000
Tennessee,Information,2007,7326,3650,1060,706,5416,750,345,6511,815,12600,3650,1080,740,5470,815,635,6920,5680,238760,4717,4816,7239,19039,19575,13794,68810,159262,11298634000,286151000,198618000,245840000,858243000,956976000,706006000,2830954000,7866504000
Tennessee,Management of Companies and Enterprises,2007,3588,210,60,105,375,641,961,1977,1611,5940,210,60,105,375,645,1005,2025,3915,414805,33,224,473,834,6580,24163,31810,382995,30249890000,34403000,19810000,37974000,93290000,556110000,1548081000,2209330000,28040560000
Tennessee,Manufacturing,2007,31337,10075,5350,4285,19710,5624,2370,27704,3633,33645,10075,5350,4305,19730,5865,2745,28340,5305,1649811,15016,30652,52131,104483,196781,212016,572588,976584,66286990000,617572000,1001592000,1736025000,3567245000,7199376000,8325106000,21311323000,41400933000
Tennessee,"Mining, Quarrying, and Oil and Gas Extraction",2007,727,205,145,105,455,110,69,634,93,1135,205,145,105,455,115,105,675,460,18216,81,758,1138,2450,3640,2695,9891,0,777100000,13633000,27197000,54868000,100456000,131795000,90181000,378895000,197586000
Tennessee,Other,2007,109,102,4,1,107,2,0,109,0,109,102,4,1,107,2,0,109,0,170,0,0,0,130,0,0,170,0,1922000,1516000,203000,0,1794000,0,0,1922000,0
Tennessee,Other Services (except Public Administration),2007,67451,41090,13710,6735,61535,4625,657,66817,634,73810,41145,13790,7010,61945,6145,1560,69650,4160,569838,75561,88272,87443,253846,164317,64126,492682,61254,12950324000,1650917000,1764459000,1891868000,5328602000,3446042000,1267039000,10373910000,2062451000
Tennessee,"Professional, Scientific, and Technical Services",2007,53364,34747,7995,4722,47464,3444,1029,51937,1427,58965,34750,8010,4865,47625,4190,1440,53255,5710,568699,53867,50802,61193,167479,107990,64043,344892,204986,29898614000,2485489000,2180789000,2823071000,7548370000,5838594000,3484668000,17180626000,12011567000
Tennessee,Real Estate and Rental and Leasing,2007,22211,15630,2952,1354,19936,1082,436,21454,757,29970,15665,3055,1560,20280,1870,1415,23565,6405,184762,23751,17562,15696,57462,32320,14810,117353,63747,6337515000,731886000,526201000,536689000,1846577000,1313996000,507315000,4071652000,2118300000
Tennessee,Retail Trade,2007,75923,42190,15018,8202,65410,6493,1381,73284,2639,120235,42295,15385,9130,66810,9450,5455,81715,38520,1518800,71369,96458,101678,276921,226705,98954,610970,857142,35291216000,1729368000,2095698000,2639840000,6472143000,7116181000,3276238000,17091432000,17716983000
Tennessee,Total,2007,104746,56746,19370,12052,88168,10802,2739,101709,3037,137855,56827,19612,12718,89157,14161,7402,110720,27135,2475512,101134,127556,160538,389228,398547,325577,1113352,1362160,90085455000,3404598000,3730827000,5041642000,12177067000,14001341000,11673088000,37851496000,52233959000
Tennessee,Transportation and Warehousing,2007,17363,8605,2542,1725,12872,1878,842,15592,1771,20995,8605,2560,1755,12920,2025,1140,16085,4910,555692,11771,14895,19257,46848,59192,54400,172876,313353,22253387000,464759000,474598000,707222000,1702303000,2075335000,2127496000,6213102000,13407564000
Tennessee,Utilities,2007,364,105,40,10,155,85,45,285,79,805,105,40,10,155,195,220,570,235,13821,9,275,0,510,4895,6095,11658,150,726467000,3182000,6886000,0,13323000,247646000,338350000,605799000,105549000
Tennessee,Wholesale Trade,2007,30769,12950,4989,3808,21747,4283,1852,27882,2887,37480,12960,5065,4010,22035,5205,2775,30015,7465,603616,18661,29737,44387,97306,124935,83513,329150,233109,30763769000,1150401000,1378241000,2128723000,4723264000,6297185000,4183849000,16062439000,13131919000
Texas,Accommodation and Food Services,2007,148440,58387,27630,26137,112154,30694,3643,146491,1949,216130,58590,27800,26800,113190,36855,15410,165455,50675,4345025,89547,182463,348781,618577,1132602,572435,2336891,2000097,60028205000,2136425000,2039667000,3989312000,8189255000,14203281000,7576813000,30076960000,29912516000
Texas,Administrative and Support and Waste Management and Remediation Services,2007,106241,59875,16430,10740,87045,11176,4109,102330,3911,125000,59910,16480,10940,87330,12020,5785,105135,19865,4541510,93890,104634,141496,339402,424152,605960,1386965,3111219,129205547000,4120031000,3429777000,4650322000,12250114000,14488972000,16487539000,43637980000,84460869000
Texas,"Agriculture, Forestry, Fishing and Hunting",2007,5367,3555,975,505,5035,230,45,5310,57,5755,3555,975,505,5035,240,90,5365,390,38226,3965,6052,6160,18805,1398,4180,30474,772,1223521000,191748000,207743000,186933000,615515000,147644000,131153000,992515000,26987000
Texas,"Arts, Entertainment, and Recreation",2007,28665,15495,4760,3882,24137,3444,697,28278,387,31510,15505,4785,3950,24240,3715,895,28850,2660,555171,21170,27092,45502,94448,129945,94098,337536,145922,14620955000,880011000,583465000,884760000,2356781000,2179156000,4995818000,9689430000,3256946000
Texas,Construction,2007,207420,121054,37128,23136,181318,20883,3675,205876,1544,211230,121070,37140,23170,181380,21315,4795,207490,3740,3011585,200592,244840,310910,758930,821295,607027,2190670,793581,135724200000,8993570000,8199365000,11417210000,28610145000,33810425000,28805712000,91361420000,43056718000
Texas,Educational Services,2007,24006,11635,3957,3073,18665,3984,873,23522,484,26630,11645,3975,3105,18725,4470,1545,24740,1890,678850,16385,26056,41371,85574,162211,130260,381618,279649,20551160000,539955000,505063000,800529000,1846332000,3973456000,4080207000,9946478000,9938298000
Texas,Finance and Insurance,2007,99175,67989,13055,5804,86848,6279,2523,95650,3525,190110,68285,13675,7120,89080,14295,13225,116600,73510,2289781,108776,76343,72363,269588,228061,251267,759268,1481344,141045016000,5240503000,3782218000,3996216000,13115606000,12817511000,14671863000,41121073000,99750154000
Texas,Health Care and Social Assistance,2007,227725,112550,53567,30006,196123,22634,5864,224621,3104,274955,112725,53840,30960,197525,30315,15980,243820,31135,5746953,203484,349596,397187,947933,883691,939599,2781634,2905849,214830355000,13324024000,14329841000,15667263000,43404287000,29696947000,27548914000,100705733000,113136780000
Texas,Information,2007,23977,12159,3668,2579,18406,2516,1192,22114,1863,48510,12170,3690,2640,18500,3160,1965,23625,24885,1237384,14589,21123,27751,68971,85280,104756,275726,950166,78214680000,1061521000,914718000,1541174000,3813265000,4462918000,6003517000,14615510000,63267237000
Texas,Management of Companies and Enterprises,2007,12409,1040,415,450,1905,2551,3152,7608,4801,20475,1040,420,450,1910,2620,3500,8030,12445,1226685,0,88,3009,453,31380,101235,139250,1086988,137071020000,722000,131185000,247032000,541125000,2006105000,6780305000,9413935000,127657085000
Texas,Manufacturing,2007,96533,35915,16463,14099,66477,17607,5888,89972,6561,105225,35935,16495,14175,66605,18490,6870,91965,13260,4109550,58631,102260,178400,352458,682183,675288,1779364,2147301,202375361000,2852970000,3351552000,6681044000,13237081000,27279829000,27709474000,70738507000,124726178000
Texas,"Mining, Quarrying, and Oil and Gas Extraction",2007,30835,17109,4568,3319,24996,3823,1039,29858,977,34940,17115,4575,3325,25015,4085,1370,30470,4470,1072359,26088,30263,44508,101111,145068,148200,395589,676734,62598494000,1738774000,1524273000,2244149000,5515817000,7822520000,7871365000,21275920000,41320296000
Texas,Other,2007,670,622,33,10,665,5,0,670,0,670,622,33,10,665,5,0,670,0,1056,478,217,139,834,222,0,1056,0,19471000,14790000,2723000,544000,18057000,1414000,0,19471000,0
Texas,Other Services (except Public Administration),2007,218958,128639,45285,24340,198264,16904,2240,217408,1550,244280,128725,45555,25535,199815,22015,6330,228160,16120,2088790,240682,294993,323297,861597,616451,219679,1716030,330793,50443145000,5628000000,6076236000,6867713000,18587875000,13120978000,5994296000,38085875000,11452705000
Texas,"Professional, Scientific, and Technical Services",2007,272878,190780,37293,20775,248848,15338,4425,268611,4267,295505,190825,37450,21325,249600,18310,7390,275300,20205,2945509,274445,242308,274415,806270,527991,410179,1750735,1165225,199100304000,16676655000,11963245000,15492077000,44141425000,34710837000,28726645000,107627485000,89887409000
Texas,Real Estate and Rental and Leasing,2007,97044,71581,12530,5514,89625,4236,1537,95398,1646,131800,71645,12815,6250,90710,7130,7010,104850,26950,874415,107963,80078,69292,259440,138484,123418,526163,310043,36411265000,4101034000,2685006000,2670676000,9448948000,5611991000,5075875000,20168988000,15315456000
Texas,Retail Trade,2007,230536,136301,45079,24475,205855,16915,3822,226592,3944,390555,136775,46595,28340,211710,28505,16420,256635,133920,5282475,223486,265683,303669,786117,593338,411985,1839530,3240300,125674724000,5780524000,6158251000,7810765000,19850277000,18273150000,15346438000,54138345000,70652130000
Texas,Total,2007,397684,229814,70929,43941,344684,38792,8869,392345,5339,521408,230224,71871,46472,348567,51039,25036,424642,96766,9041030,391980,465043,587326,1444349,1474118,1230452,4148919,4892111,373037029000,16557616000,15028864000,19771491000,51357971000,51832546000,48828299000,152018816000,221018213000
Texas,Transportation and Warehousing,2007,64332,35230,9854,6607,51691,6528,2387,60606,3726,81580,35295,9920,6740,51955,7375,4410,63740,17840,1606926,51164,59682,84097,200000,213722,168999,601112,994706,66966242000,2073466000,2119326000,3004443000,7257015000,8037417000,6882388000,22754024000,43385863000
Texas,Utilities,2007,4896,2685,900,340,3925,450,216,4591,305,9125,2685,905,350,3940,600,615,5155,3970,209279,5116,5366,3938,14016,18450,30223,65655,143159,17766276000,198965000,184392000,185912000,681381000,1103714000,2376191000,4211572000,13504836000
Texas,Wholesale Trade,2007,128095,64303,21654,15427,101384,14789,5760,121933,6162,160375,64515,22100,16630,103245,19655,11575,134475,25900,2324388,104254,133973,193736,439099,444867,383776,1284555,981632,133045967000,6085045000,6499040000,9696697000,22448650000,23293738000,20802885000,67111307000,63843636000
United States,Accommodation and Food Services,2007,2390229,1015414,461840,425241,1902495,430844,45882,2379221,11008,3162445,1017060,463430,432140,1912630,506930,191425,2610985,551460,57824320,1619295,3083527,5794528,10519840,15939885,7812199,34273610,23346517,881719080000,39743475000,37088780000,69276925000,146121370000,213114145000,111800885000,471036400000,410595905000
United States,Administrative and Support and Waste Management and Remediation Services,2007,1647654,1040666,245645,152186,1438497,144221,43859,1626577,21077,1922505,1041140,246750,155130,1443020,162880,77045,1682945,239560,49918305,1556992,1610455,2044855,5225710,5804270,7590794,18620865,31268604,1499666060000,61450951000,47850595000,63446705000,172751790000,186113455000,202719447000,561590005000,937872456000
United States,"Agriculture, Forestry, Fishing and Hunting",2007,114824,78704,18880,9936,107520,5671,1105,114296,528,118225,78725,18895,9985,107605,6205,1955,115765,2460,860525,114751,122801,129402,371907,197051,148528,720555,128407,27821125000,4036060000,3673229000,4158988000,11879520000,6729975000,4152536000,22843955000,4532357000
United States,"Arts, Entertainment, and Recreation",2007,584444,360765,82653,59849,503267,64198,13012,580477,3967,626110,360965,83035,60875,504875,70505,20260,595640,30470,10042835,424413,542245,807145,1829335,2581200,2152346,6566215,3465437,301785765000,35089115000,15410685000,17275825000,67775625000,53035050000,82336415000,203147090000,97970921000
United States,Construction,2007,4002279,2624460,659018,382344,3665822,291845,37478,3995145,7134,4057260,2624535,659170,382835,3666540,298535,49925,4015000,42260,36339415,4158990,4316305,5109630,13584925,11098360,6268720,30952005,5381360,1680655470000,157597125000,150994675000,205599150000,514190950000,523268855000,327986025000,1365445830000,314900702000
United States,Educational Services,2007,386181,189877,59360,48692,297929,66199,15882,380010,6171,434480,189960,59625,49890,299475,74430,27545,401450,33030,15196925,289041,395940,665995,1351480,2752725,2714205,6818410,8358191,470561430000,9309590000,8228905000,13928955000,31467450000,71357855000,84150515000,186975820000,282905334000
United States,Finance and Insurance,2007,1332696,942110,189125,84216,1215451,79246,23832,1318529,14167,2540455,944735,196755,104805,1246295,188825,181150,1616270,924185,32711755,1573630,1202465,1105657,3926596,3118461,3617525,10673180,21960851,2548456899000,72319830000,63245411000,72795015000,208391790000,220671265000,267526634000,696730075000,1844681048000
United States,Health Care and Social Assistance,2007,3116340,1570278,708380,401272,2679930,302859,96264,3079053,37287,3921155,1572210,713960,421075,2707245,437850,322585,3467680,453475,83988235,2872460,4686409,5326374,12920818,11820296,15206050,39949445,43940096,3341356270000,144528390000,185108390000,218888945000,548525725000,441332981000,474662050000,1464540425000,1875603951000
United States,Information,2007,382199,228102,56495,39655,324252,39849,10275,374376,7823,718895,228410,57090,41585,327085,52200,30020,409305,309590,16996565,331965,367226,524190,1228122,1526215,1613480,4385920,12561290,1115488160000,23976910000,15939965000,24515790000,64432665000,82712647000,99192078000,246558090000,863810403000
United States,Management of Companies and Enterprises,2007,141850,18618,4127,5857,28602,31580,43995,104177,37673,253215,18725,4195,6020,28940,32635,49525,111100,142115,15607010,22225,19425,37385,79035,388935,1449970,1917940,13689070,1463456015000,2785600000,1532335000,2575885000,6893820000,25359750000,95866605000,128120175000,1335335840000
United States,Manufacturing,2007,1467505,573200,267546,224917,1065663,280994,78485,1425142,42363,1656775,573405,267880,226260,1067545,297980,115150,1480675,176100,66527105,1054864,1787739,3057017,5913485,11436369,12200675,29578983,36693976,3129585514000,42265557000,58011919000,110353431000,210873766000,457488049000,515733358000,1185358818000,1926080671000
United States,"Mining, Quarrying, and Oil and Gas Extraction",2007,104330,56120,15941,12283,84344,14041,3645,102030,2300,131010,56180,16080,12645,84905,16470,7540,108915,22095,3499451,89008,106460,166561,362506,536428,508801,1411172,2081903,202095193000,4708572000,4765412000,7591924000,17069914000,26980583000,27184669000,71443585000,130202776000
United States,Other,2007,9993,9522,320,104,9946,46,1,9993,0,9993,9522,320,104,9946,46,1,9993,0,12655,0,1981,1342,11257,1261,0,12655,0,266931000,166002000,27617000,11457000,205076000,11799000,0,266931000,0
United States,Other Services (except Public Administration),2007,3389747,2131470,685451,334413,3151334,208159,22650,3382143,7604,3721260,2133570,690615,350330,3174515,272970,82150,3529635,191625,27598865,3975515,4451660,4392640,12821235,7405970,3153812,23384600,3891576,703357485000,91478280000,97732735000,103376645000,292587660000,183046560000,95455674000,571118490000,130568922000
United States,"Professional, Scientific, and Technical Services",2007,3943082,2855436,531719,294517,3681672,204614,37171,3923457,19625,4337780,2856920,535105,306155,3698180,267380,103455,4069015,268765,40899705,4229562,3472265,3924515,11688565,7634175,5651993,24976835,15701944,2664986470000,221793755000,168147865000,215045050000,604986670000,497179820000,394683455000,1497055035000,1163242016000
United States,Real Estate and Rental and Leasing,2007,1510365,1177734,174414,79896,1432044,57080,13659,1502783,7582,1900690,1179495,180035,92080,1451610,98310,75510,1625430,275260,11075547,1730434,1114132,1033693,3870888,2000945,1623870,7517395,3285303,445067745000,61633140000,36873390000,38611185000,137117715000,81233765000,67777540000,286129020000,153282680000
United States,Retail Trade,2007,3585530,2092247,733863,408368,3234478,287753,47247,3569478,16052,5618145,2098275,751930,457140,3307345,463390,246635,4017370,1600775,76510392,3501597,4719306,5331131,13719757,10473075,6153452,30477663,45085383,1826860434000,90140917000,105213855000,129849178000,325432277000,317412818000,199648399000,842596595000,977809038000
United States,Total,2007,6049655,3705275,1060250,644842,5410367,532391,88586,6031344,18311,7705018,3710700,1073875,682410,5466985,723385,355853,6546223,1158795,120604265,6139463,6974591,8656182,21770236,20922960,17173728,59866924,60737341,5026778232000,234921325000,222419546000,292088277000,749429148000,768546555000,686862018000,2204837721000,2821940511000
United States,Transportation and Warehousing,2007,878237,560851,122421,82401,765673,77783,19833,863289,14948,1099030,561450,123565,85405,770420,95590,49345,915355,183675,21933188,817177,794132,1082728,2715393,2859925,2477364,8088937,13761944,875827430000,28681021000,25426539000,36493516000,90694240000,102047212000,94217861000,287338140000,586871988000
United States,Utilities,2007,31114,16063,5102,2576,23741,4376,1611,29728,1386,83370,16085,5150,2960,24195,7085,6355,37635,45735,3113785,29916,32688,33510,97223,192906,260735,551310,2562060,255623280000,1387851000,1168600000,1648904000,4864541000,11042903000,17563404000,33526038000,222063715000
United States,Wholesale Trade,2007,1688585,950867,287188,197575,1435630,187569,43430,1666629,21956,2172320,954045,294510,214215,1462770,266525,141685,1870980,301340,29824250,1591155,1889205,2617222,6142345,6829570,5205271,18179170,11430948,1639953405000,79716815000,85488145000,124763485000,289968445000,342068720000,268869477000,900917660000,728055401000
Utah,Accommodation and Food Services,2007,17176,5625,2825,3585,12035,4033,565,16633,543,23100,5645,2835,3650,12130,4635,2155,18920,4180,468415,6628,18887,48915,75435,146246,79565,303758,163598,6114288000,212785000,184616000,468359000,871162000,1637994000,1044362000,3583018000,2519062000
Utah,Administrative and Support and Waste Management and Remediation Services,2007,17614,10990,2452,1480,14922,1305,490,16717,897,19035,11015,2455,1495,14965,1345,555,16865,2170,550665,12543,14784,17873,45718,44655,43924,147880,379648,14967260000,493246000,427614000,493517000,1454539000,1508023000,1321917000,4539651000,9934061000
Utah,"Agriculture, Forestry, Fishing and Hunting",2007,335,255,35,25,315,5,10,330,5,350,255,35,25,315,5,10,330,20,1293,78,46,225,662,0,0,925,0,42053000,8660000,2525000,5939000,19934000,0,0,29549000,0
Utah,"Arts, Entertainment, and Recreation",2007,4203,2400,605,435,3440,530,138,4108,95,4365,2400,605,455,3460,570,160,4190,175,90695,2418,2949,4956,11909,20574,15523,53884,28248,1557547000,102569000,63930000,76836000,279613000,280950000,185182000,866888000,429227000
Utah,Construction,2007,56892,36090,10280,5790,52160,3950,465,56575,317,57070,36090,10280,5795,52165,3980,485,56630,440,459150,54886,66699,76156,200337,145520,54762,411685,35423,17629640000,2019672000,1953759000,2460094000,6448351000,5551756000,2502916000,14914180000,2060064000
Utah,Educational Services,2007,3921,2145,525,501,3171,490,125,3786,135,4245,2145,545,550,3240,510,140,3890,355,103821,2109,2900,6209,11401,17960,13290,48882,0,2537806000,85093000,50656000,107115000,265836000,409470000,371226000,1190486000,1068500000
Utah,Finance and Insurance,2007,18208,13135,1780,755,15670,949,365,16984,1224,27055,13145,1810,875,15830,1845,1435,19110,7945,267542,13866,9472,8517,33613,28879,22491,95462,157238,12434828000,620723000,358936000,368680000,1388431000,1382883000,1220582000,4446037000,7725070000
Utah,Health Care and Social Assistance,2007,27388,14480,6180,3380,24040,2178,551,26769,619,31080,14480,6190,3505,24175,2960,1865,29000,2080,425806,18072,41070,42420,108057,82759,73614,274590,131768,15035263000,1356691000,1252216000,1275858000,3914612000,2666161000,2130008000,8947186000,4837555000
Utah,Information,2007,5129,2620,575,460,3655,650,205,4510,619,7165,2620,580,465,3665,700,330,4695,2470,171363,2531,2268,3763,11151,19055,13320,50838,74018,8237084000,138687000,93346000,164630000,454489000,1030151000,880672000,2506776000,3890650000
Utah,Management of Companies and Enterprises,2007,1691,210,30,40,280,330,356,966,725,2165,210,30,50,290,330,360,980,1185,98904,205,0,44,627,3873,9408,14105,84799,7284041000,65796000,5857000,827000,85180000,212601000,975267000,1409975000,5875332000
Utah,Manufacturing,2007,16165,6205,2550,2540,11295,2791,821,14907,1258,16725,6205,2555,2540,11300,2860,905,15065,1660,512575,6404,13005,27520,52576,93219,65424,249792,211046,21457187000,359012000,414946000,890650000,1806837000,3365779000,2674527000,9023296000,10499565000
Utah,"Mining, Quarrying, and Oil and Gas Extraction",2007,2061,980,260,215,1455,279,65,1799,262,2145,980,260,215,1455,285,75,1815,330,44147,1230,1357,2570,5438,7937,2343,19593,25903,2496599000,75024000,64683000,112102000,263913000,353641000,164845000,1023820000,1588198000
Utah,Other,2007,60,56,3,0,59,1,0,60,0,60,56,3,0,59,1,0,60,0,100,52,0,0,76,0,0,100,0,891000,747000,125000,0,872000,0,0,891000,0
Utah,Other Services (except Public Administration),2007,20582,12765,4050,2021,18836,1188,196,20220,362,23175,12765,4070,2105,18940,2145,590,21675,1500,241976,19699,25568,24272,72596,34032,9187,120938,108351,6710598000,526059000,573926000,592689000,1715524000,804415000,217826000,3007105000,3575602000
Utah,"Professional, Scientific, and Technical Services",2007,40052,28810,4460,2645,35915,2244,800,38959,1093,42105,28810,4475,2690,35975,2570,1025,39570,2535,372568,33098,27184,32661,96820,76573,63107,245290,113154,17691275000,1611163000,1087101000,1512757000,4254394000,4250980000,3597597000,12382690000,4665236000
Utah,Real Estate and Rental and Leasing,2007,22526,19150,1483,700,21333,579,179,22091,435,24605,19155,1525,765,21445,850,375,22670,1935,97135,3478,8818,7372,29933,16686,9347,70738,19520,3013817000,742972000,256759000,223071000,1259484000,603770000,287201000,2208692000,665483000
Utah,Retail Trade,2007,29943,14110,6087,4148,24345,3008,825,28178,1765,44370,14125,6175,4555,24855,4555,2550,31960,12410,689101,16345,34909,50955,105798,92855,71463,293327,348125,16294823000,547493000,809569000,1168548000,2557512000,2399325000,2336597000,7696948000,7949738000
Utah,Total,2007,60989,36873,9525,6212,52610,5288,1268,59166,1823,71880,36892,9590,6462,52944,6687,2932,62563,9317,1102821,54077,62745,82443,199265,196427,143919,539611,563210,38730072000,1996757000,1728446000,2341576000,6066779000,6334317000,5300428000,17701524000,21028548000
Utah,Transportation and Warehousing,2007,10039,6315,1085,725,8125,804,255,9184,855,10930,6315,1085,735,8135,850,285,9270,1660,237284,7695,6587,8148,23533,25642,17052,75220,149464,9621643000,261953000,200603000,272044000,776138000,968186000,612572000,2608807000,6517077000
Utah,Utilities,2007,388,230,45,30,305,31,15,351,37,1010,230,45,30,305,90,25,420,590,15163,0,325,312,1011,779,0,4185,0,1151954000,6124000,11155000,12077000,30555000,45460000,0,267798000,0
Utah,Wholesale Trade,2007,16378,7585,2365,1759,11709,2008,925,14642,1736,18405,7590,2380,1810,11780,2345,1335,15460,2945,243209,9382,12680,19383,44509,52648,30560,143943,85002,11793556000,466453000,526732000,801540000,1913074000,2360431000,1454209000,6329916000,4779304000
Vermont,Accommodation and Food Services,2007,8764,3615,1605,1715,6935,1476,157,8568,196,9700,3615,1625,1745,6985,1705,350,9040,660,145854,5521,10648,23558,39946,46115,19355,106131,37438,2151245000,126516000,138451000,291821000,558760000,697668000,281376000,1550681000,600150000
Vermont,Administrative and Support and Waste Management and Remediation Services,2007,4936,3400,725,295,4420,235,60,4715,221,5155,3400,725,300,4425,275,115,4815,340,36594,3926,3993,3109,12804,5614,0,22260,12019,935029000,161605000,113056000,79600000,383252000,171219000,11080000,633492000,238286000
Vermont,"Agriculture, Forestry, Fishing and Hunting",2007,675,585,55,25,665,0,10,675,0,675,585,55,25,665,0,10,675,0,1324,749,300,0,1511,0,0,1324,0,50407000,18937000,8349000,0,38520000,0,0,50407000,0
Vermont,"Arts, Entertainment, and Recreation",2007,2354,1545,325,245,2115,175,34,2324,30,2405,1545,325,245,2115,190,65,2370,35,35955,1729,1520,2868,6592,4317,5559,19868,16032,617024000,107449000,38063000,64503000,222711000,79067000,58037000,405136000,209698000
Vermont,Construction,2007,15528,11610,2115,1105,14830,580,83,15493,35,15535,11610,2115,1105,14830,585,85,15500,35,75777,15015,12966,13728,44539,18505,7448,73826,0,3275353000,695224000,499793000,602406000,1819698000,838265000,396362000,3183727000,1173000
Vermont,Educational Services,2007,1693,830,245,180,1255,273,100,1628,65,1775,830,245,190,1265,290,135,1690,85,66218,1150,1494,1962,5096,9350,18854,34309,30988,1739977000,37136000,34593000,39616000,124345000,262956000,538581000,943578000,762253000
Vermont,Finance and Insurance,2007,2926,1600,380,190,2170,219,108,2497,429,5250,1605,395,265,2265,595,675,3535,1715,42803,2098,2196,1922,6417,6399,7890,23633,14592,2532243000,115359000,111399000,103536000,358865000,347967000,326183000,1195626000,1106047000
Vermont,Health Care and Social Assistance,2007,8997,4365,1920,1150,7435,969,351,8755,242,10915,4365,1920,1180,7465,1350,1255,10070,845,234227,7238,11436,12068,34243,34593,42568,117856,105680,7370511000,334699000,389781000,469471000,1212294000,1007918000,1413049000,3783958000,3201450000
Vermont,Information,2007,1937,985,295,190,1470,235,76,1781,156,2615,985,295,200,1480,320,170,1970,645,20900,1149,1135,1587,4562,6090,1890,15866,3670,834013000,51248000,34406000,50039000,160364000,289856000,68093000,642684000,183347000
Vermont,Management of Companies and Enterprises,2007,370,15,20,20,55,70,100,225,145,400,15,20,20,55,75,100,230,170,16732,0,80,0,172,728,2269,3210,13522,1054813000,0,7635000,0,11900000,30779000,111949000,157435000,897378000
Vermont,Manufacturing,2007,5234,2345,855,635,3835,830,297,4962,272,5425,2345,855,640,3840,855,375,5070,355,104021,2366,3394,5070,13828,24168,12469,68037,20806,4274703000,106023000,117140000,181970000,483118000,1030002000,484998000,2714541000,974155000
Vermont,"Mining, Quarrying, and Oil and Gas Extraction",2007,256,140,50,10,200,25,10,235,21,280,140,50,10,200,45,10,255,25,208,9,293,0,555,925,0,1685,0,184123000,8081000,8021000,0,22399000,61843000,0,103079000,0
Vermont,Other,2007,13,11,1,1,13,0,0,13,0,13,11,1,1,13,0,0,13,0,29,0,0,0,29,0,0,29,0,293000,99000,0,0,293000,0,0,293000,0
Vermont,Other Services (except Public Administration),2007,9896,6550,2045,705,9300,393,78,9771,125,10305,6555,2075,745,9375,565,160,10100,205,45960,11452,12564,7739,33347,8455,0,44803,397,1090254000,275437000,278228000,186613000,752785000,217854000,2232000,1040345000,17483000
Vermont,"Professional, Scientific, and Technical Services",2007,10790,7605,1565,795,9965,415,140,10520,270,11030,7605,1575,800,9980,525,160,10665,365,80015,9530,9691,8862,30333,11403,5042,51047,17594,3426327000,494697000,458221000,459511000,1444506000,682059000,345482000,2709606000,534494000
Vermont,Real Estate and Rental and Leasing,2007,3552,2680,400,175,3255,130,25,3410,142,3975,2685,405,175,3265,315,40,3620,355,15962,3965,2263,1660,8719,3652,43,13442,1390,458780000,124644000,75745000,46841000,271672000,98942000,984000,390672000,51275000
Vermont,Retail Trade,2007,14797,6700,3288,2143,12131,1354,337,13822,975,18955,6710,3330,2290,12330,1835,1415,15580,3375,196406,9286,19345,23900,57408,33704,13088,111795,36807,4702876000,280092000,412430000,611371000,1354794000,1167036000,380569000,3110845000,784868000
Vermont,Total,2007,19503,11570,3340,2014,16924,1566,365,18855,648,22341,11575,3371,2104,17050,2092,1134,20276,2065,268086,19502,21837,26499,67838,54572,42269,164679,103407,8821572000,651947000,620981000,774347000,2047275000,1784965000,1471256000,5303496000,3518076000
Vermont,Transportation and Warehousing,2007,2390,1450,265,155,1870,264,80,2214,176,2700,1450,265,155,1870,295,120,2285,415,28048,1488,1276,1264,4406,6548,791,14939,4750,917627000,67098000,43981000,40428000,172180000,237329000,27921000,511026000,183577000
Vermont,Utilities,2007,121,50,5,15,70,12,18,100,21,250,50,5,15,70,20,70,160,90,8454,26,0,0,140,0,0,2844,0,762587000,1926000,0,0,14688000,0,0,238069000,0
Vermont,Wholesale Trade,2007,3890,1725,570,400,2695,535,246,3476,414,4295,1725,570,410,2705,620,360,3685,610,49998,1927,2639,3367,9710,12555,8177,38763,7822,2279263000,112632000,116136000,159772000,450527000,538518000,390856000,1728053000,442857000
Virginia,Accommodation and Food Services,2007,57062,22135,11048,10773,43956,10349,1438,55743,1319,78505,22185,11070,10895,44150,11690,5360,61200,17305,1517936,35868,72075,143287,252467,370755,196895,818669,687286,22218214000,897456000,964678000,1854595000,3723230000,5071463000,2569404000,11385214000,10809612000
Virginia,Administrative and Support and Waste Management and Remediation Services,2007,45982,26605,7030,4427,38062,4263,1654,43979,2003,52295,26605,7055,4460,38120,4775,2425,45320,6975,1191466,39907,45150,58409,147596,154509,205718,522728,653415,39378945000,1617978000,1273422000,1839109000,4750007000,4852317000,5876095000,15803431000,23158443000
Virginia,"Agriculture, Forestry, Fishing and Hunting",2007,3460,2350,720,255,3325,80,25,3430,30,3475,2350,720,255,3325,80,40,3445,30,20231,3930,4659,3039,11959,1631,0,16894,702,751432000,119500000,127224000,78224000,332466000,51819000,0,493479000,50174000
Virginia,"Arts, Entertainment, and Recreation",2007,12737,7203,1755,1485,10443,1700,309,12452,285,13810,7205,1755,1495,10455,1810,415,12680,1130,229675,7819,10975,19162,39985,67283,33319,148284,68186,4899762000,359664000,203662000,364728000,951268000,1179706000,793904000,3251971000,1175751000
Virginia,Construction,2007,124864,79060,21770,12375,113205,9679,1300,124184,680,126135,79060,21770,12375,113205,9880,1535,124620,1515,1138343,132675,142570,164648,441923,364295,189101,1000080,119388,48687055000,4528660000,4593695000,6309305000,15435550000,16187540000,9043235000,40863695000,6822931000
Virginia,Educational Services,2007,11180,5657,1660,1255,8572,1766,481,10819,361,12135,5660,1665,1295,8620,1900,605,11125,1010,314105,7170,10891,16346,35899,71872,70374,184850,124905,9069465000,291205000,220081000,347885000,864255000,1866355000,2229393000,5298010000,3537520000
Virginia,Finance and Insurance,2007,32871,21635,4362,1905,27902,1904,1027,30833,2038,62495,21675,4500,2255,28430,4015,4900,37345,25150,776789,34573,26893,23078,84770,59645,76013,231398,508772,48586141000,1509914000,1278163000,1246431000,4064993000,3626353000,4184179000,12624172000,34678736000
Virginia,Health Care and Social Assistance,2007,69468,31195,16463,10216,57874,8016,1949,67839,1629,87695,31225,16620,10900,58745,11600,6350,76695,11000,1860398,55419,106591,134017,301306,295772,279875,886331,901716,76391055000,2813680000,4505327000,6060691000,13418436000,11836488000,9592448000,35072720000,39622057000
Virginia,Information,2007,10640,5040,1440,1070,7550,1325,638,9513,1127,20595,5045,1460,1095,7600,1525,945,10070,10525,510304,5328,8109,10796,26625,39831,55913,135904,274975,35090739000,401408000,410384000,641324000,1497593000,2339420000,3347353000,8004192000,25818697000
Virginia,Management of Companies and Enterprises,2007,4279,295,80,160,535,725,1323,2583,1696,5805,295,80,160,535,740,1380,2655,3150,324285,228,0,788,1563,8378,36848,46789,277270,27174165000,29587000,0,39599000,97970000,517979000,2790563000,3418520000,23755645000
Virginia,Manufacturing,2007,26806,9610,4710,3660,17980,4541,1837,24358,2448,28715,9615,4710,3675,18000,4760,2290,25050,3665,1148960,15091,26827,43314,91156,157792,156932,462931,606982,49327840000,640092000,877803000,1556567000,3278083000,6199676000,6294558000,17896786000,27953366000
Virginia,"Mining, Quarrying, and Oil and Gas Extraction",2007,1107,320,110,160,590,260,114,964,143,1600,320,110,160,590,270,255,1115,485,50086,168,530,1947,3133,9477,7985,23604,19052,2544562000,20829000,23143000,81820000,147843000,405640000,417146000,1112162000,1191005000
Virginia,Other,2007,162,153,7,2,162,0,0,162,0,162,153,7,2,162,0,0,162,0,0,0,38,0,0,0,0,0,0,2885000,2679000,153000,0,2885000,0,0,2885000,0
Virginia,Other Services (except Public Administration),2007,98900,58910,20929,10609,90448,6720,988,98156,744,108115,58975,21065,10995,91035,8270,2720,102025,6090,834553,109362,136065,137881,386059,231278,89839,714241,100213,25296840000,2671001000,3256658000,3828324000,9766260000,7175360000,3855714000,20971420000,3674489000
Virginia,"Professional, Scientific, and Technical Services",2007,123260,83535,15530,9259,108324,8636,3341,120301,2959,139410,83540,15575,9425,108540,10150,5415,124105,15305,2013672,106722,101293,121212,324892,300402,332848,989899,1016733,147706338000,7280603000,5719853000,7520111000,20542099000,21494953000,25235391000,67466063000,79871768000
Virginia,Real Estate and Rental and Leasing,2007,35774,26950,3820,1903,32673,1526,692,34891,883,46640,26990,3910,2170,33070,2875,2770,38715,7925,293668,39470,23813,23655,87987,46487,50212,192401,84572,12277565000,1518220000,828197000,908734000,3274696000,1935870000,2485341000,8061652000,3854945000
Virginia,Retail Trade,2007,88813,47514,18371,10414,76299,7367,1976,85642,3171,146910,47625,18685,11755,78065,11385,6460,95910,51000,2068686,76595,114741,126689,323529,227621,142352,738066,1244377,50033914000,1951272000,2573904000,3253296000,7765429000,7428820000,5182516000,20904359000,28757412000
Virginia,Total,2007,157501,91681,27433,16983,136097,14489,3654,154240,3261,200503,91773,27667,17800,137240,18559,9727,165526,34977,3196914,155066,180503,225592,561161,530506,452834,1544501,1652413,136311818000,5787940000,5827037000,7857544000,19472521000,20435790000,19670060000,59578371000,76733447000
Virginia,Transportation and Warehousing,2007,23373,14180,2770,1964,18914,2032,839,21785,1588,26795,14180,2780,1990,18950,2260,1205,22415,4380,504069,19776,17141,25126,64803,61786,50531,183377,295941,20949256000,618161000,515171000,819241000,2008096000,2222958000,2012522000,6370622000,13235652000
Virginia,Utilities,2007,546,175,60,20,255,73,78,406,140,1600,175,60,20,255,90,225,570,1030,79718,275,316,39,800,2034,6948,10540,36149,7355499000,7428000,8066000,1026000,22372000,120668000,419440000,607153000,6708971000
Virginia,Wholesale Trade,2007,31587,15372,4607,3442,23421,3866,1759,29046,2541,38975,15375,4710,3615,23700,4720,3340,31760,7215,577013,22114,27272,39812,98028,115087,90055,319119,229806,30249471000,1335246000,1328495000,1907698000,4651995000,5688580000,4692207000,15594532000,13682255000
Washington,Accommodation and Food Services,2007,64247,26780,13635,12157,52572,9619,1233,63424,823,80115,26805,13665,12460,52930,12085,4240,69255,10860,1179399,40152,87569,160718,289431,330192,158986,779070,380303,19022287000,944957000,1058132000,2175401000,4179203000,5093502000,2567178000,11950683000,6915315000
Washington,Administrative and Support and Waste Management and Remediation Services,2007,40439,24945,6475,3740,35160,3042,931,39133,1306,44380,24945,6490,3850,35285,3240,1345,39870,4510,743489,36240,41379,47908,128664,105748,97773,349479,379452,26449752000,1161045000,1140398000,1425397000,3730212000,3271924000,3028057000,10465812000,15205097000
Washington,"Agriculture, Forestry, Fishing and Hunting",2007,7757,5660,845,620,7125,429,140,7694,63,7890,5660,845,620,7125,445,185,7755,135,66755,4988,4876,7416,19841,15250,17458,53654,0,2814006000,334401000,203950000,292640000,878101000,685579000,634381000,2232498000,356523000
Washington,"Arts, Entertainment, and Recreation",2007,12870,7190,1850,1413,10453,1661,563,12677,193,13630,7190,1850,1415,10455,1750,950,13155,475,284736,6993,11060,17660,38887,68220,91767,204703,66571,7660424000,353830000,239347000,331551000,971114000,1173061000,2412159000,4613085000,1870899000
Washington,Construction,2007,130006,88090,20795,11268,120153,8273,1065,129491,515,130730,88090,20800,11270,120160,8400,1290,129850,880,993495,134616,135128,150598,421835,310332,151706,889390,82403,50058860000,5229840000,4914669000,6267492000,16417815000,16037108000,9845767000,42529590000,6230326000
Washington,Educational Services,2007,10638,5535,1700,1330,8565,1495,313,10373,265,11310,5540,1700,1350,8590,1685,450,10725,585,238119,7662,10851,17556,37014,56264,37947,135952,99236,5729046000,238575000,206028000,351333000,810938000,1382219000,1033599000,3323846000,2315880000
Washington,Finance and Insurance,2007,29708,19988,3640,1557,25185,1600,975,27760,1948,55845,20035,3775,1835,25645,2875,5155,33675,22170,552029,30694,20256,17570,69195,47196,76579,202760,348218,34973728000,1370399000,1028605000,1070917000,3639176000,3074150000,4479357000,11438157000,23384966000
Washington,Health Care and Social Assistance,2007,77869,40595,17685,9343,67623,6671,2142,76436,1433,92450,40620,17735,9775,68130,9635,6255,84020,8430,1708118,69190,115719,120847,308505,250617,308279,879135,802697,70656183000,2711091000,4348984000,4512572000,11558857000,8759798000,11284936000,32022054000,37981662000
Washington,Information,2007,10461,5435,1364,1026,7825,1185,483,9493,968,16545,5450,1370,1050,7870,1295,705,9870,6675,517090,3898,5549,11617,22823,35551,25403,80229,192915,56276054000,415834000,324715000,585830000,1214122000,2314436000,1653095000,4873404000,17216908000
Washington,Management of Companies and Enterprises,2007,3846,381,115,180,676,751,1056,2483,1363,4990,385,130,185,700,760,1105,2565,2425,394241,421,530,811,1838,8143,32159,42165,352101,35647375000,92329000,78830000,56355000,228561000,532821000,2036708000,2799240000,32843815000
Washington,Manufacturing,2007,36678,15665,6110,5000,26775,5892,1835,34502,2176,38145,15665,6115,5020,26800,6035,2155,34990,3155,1072560,23236,35885,57962,124530,214527,175802,576741,369824,52386831000,1033738000,1279233000,2300879000,4791275000,9118128000,8633904000,24748426000,20778508000
Washington,"Mining, Quarrying, and Oil and Gas Extraction",2007,809,305,105,165,575,97,50,722,87,950,305,105,165,575,130,65,770,180,18856,266,691,1805,2904,3299,0,7925,6743,898983000,23629000,30062000,70468000,126406000,152819000,0,439425000,315385000
Washington,Other,2007,262,255,5,1,261,1,0,262,0,262,255,5,1,261,1,0,262,0,268,195,0,0,232,0,0,268,0,5887000,5272000,0,0,5501000,0,0,5887000,0
Washington,Other Services (except Public Administration),2007,74642,46366,14998,7499,68863,4469,744,74076,566,82635,46865,15065,7905,69835,6165,2045,78045,4590,560336,82165,97056,95065,276572,142212,48704,490570,39748,14735575000,1998262000,2224177000,2380895000,6623743000,3818909000,1530389000,12420554000,1496611000
Washington,"Professional, Scientific, and Technical Services",2007,94606,67255,11587,6954,85796,5094,1717,92607,1999,99050,67260,11620,7130,86010,5810,2545,94365,4685,826615,89880,74775,89090,263281,163436,119646,554619,252382,55147480000,5024225000,3654082000,5050761000,13776297000,11427888000,9253004000,34848978000,19610006000
Washington,Real Estate and Rental and Leasing,2007,43113,33397,4758,2168,40323,1577,580,42480,633,52350,33440,4840,2590,40870,2595,2130,45595,6755,254633,44782,27853,26792,104428,45498,28174,192667,51555,9324840000,1592504000,957284000,1035710000,3603111000,1618386000,1266811000,6781890000,2145309000
Washington,Retail Trade,2007,79123,41758,16371,9630,67759,7477,1557,76793,2330,114950,41845,16730,10660,69235,11565,5540,86340,28610,1544204,59447,97330,119336,286545,258254,119430,686449,766485,41216566000,1705534000,2279467000,3127708000,7144846000,8641784000,4376268000,20785069000,19679836000
Washington,Total,2007,153567,92805,26216,15968,134989,12783,3058,150830,2737,184542,92981,26446,16801,136228,16672,8247,161147,23395,2501684,149672,172252,211611,533535,465683,366158,1365376,1136308,112307548000,5416609000,5429946000,7094775000,17941330000,17766709000,15752162000,51460201000,60847347000
Washington,Transportation and Warehousing,2007,22127,12765,2710,2111,17586,2002,993,20581,1546,25645,12765,2760,2180,17705,2385,1530,21620,4025,439339,16954,16575,25499,61369,60761,46672,183318,234272,19406802000,704180000,599201000,948571000,2317084000,2284402000,2020818000,7009310000,11959134000
Washington,Utilities,2007,1042,640,165,55,860,80,27,967,75,1510,640,170,55,865,125,70,1060,450,35044,1070,950,617,2708,2731,0,4724,1371,2620957000,21875000,27819000,28243000,87765000,178177000,0,206616000,104437000
Washington,Wholesale Trade,2007,40483,20090,6344,4170,30604,5033,1999,37636,2847,48280,20125,6440,4485,31050,6375,3475,40900,7380,645054,29862,38672,47957,122976,148957,109913,394316,216128,34570881000,1656294000,1944293000,2444297000,6114598000,7603527000,5064727000,19339720000,13913794000
West Virginia,Accommodation and Food Services,2007,13535,5535,2680,2260,10475,2127,487,13089,446,18045,5535,2685,2350,10570,2865,1730,15165,2880,308437,7227,17877,29880,56569,76248,54508,188817,118726,3628312000,152351000,178689000,308617000,642395000,866879000,594006000,2111567000,1514651000
West Virginia,Administrative and Support and Waste Management and Remediation Services,2007,6502,3375,1100,715,5190,601,208,5999,503,7195,3375,1100,720,5195,655,280,6130,1065,156930,4871,6377,8162,21427,19863,19802,68483,76566,3513821000,132285000,157327000,233415000,542174000,534639000,364391000,1587122000,1649887000
West Virginia,"Agriculture, Forestry, Fishing and Hunting",2007,1578,1175,290,75,1540,10,10,1560,18,1590,1175,290,75,1540,10,15,1565,25,5511,2174,1662,937,4868,0,0,5405,0,123651000,42108000,26704000,27037000,97763000,0,0,119388000,0
West Virginia,"Arts, Entertainment, and Recreation",2007,3704,1975,825,445,3245,336,59,3640,64,3940,1975,825,515,3315,475,70,3860,80,51648,2329,5170,5351,14034,9550,5658,31838,18853,937789000,72451000,85352000,94890000,263002000,139942000,68351000,507850000,415282000
West Virginia,Construction,2007,22018,14365,4040,1970,20375,1272,254,21901,117,22125,14365,4040,1970,20375,1285,310,21970,155,158319,23110,25340,24988,75881,44197,20833,149249,4517,6191719000,659251000,628922000,811516000,2137890000,1886911000,1246401000,5695669000,278720000
West Virginia,Educational Services,2007,1308,565,250,125,940,238,80,1258,50,1390,565,250,125,940,250,90,1280,110,36651,749,1373,1255,4216,5974,7267,18487,14105,704560000,18663000,28042000,20816000,73362000,102019000,147001000,346879000,214229000
West Virginia,Finance and Insurance,2007,6049,3533,945,350,4828,450,178,5456,593,10910,3535,955,490,4980,1175,770,6925,3985,98611,6688,5519,4061,16987,15173,10318,44620,13106,3842003000,198368000,176836000,163564000,551041000,525136000,335034000,1470145000,2143676000
West Virginia,Health Care and Social Assistance,2007,18328,7455,4645,2633,14733,2039,886,17658,670,24230,7465,4665,2700,14830,2985,2665,20480,3750,561329,15467,28986,33306,79046,77195,112437,273777,275279,19228640000,552827000,892470000,1164561000,2628087000,2311696000,2737960000,7771306000,10999501000
West Virginia,Information,2007,1609,600,270,235,1105,167,95,1367,242,3405,600,270,235,1105,240,175,1520,1885,34328,473,1304,2386,4644,4801,4255,17076,17203,1886181000,19366000,27698000,47412000,112696000,143669000,136310000,493805000,1365804000
West Virginia,Management of Companies and Enterprises,2007,830,60,25,15,100,165,260,525,305,985,60,25,15,100,165,275,540,445,22755,98,116,140,308,1493,6216,8190,14565,1242985000,2659000,5999000,5835000,14529000,58909000,319830000,393545000,849440000
West Virginia,Manufacturing,2007,6596,2025,1075,1045,4145,1264,433,5842,754,7035,2025,1075,1045,4145,1365,520,6030,1005,246651,1778,5449,10910,21676,37731,15880,94690,119417,10815193000,69159000,147224000,315630000,600377000,1216194000,664961000,3202050000,6483551000
West Virginia,"Mining, Quarrying, and Oil and Gas Extraction",2007,2681,1121,400,300,1821,471,185,2477,204,3325,1125,400,310,1835,495,225,2555,770,137627,1039,2188,3421,8189,17475,18073,46070,90201,8064090000,115757000,89420000,134953000,344670000,760682000,997466000,2205220000,5803323000
West Virginia,Other,2007,22,21,1,0,22,0,0,22,0,22,21,1,0,22,0,0,22,0,22,0,0,0,22,0,0,22,0,343000,307000,0,0,343000,0,0,343000,0
West Virginia,Other Services (except Public Administration),2007,22463,14420,4640,1985,21045,1013,159,22217,246,23995,14420,4675,2060,21155,1410,205,22770,1225,132189,24974,28783,25329,81455,31167,5084,122322,3269,2693757000,436727000,497921000,498096000,1452772000,688231000,157799000,2409200000,209923000
West Virginia,"Professional, Scientific, and Technical Services",2007,14011,8710,2395,1200,12305,876,325,13506,505,15215,8710,2405,1245,12360,1310,450,14120,1095,112506,14376,15296,15185,46065,25626,12628,88600,19494,4714569000,464280000,478350000,602279000,1573310000,1178738000,596825000,3450854000,1110335000
West Virginia,Real Estate and Rental and Leasing,2007,6506,4735,825,324,5884,233,88,6205,301,7780,4750,855,385,5990,335,310,6635,1145,33110,7740,4550,3180,16462,5041,691,25408,5607,871020000,186299000,113630000,101016000,413651000,127696000,15098000,635175000,203008000
West Virginia,Retail Trade,2007,22344,10560,4843,2949,18352,2285,407,21044,1300,35015,10580,4940,3245,18765,3575,1795,24135,10880,384163,16255,28629,33321,84493,70579,23356,191266,159868,7510677000,346433000,570029000,752524000,1742563000,1779394000,477216000,4124848000,2760557000
West Virginia,Total,2007,31923,17280,6245,3604,27129,2887,753,30769,1154,40492,17295,6311,3809,27415,4102,2138,33655,6837,581023,31771,40819,47646,120236,105577,82032,307845,273178,18058858000,773283000,917119000,1232798000,2923200000,2969541000,2452215000,8344956000,9713902000
West Virginia,Transportation and Warehousing,2007,6297,3590,900,585,5075,581,164,5820,477,7020,3590,910,585,5085,615,215,5915,1105,72132,5504,5324,6858,18651,16038,4161,42379,19137,2505249000,155080000,148224000,194939000,512579000,515526000,150075000,1249229000,858670000
West Virginia,Utilities,2007,381,125,65,50,240,35,20,295,86,1100,125,65,50,240,85,20,345,755,27196,128,158,0,905,783,0,457,20174,1876915000,3585000,5775000,0,20187000,25977000,0,11164000,1534887000
West Virginia,Wholesale Trade,2007,6668,2390,1095,872,4357,962,399,5718,950,8050,2395,1120,925,4440,1215,570,6225,1825,96862,2745,5531,7449,20029,22544,11296,61814,27703,4138995000,152831000,185796000,301584000,671183000,904297000,492073000,2337956000,1439191000
Wisconsin,Accommodation and Food Services,2007,60341,25267,11109,11221,47597,10834,1110,59541,800,72005,25340,11125,11355,47820,12630,3910,64360,7645,1130852,39948,73915,151212,267066,393708,155964,817482,236354,12910817000,810935000,713860000,1380874000,2910760000,4169344000,1822273000,8913028000,3967356000
Wisconsin,Administrative and Support and Waste Management and Remediation Services,2007,29369,17665,4392,2705,24762,2467,851,28080,1289,34145,17675,4410,2755,24840,2850,1510,29200,4945,682323,24393,28102,35045,88280,86923,115353,303857,339434,17122234000,888479000,792471000,997424000,2734240000,2228078000,2563313000,7783202000,8261756000
Wisconsin,"Agriculture, Forestry, Fishing and Hunting",2007,2613,1985,375,120,2480,65,40,2585,28,2640,1985,375,120,2480,65,45,2590,50,16475,1846,2303,1285,6608,918,0,12018,1749,633419000,73094000,60187000,34317000,172569000,37816000,0,425088000,83150000
Wisconsin,"Arts, Entertainment, and Recreation",2007,13116,7655,1812,1648,11115,1596,262,12973,143,13500,7655,1820,1675,11150,1720,295,13165,335,180159,9938,11618,21612,44544,58574,36314,147161,8492,4584975000,360217000,227578000,343491000,946433000,973240000,1948115000,4036510000,90795000
Wisconsin,Construction,2007,82705,56835,13680,6615,77130,4689,513,82332,373,83530,56835,13680,6630,77145,4900,715,82760,770,584351,90383,88707,87060,266650,167588,57995,506678,65645,29659432000,3518836000,3387451000,3893205000,10804020000,9117211000,3836693000,24896536000,4404803000
Wisconsin,Educational Services,2007,6961,2835,1180,995,5010,1475,220,6705,256,7475,2835,1180,1020,5035,1590,355,6980,495,252993,3191,7595,12809,25353,56837,25103,108119,139308,6912278000,115410000,134549000,240168000,496078000,1207444000,673642000,2448791000,4407746000
Wisconsin,Finance and Insurance,2007,26363,17048,3239,1449,21736,2203,908,24847,1516,48280,17070,3340,1740,22150,5415,4950,32515,15765,703983,25642,19166,18206,65731,73938,97474,239256,444024,40671764000,1053529000,825473000,847084000,2799228000,3371354000,5226341000,11510005000,28345618000
Wisconsin,Health Care and Social Assistance,2007,51601,22277,11535,7664,41476,6194,2246,49916,1685,71840,22295,11670,8215,42180,9720,6645,58545,13295,1809344,38401,75677,101584,217874,229365,329640,785116,1002188,69864140000,2138071000,2881448000,3828225000,8925641000,8596997000,8871550000,26696787000,42525981000
Wisconsin,Information,2007,5940,2455,910,713,4078,845,269,5192,748,11400,2455,910,745,4110,1215,445,5770,5630,254056,3271,4345,9248,17708,28362,16991,69578,162791,12594774000,150078000,191611000,313094000,684439000,1075524000,638019000,2599702000,9827178000
Wisconsin,Management of Companies and Enterprises,2007,3576,285,55,115,455,750,1032,2237,1339,5420,285,55,120,460,765,1090,2315,3105,336300,407,283,46,1275,9040,32935,43335,292684,27391975000,44964000,23550000,25133000,99410000,454990000,1885055000,2439455000,24927021000
Wisconsin,Manufacturing,2007,44486,13810,6945,6814,27569,9730,3707,41006,3480,48230,13815,6955,6865,27635,10215,4675,42525,5705,2332099,19358,41937,84394,158013,387080,461536,1065732,1141561,104182416000,875610000,1450600000,3114620000,5703312000,15619424000,19611317000,43377596000,55206427000
Wisconsin,"Mining, Quarrying, and Oil and Gas Extraction",2007,695,270,125,65,460,127,41,628,67,775,270,125,65,460,140,85,685,90,15012,202,798,628,1793,3120,2993,8272,6366,723827000,20632000,31581000,34139000,89031000,157922000,140128000,405468000,296471000
Wisconsin,Other,2007,166,166,0,0,166,0,0,166,0,166,166,0,0,166,0,0,166,0,0,0,0,0,0,0,0,0,0,1862000,1862000,0,0,1862000,0,0,1862000,0
Wisconsin,Other Services (except Public Administration),2007,70890,41075,15700,8249,65024,4739,586,70349,541,76830,41100,15810,8615,65525,6355,1585,73465,3365,574889,73630,101640,105799,286387,154593,46876,495161,69557,12463912000,1673458000,1991139000,2028470000,5731408000,3330753000,1075631000,10292816000,1720742000
Wisconsin,"Professional, Scientific, and Technical Services",2007,54477,35410,8290,4976,48676,3640,913,53229,1248,57835,35430,8320,5145,48895,4435,1545,54875,2960,504742,48797,52852,64637,171687,121509,65841,374898,110653,26502411000,2223392000,2241461000,2971834000,7470286000,6545487000,4141041000,18597953000,7634943000
Wisconsin,Real Estate and Rental and Leasing,2007,20740,15150,2675,1268,19093,854,382,20329,411,25405,15170,2745,1390,19305,1340,1625,22270,3135,135659,22476,16294,15480,55648,25091,18146,104051,25606,4128680000,650407000,444302000,494904000,1603625000,832105000,632386000,3293767000,783658000
Wisconsin,Retail Trade,2007,71673,34571,15374,9770,59715,7827,1806,69348,2325,105325,34800,15810,10850,61460,11600,6455,79515,25810,1584057,57672,96394,125505,285732,264058,157852,725212,675242,34136932000,1395150000,2005534000,2756814000,6208407000,7012563000,3938968000,17469773000,13928015000
Wisconsin,Total,2007,117426,64790,21037,14024,99851,12425,2742,115018,2408,146286,64891,21272,14764,100927,16688,8033,125648,20638,2484051,108793,138740,187862,435395,469803,392796,1297994,1186057,92637609000,3619881000,3927840000,5409604000,12957325000,15207870000,14212417000,42377612000,50259997000
Wisconsin,Transportation and Warehousing,2007,24809,14785,3120,2349,20254,2544,814,23612,1197,28000,14785,3125,2400,20310,2845,1240,24395,3605,511875,16459,19701,29533,72322,85034,70880,234588,272839,18557316000,758200000,628141000,943596000,2367084000,2858676000,2414182000,7765326000,10631179000
Wisconsin,Utilities,2007,372,85,25,25,135,130,15,280,92,1340,85,25,30,140,185,25,350,990,61176,46,0,330,583,4562,0,6832,53874,4540902000,3195000,0,20408000,26565000,228286000,0,355898000,4166175000
Wisconsin,Wholesale Trade,2007,30658,13710,4815,3896,22421,4350,1700,28471,2187,36625,13740,4880,4085,22705,5455,2970,31130,5495,570064,20734,28556,46169,99825,138368,110111,367616,175060,27733687000,1085675000,1309811000,2206747000,4707297000,6401057000,5000365000,16597808000,9664585000
Wyoming,Accommodation and Food Services,2007,7597,2810,1630,1260,5700,1480,213,7393,204,8790,2820,1630,1270,5720,1775,575,8070,720,131933,3771,10854,17090,31877,50738,23448,106547,13195,2134346000,139296000,133722000,195731000,472217000,731425000,348074000,1556664000,449659000
Wyoming,Administrative and Support and Waste Management and Remediation Services,2007,4245,2770,632,328,3730,230,55,4015,230,4485,2770,645,355,3770,245,55,4070,415,37283,3092,3059,3024,11645,4132,0,20825,9702,1031913000,138937000,88172000,72764000,334803000,119764000,0,622413000,357367000
Wyoming,"Agriculture, Forestry, Fishing and Hunting",2007,460,375,50,15,440,10,0,450,10,460,375,50,15,440,10,0,450,10,851,462,84,34,886,0,0,826,0,31310000,12598000,4951000,1259000,26358000,0,0,29254000,0
Wyoming,"Arts, Entertainment, and Recreation",2007,2112,1480,210,205,1895,175,20,2090,22,2200,1480,210,205,1895,205,20,2120,80,15140,1510,1137,2333,5914,4434,0,11012,0,324664000,79338000,18837000,34183000,146799000,99118000,0,279942000,0
Wyoming,Construction,2007,15253,10010,2770,1485,14265,803,105,15173,80,15290,10010,2770,1490,14270,815,115,15200,90,97188,15124,17292,18919,53134,26656,5830,90413,3465,4450450000,592732000,609238000,784384000,2023415000,1384224000,388093000,4004120000,224467000
Wyoming,Educational Services,2007,715,420,75,100,595,70,25,690,25,755,420,75,100,595,70,60,725,30,6457,445,290,996,1945,2074,1094,6271,0,166825000,14823000,5925000,14928000,40980000,44056000,34061000,149462000,0
Wyoming,Finance and Insurance,2007,3091,1930,370,159,2459,261,69,2789,302,4920,1930,380,235,2545,700,195,3440,1480,31909,2699,1975,1695,6772,8271,1736,19108,12117,1417929000,102810000,76522000,60094000,260792000,337891000,71885000,757227000,615470000
Wyoming,Health Care and Social Assistance,2007,7703,3885,1573,1009,6467,724,279,7470,233,8595,3885,1575,1010,6470,1045,505,8020,575,142349,5115,9697,11747,29696,24670,41788,103852,33199,5188060000,323797000,364356000,442920000,1164639000,860112000,1563517000,3795529000,1267806000
Wyoming,Information,2007,1148,440,160,135,735,212,73,1020,128,1695,440,165,145,750,275,160,1185,510,21118,289,109,1122,3186,5352,1227,13156,0,755236000,20397000,18972000,30533000,101198000,141263000,55859000,421345000,110617000
Wyoming,Management of Companies and Enterprises,2007,388,50,10,35,95,90,80,265,123,465,50,10,35,95,90,85,270,195,8175,0,0,39,0,1138,1205,2783,0,524550000,4620000,0,7670000,13466000,81388000,84834000,197828000,262825000
Wyoming,Manufacturing,2007,2777,1370,425,320,2115,345,120,2580,197,2850,1370,425,335,2130,350,140,2620,230,41622,1216,1542,2211,6418,7204,2673,23257,14485,2168911000,53738000,48524000,73983000,209199000,296624000,156629000,919304000,1017297000
Wyoming,"Mining, Quarrying, and Oil and Gas Extraction",2007,3853,1695,645,465,2805,510,113,3428,425,4280,1695,645,465,2805,515,170,3490,790,133534,2264,3494,5966,11565,17310,8220,38985,87983,8527172000,135671000,177051000,285220000,610621000,1052115000,408725000,2115912000,6052940000
Wyoming,Other,2007,45,39,5,1,45,0,0,45,0,45,39,5,1,45,0,0,45,0,0,31,0,0,0,0,0,0,0,1442000,705000,498000,0,1442000,0,0,1442000,0
Wyoming,Other Services (except Public Administration),2007,9161,6015,1780,845,8640,305,95,9040,121,9480,6015,1790,915,8720,380,105,9205,275,44327,10130,10527,9797,32799,6917,350,41952,1091,1151758000,264197000,246511000,257778000,793443000,180291000,16687000,1043599000,56830000
Wyoming,"Professional, Scientific, and Technical Services",2007,9437,6710,1370,712,8792,347,140,9279,158,9715,6710,1370,740,8820,430,165,9415,300,45140,8367,7929,8345,26832,8380,3186,41842,1842,1995859000,424542000,327197000,371139000,1157172000,429182000,173619000,1880500000,76509000
Wyoming,Real Estate and Rental and Leasing,2007,5072,3980,450,230,4660,165,60,4885,187,5540,3990,450,230,4670,245,220,5135,405,21155,5085,2474,2075,10502,2591,741,16452,4768,725349000,190516000,67585000,62386000,346129000,95225000,15710000,483121000,226672000
Wyoming,Retail Trade,2007,11707,5680,2460,1401,9541,1157,307,11005,702,14945,5680,2485,1560,9725,1660,745,12130,2815,138561,6718,12755,15470,40383,31024,7034,90741,40532,3393735000,228820000,314353000,425768000,1008593000,921666000,216624000,2318260000,935198000
Wyoming,Total,2007,18114,10704,3138,1855,15697,1436,356,17489,625,20765,10710,3161,1966,15837,1939,787,18563,2202,215615,17777,20393,24487,62657,47871,31005,141533,74082,8162130000,608267000,583948000,742658000,1934873000,1642688000,1160847000,4738408000,3423722000
Wyoming,Transportation and Warehousing,2007,4012,2510,580,305,3395,225,80,3700,312,4610,2510,580,320,3410,255,205,3870,740,38426,2937,3594,2906,10677,5807,0,22624,11376,1713471000,124961000,147773000,122509000,424565000,269440000,0,995109000,532955000
Wyoming,Utilities,2007,220,80,20,25,125,35,10,170,50,555,80,20,35,135,70,45,250,305,10043,0,42,0,0,1309,0,2634,6087,771199000,3111000,1476000,0,5325000,78209000,0,157387000,493248000
Wyoming,Wholesale Trade,2007,3127,1125,480,335,1940,448,229,2617,510,3970,1125,505,365,1995,560,370,2925,1045,36570,1021,1810,3385,7742,6756,2328,20845,12825,1980939000,66556000,91808000,150162000,346485000,337359000,143398000,1006918000,845966000
