state_name,industry_name,YEAR,firms_01: Total,firms_02: <5,firms_03: 5-9,firms_04: 10-19,firms_05: <20,firms_06: 20-99,firms_07: 100-499,firms_08: <500,firms_09: 500+,establishments_01: Total,establishments_02: <5,establishments_03: 5-9,establishments_04: 10-19,establishments_05: <20,establishments_06: 20-99,establishments_07: 100-499,establishments_08: <500,establishments_09: 500+,employment_01: Total,employment_02: <5,employment_03: 5-9,employment_04: 10-19,employment_05: <20,employment_06: 20-99,employment_07: 100-499,employment_08: <500,employment_09: 500+,annual_payroll_01: Total,annual_payroll_02: <5,annual_payroll_03: 5-9,annual_payroll_04: 10-19,annual_payroll_05: <20,annual_payroll_06: 20-99,annual_payroll_07: 100-499,annual_payroll_08: <500,annual_payroll_09: 500+
Alabama,Accommodation and Food Services,2013,28542,10395,5248,5638,21281,5489,889,27659,883,41915,10415,5290,5725,21430,6590,3495,31515,10400,807081,17683,34945,77168,130996,194821,121110,448511,358411,11169270000,433240000,451473000,969433000,1862270000,2628231000,1521108000,6035435000,5130794000
Alabama,Administrative and Support and Waste Management and Remediation Services,2013,18138,9750,2900,1563,14213,1831,748,16792,1346,21000,9760,2910,1595,14265,1950,975,17190,3810,664886,15784,18307,19819,55914,67755,90796,221057,427908,17725152000,539564000,524637000,654061000,1743858000,2138533000,2450192000,6507792000,10597257000
Alabama,"Agriculture, Forestry, Fishing and Hunting",2013,3904,1895,1165,515,3575,235,33,3843,61,3980,1895,1165,515,3575,240,35,3850,130,30945,3263,7093,6589,17420,7082,998,27135,1286,1140608000,125657000,231436000,247956000,611168000,280387000,24034000,970341000,95875000
Alabama,"Arts, Entertainment, and Recreation",2013,5116,2940,795,565,4300,609,114,5023,93,5455,2940,795,600,4335,640,175,5150,305,78176,3977,5087,6930,16773,23913,12788,57627,17347,1472114000,117119000,95747000,119661000,346884000,424541000,268190000,1118179000,317765000
Alabama,Construction,2013,36165,21335,6435,4095,31865,3366,516,35747,418,36795,21335,6435,4095,31865,3465,590,35920,875,390804,37789,41467,53489,134845,121681,57574,324949,56254,17193315000,1239895000,1397110000,2022910000,4685205000,5367093000,2871988000,13520470000,3095898000
Alabama,Educational Services,2013,3927,1665,635,570,2870,660,200,3730,197,4215,1665,635,575,2875,735,260,3870,345,140258,2415,4111,7235,14469,25012,26936,67860,69647,4103606000,63823000,68986000,121660000,262304000,520866000,811945000,1679214000,2376376000
Alabama,Finance and Insurance,2013,15898,9890,2175,855,12920,1168,555,14643,1255,35790,9900,2250,1235,13385,3380,3275,20040,15750,340078,17169,12203,9264,41618,40389,34438,120564,122850,21560311000,721902000,595165000,515662000,1899548000,1950100000,1757700000,5812162000,15537136000
Alabama,Health Care and Social Assistance,2013,40532,16390,10485,6485,33360,4637,1411,39408,1124,51570,16405,10535,6795,33735,6095,5285,45115,6455,1200466,33000,69357,85041,189873,170682,198046,567800,615973,51916431000,1831243000,2932699000,3935924000,8731887000,7977755000,6912112000,23842225000,27583758000
Alabama,Information,2013,3664,1500,575,371,2446,410,242,3098,566,7330,1500,585,400,2485,520,310,3315,4015,149088,2402,3183,4232,10552,10573,15451,47536,97022,8098905000,88661000,121041000,187670000,423277000,639298000,748243000,2191780000,5772634000
Alabama,Management of Companies and Enterprises,2013,2249,85,65,20,170,505,621,1296,953,3085,85,65,20,170,510,690,1370,1715,83285,80,325,20,530,5401,12170,18265,64984,6566885000,8548000,19555000,579000,32311000,313246000,770430000,1125615000,5439367000
Alabama,Manufacturing,2013,19374,6295,3115,2339,11749,3652,1568,16969,2405,20995,6295,3115,2360,11770,3700,1785,17255,3740,1080382,8264,17652,25363,57753,126430,138789,362914,623020,51600410000,415322000,592717000,982563000,2166946000,5274392000,5753946000,14845827000,32476613000
Alabama,"Mining, Quarrying, and Oil and Gas Extraction",2013,968,295,100,120,515,155,77,747,221,1220,295,100,120,515,170,90,775,445,36625,271,408,845,2141,5789,3201,12481,22648,2706715000,17947000,23522000,39055000,92504000,246587000,185050000,621223000,1896554000
Alabama,Other,2013,118,113,5,0,118,0,0,118,0,118,113,5,0,118,0,0,118,0,120,90,30,0,120,0,0,120,0,2284000,1881000,403000,0,2284000,0,0,2284000,0
Alabama,Other Services (except Public Administration),2013,50744,31320,10491,4854,46665,3132,427,50224,520,54790,31335,10550,5085,46970,4025,890,51885,2905,396477,61150,67459,62361,194501,106677,34090,342458,39041,9338631000,1378079000,1380408000,1444196000,4229042000,2291512000,763893000,7488004000,1453786000
Alabama,"Professional, Scientific, and Technical Services",2013,41614,27428,6030,3437,36895,2686,860,40441,1173,46205,27435,6050,3510,36995,3285,1205,41485,4720,460174,44612,38173,44474,129549,87544,63516,286698,162422,30304301000,1963166000,1766531000,2379062000,6177658000,5704845000,5367496000,17407211000,12401202000
Alabama,Real Estate and Rental and Leasing,2013,14605,10375,1752,847,12974,718,380,14072,533,19265,10400,1845,980,13225,1285,1270,15780,3485,111785,15663,10344,10462,38083,20069,17307,77192,33772,4088022000,545234000,375618000,348491000,1277880000,804969000,636307000,2759033000,1273583000
Alabama,Retail Trade,2013,55595,31590,11190,5408,48188,4422,973,53583,2012,90170,31680,11385,5945,49010,7945,3620,60575,29595,1015871,53285,69356,66960,203011,144718,73556,432898,540480,24660865000,1362465000,1684829000,1868642000,4998562000,4651260000,2495548000,12354134000,11561503000
Alabama,Total,2013,73371,39890,13622,8199,61711,7258,1977,70946,2425,97578,39946,13760,8647,62353,9949,5461,77763,19815,1603100,74251,89532,108818,272601,264020,228672,765293,837807,62408287000,2427857000,2774013000,3645259000,8847129000,9614058000,8719813000,27181000000,35227287000
Alabama,Transportation and Warehousing,2013,12159,6515,1564,1102,9181,1236,615,11032,1127,14225,6515,1565,1115,9195,1350,870,11415,2810,287697,10092,9529,12209,35043,35533,43094,119916,141446,12376929000,364401000,315066000,416186000,1168772000,1265618000,1688338000,4396524000,6844614000
Alabama,Utilities,2013,566,160,135,25,320,110,30,460,106,2180,160,135,25,320,210,80,610,1570,41988,6,870,350,1511,5223,3006,10075,5911,3409367000,8851000,31455000,15180000,55486000,349601000,201841000,618668000,497983000
Alabama,Wholesale Trade,2013,21401,9128,3330,2426,14884,2773,1386,19043,2358,27115,9150,3365,2540,15055,3650,2405,21110,6005,350181,14134,21033,28434,66985,73627,62754,215778,117409,18488895000,707651000,1009245000,1398641000,3182990000,3706011000,3290643000,10726211000,6963021000
Alaska,Accommodation and Food Services,2013,9010,4330,1775,1429,7534,1082,182,8798,212,10675,4340,1805,1440,7585,1370,750,9705,970,138458,5247,11409,19024,36383,38125,22237,99595,37381,3441400000,282316000,219297000,340254000,847975000,807694000,480886000,2244432000,1174178000
Alaska,Administrative and Support and Waste Management and Remediation Services,2013,4980,2950,760,455,4165,333,125,4623,357,5755,2950,760,465,4175,430,215,4820,935,95398,2891,4080,4848,13481,8442,6343,36275,52145,4251752000,181649000,159455000,192721000,567893000,346126000,184812000,1452593000,2457179000
Alaska,"Agriculture, Forestry, Fishing and Hunting",2013,2160,2055,30,30,2115,20,15,2150,10,2165,2055,30,30,2115,20,15,2150,15,4789,43,0,230,310,0,0,3183,0,264823000,102217000,0,5703000,122983000,12388000,0,220073000,0
Alaska,"Arts, Entertainment, and Recreation",2013,2560,1780,335,215,2330,195,15,2540,20,2730,1780,345,255,2380,210,30,2620,110,22362,1422,1775,2765,6455,6224,957,14311,0,453274000,103044000,37289000,58826000,207357000,117240000,14133000,360924000,0
Alaska,Construction,2013,11870,8175,1860,952,10987,579,83,11649,221,12110,8175,1860,955,10990,630,90,11710,400,88544,9252,10923,11926,34373,17682,3233,59384,27045,7254163000,804918000,768155000,1007055000,2632221000,1689184000,436018000,5026482000,2118074000
Alaska,Educational Services,2013,1183,590,225,165,980,110,45,1135,48,1360,590,225,165,980,125,175,1280,80,15507,667,1217,1882,4531,2711,3294,13316,573,427876000,26922000,33223000,38170000,117688000,72770000,74426000,345384000,20394000
Alaska,Finance and Insurance,2013,2110,1095,340,120,1555,130,107,1792,318,3815,1095,345,125,1565,285,395,2245,1570,35361,1608,1775,901,4657,2780,180,11810,15838,2221458000,103142000,93322000,59116000,286089000,160881000,170099000,804338000,1127836000
Alaska,Health Care and Social Assistance,2013,10145,4640,2325,1545,8510,873,434,9817,328,12235,4640,2325,1595,8560,1150,925,10635,1600,225665,7616,15145,18694,43201,29043,57683,137387,79623,12319358000,552009000,740149000,1188127000,2521982000,1597100000,2634559000,6949339000,4858392000
Alaska,Information,2013,1040,435,150,115,700,135,68,903,137,1970,435,150,130,715,230,205,1150,820,31912,395,639,432,2443,2983,2623,7386,10163,2005414000,25153000,29772000,34226000,101965000,142378000,158228000,486210000,1405916000
Alaska,Management of Companies and Enterprises,2013,577,25,15,25,65,136,155,356,221,840,25,15,25,65,140,195,400,440,32205,0,0,306,338,1420,5503,7270,25027,3640962000,0,3640000,25627000,39725000,74040000,346926000,461885000,3188359000
Alaska,Manufacturing,2013,2297,1205,430,225,1860,245,40,2145,152,2635,1210,430,225,1865,270,70,2205,430,56399,698,1772,1838,5882,5287,1224,18091,37593,2379716000,98082000,77310000,116384000,365200000,240157000,180721000,896534000,1446808000
Alaska,"Mining, Quarrying, and Oil and Gas Extraction",2013,710,320,65,75,460,55,74,589,121,850,320,65,75,460,55,75,590,260,52985,115,0,826,1250,1209,5131,9454,40193,5684114000,47067000,17669000,98035000,202146000,161819000,596801000,1360840000,4287176000
Alaska,Other,2013,30,30,0,0,30,0,0,30,0,30,30,0,0,30,0,0,30,0,0,0,0,0,0,0,0,0,0,454000,454000,0,0,454000,0,0,454000,0
Alaska,Other Services (except Public Administration),2013,8439,5160,1828,785,7773,400,75,8248,191,9075,5170,1855,850,7875,565,270,8710,365,48359,8547,11318,9111,29807,11494,177,45086,1483,1625697000,280624000,341800000,342381000,986091000,397828000,7290000,1491036000,72228000
Alaska,"Professional, Scientific, and Technical Services",2013,8699,5635,990,685,7310,570,228,8108,591,9645,5635,995,710,7340,695,330,8365,1280,93132,7411,5972,5851,23482,15654,9568,51485,37307,6475574000,557970000,407837000,541006000,1565992000,1176319000,820582000,3700238000,2450332000
Alaska,Real Estate and Rental and Leasing,2013,3902,2825,440,205,3470,173,73,3716,186,4390,2830,460,230,3520,280,270,4070,320,21419,3718,2078,2035,8800,3333,1911,16581,2749,1027572000,152900000,107116000,70740000,353738000,156156000,86556000,699822000,171147000
Alaska,Retail Trade,2013,9543,4795,1898,1233,7926,863,191,8980,563,12515,4860,1955,1345,8160,1345,545,10050,2465,153506,5913,10685,13239,33106,21012,9408,71904,48571,4795778000,276271000,333334000,396162000,1088391000,789008000,380814000,2477621000,1485292000
Alaska,Total,2013,16733,9955,2869,1742,14566,1211,347,16124,609,20519,9983,2925,1850,14758,1750,1121,17629,2890,266627,14927,18905,23087,56919,42143,42254,141316,125311,14601116000,801873000,798067000,1066884000,2666824000,2043633000,2143784000,6854241000,7746875000
Alaska,Transportation and Warehousing,2013,4298,2525,573,285,3383,288,223,3894,404,5420,2525,575,285,3385,410,500,4295,1125,73209,1663,2666,2545,8102,5718,7200,32111,31833,4742408000,190843000,163522000,132894000,525297000,304829000,549060000,1780955000,2240040000
Alaska,Utilities,2013,310,105,50,37,192,72,41,305,5,470,105,55,45,205,95,155,455,15,9186,45,217,421,881,2030,4250,8772,0,860912000,5129000,13724000,18514000,47367000,180113000,433932000,820682000,0
Alaska,Wholesale Trade,2013,2837,1015,360,270,1645,328,258,2231,606,3790,1025,375,300,1700,445,395,2540,1250,38375,986,1205,2044,6034,5331,5647,21219,12643,2501471000,60764000,95704000,130394000,369134000,299074000,345803000,1254501000,1010656000
Arizona,Accommodation and Food Services,2013,40868,13169,8150,7962,29281,9157,1223,39661,1207,59460,13180,8160,8085,29425,10620,4905,44950,14510,1257378,21459,54579,107163,184871,340214,181361,711687,548808,21948983000,585899000,723658000,1399786000,2717055000,5139986000,2631516000,10537977000,11138256000
Arizona,Administrative and Support and Waste Management and Remediation Services,2013,35491,20845,5185,3185,29215,3084,1275,33574,1917,40750,20850,5205,3220,29275,3310,1520,34105,6645,1140292,30184,32483,41198,103978,114857,177033,407748,730132,37103763000,1072854000,988782000,1299480000,3386446000,3457941000,5082491000,12151731000,24862165000
Arizona,"Agriculture, Forestry, Fishing and Hunting",2013,950,640,135,70,845,75,20,940,10,970,640,135,70,845,85,30,960,10,6762,601,185,751,2584,1986,860,6377,0,211180000,41669000,21368000,25755000,102232000,51684000,21912000,198520000,0
Arizona,"Arts, Entertainment, and Recreation",2013,7782,4355,840,825,6020,1068,475,7563,219,8805,4355,850,830,6035,1130,785,7950,855,184426,3042,4329,8945,17658,39334,64296,131650,37266,5931079000,211274000,136464000,190684000,587522000,708606000,3078336000,4502033000,949712000
Arizona,Construction,2013,55745,34345,9345,5360,49050,5043,925,55018,727,56330,34345,9345,5365,49055,5080,1105,55240,1090,616180,51646,61235,68504,185119,192995,108821,498086,95232,28693590000,2015585000,2158862000,2722206000,6936125000,8242702000,5275064000,20991295000,6184465000
Arizona,Educational Services,2013,8786,4005,1340,1175,6520,1553,376,8449,337,10300,4010,1350,1195,6555,1695,560,8810,1490,360959,4967,8377,15421,30280,63385,41734,136048,216997,11576624000,198339000,211716000,355527000,782969000,1839612000,1344843000,3982046000,7264307000
Arizona,Finance and Insurance,2013,24812,17870,2415,884,21169,872,743,22784,2028,47260,17885,2435,955,21275,1385,2305,24965,22295,633943,22963,13083,9959,46206,25880,46129,126726,478776,41359288000,1271273000,749084000,739759000,2845891000,1687376000,3049637000,7904536000,32510330000
Arizona,Health Care and Social Assistance,2013,66978,36850,13703,7340,57893,5570,1808,65271,1707,85165,36895,13810,7635,58340,8125,5655,72120,13045,1625111,56355,89348,93256,240295,209716,278125,741700,861103,77469136000,3801434000,3789940000,4015287000,11699340000,8521989000,11111355000,31683910000,44767652000
Arizona,Information,2013,6397,3275,715,524,4514,645,367,5526,871,10285,3275,715,525,4515,780,455,5750,4535,222045,3226,3971,5718,14260,18631,24398,64292,148024,12990313000,248636000,219309000,319084000,819857000,1037296000,1715705000,3771389000,8734444000
Arizona,Management of Companies and Enterprises,2013,3054,255,55,65,375,440,847,1662,1392,4635,255,55,65,375,445,920,1740,2895,230854,0,0,0,908,5245,29370,35744,195110,21877560000,37795000,9133000,1584000,82860000,295200000,1925720000,2303780000,19573780000
Arizona,Manufacturing,2013,20227,8355,3335,2805,14495,3147,1160,18802,1425,21120,8355,3335,2805,14495,3245,1340,19080,2040,615066,9875,18607,32509,68136,106896,78384,297774,250076,36675467000,533500000,705256000,1268867000,2737294000,4737250000,3679205000,12838687000,19786439000
Arizona,"Mining, Quarrying, and Oil and Gas Extraction",2013,955,420,145,94,659,144,42,845,110,1215,420,145,95,660,175,55,890,325,28664,194,460,931,2101,3497,0,8607,879,2074405000,20729000,36469000,39513000,143526000,189944000,58014000,638708000,1462812000
Arizona,Other,2013,182,176,3,3,182,0,0,182,0,182,176,3,3,182,0,0,182,0,191,132,0,39,191,0,0,191,0,6300000,5511000,0,701000,6300000,0,0,6300000,0
Arizona,Other Services (except Public Administration),2013,48183,29505,9455,4706,43666,3076,776,47518,665,53840,29540,9525,4925,43990,4075,2185,50250,3590,417763,51910,61958,60792,177676,104320,63972,354547,49389,11177456000,1433536000,1529989000,1594552000,4592779000,2586323000,1853374000,9199899000,1653171000
Arizona,"Professional, Scientific, and Technical Services",2013,76722,56712,8327,4541,69580,3776,1389,74745,1977,82365,56720,8350,4645,69715,4370,2085,76170,6195,637391,67704,53235,56699,187733,113961,72683,382669,229021,39310119000,4069895000,2716568000,3212221000,10040100000,7146891000,5160852000,22676812000,15905607000
Arizona,Real Estate and Rental and Leasing,2013,33552,26748,2860,1391,30999,1103,569,32671,881,41175,26765,2975,1530,31270,1655,1710,34635,6540,210686,24384,17219,16314,67185,30203,28456,132541,72134,9753585000,1512951000,623285000,623740000,2781996000,1349430000,1387235000,6033527000,3416707000
Arizona,Retail Trade,2013,49690,27494,9727,5092,42313,3697,1253,47263,2427,89015,27575,9980,5850,43405,6195,4645,54245,34770,1446067,38405,52975,54927,148858,110325,105280,384044,921042,38680426000,1231794000,1452255000,1721160000,4460542000,3875178000,4453789000,13275138000,23246406000
Arizona,Total,2013,102313,61384,16228,9932,87544,9066,2661,99271,3042,132762,61450,16378,10368,88196,11478,6795,106469,26293,2173205,96097,106897,131847,334841,332594,311977,979412,1193793,92770088000,4044076000,3571132000,4495092000,12110300000,11631418000,12577749000,36319467000,56450621000
Arizona,Transportation and Warehousing,2013,13562,7313,1760,1186,10259,1244,722,12225,1337,15805,7320,1770,1210,10300,1355,1015,12670,3135,331594,7725,9481,12310,31483,36147,38748,120124,201238,13610601000,376298000,380172000,444341000,1270456000,1302215000,1415438000,4222424000,9056866000
Arizona,Utilities,2013,793,420,105,50,575,42,69,686,107,1290,420,110,50,580,70,245,895,395,29310,817,610,254,2033,1550,8227,12036,154,2640672000,49624000,23819000,28959000,102822000,107936000,575460000,797924000,11165000
Arizona,Wholesale Trade,2013,27150,13540,3600,2596,19736,3072,1617,24425,2725,33115,13565,3625,2770,19960,3595,2455,26010,7105,476525,17174,21460,28659,74687,80930,59145,235421,227548,29510477000,1052828000,1041045000,1609440000,3810526000,4110409000,3049386000,11846737000,16906338000
Arkansas,Accommodation and Food Services,2013,20810,7095,3740,4315,15150,4491,560,20201,609,27205,7110,3775,4365,15250,5320,2195,22765,4440,471422,10693,24987,57821,95425,157946,71610,326065,144920,6211205000,244453000,294654000,715579000,1258085000,2009365000,862948000,4152135000,1997293000
Arkansas,Administrative and Support and Waste Management and Remediation Services,2013,11581,6645,1760,1025,9430,1000,355,10785,796,13125,6650,1760,1035,9445,1135,560,11140,1985,274645,9893,10389,12077,35253,34075,35208,116178,88630,8120266000,348895000,333287000,376032000,1101006000,891865000,763114000,3089172000,2823341000
Arkansas,"Agriculture, Forestry, Fishing and Hunting",2013,3136,1755,815,320,2890,150,25,3065,71,3270,1755,815,320,2890,170,25,3085,185,21330,2785,5088,3901,12508,3785,1112,19540,327,764679000,120595000,220601000,145653000,502483000,115944000,21430000,692417000,40508000
Arkansas,"Arts, Entertainment, and Recreation",2013,3989,2440,625,422,3487,340,92,3919,70,4070,2465,625,430,3520,355,120,3995,75,41302,3155,3190,5385,12822,10976,6611,34651,890,848809000,126269000,65250000,82877000,282227000,207286000,129528000,704623000,49321000
Arkansas,Construction,2013,25637,16270,4420,2510,23200,1993,225,25418,219,25865,16270,4420,2510,23200,2025,290,25515,350,200841,26244,29178,32750,90491,63986,17929,183540,10238,8123042000,831611000,940222000,1228880000,3022395000,2685683000,989862000,7202875000,532819000
Arkansas,Educational Services,2013,2700,1305,400,290,1995,435,150,2580,120,3230,1305,400,300,2005,485,205,2695,535,81502,1407,2350,3772,8095,17532,22471,50160,28989,1739592000,47776000,42010000,57871000,152267000,384334000,552016000,1135377000,518584000
Arkansas,Finance and Insurance,2013,12211,8343,1530,477,10350,681,371,11402,809,21940,8345,1560,675,10580,2035,2400,15015,6925,173731,13435,8220,5349,29028,21851,25925,82526,88741,9593056000,496423000,376990000,268927000,1170741000,1066202000,1224104000,3855393000,5579491000
Arkansas,Health Care and Social Assistance,2013,29705,14115,6680,3560,24355,3051,1302,28708,997,37630,14120,6690,3675,24485,4675,3620,32780,4850,825577,22531,44233,44994,115079,129079,161306,419581,400375,32544203000,1474646000,1686329000,1755535000,4965916000,4301859000,4822207000,14440690000,17833142000
Arkansas,Information,2013,2484,1030,400,255,1685,284,98,2067,417,4855,1030,400,270,1700,355,230,2285,2570,82347,866,1487,2583,6931,8449,2715,22285,59077,4003012000,65323000,62180000,90206000,230917000,414527000,147421000,978407000,3025921000
Arkansas,Management of Companies and Enterprises,2013,1569,85,45,35,165,305,417,887,682,5710,85,45,35,165,320,460,945,4765,173197,0,225,0,0,3315,9950,13726,159194,16895730000,10310000,15090000,0,31810000,151098000,514899000,715800000,16169727000
Arkansas,Manufacturing,2013,11853,3925,2020,1545,7490,1882,830,10202,1651,13050,3925,2020,1565,7510,2045,1030,10585,2465,670886,5305,10094,15779,37091,58966,52525,179242,430689,27642890000,198517000,327542000,574940000,1243543000,2152613000,2084703000,6578176000,18025646000
Arkansas,"Mining, Quarrying, and Oil and Gas Extraction",2013,1762,765,265,195,1225,205,98,1528,234,2030,765,265,195,1225,210,120,1555,475,41357,1149,1676,2106,5469,5995,4268,16894,23514,2930591000,60987000,80098000,91081000,258959000,366005000,274114000,946515000,1913624000
Arkansas,Other,2013,86,80,6,0,86,0,0,86,0,86,80,6,0,86,0,0,86,0,0,0,0,0,0,0,0,0,0,2690000,2195000,495000,0,2690000,0,0,2690000,0
Arkansas,Other Services (except Public Administration),2013,31433,20445,6222,2496,29163,1709,240,31112,321,33055,20460,6250,2630,29340,2300,495,32135,920,208880,38575,39352,31687,111516,56670,16527,193216,10731,4680950000,821631000,861938000,726675000,2438490000,1124754000,342861000,4146309000,379059000
Arkansas,"Professional, Scientific, and Technical Services",2013,26898,19300,3651,1730,24681,1082,390,26153,745,28780,19300,3665,1790,24755,1405,940,27100,1680,166675,28929,21969,21454,74654,32775,17014,129590,30447,8451824000,1325679000,910973000,1002704000,3291605000,1756213000,778939000,6101606000,1974488000
Arkansas,Real Estate and Rental and Leasing,2013,11505,9075,1028,422,10525,435,231,11191,314,14110,9075,1045,525,10645,890,715,12250,1860,63077,11199,5848,4973,25581,11877,3452,44671,17865,2094576000,404516000,175573000,162902000,761035000,439587000,161944000,1432430000,627301000
Arkansas,Retail Trade,2013,35239,18322,8211,4050,30583,2545,576,33704,1535,54575,18355,8305,4465,31125,4480,2805,38410,16165,553568,30429,52030,50630,138579,79252,46885,273517,252211,13175765000,762157000,1191513000,1330763000,3312959000,2514838000,1360695000,7395459000,5572243000
Arkansas,Total,2013,50318,28610,9083,5212,42905,4491,1197,48593,1725,64772,28637,9150,5495,43282,6359,3681,53322,11450,978094,49491,59531,69143,178165,163819,134248,476232,501862,36808096000,1637624000,1719877000,2081762000,5439263000,5102334000,4455181000,14996778000,21811318000
Arkansas,Transportation and Warehousing,2013,10160,5694,1547,945,8186,859,340,9385,775,11820,5710,1555,980,8245,895,450,9590,2230,232549,7948,9258,10835,30109,28828,19223,80221,122939,10102975000,294897000,300381000,399330000,1023204000,1106724000,787377000,2988990000,5902109000
Arkansas,Utilities,2013,709,390,115,25,530,60,44,634,75,1670,390,115,25,530,135,165,830,840,32676,892,644,292,1870,1224,6763,11765,17200,2616917000,23247000,19696000,10870000,56562000,174708000,447569000,693546000,1575550000
Arkansas,Wholesale Trade,2013,13975,5670,1986,1592,9248,1987,927,12162,1813,17440,5670,2010,1685,9365,2560,1580,13505,3935,211987,7712,10760,16609,41876,49479,26800,127147,68225,10979943000,411813000,481621000,840104000,1825522000,2323798000,1411713000,6248602000,4264620000
California,Accommodation and Food Services,2013,302511,113603,63520,60007,237130,56862,6281,300273,2238,400270,114150,63765,61230,239145,68965,24990,333100,67170,7323195,189487,413819,797961,1401384,2131229,1065697,4624465,2653158,141092395000,4795257000,6018571000,12538270000,23526255000,38386737000,19886318000,81815315000,59243322000
California,Administrative and Support and Waste Management and Remediation Services,2013,180906,110093,27385,17176,154654,17245,5163,177062,3844,212270,110185,27450,17615,155250,18980,7555,181785,30485,6036220,173294,178331,223545,578460,650749,740565,1964733,4041098,244846244000,7657147000,6309932000,8130903000,22103486000,25678661000,26367569000,74227838000,171568405000
California,"Agriculture, Forestry, Fishing and Hunting",2013,9334,5930,1475,715,8120,894,235,9249,85,9550,5930,1475,720,8125,940,355,9420,130,124018,7933,9221,9121,27145,37670,26667,92823,23943,4546131000,502349000,414789000,415224000,1357816000,1564986000,769752000,3737116000,577810000
California,"Arts, Entertainment, and Recreation",2013,101787,77515,8511,6029,92055,7102,1822,100979,808,108090,77555,8535,6110,92200,7715,2730,102645,5445,1518175,54272,55736,79910,213553,287672,277021,788569,709676,70714030000,19977578000,2796209000,3179532000,25957127000,7064374000,13346614000,47457895000,22225872000
California,Construction,2013,326663,212285,52387,32102,296774,25165,3312,325251,1412,330840,212290,52400,32155,296845,25705,4515,327065,3775,3069775,335176,345570,427927,1111785,961905,498488,2575560,487974,171987655000,14416990000,14388305000,20352500000,49157795000,53313785000,31878305000,134507015000,37144566000
California,Educational Services,2013,57953,28110,8913,7358,44381,9967,2583,56931,1022,65695,28135,8955,7565,44655,11675,4125,60455,5240,1954115,44335,59424,100118,205097,395054,417357,1020805,927889,72499110000,1608080000,1427620000,2346872000,5396115000,12483120000,15800098000,33778485000,38617942000
California,Finance and Insurance,2013,139832,101283,17033,7612,125928,7365,2811,136104,3728,249650,101435,17365,8470,127270,11910,14040,153220,96430,2934845,158218,108398,97389,373014,253650,340419,976600,1919714,294261916000,9701859000,6958739000,8902621000,25772849000,26640923000,32995739000,85829537000,204694616000
California,Health Care and Social Assistance,2013,444236,256474,96823,45605,398902,32233,8984,440119,4117,523200,256865,97510,47920,402295,46220,28980,477495,45705,8926860,455554,633221,595230,1696810,1234822,1297603,4233638,4617979,473222559000,26581530000,26034594000,24743030000,77371579000,49193743000,49160807000,175764654000,293381209000
California,Information,2013,77528,51543,7905,5756,65204,6880,2723,74807,2721,107680,51590,7935,5910,65435,7840,4280,77555,30125,2565093,54494,50982,70519,187596,251346,319302,768602,1874154,270211721000,8178329000,3644205000,5335997000,17704771000,21924168000,32944922000,73409095000,204240737000
California,Management of Companies and Enterprises,2013,15777,1300,385,591,2276,3189,4749,10214,5563,25660,1300,390,595,2285,3265,5180,10730,14930,1444100,1626,1680,4320,7574,39483,166728,213890,1230087,169161290000,229940000,131399000,359790000,721455000,2921402000,13078665000,16722805000,152438485000
California,Manufacturing,2013,181376,74674,32755,26603,134032,31837,8432,174301,7075,190770,74710,32785,26690,134185,32755,10130,177070,13700,5650167,128064,210135,354046,710277,1246246,1032795,3063530,2336006,348683319000,5915989000,8062197000,14691224000,29062888000,57824770000,55237981000,145598432000,179862479000
California,"Mining, Quarrying, and Oil and Gas Extraction",2013,3152,1385,470,364,2219,417,185,2821,331,4095,1385,470,375,2230,430,235,2895,1200,126235,2043,3018,4549,10118,12760,22913,47415,74867,12057404000,171311000,184644000,310010000,673973000,1069561000,2029956000,3912515000,7822926000
California,Other,2013,1748,1673,55,17,1745,3,0,1748,0,1748,1673,55,17,1745,3,0,1748,0,0,0,332,210,0,0,0,0,0,48611000,39245000,6536000,2064000,47845000,0,0,48611000,0
California,Other Services (except Public Administration),2013,321889,207155,58862,29506,295523,21721,3155,320399,1490,355140,207275,59300,30755,297330,27310,9935,334575,20565,2768407,375319,377606,387098,1140411,759602,365886,2278680,444328,84254615000,10418873000,10264733000,11086243000,31772887000,22447610000,12671532000,67144560000,15704542000
California,"Professional, Scientific, and Technical Services",2013,547009,399433,68389,36972,504794,28976,7048,540818,6191,586410,399565,68745,38085,506395,34390,12895,553680,32730,5743460,525203,445236,482601,1513230,997588,747244,3268435,2371551,497957755000,37685050000,27076320000,33452115000,98213485000,81971300000,71660348000,252149030000,242066012000
California,Real Estate and Rental and Leasing,2013,197944,153143,22535,10135,185813,8183,2261,196257,1687,249800,153380,23235,11640,188255,13830,13730,215815,33985,1355371,220952,142042,129696,493610,274480,205555,980895,346434,71608038000,10659876000,5906560000,5926955000,22497690000,13733928000,10948199000,47647440000,23280042000
California,Retail Trade,2013,346204,205026,69106,36577,310709,25816,5709,342234,3970,534100,205765,70905,40935,317605,39210,23290,380105,153995,7586436,327700,421003,460786,1205545,907787,631615,2817199,4314792,215044260000,10246786000,11184533000,13348769000,34489718000,31299959000,26489370000,93509394000,119736805000
California,Total,2013,711086,440341,118858,71915,631114,61835,12335,705284,5802,874243,441011,120100,75369,636480,78756,37393,752629,121614,13401863,715711,779587,956301,2451599,2343264,1855713,6650576,6751287,742523853000,37108705000,29849236000,37994481000,104952422000,102806471000,96989201000,304748094000,437775759000
California,Transportation and Warehousing,2013,88480,49769,14288,9288,73345,8481,2938,84764,3716,106985,49820,14390,9530,73740,9925,5420,89085,17900,2168056,76248,89263,119858,285317,276004,248739,823031,1300482,99817662000,3034271000,3284316000,4372234000,10717900000,11503766000,11288848000,33759151000,63797696000
California,Utilities,2013,2586,1310,505,240,2055,215,73,2343,243,5925,1310,515,260,2085,275,190,2550,3375,23180,2421,3096,2865,8587,5267,6367,21191,14647,2214855000,96123000,151167000,190639000,459810000,464981000,551880000,1557288000,1466369000
California,Wholesale Trade,2013,258443,143821,43707,28960,216488,27475,7956,251919,6524,296345,144045,44100,30200,218345,32425,14390,265160,31185,4169653,241560,284827,372307,907399,929268,712047,2558908,1524299,319441895000,12793387000,14236129000,19310124000,46372400000,53097998000,49919216000,149979040000,167149757000
Colorado,Accommodation and Food Services,2013,48659,16080,9857,10162,36099,10260,1152,47511,1148,64830,16105,9890,10275,36270,11990,4905,53165,11665,1247970,24629,63176,133837,222912,360574,184753,767165,447187,22893715000,717410000,930349000,2050843000,3727625000,6130324000,3215963000,13082860000,9682512000
Colorado,Administrative and Support and Waste Management and Remediation Services,2013,38051,23995,5195,3020,32210,3030,957,36197,1854,42670,24020,5205,3055,32280,3285,1220,36785,5885,1079500,29998,33062,39139,105762,110139,96029,324344,607425,46756753000,1468666000,1106815000,1386843000,3990004000,3850790000,3290199000,11735978000,26136755000
Colorado,"Agriculture, Forestry, Fishing and Hunting",2013,1570,1215,210,60,1485,55,15,1555,15,1570,1215,210,60,1485,55,15,1555,15,7995,359,1278,430,3490,1816,0,7670,0,273667000,46902000,49212000,19731000,119345000,70584000,0,262037000,0
Colorado,"Arts, Entertainment, and Recreation",2013,11972,7695,1555,1040,10290,1066,334,11690,282,12600,7705,1555,1045,10305,1150,410,11865,735,245287,6940,9748,13342,31550,38289,51632,129112,95507,7209555000,429641000,226560000,286185000,968385000,767218000,1402449000,3234529000,1863389000
Colorado,Construction,2013,78766,56530,10300,5605,72435,4832,782,78049,717,79425,56535,10300,5610,72445,4915,940,78300,1125,614540,77308,67075,73981,222091,172084,91648,492620,92829,32872850000,3328410000,2806780000,3454839000,9615175000,8918793000,5595162000,24423905000,6853231000
Colorado,Educational Services,2013,11543,6680,1560,1210,9450,1440,340,11230,313,12165,6680,1575,1220,9475,1565,435,11475,690,233407,8278,10132,15708,35557,57842,36622,132742,94407,7227691000,360307000,259965000,388896000,1013543000,1599625000,1303126000,3996361000,2873922000
Colorado,Finance and Insurance,2013,30559,22582,2860,959,26401,1350,740,28491,2068,49570,22595,2890,1085,26570,2500,2650,31720,17850,500310,26203,17336,10810,54247,40688,45039,155303,294269,38073714000,1748352000,1128426000,835343000,3830073000,3386554000,3274077000,10943698000,25485214000
Colorado,Health Care and Social Assistance,2013,63127,35220,12380,7165,54765,5371,1647,61783,1344,75405,35230,12410,7465,55105,7175,4680,66960,8445,1323422,54723,80559,94987,234144,203702,247702,695609,594628,60756720000,2962837000,3335278000,3966780000,10297881000,8556591000,9196881000,28235491000,31052055000
Colorado,Information,2013,9856,5300,1115,837,7252,799,549,8600,1256,15155,5300,1115,860,7275,915,690,8880,6275,403158,5166,6646,8816,23328,23761,32916,88340,308349,31528367000,453395000,358160000,578649000,1429169000,1751395000,2519082000,6118376000,25027549000
Colorado,Management of Companies and Enterprises,2013,3485,315,66,100,481,586,937,2004,1481,5090,315,70,100,485,600,995,2080,3010,255230,457,277,652,1444,7967,33280,42820,213560,28220370000,42781000,31794000,66819000,144665000,676650000,2991147000,3818630000,24143390000
Colorado,Manufacturing,2013,23574,11145,3830,2923,17898,3164,1063,22125,1449,24330,11145,3835,2940,17920,3265,1220,22405,1925,496213,15412,20417,31746,75471,101250,60108,286505,163069,27210067000,669521000,859426000,1355169000,3144420000,4769075000,3219831000,13604576000,10659864000
Colorado,"Mining, Quarrying, and Oil and Gas Extraction",2013,5977,3375,720,595,4690,590,213,5493,484,6595,3380,730,600,4710,615,245,5570,1025,139160,1608,4815,7379,16987,18183,18425,60020,71050,14951119000,443117000,349073000,743110000,1557559000,1655098000,1753335000,5867080000,8763158000
Colorado,Other,2013,215,206,9,0,215,0,0,215,0,215,206,9,0,215,0,0,215,0,0,0,0,0,0,0,0,0,0,4315000,3839000,476000,0,4315000,0,0,4315000,0
Colorado,Other Services (except Public Administration),2013,60767,38643,11523,5492,55658,3687,685,60030,737,66215,38695,11640,5685,56020,4750,1615,62385,3830,493058,65011,74342,70599,213583,129149,57449,404694,62243,15219041000,1934822000,2099246000,2008063000,6053746000,3745387000,1922812000,11916866000,2870049000
Colorado,"Professional, Scientific, and Technical Services",2013,114594,88295,11155,6008,105458,4702,1994,112154,2440,121580,88315,11235,6115,105665,5265,2585,113515,8065,912311,88032,71671,76531,267344,140878,92150,511164,383482,71138484000,6554593000,4223661000,5042539000,15871010000,10636540000,7969451000,35008323000,35646732000
Colorado,Real Estate and Rental and Leasing,2013,40945,33502,3190,1613,38305,1207,509,40021,924,47725,33625,3235,1740,38600,1840,1295,41735,5990,198967,29005,19659,19668,80883,36359,15453,141250,51900,8698002000,1871542000,731375000,763608000,3382696000,1473136000,622390000,5928574000,2736447000
Colorado,Retail Trade,2013,61632,34650,12342,6730,53722,4364,1097,59183,2449,92965,34755,12520,7380,54655,6665,3975,65295,27670,1149003,47708,71271,77597,194521,140769,69100,452235,591626,34149051000,1649475000,1972397000,2236375000,5937557000,5012236000,3011983000,14305955000,18652813000
Colorado,Total,2013,128087,82343,18753,11439,112535,9792,2633,124960,3127,154875,82446,18888,11862,113196,12295,6285,131776,23099,2090975,124461,123297,151112,398870,349378,273092,1021340,1069635,102236869000,5338220000,4522949000,5625378000,15486547000,14331217000,13010050000,42827814000,59409055000
Colorado,Transportation and Warehousing,2013,15127,9090,1845,1099,12034,1119,665,13818,1309,17285,9095,1845,1115,12055,1175,860,14090,3195,302232,10777,11428,13415,38378,33500,18678,102028,164110,14433576000,465176000,423938000,475780000,1393298000,1573891000,913881000,4207689000,8731123000
Colorado,Utilities,2013,1001,545,130,40,715,140,66,921,80,1905,545,130,45,720,235,140,1095,810,11864,892,694,362,1956,5924,4385,12458,47,3113023000,25581000,24757000,19707000,82354000,477426000,366545000,953912000,3743000
Colorado,Wholesale Trade,2013,30304,15924,3963,2821,22708,2870,1795,27373,2931,36220,15945,4005,2915,22865,3515,2550,28930,7290,467115,22761,24067,33092,84261,76508,55484,232934,209566,32593880000,1292199000,1341552000,1778530000,4492085000,4564847000,3651900000,13454544000,17661948000
Connecticut,Accommodation and Food Services,2013,35095,14690,6760,6497,27947,6042,480,34469,626,42125,14705,6805,6560,28070,6730,1915,36715,5410,635933,25545,45228,86949,159600,210324,65667,440736,187840,12806615000,636670000,691208000,1415016000,2751186000,3910834000,1152169000,7856771000,4941218000
Connecticut,Administrative and Support and Waste Management and Remediation Services,2013,23824,15435,3250,1775,20460,1672,621,22753,1071,26500,15435,3260,1800,20495,1760,760,23015,3485,424155,19721,20281,21207,63388,56961,68106,197736,219273,16621840000,1192446000,912905000,1033515000,3220386000,3237126000,1934087000,8776583000,7305129000
Connecticut,"Agriculture, Forestry, Fishing and Hunting",2013,415,285,75,45,405,10,0,415,0,415,285,75,45,405,10,0,415,0,1386,249,311,272,1071,0,0,1386,0,45667000,14367000,8933000,5450000,31212000,0,0,45667000,0
Connecticut,"Arts, Entertainment, and Recreation",2013,7396,4030,1045,830,5905,1140,196,7241,155,8005,4030,1050,845,5925,1240,315,7480,525,128086,4319,6541,10689,23919,45784,27981,104953,20471,3201634000,373133000,231699000,297167000,948918000,1229378000,461354000,2807398000,340054000
Connecticut,Construction,2013,39347,28205,5460,2945,36610,2178,283,39071,276,39495,28210,5460,2950,36620,2205,300,39125,370,249814,38347,34779,37971,116750,75623,22418,220900,21607,15805890000,2252657000,1838764000,2382805000,6538848000,5054129000,1630026000,13612565000,1697945000
Connecticut,Educational Services,2013,6549,3055,1155,865,5075,848,390,6313,236,6915,3055,1160,870,5085,880,470,6435,480,333268,4150,7488,11495,24503,34792,56553,117769,202820,15825258000,171532000,159859000,241269000,578194000,1274913000,2779253000,4762538000,10634658000
Connecticut,Finance and Insurance,2013,17804,10568,2477,1238,14283,1246,716,16245,1559,30655,10575,2525,1340,14440,1995,2555,18990,11665,570376,18043,14791,14642,49628,39836,57809,156499,406860,77040060000,1514670000,1567720000,2186512000,5394247000,6182200000,9153551000,21631009000,53890766000
Connecticut,Health Care and Social Assistance,2013,38310,15540,8615,5815,29970,4762,2291,37023,1287,52280,15595,8755,6285,30635,6925,6800,44360,7920,1354570,29043,55583,76925,165480,179706,306240,669779,676716,62809768000,1545572000,2436781000,3589057000,7628120000,8092568000,11358849000,27535502000,34839560000
Connecticut,Information,2013,5136,2195,710,540,3445,650,269,4364,772,8280,2195,710,545,3450,710,350,4510,3770,175174,2592,4254,6491,14422,16937,19998,58850,105059,13175170000,230646000,230738000,368041000,866932000,1112147000,1309055000,3701014000,7983181000
Connecticut,Management of Companies and Enterprises,2013,2464,180,55,105,340,290,609,1239,1225,3530,180,55,105,340,295,670,1305,2225,173430,42,0,666,1119,3385,19450,24335,149095,22976760000,42193000,0,85995000,171148000,245480000,1804563000,2221965000,20754795000
Connecticut,Manufacturing,2013,20643,7425,3795,2880,14100,4130,1222,19452,1191,21290,7425,3795,2885,14105,4225,1365,19695,1595,571238,10359,20747,32246,69718,144559,106787,360411,178355,36962564000,655476000,990826000,1661316000,3661009000,8078279000,6499468000,20404639000,13887188000
Connecticut,"Mining, Quarrying, and Oil and Gas Extraction",2013,258,135,40,25,200,25,10,235,23,385,135,40,25,200,25,20,245,140,3188,184,210,322,750,296,0,1712,208,313493000,12356000,12414000,22769000,52702000,30976000,0,178213000,105917000
Connecticut,Other,2013,114,114,0,0,114,0,0,114,0,114,114,0,0,114,0,0,114,0,0,0,0,0,0,0,0,0,0,2529000,2529000,0,0,2529000,0,0,2529000,0
Connecticut,Other Services (except Public Administration),2013,43745,26540,9730,4352,40622,2353,312,43287,458,46530,26575,9795,4475,40845,2745,640,44230,2300,294343,51004,62234,55733,170349,72838,10529,262330,21677,9191353000,1431771000,1729541000,1632614000,4817671000,2263704000,553642000,7987749000,792750000
Connecticut,"Professional, Scientific, and Technical Services",2013,43377,28817,6273,3520,38610,2494,732,41836,1541,46330,28825,6300,3575,38700,2775,980,42455,3875,513950,40596,39867,44468,131899,82047,41684,261012,240929,45843296000,2816191000,2512461000,3264569000,8674856000,7019806000,3572297000,19695859000,24950113000
Connecticut,Real Estate and Rental and Leasing,2013,12165,8725,1535,613,10873,553,261,11687,478,15795,8745,1570,720,11035,695,1155,12885,2910,84401,13485,9263,6492,30508,15063,10033,58495,14722,4654384000,658609000,486500000,378980000,1546196000,834666000,440385000,3073499000,1156745000
Connecticut,Retail Trade,2013,43484,24389,8355,4326,37070,3387,901,41358,2126,62865,24440,8540,4660,37640,4290,2505,44435,18430,895940,35453,47344,48413,140121,96959,56890,318659,382319,25687240000,1256371000,1461318000,1678839000,4482098000,4700659000,2282789000,12213478000,9584771000
Connecticut,Total,2013,71714,40479,12642,7808,60929,6835,1803,69567,2147,88498,40536,12770,8130,61436,8208,4547,74191,14307,1473605,70229,82761,103705,256695,247294,217361,721350,752255,85897033000,3312227000,3446669000,4662077000,11420973000,12437287000,11491287000,35349547000,50547486000
Connecticut,Transportation and Warehousing,2013,6702,3055,1045,705,4805,817,332,5954,748,8055,3065,1045,715,4825,895,440,6160,1895,194866,3646,5801,8080,18236,21748,16812,69103,82698,8253529000,254474000,276855000,415324000,1028314000,1220611000,574667000,3308460000,3892146000
Connecticut,Utilities,2013,307,50,40,25,115,68,30,213,94,695,55,40,30,125,75,70,270,425,2338,58,162,345,620,936,0,2331,316,200792000,4871000,13522000,22565000,42512000,95396000,88354000,226501000,37100000
Connecticut,Wholesale Trade,2013,18970,8565,2860,2164,13589,2368,1144,17101,1869,21775,8580,2870,2220,13670,2565,1425,17660,4115,348360,11951,16124,25014,57924,70112,50114,197880,137409,25412214000,1079415000,1131398000,1769935000,4148571000,4874157000,3277151000,13531873000,10988590000
Delaware,Accommodation and Food Services,2013,8327,3320,1375,1395,6090,1644,228,7962,365,10175,3325,1375,1405,6105,1740,800,8645,1530,173252,4901,9186,18867,33224,58481,28748,122427,50919,3144356000,190071000,144678000,274310000,613546000,993142000,444939000,2091088000,906040000
Delaware,Administrative and Support and Waste Management and Remediation Services,2013,6357,3480,915,555,4950,575,200,5725,632,7005,3480,925,555,4960,590,210,5760,1245,139464,4695,5410,6619,16962,16921,15177,54493,78367,3920367000,228131000,182042000,243354000,698027000,561491000,336868000,1814643000,1843691000
Delaware,"Agriculture, Forestry, Fishing and Hunting",2013,210,160,35,15,210,0,0,210,0,210,160,35,15,210,0,0,210,0,501,122,160,0,501,0,0,501,0,18087000,3159000,6030000,0,18087000,0,0,18087000,0
Delaware,"Arts, Entertainment, and Recreation",2013,1907,1140,190,190,1520,255,60,1835,72,2025,1140,190,190,1520,275,80,1875,150,32668,1050,777,1484,4661,6976,3632,20331,7148,886972000,68001000,15820000,45885000,156636000,170093000,147618000,774314000,180984000
Delaware,Construction,2013,10837,7015,1725,1020,9760,825,150,10735,102,10890,7015,1725,1020,9760,835,155,10750,140,88120,10378,10986,12129,35712,29296,13604,83083,2000,4588982000,438471000,472018000,573941000,1527761000,1716236000,821122000,4281850000,140757000
Delaware,Educational Services,2013,1435,570,265,205,1040,205,95,1340,95,1480,570,265,205,1040,220,100,1360,120,33567,614,1526,2222,4298,8119,10079,25938,6148,1246575000,25047000,39225000,51319000,124984000,239941000,365485000,812534000,353160000
Delaware,Finance and Insurance,2013,5948,3275,578,285,4138,351,317,4806,1142,10140,3305,610,360,4275,495,605,5375,4765,181224,2082,2651,2610,10405,7516,4493,23295,151560,16260660000,233364000,148638000,181188000,603771000,560532000,268347000,1522158000,13450362000
Delaware,Health Care and Social Assistance,2013,9580,3345,2205,1761,7311,1265,407,8983,597,12735,3350,2225,1830,7405,1715,1230,10350,2385,302537,5763,13903,22811,43463,40147,39558,135164,159442,15417854000,400477000,661444000,1106900000,2217027000,1858851000,1462979000,5951952000,9176999000
Delaware,Information,2013,1402,675,145,118,938,135,40,1113,289,2230,675,145,120,940,145,75,1160,1070,28669,152,565,592,2351,1454,938,6724,18206,1539021000,56066000,31807000,36630000,183825000,142533000,58376000,597846000,885459000
Delaware,Management of Companies and Enterprises,2013,3588,1341,65,40,1446,276,495,2217,1371,4655,1400,70,40,1510,315,575,2400,2255,72118,0,0,0,0,2220,4859,9363,63955,7990976000,62171000,0,83000,84268000,128504000,314929000,528870000,7515445000
Delaware,Manufacturing,2013,2708,1040,395,345,1780,434,176,2390,318,2835,1040,395,355,1790,445,200,2435,400,95702,820,1031,2819,6402,8540,6628,31016,57735,4984080000,68493000,61996000,124564000,317902000,431017000,416764000,1669001000,2811321000
Delaware,"Mining, Quarrying, and Oil and Gas Extraction",2013,57,30,0,5,35,15,0,50,7,70,30,0,5,35,15,0,50,20,211,0,0,0,0,0,0,194,0,18575000,0,0,0,0,0,0,17762000,0
Delaware,Other,2013,31,28,2,1,31,0,0,31,0,31,28,2,1,31,0,0,31,0,0,0,0,0,0,0,0,0,0,1300000,0,0,0,1300000,0,0,1300000,0
Delaware,Other Services (except Public Administration),2013,10251,6085,2070,1092,9247,699,100,10046,205,10715,6085,2095,1145,9325,820,115,10260,455,67933,10871,12372,13615,38301,20389,0,63142,3419,1904893000,311375000,305034000,355906000,1008630000,546384000,4995000,1770331000,98202000
Delaware,"Professional, Scientific, and Technical Services",2013,12457,8105,1430,929,10464,901,340,11705,752,13245,8105,1440,985,10530,1075,405,12010,1235,154512,8511,8787,11265,31397,24899,20748,81025,63493,13626025000,861809000,580484000,736609000,2235016000,1950006000,2652413000,6999997000,5949546000
Delaware,Real Estate and Rental and Leasing,2013,4592,3165,405,205,3775,248,143,4166,426,5385,3170,410,220,3800,380,330,4510,875,25683,3789,2027,2270,9309,5601,3211,20586,1707,1163679000,191132000,91030000,107490000,415643000,287283000,118118000,964382000,142708000
Delaware,Retail Trade,2013,12521,6420,2198,1089,9707,886,373,10966,1555,18075,6445,2265,1200,9910,1240,745,11895,6180,243476,7942,11395,9932,34325,23538,16408,84508,142442,6326562000,281104000,314759000,348524000,1020485000,916556000,731468000,2870522000,2982478000
Delaware,Total,2013,19400,10641,2951,1963,15555,1864,633,18052,1348,24151,10678,3000,2058,15736,2263,1225,19224,4927,382128,17077,19382,26002,62461,62327,49408,174196,207932,19541151000,784017000,701908000,1006095000,2492020000,2586282000,2439817000,7518119000,12023032000
Delaware,Transportation and Warehousing,2013,3011,1585,373,259,2217,356,108,2681,330,3185,1585,375,260,2220,380,115,2715,470,51744,552,1881,2153,6740,7460,4020,22101,24773,2141418000,84999000,49756000,69613000,230529000,266968000,148393000,858120000,1114450000
Delaware,Utilities,2013,120,30,10,0,40,0,27,67,53,225,30,20,0,50,0,35,85,140,6014,3,0,0,3,0,0,0,0,543865000,11000,0,0,4169000,0,0,0,0
Delaware,Wholesale Trade,2013,4726,2340,419,360,3119,554,294,3967,759,5320,2340,425,375,3140,630,350,4120,1200,55527,1928,1366,2618,7762,8109,4557,28009,14006,4261241000,187186000,93499000,139033000,536002000,468074000,328477000,1711320000,1194859000
District of Columbia,Accommodation and Food Services,2013,9232,3095,1520,1415,6030,2353,369,8752,480,12175,3100,1530,1425,6055,2450,695,9200,2975,301673,5375,9602,18506,33510,90699,37586,163404,118893,8440848000,199627000,192248000,381349000,786284000,2015246000,875409000,3684996000,3786780000
District of Columbia,Administrative and Support and Waste Management and Remediation Services,2013,3897,1425,415,365,2205,630,438,3273,624,5475,1430,425,370,2225,655,585,3465,2010,159845,1329,2084,3910,8503,21958,45446,80061,68106,6790601000,149780000,160269000,251483000,647987000,1000823000,1629830000,3425887000,3056007000
District of Columbia,"Agriculture, Forestry, Fishing and Hunting",2013,10,10,0,0,10,0,0,10,0,10,10,0,0,10,0,0,10,0,0,0,0,0,0,0,0,0,0,0,0,0,0,0,0,0,0,0
District of Columbia,"Arts, Entertainment, and Recreation",2013,1457,820,140,155,1115,158,85,1358,99,1600,820,140,155,1115,165,125,1405,195,34509,673,674,1662,3891,5378,8412,18454,6068,2382322000,60452000,32495000,73020000,187272000,192011000,268703000,651412000,805456000
District of Columbia,Construction,2013,2218,1065,375,265,1705,370,84,2159,59,2225,1065,375,265,1705,370,90,2165,60,33774,941,2118,2414,6971,11462,7265,29882,0,2144143000,95497000,105688000,209134000,436585000,725535000,470832000,1831337000,0
District of Columbia,Educational Services,2013,2518,915,340,240,1495,491,333,2319,199,2725,915,340,245,1500,500,415,2415,310,264297,210,2108,2117,5568,19702,40883,71300,190713,12205005000,75885000,122783000,117449000,338292000,1012311000,1963557000,3498825000,8574488000
District of Columbia,Finance and Insurance,2013,2764,830,300,205,1335,330,238,1903,861,4980,835,300,215,1350,440,425,2215,2765,55253,466,1377,2308,4927,5894,1488,15764,36902,9200449000,110291000,166105000,355830000,689065000,722540000,225715000,1940704000,7063955000
District of Columbia,Health Care and Social Assistance,2013,8854,4085,1665,1035,6785,1099,552,8436,418,10380,4085,1665,1115,6865,1395,1065,9325,1055,320806,6813,10207,12147,29838,35985,70921,140838,162030,17973677000,449837000,566445000,712869000,1764075000,1448899000,2613259000,5940333000,11293589000
District of Columbia,Information,2013,2492,870,245,175,1290,365,184,1839,653,3515,870,245,175,1290,365,195,1850,1665,96094,537,721,1137,2904,9590,9464,28343,59467,10494394000,112358000,92682000,126579000,391489000,831781000,807148000,2458439000,7127720000
District of Columbia,Management of Companies and Enterprises,2013,781,60,15,5,80,40,130,250,531,995,60,15,5,80,40,130,250,745,54150,0,80,0,0,35,3909,4381,74,5135870000,2876000,10645000,0,19163000,28007000,197546000,247495000,4888375000
District of Columbia,Manufacturing,2013,500,265,110,40,415,50,10,475,25,510,265,110,40,415,50,10,475,35,3109,222,406,98,898,307,0,2169,0,162079000,14199000,20132000,4104000,47335000,15340000,0,106556000,0
District of Columbia,"Mining, Quarrying, and Oil and Gas Extraction",2013,20,5,0,0,5,0,0,5,15,20,5,0,0,5,0,0,5,15,0,0,0,0,0,0,0,0,0,0,0,0,0,0,0,0,0,0
District of Columbia,Other,2013,56,53,3,0,56,0,0,56,0,56,53,3,0,56,0,0,56,0,48,32,0,0,48,0,0,48,0,1563000,1151000,412000,0,1563000,0,0,1563000,0
District of Columbia,Other Services (except Public Administration),2013,18462,8048,3515,2533,14096,2907,1101,18104,358,20760,8050,3530,2565,14145,3095,1445,18685,2075,372335,12873,22686,31341,70564,99337,117305,290489,63438,27382419000,1018308000,1367299000,2198186000,4623212000,7676302000,9836556000,22193562000,4509806000
District of Columbia,"Professional, Scientific, and Technical Services",2013,21878,11477,2812,2010,16299,2399,1207,19905,1973,26390,11525,2815,2020,16360,2455,1370,20185,6205,488135,15306,17683,24232,59519,69649,67443,206813,279024,57614378000,2247253000,1850163000,2834120000,7020739000,7700151000,7098990000,22332117000,35063043000
District of Columbia,Real Estate and Rental and Leasing,2013,3879,2210,453,308,2971,377,225,3573,306,5610,2225,470,310,3005,505,530,4040,1570,46388,2685,2793,3465,8886,10093,9546,30527,15635,3416697000,240883000,153923000,210505000,633092000,673744000,630970000,1994434000,1398108000
District of Columbia,Retail Trade,2013,6986,3825,1090,573,5488,414,235,6137,849,8595,3835,1100,595,5530,500,340,6370,2225,91692,5822,5010,4687,16906,6981,2367,32601,49795,2707284000,204905000,149809000,138195000,553860000,264740000,58354000,1040760000,1475707000
District of Columbia,Total,2013,17304,8052,2658,1892,12602,2395,977,15974,1330,21919,8071,2676,1936,12683,2647,1518,16848,5071,491130,14096,17495,24410,56001,83260,94560,233821,257309,35131275000,1051221000,1065037000,1634492000,3750750000,5151516000,5883450000,14785716000,20345559000
District of Columbia,Transportation and Warehousing,2013,707,300,65,35,400,75,69,544,163,785,300,65,35,400,75,70,545,240,5912,106,147,74,680,998,870,3541,2403,336356000,24917000,5297000,5288000,53343000,27874000,57848000,195854000,145167000
District of Columbia,Utilities,2013,163,15,0,5,20,0,0,20,143,240,15,0,5,20,0,0,20,220,10,0,0,0,0,0,0,0,23,3585000,338000,0,0,887000,0,0,887000,3482000
District of Columbia,Wholesale Trade,2013,1714,680,235,130,1045,157,95,1297,417,2325,680,240,140,1060,175,100,1335,990,11673,134,605,952,3478,1705,87,6937,3463,1155758000,47629000,57921000,56438000,212345000,104835000,4543000,511300000,490823000
Florida,Accommodation and Food Services,2013,142140,59451,25921,24830,110202,26722,3207,140131,2009,189045,59515,26000,25015,110530,29430,10030,149990,39055,4147971,96910,171745,334337,604165,1008942,523415,2138687,2002349,76291290000,2449412000,2446463000,4778800000,9675642000,16340021000,9272561000,35307052000,40973360000
Florida,Administrative and Support and Waste Management and Remediation Services,2013,150025,106650,17960,9815,134425,8984,3139,146548,3477,168995,106675,17995,9970,134640,9740,4575,148955,20040,6536436,140674,117112,127798,408811,339843,456026,1227363,5239117,260424685000,4903223000,3548097000,4078139000,12570437000,10889621000,13460399000,37318579000,220232299000
Florida,"Agriculture, Forestry, Fishing and Hunting",2013,4832,3235,695,475,4405,305,76,4786,46,4930,3235,695,485,4415,335,110,4860,70,44286,4240,4173,5715,14728,9884,9111,34746,9895,1315907000,161735000,150976000,207886000,535806000,289427000,194542000,1058869000,265392000
Florida,"Arts, Entertainment, and Recreation",2013,36268,23860,3750,2940,30550,3807,1269,35626,642,38980,23860,3755,2980,30595,4170,1700,36465,2515,884579,22071,23587,38030,89414,158253,196481,451060,389392,25146936000,1537487000,544275000,782365000,2879124000,3619657000,7158696000,14068206000,10706651000
Florida,Construction,2013,222470,159700,29710,17343,206753,13054,1653,221460,1010,224920,159700,29715,17390,206805,13365,2310,222480,2440,1542035,227448,194060,230440,660805,474025,216383,1357115,172406,65052430000,7299830000,6439810000,8688210000,22427850000,20466885000,11054482000,54214465000,10193396000
Florida,Educational Services,2013,29303,16875,3717,2985,23577,4067,1007,28651,652,32655,16885,3745,3000,23630,4605,1720,29955,2700,780300,21801,24797,39573,87012,163703,144752,402175,365212,28019015000,791170000,576029000,901825000,2273880000,4641828000,4778201000,11908080000,15861815000
Florida,Finance and Insurance,2013,88084,63781,11447,4381,79609,3586,1853,85048,3036,155440,63865,11655,4975,80495,6390,7210,94095,61345,1675258,81471,72993,55338,218634,120788,159828,514941,1101904,117810418000,4740518000,3620403000,3271372000,11705654000,8438046000,11291510000,31678477000,85618131000
Florida,Health Care and Social Assistance,2013,235260,132480,52589,25920,210989,16200,4975,232164,3096,284770,132615,52915,27025,212555,22335,15575,250465,34305,5041353,209209,344978,342558,909984,604527,739700,2272536,2714981,230683015000,11897060000,14706688000,14553951000,41171398000,27533976000,28081742000,96925181000,132089855000
Florida,Information,2013,24564,16401,2500,1735,20636,1628,760,23024,1540,39700,16425,2515,1740,20680,1840,1160,23680,16020,774168,17120,15386,20986,61379,55691,49200,174222,594384,53580770000,1159490000,693484000,1123883000,3020770000,3039373000,3227766000,9663465000,43196933000
Florida,Management of Companies and Enterprises,2013,7947,1165,256,270,1691,1361,1837,4889,3058,13595,1165,260,270,1695,1400,1925,5020,8575,674065,1525,1349,2070,4940,17593,60110,82670,591395,56972615000,189755000,113092000,144430000,447400000,1157400000,4957395000,6562195000,50410420000
Florida,Manufacturing,2013,60601,31775,9510,7062,48347,7091,2472,57910,2691,63555,31775,9515,7085,48375,7260,2930,58565,4990,1304956,49717,55394,84123,202534,250483,214761,721605,509938,66191026000,1868760000,1981704000,3324885000,7491124000,10523891000,9971045000,30202791000,33205952000
Florida,"Mining, Quarrying, and Oil and Gas Extraction",2013,1123,625,140,85,850,130,37,1017,106,1315,625,140,85,850,150,60,1060,255,16914,495,759,413,2298,3022,807,7273,9461,1121784000,33740000,30973000,45967000,114628000,142785000,62001000,378803000,724876000
Florida,Other,2013,475,456,15,3,474,1,0,475,0,475,456,15,3,474,1,0,475,0,468,0,83,36,0,0,0,468,0,12044000,10556000,1132000,338000,12026000,0,0,12044000,0
Florida,Other Services (except Public Administration),2013,207274,145285,32517,16027,193829,10752,1542,206123,1151,223445,145355,32625,16320,194300,13160,4500,211960,11485,1503717,214028,210701,212021,669414,382429,160993,1221453,271856,39494416000,6060332000,5098423000,5358258000,16530376000,9832858000,4208022000,30744116000,8597522000
Florida,"Professional, Scientific, and Technical Services",2013,340021,267991,35103,17549,320643,12570,3309,336522,3499,361815,268035,35250,18040,321325,15635,6365,343325,18490,2222306,329641,226776,228157,827587,413633,268935,1518481,668621,141204405000,19516165000,11570147000,12961232000,44057240000,26793041000,18450742000,89533100000,50196668000
Florida,Real Estate and Rental and Leasing,2013,128198,106953,10886,4448,122287,3123,1438,126848,1350,154760,107075,11160,4905,123140,4230,5855,133225,21535,718517,124560,68194,56122,263114,97869,98071,463625,216356,29393962000,5212219000,2481968000,2139630000,9860093000,4063094000,4381948000,18449884000,10780282000
Florida,Retail Trade,2013,231680,158144,37446,18028,213618,11603,2830,228051,3629,361735,158535,38230,19850,216615,18750,8695,244060,117675,4505776,220491,230579,221451,672512,379184,260455,1345628,2189925,118550058000,6747397000,5873048000,5916150000,18603560000,13516549000,11835950000,44412349000,55517025000
Florida,Total,2013,417164,286014,60008,33545,379567,26874,6239,412680,4484,510389,286268,60507,34858,381633,33769,16751,432153,78236,7134644,445249,392028,444892,1282169,995300,806684,3084153,4050491,294142009000,16690405000,13502063000,15423621000,45616089000,36767865000,33003616000,115387570000,178754439000
Florida,Transportation and Warehousing,2013,59655,41844,6482,3805,52131,3540,1479,57150,2505,67585,41875,6540,3880,52295,3905,2145,58345,9240,1020835,44882,41210,46694,147459,109421,86092,362571,608953,44873370000,2020933000,1418186000,1729880000,5223468000,4370695000,3529780000,13508734000,28418965000
Florida,Utilities,2013,1464,780,255,57,1092,131,117,1340,124,3655,780,255,70,1105,210,375,1690,1965,134736,1313,1788,555,3863,4980,19412,31710,100125,11761511000,50094000,75902000,24439000,159456000,311126000,1354924000,2072439000,9607245000
Florida,Wholesale Trade,2013,138588,90988,19406,10706,121100,9767,3576,134443,4145,158675,91065,19495,11190,121750,11930,6515,140195,18480,1495489,136089,122375,134199,407008,298500,209326,939159,519071,81907275000,6396311000,5745469000,6488492000,18672613000,15393334000,11773566000,46618066000,32982984000
Georgia,Accommodation and Food Services,2013,68703,24848,12580,13195,50623,15004,1682,67309,1394,95620,25080,12635,13350,51065,16970,6610,74645,20975,1926833,40646,83416,181187,306330,546223,259798,1115023,811554,29288490000,1039490000,1103988000,2386042000,4531210000,7774858000,3760807000,16167265000,13116182000
Georgia,Administrative and Support and Waste Management and Remediation Services,2013,50216,30860,6575,4325,41760,4202,1777,47739,2477,59620,30865,6600,4355,41820,4405,2380,48605,11015,1602864,42937,40980,56070,142682,155919,202738,518278,1079021,54103690000,1835315000,1387091000,2093767000,5363508000,5429779000,6423655000,17593917000,36282677000
Georgia,"Agriculture, Forestry, Fishing and Hunting",2013,4605,2350,1165,525,4040,451,60,4551,54,4705,2355,1165,525,4045,460,65,4570,135,38146,2760,7050,6460,17514,13450,0,36305,427,1399633000,135674000,253347000,249617000,652815000,491782000,6701000,1295958000,41470000
Georgia,"Arts, Entertainment, and Recreation",2013,12748,7845,1690,1240,10775,1376,327,12478,270,13750,7845,1690,1265,10800,1480,515,12795,955,210872,7870,10362,16195,36349,51508,40245,133869,52697,6713725000,461493000,250947000,336604000,1073078000,874265000,1128335000,3252726000,2936259000
Georgia,Construction,2013,79536,52935,11790,7250,71975,5889,925,78789,747,80475,52935,11790,7260,71985,5975,1130,79090,1385,717515,79014,77666,97101,255396,211296,113463,586100,109876,34189660000,2994400000,2834495000,4000378000,9834565000,10157960000,5771544000,26081445000,7212078000
Georgia,Educational Services,2013,13121,7110,1870,1325,10305,1863,551,12719,402,14490,7120,1870,1325,10315,2295,620,13230,1260,404523,8657,11955,17638,41195,73188,74829,195001,197314,15527920000,317837000,252230000,361136000,942879000,2001800000,2716759000,5786404000,9363677000
Georgia,Finance and Insurance,2013,38844,25933,5115,1821,32869,2266,1231,36366,2478,72520,25990,5235,2290,33515,5120,5050,43685,28835,784226,38230,30976,20730,87104,74910,85590,264979,396318,62784009000,1956162000,1526025000,1511853000,5000275000,4738977000,6113554000,16216970000,44433081000
Georgia,Health Care and Social Assistance,2013,92037,45045,20860,12455,78360,9579,2010,89949,2088,116040,45075,20965,12980,79020,12625,6505,98150,17890,2251490,73438,137636,165091,381301,354335,276401,1018052,1185188,101132560000,4221189000,5788900000,6830260000,16855961000,14204289000,10317176000,41507049000,58746375000
Georgia,Information,2013,11244,5850,1290,845,7985,1252,571,9808,1436,20005,5855,1290,845,7990,1445,945,10380,9625,549576,7706,7724,10275,27097,41622,44993,117645,393194,42045999000,439973000,411112000,577528000,1461572000,2794369000,3048585000,7514899000,32317690000
Georgia,Management of Companies and Enterprises,2013,5194,390,115,135,640,800,1276,2716,2478,8685,390,115,135,640,810,1300,2750,5935,556815,8,132,713,350,9420,36760,48045,508443,56565275000,170912000,51428000,46329000,268846000,646755000,2649770000,3581575000,52983700000
Georgia,Manufacturing,2013,33412,12515,5160,4245,21920,5387,2428,29735,3677,36425,12515,5170,4275,21960,5700,2810,30470,5955,1614087,19243,29565,52514,108312,198041,201017,559161,966444,75102387000,808923000,1058412000,1951135000,4045960000,8387347000,8793555000,23299869000,47970894000
Georgia,"Mining, Quarrying, and Oil and Gas Extraction",2013,609,195,135,65,395,80,39,514,95,980,195,135,65,395,85,85,565,415,19159,120,391,776,1893,1636,173,9281,9632,1102878000,9789000,27865000,34901000,83161000,91692000,8120000,541817000,552423000
Georgia,Other,2013,302,284,16,2,302,0,0,302,0,302,284,16,2,302,0,0,302,0,0,0,95,0,0,0,0,0,0,8659000,6761000,1642000,0,8659000,0,0,8659000,0
Georgia,Other Services (except Public Administration),2013,96130,62435,17635,8347,88417,5848,1008,95273,857,103105,62500,17740,8620,88860,7290,1825,97975,5130,772557,110599,113407,109316,337481,212303,85937,641671,115282,20351377000,2738466000,2741604000,2750709000,8254091000,5361464000,2593297000,16375932000,3751013000
Georgia,"Professional, Scientific, and Technical Services",2013,132514,99576,13813,7814,121203,6228,2224,129655,2859,141205,99580,13880,7970,121430,7030,2905,131365,9840,1145859,102807,89311,100895,323056,197525,163876,693028,428255,80519338000,7306270000,4565004000,5975687000,17863231000,13542897000,11051675000,42761173000,36279489000
Georgia,Real Estate and Rental and Leasing,2013,39783,31168,3578,1594,36340,1529,844,38713,1070,52565,31235,3660,1705,36600,2310,3350,42260,10305,256657,34737,22534,19632,80236,45873,46529,179581,68827,12680144000,1659616000,794600000,923657000,3389816000,2217993000,2306663000,8076467000,4911287000
Georgia,Retail Trade,2013,105344,67462,18807,8547,94816,6092,1488,102396,2948,167190,67640,19145,9380,96165,9460,5155,110780,56410,2037469,111628,118612,108619,343091,205454,105757,675911,1176588,50566769000,2913461000,2791701000,2912230000,8654404000,7323137000,4026080000,20345049000,27287627000
Georgia,Total,2013,169726,104164,26649,16170,146983,14774,3995,165752,3974,217559,104339,26880,16828,148047,18568,9585,176200,41359,3458050,167881,174243,215188,557312,535732,428549,1521593,1936457,154628032000,6460319000,5865293000,7585575000,19911187000,20003527000,18162867000,58077581000,96550451000
Georgia,Transportation and Warehousing,2013,25255,14490,2930,1865,19285,2135,1432,22852,2403,30510,14515,2945,1900,19360,2380,1835,23575,6935,808371,14404,18283,22708,63360,60151,63966,198985,543033,37325682000,781352000,635240000,839662000,2303940000,2357484000,2642493000,7656963000,26324605000
Georgia,Utilities,2013,686,215,55,30,300,150,119,569,117,2990,215,55,30,300,225,420,945,2045,103181,406,274,164,1063,7241,20180,29824,121,8684223000,23358000,8583000,16103000,60316000,431083000,1419249000,1972608000,16192000
Georgia,Wholesale Trade,2013,55390,28305,8200,5631,42136,5925,3204,51265,4125,65405,28370,8235,5855,42460,6775,4420,53655,11750,953166,44415,52213,67766,169026,169033,144087,503890,416553,59757128000,2325857000,2565406000,3626368000,8560045000,9437937000,8525943000,27593614000,31307634000
Hawaii,Accommodation and Food Services,2013,13992,4780,2878,2590,10248,2984,349,13581,411,17840,4780,2890,2595,10265,3450,1060,14775,3065,500844,8364,18146,33483,60617,118846,65069,245045,249604,13711457000,248962000,286270000,539621000,1069701000,2309562000,1569015000,4982937000,8533817000
Hawaii,Administrative and Support and Waste Management and Remediation Services,2013,7826,4075,1270,720,6065,881,353,7299,527,9025,4075,1280,730,6085,980,590,7655,1370,201767,6554,7492,8116,23032,31614,41540,100341,83384,6195299000,218443000,212714000,238331000,705117000,1006393000,977025000,2924826000,2686690000
Hawaii,"Agriculture, Forestry, Fishing and Hunting",2013,165,130,20,5,155,10,0,165,0,165,130,20,5,155,10,0,165,0,219,35,0,0,149,0,0,219,0,13016000,5564000,0,0,6908000,0,0,13016000,0
Hawaii,"Arts, Entertainment, and Recreation",2013,2426,1105,355,275,1735,437,160,2332,94,2610,1105,355,280,1740,465,255,2460,150,54337,1113,2102,3184,6733,15577,16632,44392,5995,1308096000,47895000,45830000,71562000,185218000,322453000,452375000,1078900000,141110000
Hawaii,Construction,2013,13246,7715,2350,1635,11700,1178,191,13069,177,13415,7715,2350,1640,11705,1240,230,13175,240,133358,11575,14795,20396,48885,40741,19826,114428,14443,8393314000,545668000,663084000,1137213000,2400086000,2637226000,1581900000,7057532000,1078698000
Hawaii,Educational Services,2013,2413,1020,385,370,1775,425,105,2305,108,2585,1020,390,375,1785,480,170,2435,150,89798,1391,2333,4748,9101,15856,13918,41491,47235,2960010000,40819000,40808000,98880000,200399000,416495000,505378000,1215690000,1701661000
Hawaii,Finance and Insurance,2013,4019,2176,480,215,2871,283,211,3365,654,7170,2180,490,255,2925,565,720,4210,2960,95143,1583,2220,2031,7737,8365,13504,34718,57907,5911340000,182640000,143333000,134109000,500727000,404678000,838311000,1952184000,3875511000
Hawaii,Health Care and Social Assistance,2013,14622,7620,3737,1487,12844,999,460,14303,319,17905,7620,3790,1610,13020,1570,1510,16100,1805,320377,13989,23566,18556,56937,40810,59855,164172,139223,15750031000,853291000,1109142000,852471000,2846402000,1530756000,2329205000,7000666000,8651580000
Hawaii,Information,2013,1587,720,220,120,1060,135,60,1255,332,2530,720,220,130,1070,160,125,1355,1175,40527,384,788,874,2570,2824,530,8559,24203,2435308000,41270000,43617000,40475000,168900000,128313000,32176000,448001000,1812589000
Hawaii,Management of Companies and Enterprises,2013,948,15,30,40,85,230,260,575,373,1235,15,30,45,90,235,290,615,620,29947,4,0,0,308,1848,6623,8835,21172,2020113000,1024000,0,11671000,21405000,94115000,359768000,475560000,1548795000
Hawaii,Manufacturing,2013,3751,1755,720,550,3025,449,145,3619,132,3860,1755,720,550,3025,465,200,3690,170,44559,1625,2659,5552,12573,8379,4597,36822,4565,1554412000,73936000,82978000,187634000,396561000,244187000,144745000,1178534000,254772000
Hawaii,"Mining, Quarrying, and Oil and Gas Extraction",2013,35,5,10,10,25,0,5,30,5,35,5,10,10,25,0,5,30,5,338,0,0,0,0,0,0,0,0,32869000,0,0,0,2250000,0,0,3204000,0
Hawaii,Other,2013,25,24,1,0,25,0,0,25,0,25,24,1,0,25,0,0,25,0,30,24,0,0,30,0,0,30,0,793000,772000,0,0,793000,0,0,793000,0
Hawaii,Other Services (except Public Administration),2013,15441,10070,2485,1400,13955,1071,205,15231,210,17225,10085,2485,1440,14010,1440,630,16080,1145,124543,17167,15512,16948,50966,35487,7329,104966,7959,3517442000,532534000,458539000,524841000,1538248000,1016036000,228778000,3133454000,224571000
Hawaii,"Professional, Scientific, and Technical Services",2013,14550,9550,2010,1159,12719,895,288,13902,648,16305,9550,2010,1185,12745,1040,415,14200,2105,109824,11398,12488,14299,39729,27237,8028,81019,21861,6992876000,757686000,657224000,834048000,2301435000,1857248000,597470000,4928155000,1934683000
Hawaii,Real Estate and Rental and Leasing,2013,7969,5720,946,466,7132,338,220,7690,279,9485,5735,980,480,7195,695,355,8245,1240,48143,7219,4954,5126,20796,9784,4127,37128,7203,2546415000,396608000,216217000,227320000,874414000,432706000,230085000,1687351000,725956000
Hawaii,Retail Trade,2013,14817,7490,2959,1592,12041,1205,429,13675,1142,23410,7505,3055,1785,12345,2335,1675,16355,7055,325067,9240,15626,16445,45577,34250,29592,116485,168243,8894807000,321045000,410248000,429711000,1217737000,1023508000,1097571000,3708675000,4716673000
Hawaii,Total,2013,25017,13777,4507,2754,21038,2419,619,24076,941,31622,13794,4579,2889,21262,3385,1874,26521,5101,502530,24089,29602,36554,90245,93375,79744,263364,239166,19881066000,942630000,1007169000,1269513000,3219312000,3262193000,3037559000,9519064000,10362002000
Hawaii,Transportation and Warehousing,2013,3461,1335,520,390,2245,567,285,3097,364,4255,1340,525,395,2260,670,505,3435,820,125762,1429,2627,3895,10141,15341,18142,48479,56277,5507413000,70389000,102767000,139927000,341385000,580870000,658975000,1750025000,2900011000
Hawaii,Utilities,2013,139,35,25,5,65,15,10,90,49,290,35,25,5,65,65,45,175,115,7648,0,126,0,213,298,0,1613,0,735128000,0,5989000,0,13563000,18098000,0,126149000,6956000
Hawaii,Wholesale Trade,2013,7508,3470,1210,893,5573,820,364,6757,751,8640,3480,1265,930,5675,1060,590,7325,1315,89688,3983,5919,9196,20546,19030,12771,64523,19393,4274462000,223945000,275145000,410620000,975093000,846006000,607630000,2803701000,1193128000
Idaho,Accommodation and Food Services,2013,14177,5125,2935,3120,11180,2240,369,13789,388,17755,5185,2950,3175,11310,2905,1355,15570,2185,271268,8127,19547,41847,69680,73014,44640,188840,79906,3904663000,167240000,220303000,519469000,914455000,1032961000,613716000,2576978000,1226545000
Idaho,Administrative and Support and Waste Management and Remediation Services,2013,10383,6770,1450,775,8995,627,210,9832,551,11010,6770,1455,795,9020,670,250,9940,1070,166060,8832,8609,8355,27563,18000,20265,68652,93538,4302850000,292976000,223109000,259488000,814070000,521793000,384969000,1855902000,2350622000
Idaho,"Agriculture, Forestry, Fishing and Hunting",2013,2210,1615,265,160,2040,115,30,2185,25,2220,1615,265,160,2040,115,30,2185,35,16726,765,1660,1975,6043,4723,2739,15170,240,585645000,109568000,72777000,90207000,279898000,176831000,50068000,559910000,8505000
Idaho,"Arts, Entertainment, and Recreation",2013,3587,2345,430,350,3125,330,75,3530,57,3695,2345,430,360,3135,350,110,3595,100,44459,1884,2261,3926,9604,10651,7892,30176,6459,693586000,94090000,43010000,63619000,216441000,189370000,120553000,557922000,68500000
Idaho,Construction,2013,29064,21255,4210,2035,27500,1287,154,28941,123,29185,21255,4210,2035,27500,1335,185,29020,165,148789,31122,27200,26321,85229,42865,7144,144165,3276,6182480000,1080728000,904684000,987534000,2983582000,1999658000,403958000,5867140000,224640000
Idaho,Educational Services,2013,2179,1080,355,230,1665,360,45,2070,109,2300,1080,355,240,1675,415,60,2150,150,61867,287,2042,2692,6868,12869,2928,23672,36332,1274192000,49082000,31702000,53804000,141397000,281705000,65986000,513572000,726358000
Idaho,Finance and Insurance,2013,7697,5190,830,285,6305,305,260,6870,827,13860,5200,850,395,6445,685,1405,8535,5325,99675,7090,4852,2985,16592,5201,679,40884,55330,5252709000,278323000,191950000,139639000,636594000,388625000,668596000,1833640000,3215587000
Idaho,Health Care and Social Assistance,2013,21578,10920,4630,2725,18275,2066,630,20971,607,24760,10935,4645,2845,18425,2860,1655,22940,1820,420965,16145,30447,35105,84205,78824,71147,238339,172905,16197233000,914764000,999643000,1214066000,3160177000,2569478000,1928496000,7783786000,8061987000
Idaho,Information,2013,2253,1015,261,230,1506,271,101,1878,375,3165,1015,265,250,1530,360,135,2025,1140,53379,991,783,1548,4740,6574,2554,15011,30971,2423345000,61213000,33752000,60115000,180289000,237876000,134701000,865281000,1422017000
Idaho,Management of Companies and Enterprises,2013,934,75,0,50,125,201,226,552,382,1230,75,0,50,125,205,235,565,665,39477,0,0,262,378,1534,5847,7721,31756,2804806000,6615000,0,13760000,22770000,85867000,340364000,450110000,2360940000
Idaho,Manufacturing,2013,8376,3785,1465,1060,6310,1181,416,7907,469,8695,3785,1470,1060,6315,1220,465,8000,695,208043,3877,6776,10509,26345,34788,24522,104631,90746,9471552000,173613000,224106000,376924000,906059000,1404271000,921736000,3996731000,4893945000
Idaho,"Mining, Quarrying, and Oil and Gas Extraction",2013,587,275,110,40,425,77,36,538,49,625,275,110,40,425,80,40,545,80,9348,218,664,326,1399,1674,825,5843,2158,720960000,18684000,45869000,15998000,100895000,111608000,62891000,424763000,179122000
Idaho,Other,2013,56,52,1,2,55,1,0,56,0,56,52,1,2,55,1,0,56,0,0,0,0,0,0,0,0,0,0,1168000,706000,0,0,924000,0,0,1168000,0
Idaho,Other Services (except Public Administration),2013,15377,10185,2870,1284,14339,662,155,15156,221,16390,10185,2880,1420,14485,1025,265,15775,615,91088,17281,17588,15025,52380,16993,6895,80487,4346,2205575000,436309000,448739000,382829000,1307270000,398494000,165436000,1912056000,172505000
Idaho,"Professional, Scientific, and Technical Services",2013,19892,14095,2620,1330,18045,879,278,19202,690,21090,14095,2635,1360,18090,1070,400,19560,1530,144122,17989,16416,15891,53512,23104,7340,89135,50956,7619585000,819768000,676445000,730751000,2268559000,1241245000,412861000,4093041000,3439047000
Idaho,Real Estate and Rental and Leasing,2013,9384,7720,745,321,8786,220,156,9162,222,10575,7725,780,365,8870,390,560,9820,755,27094,7926,3526,3267,14532,3611,1507,22814,3058,989819000,317056000,118743000,88592000,554236000,166874000,65658000,841196000,124385000
Idaho,Retail Trade,2013,19784,9820,4050,2344,16214,1735,483,18432,1352,28945,9825,4110,2585,16520,2710,2080,21310,7635,366692,14643,25022,27563,74273,48574,21178,159979,185180,9400253000,451887000,567619000,777107000,1828864000,1582038000,665357000,4523722000,4309177000
Idaho,Total,2013,36212,22163,5852,3496,31511,2714,757,34982,1230,43124,22188,5899,3691,31778,3721,2095,37594,5530,509986,34965,38618,46166,119749,93728,71405,284882,225104,18559112000,1181124000,1097471000,1361261000,3639856000,3105741000,2327867000,9073464000,9485648000
Idaho,Transportation and Warehousing,2013,8164,5520,980,545,7045,512,210,7767,397,8675,5520,980,550,7050,550,270,7870,805,81203,7158,5553,6584,20348,14096,11942,50753,20054,2952165000,270107000,199499000,237389000,743058000,483007000,450735000,1813530000,779136000
Idaho,Utilities,2013,586,375,60,30,465,55,10,530,56,1015,375,60,30,465,95,35,595,420,1108,62,241,152,1278,1813,0,3449,0,40669000,10265000,14685000,6190000,43384000,129577000,0,189941000,0
Idaho,Wholesale Trade,2013,8059,3419,1025,694,5138,1114,657,6909,1150,10150,3420,1040,730,5190,1560,940,7690,2460,123123,3714,5117,7022,18355,28114,17313,74175,41524,6304688000,228207000,245351000,318753000,869422000,1223974000,853109000,3295406000,2721054000
Illinois,Accommodation and Food Services,2013,105398,42860,20840,18645,82345,19333,2114,103792,1606,138475,42910,20880,18790,82580,22020,7095,111695,26780,2407516,74401,137581,253152,467145,708364,307873,1485240,832876,42680580000,1726384000,1867300000,3491939000,7094926000,11180937000,5460154000,23745856000,18839226000
Illinois,Administrative and Support and Waste Management and Remediation Services,2013,73475,48005,8640,5492,62137,6080,2471,70688,2787,84305,48020,8675,5535,62230,6515,3140,71885,12420,2375360,54272,54579,72660,188588,230933,338452,764513,1594200,74795811000,3323552000,2225698000,2882587000,8464696000,8877275000,10967004000,28494459000,45669087000
Illinois,"Agriculture, Forestry, Fishing and Hunting",2013,1600,1230,220,60,1510,30,30,1570,30,1740,1230,220,60,1510,40,80,1630,110,5806,341,1246,600,2462,865,0,5843,0,408723000,55987000,48273000,32200000,141887000,31344000,50415000,239467000,0
Illinois,"Arts, Entertainment, and Recreation",2013,21306,12740,2890,2185,17815,2558,583,20956,350,22915,12760,2930,2200,17890,2695,900,21485,1430,381566,15021,18280,29835,63089,97993,84889,247059,114800,12253796000,723341000,470398000,567903000,1786485000,2237481000,4543873000,8596046000,2974957000
Illinois,Construction,2013,139570,103865,17755,9393,131013,6924,920,138857,713,140435,103870,17755,9415,131040,7060,1100,139200,1235,890275,133752,114268,123319,382515,253665,122364,762305,117013,59564980000,6685615000,5840768000,7534155000,20066350000,18550010000,9994565000,48787535000,9964290000
Illinois,Educational Services,2013,18844,8995,2670,2315,13980,3343,911,18234,610,20680,9000,2675,2370,14045,3585,1375,19005,1675,804539,11658,17759,31183,63167,139022,128433,333589,465894,31209876000,455722000,409726000,614750000,1490891000,3785148000,4551359000,9957631000,21229803000
Illinois,Finance and Insurance,2013,63333,41995,8141,3481,53617,4499,2126,60242,3091,111835,42030,8310,4000,54340,8445,8540,71325,40510,1492160,68956,50214,43697,167112,155371,182867,513654,949898,142495925000,3603262000,3107728000,3458373000,10211440000,12707299000,15843995000,39234434000,102277607000
Illinois,Health Care and Social Assistance,2013,133886,68595,27698,16779,113072,13217,4804,131093,2793,166910,68670,27920,17755,114345,18370,13855,146570,20340,3925776,116856,180446,224220,532128,508722,683132,1737088,2150752,171918425000,6226383000,7828678000,10523169000,24615621000,20973923000,22365647000,68574902000,102801161000
Illinois,Information,2013,15444,7845,1915,1341,11101,1701,984,13786,1658,26500,7860,1945,1375,11180,1940,1315,14435,12065,617770,8718,8963,16513,36353,57396,75588,176692,431030,44864399000,573473000,606473000,859854000,2080865000,3652590000,5379541000,11352955000,32866596000
Illinois,Management of Companies and Enterprises,2013,7335,445,120,230,795,1271,1944,4010,3325,11470,445,120,230,795,1290,2060,4145,7325,980270,0,522,1408,2317,15420,66720,84795,895262,109621765000,75397000,43185000,126295000,246020000,1176065000,5387015000,6809100000,102812665000
Illinois,Manufacturing,2013,64468,22545,10445,9429,42419,12822,4483,59724,4744,68040,22575,10460,9505,42540,13445,5025,61010,7030,2635794,33775,63944,120056,232251,498283,505870,1305575,1216011,147652382000,1767540000,2651042000,5331369000,10086451000,24709003000,26713340000,64581615000,76510535000
Illinois,"Mining, Quarrying, and Oil and Gas Extraction",2013,2438,1365,360,272,1997,190,90,2277,161,2810,1365,360,280,2005,240,215,2460,350,43772,2256,2203,3383,8006,5889,5715,24384,14960,3141119000,109244000,105876000,179164000,403149000,365036000,540689000,1669951000,1273788000
Illinois,Other,2013,321,313,5,2,320,1,0,321,0,321,313,5,2,320,1,0,321,0,271,0,27,0,0,0,0,271,0,6995000,6133000,164000,0,6858000,0,0,6995000,0
Illinois,Other Services (except Public Administration),2013,147412,91900,29283,14380,135563,9311,1520,146394,1018,159495,91985,29585,15140,136710,11750,3570,152030,7465,1218827,169212,190412,187337,550438,317215,144893,1027580,131957,39225277000,4464606000,4877838000,5257665000,14622746000,9656403000,6018167000,30891058000,5745891000
Illinois,"Professional, Scientific, and Technical Services",2013,183714,134963,20643,11907,167513,9752,3073,180338,3376,193830,135015,20710,12245,167970,11315,4000,183285,10545,1958046,152767,133118,156058,472910,319930,252100,1058425,872725,155868306000,11485620000,7633457000,10106826000,29286223000,24342529000,21775084000,75833610000,78716269000
Illinois,Real Estate and Rental and Leasing,2013,49011,36363,5731,2618,44712,2306,941,47959,1052,60675,36435,5855,2855,45145,3340,2610,51095,9580,347826,45280,36692,32775,118550,71800,49544,246089,92297,18558775000,2218219000,1597705000,1516187000,5339495000,3600743000,2737107000,12067105000,5805462000
Illinois,Retail Trade,2013,123556,72660,23238,11938,107836,9833,2569,120238,3318,198505,72800,23780,13205,109785,14420,9600,133805,64700,2956550,114321,144231,145965,405668,353451,211731,1002369,1709033,74051797000,3266068000,3553009000,4099151000,11019030000,12251726000,8039915000,31610710000,39467225000
Illinois,Total,2013,253743,156484,39569,24488,220541,22726,5959,249226,4517,315364,156647,39979,25634,222260,28665,14898,265823,49541,5209070,246844,259182,326686,832712,845711,738928,2417351,2791719,262263398000,10548446000,9787759000,13158249000,33494454000,37191730000,35976067000,106662251000,155601147000
Illinois,Transportation and Warehousing,2013,61528,43795,5629,3987,53411,3657,1823,58891,2637,68180,43815,5650,4025,53490,3940,2380,59810,8370,1006885,30971,35409,48731,135708,108943,116679,377120,524810,43778126000,1891801000,1410876000,1997601000,5365948000,4851389000,5265140000,15910524000,23600071000
Illinois,Utilities,2013,911,370,85,80,535,175,53,763,148,2505,370,85,95,550,265,110,925,1580,118285,32,519,595,1548,7131,5448,15694,95169,12265931000,27537000,16827000,48877000,110717000,557567000,523056000,1270083000,9967812000
Illinois,Wholesale Trade,2013,80249,40458,11857,8654,60969,10413,4146,75528,4721,95910,40515,11955,9080,61550,12645,7520,81715,14195,1537113,61869,76243,110072,253442,331640,250376,850174,635460,108034962000,3798430000,4353714000,6529835000,14718293000,20666188000,15714629000,51832576000,53642527000
Indiana,Accommodation and Food Services,2013,46636,16165,9000,9268,34433,9639,1293,45365,1271,65730,16185,9015,9390,34590,11125,5120,50835,14895,1286692,26874,60455,128083,216190,349169,168449,736835,541635,18157894000,626412000,696410000,1526368000,2850211000,4478395000,2156816000,9516106000,8450618000
Indiana,Administrative and Support and Waste Management and Remediation Services,2013,31057,18245,4665,2920,25830,2757,900,29487,1570,35870,18245,4675,2975,25895,2990,1315,30200,5670,936960,24018,29611,35937,93184,99197,97996,304221,622241,26504443000,1039589000,880193000,1083282000,3017831000,3164484000,2500898000,9192992000,17045797000
Indiana,"Agriculture, Forestry, Fishing and Hunting",2013,1276,975,145,60,1180,40,26,1246,30,1365,975,145,60,1180,40,45,1265,100,6183,928,858,720,2511,885,0,4291,0,302251000,49456000,18552000,27810000,100196000,36638000,0,181275000,0
Indiana,"Arts, Entertainment, and Recreation",2013,10048,5585,1647,1155,8387,1237,242,9866,182,10505,5585,1680,1165,8430,1370,315,10115,390,147201,6178,10543,15330,33784,45580,25925,113907,22684,4356319000,276491000,209640000,295296000,812463000,850834000,654780000,3020843000,444131000
Indiana,Construction,2013,64274,41725,11210,6049,58984,4103,644,63731,543,65010,41735,11215,6055,59005,4195,800,64000,1010,581625,68081,72060,79315,221760,146862,67852,446885,103790,31239855000,2577862000,2736208000,3610695000,8954115000,8243366000,4186970000,21776175000,7204821000
Indiana,Educational Services,2013,7284,3115,1280,1048,5443,1227,270,6940,344,8000,3115,1295,1100,5510,1365,400,7275,725,330331,3701,8063,13694,26516,48579,33740,112596,214646,9150252000,142025000,145209000,251413000,541227000,1163961000,1012064000,2852067000,6153284000
Indiana,Finance and Insurance,2013,24088,16104,3059,1158,20321,1299,846,22466,1622,48335,16120,3145,1450,20715,3065,4905,28685,19650,468602,27929,17898,14036,62543,43779,79968,190282,275066,29920231000,1123667000,873849000,724147000,2753701000,2167669000,4417113000,9638831000,20044669000
Indiana,Health Care and Social Assistance,2013,52126,22755,11970,7009,41734,5948,2574,50256,1870,75965,22765,12090,7355,42210,8510,7270,57990,17975,1966724,39055,80045,91320,215821,229100,390045,844045,1116421,82305365000,1777229000,3136754000,3722055000,8651510000,8714355000,12752171000,30460470000,51121447000
Indiana,Information,2013,5289,2365,651,570,3586,684,253,4523,766,10390,2365,660,590,3615,810,555,4980,5410,201953,3061,3798,7229,15100,20466,17415,56742,145484,10205763000,148550000,141677000,278921000,582536000,930577000,768701000,2377239000,7844788000
Indiana,Management of Companies and Enterprises,2013,3123,85,40,95,220,565,968,1753,1370,4425,85,40,95,220,570,1055,1845,2580,277167,92,105,515,749,6778,28855,36435,241254,27483340000,10182000,4690000,31660000,46760000,334284000,1613970000,1997825000,25485515000
Indiana,Manufacturing,2013,37021,10649,5975,5336,21960,7860,3297,33117,3904,40230,10650,5975,5360,21985,8310,3850,34145,6085,2224747,17252,36051,65629,128087,301696,357981,840695,1254830,115802912000,720677000,1259931000,2634165000,4855658000,13176477000,15601657000,35597934000,73028740000
Indiana,"Mining, Quarrying, and Oil and Gas Extraction",2013,959,390,115,130,635,112,62,809,150,1470,400,115,155,670,160,115,945,525,28172,469,348,1068,2335,1598,0,9708,13286,2062143000,25980000,18951000,62466000,132157000,88756000,13736000,589444000,975750000
Indiana,Other,2013,120,117,3,0,120,0,0,120,0,120,117,3,0,120,0,0,120,0,0,0,0,0,0,0,0,0,0,2130000,1947000,0,0,2130000,0,0,2130000,0
Indiana,Other Services (except Public Administration),2013,75278,44988,16224,7601,68813,4919,840,74572,706,82045,45025,16305,8065,69395,6620,2435,78450,3595,609349,88040,103613,99564,293493,166334,60015,528280,53071,15353608000,1943442000,2283437000,2334428000,6577606000,4068916000,1647722000,12479860000,2126405000
Indiana,"Professional, Scientific, and Technical Services",2013,59121,39975,8325,4820,53120,3452,1059,57631,1490,63900,39975,8370,4945,53290,4260,1620,59170,4730,527353,61148,53174,60839,179125,104707,62337,351112,154196,31925052000,2523580000,2271086000,2912249000,7759090000,5975011000,4185610000,18199864000,13035545000
Indiana,Real Estate and Rental and Leasing,2013,22122,16330,2348,1186,19864,1059,558,21481,641,29240,16350,2390,1320,20060,2225,2280,24565,4675,157414,23650,14507,14434,54126,28916,19683,110908,38569,6159693000,806828000,468998000,477186000,1791572000,1205706000,974089000,4106936000,1735308000
Indiana,Retail Trade,2013,62594,32606,13198,7015,52819,5781,1459,60059,2535,107610,32690,13570,7995,54255,9465,6325,70045,37565,1540308,52570,76407,84308,214838,187530,105513,551826,888485,36369419000,1403643000,1909744000,2244979000,5578227000,6022429000,3472234000,15484099000,19591900000
Indiana,Total,2013,108554,59704,19523,12169,91396,11090,2976,105462,3092,143515,59765,19729,12825,92319,14639,8622,115580,27935,2555979,104367,128393,162435,395195,407307,366335,1168837,1387142,103134350000,3429819000,3879837000,5174231000,12483887000,14426622000,14054334000,40964843000,62169507000
Indiana,Transportation and Warehousing,2013,22313,11985,3150,2239,17374,2130,921,20425,1888,25410,11995,3155,2285,17435,2315,1130,20880,4530,563876,13414,19221,27012,69098,68142,55099,198468,301873,22437492000,686355000,707076000,1080116000,2497937000,2694097000,2087191000,7475388000,12861714000
Indiana,Utilities,2013,960,340,180,100,620,185,25,830,130,2655,340,180,115,635,225,85,945,1710,58901,732,1091,185,2752,7424,1622,13424,46061,5937946000,29638000,43326000,49464000,129127000,518405000,153686000,922383000,4317500000
Indiana,Wholesale Trade,2013,31017,13620,4552,3438,21610,4527,2101,28238,2779,38820,13640,4610,3650,21900,5575,3490,30965,7855,560958,19250,28742,41493,94993,130957,86745,331271,213161,30464398000,1037512000,1331934000,2021506000,4487978000,6708006000,4560408000,16525460000,13535588000
Iowa,Accommodation and Food Services,2013,28275,10565,5290,5796,21651,5240,701,27592,683,35490,10565,5300,5895,21760,6330,2605,30695,4795,566650,17083,34937,80113,133089,183683,78133,395589,171581,7682648000,327944000,356967000,845999000,1541774000,2219456000,968844000,4738592000,2874212000
Iowa,Administrative and Support and Waste Management and Remediation Services,2013,15690,9890,2160,1210,13260,1149,358,14767,923,17865,9900,2160,1235,13295,1310,460,15065,2800,347727,13434,13459,15168,43840,39096,30000,120051,219796,9788784000,512071000,393967000,466868000,1404098000,1175231000,877920000,3543738000,6117980000
Iowa,"Agriculture, Forestry, Fishing and Hunting",2013,1540,1245,135,55,1435,40,55,1530,10,1790,1245,135,55,1435,50,245,1730,60,11174,262,756,152,2491,924,3346,8554,0,582529000,80835000,37228000,9689000,144679000,25517000,165085000,391193000,0
Iowa,"Arts, Entertainment, and Recreation",2013,7100,4380,1055,755,6190,645,160,6995,105,7325,4380,1060,760,6200,695,210,7105,220,94103,5949,6211,9605,22892,23020,19130,67956,14041,1800810000,183684000,119730000,149238000,471645000,363620000,292480000,1225693000,302017000
Iowa,Construction,2013,41730,29015,6579,3215,38809,2314,367,41490,240,42160,29020,6585,3220,38825,2430,465,41720,440,284635,43774,42747,41845,131364,81862,36878,257125,22016,15480569000,1958993000,1823194000,2157562000,5964160000,4712428000,2594962000,13471649000,1647550000
Iowa,Educational Services,2013,3392,1505,505,460,2470,545,173,3188,204,3980,1505,505,470,2480,610,445,3535,445,229515,1709,3026,5835,11853,19558,26629,61096,158953,5991989000,55422000,55047000,92495000,215413000,415876000,696234000,1400994000,3958160000
Iowa,Finance and Insurance,2013,17993,11693,2218,1067,14978,1286,651,16915,1078,30415,11710,2295,1465,15470,3885,3445,22800,7615,429779,18336,13053,12892,47206,43547,63040,157147,264022,27814050000,748350000,592277000,622809000,2009024000,2156062000,3595632000,7901599000,19484169000
Iowa,Health Care and Social Assistance,2013,28850,12710,5140,3657,21507,4190,1937,27634,1216,41190,12725,5200,3905,21830,6355,6070,34255,6935,1078554,21902,33253,47901,105224,172447,277323,561013,469987,40569441000,1016216000,1329539000,1951531000,4323109000,5335710000,8785579000,18574192000,21879964000
Iowa,Information,2013,4327,1720,735,632,3087,478,197,3762,565,7585,1720,740,645,3105,810,480,4395,3190,143832,2498,4617,7044,16146,14396,10967,48314,94968,6670724000,99402000,143129000,262984000,525372000,734986000,551081000,1942021000,4696141000
Iowa,Management of Companies and Enterprises,2013,1971,80,30,116,226,380,616,1222,749,2395,80,30,125,235,380,650,1265,1130,94400,36,0,353,550,3605,17590,21745,72453,7028390000,5235000,0,16522000,29925000,220455000,1135840000,1386220000,5633137000
Iowa,Manufacturing,2013,15606,5025,2500,1944,9469,2919,1467,13855,1751,17660,5025,2515,1955,9495,3150,1920,14565,3095,852199,7365,13274,20008,46220,96812,126571,307785,494436,40588837000,267850000,458459000,772526000,1633643000,4277989000,5745341000,13458415000,24341701000
Iowa,"Mining, Quarrying, and Oil and Gas Extraction",2013,349,125,40,40,205,64,41,310,39,945,125,40,40,205,195,155,555,390,9223,27,250,525,924,2193,2807,6267,0,499944000,7765000,9680000,25760000,43836000,131019000,160740000,350364000,145329000
Iowa,Other,2013,94,89,3,2,94,0,0,94,0,94,89,3,2,94,0,0,94,0,0,0,0,0,0,0,0,0,0,2070000,1359000,0,0,2070000,0,0,2070000,0
Iowa,Other Services (except Public Administration),2013,42445,28130,8517,3382,40029,1723,350,42102,343,45295,28185,8770,3735,40690,2425,910,44025,1270,249075,53065,54199,42943,152572,54913,13327,229581,11997,6052487000,1146199000,1158953000,1011569000,3346720000,1449128000,377931000,5341887000,472843000
Iowa,"Professional, Scientific, and Technical Services",2013,28929,19015,4615,2337,25967,1708,460,28135,794,31300,19015,4625,2430,26070,2290,770,29130,2170,245279,26532,28140,28277,87688,52103,18382,166375,69429,13323877000,1199687000,1147179000,1277540000,3680913000,3094983000,1159969000,8349105000,4779992000
Iowa,Real Estate and Rental and Leasing,2013,11125,8538,1048,510,10096,419,273,10788,337,13715,8550,1055,635,10240,770,800,11810,1905,56281,9582,5742,5641,24372,10149,4748,44101,8827,2143606000,365258000,191889000,175274000,764281000,384335000,236127000,1607078000,380884000
Iowa,Retail Trade,2013,38185,18730,8238,5026,31994,3519,950,36463,1722,59885,18775,8355,5520,32650,5865,3210,41725,18160,848103,31550,50225,58073,149416,105417,50784,321626,417102,19394204000,790549000,1177005000,1559814000,3562597000,3392115000,1745282000,8915621000,8371932000
Iowa,Total,2013,62453,35963,10670,6638,53271,5750,1600,60621,1832,80581,36007,10816,7137,53960,8625,5459,68044,12537,1305216,61305,70001,88090,219396,214044,199830,633270,671946,50343119000,1960960000,2080305000,2746503000,6787768000,7444301000,7810023000,22042092000,28301027000
Iowa,Transportation and Warehousing,2013,15719,10170,2060,1130,13360,1072,439,14871,848,17425,10170,2075,1160,13405,1280,600,15285,2140,274446,13004,12745,14186,42537,30973,22432,101228,163344,10578571000,466878000,445809000,523029000,1462584000,1231984000,1035634000,3827416000,6607148000
Iowa,Utilities,2013,476,90,55,60,205,155,27,387,89,1360,90,55,60,205,325,65,595,765,37848,73,0,773,1318,5785,0,7840,20021,2903712000,3244000,19376000,45043000,71325000,360163000,0,477381000,1643509000
Iowa,Wholesale Trade,2013,17326,6795,2523,2204,11522,2698,1353,15573,1753,24655,6805,2565,2365,11735,3970,3790,19495,5160,322383,9923,14934,26175,54600,74722,72795,216141,91224,16468381000,462414000,694191000,1262680000,2527491000,3880137000,3968673000,10864448000,5140025000
Kansas,Accommodation and Food Services,2013,21710,7645,3930,4115,15690,4557,610,20857,853,30305,7645,3950,4145,15740,5360,2010,23110,7195,539492,11434,26596,56487,95258,162107,66176,324105,214111,7329710000,269397000,281889000,626251000,1180548000,2097241000,881082000,4161662000,3150712000
Kansas,Administrative and Support and Waste Management and Remediation Services,2013,15744,9175,2280,1415,12870,1333,515,14718,1026,17445,9185,2290,1450,12925,1400,585,14910,2535,360272,13049,14310,17782,46466,48921,54909,160034,164637,11058000000,470264000,406641000,554590000,1471771000,1545274000,1593913000,4826133000,4982285000
Kansas,"Agriculture, Forestry, Fishing and Hunting",2013,1040,745,160,95,1000,30,5,1035,5,1040,745,160,95,1000,30,5,1035,5,4066,175,834,981,2899,901,0,3934,0,148556000,36258000,35013000,41298000,118915000,22299000,0,147340000,0
Kansas,"Arts, Entertainment, and Recreation",2013,4815,2730,615,650,3995,575,135,4705,110,5045,2730,615,660,4005,635,210,4850,195,74811,2978,3709,7731,16370,21582,13800,54430,14789,1385944000,97681000,72922000,137412000,321371000,365202000,288340000,1015283000,244907000
Kansas,Construction,2013,33628,21715,5928,3015,30658,2295,345,33298,330,34010,21715,5945,3020,30680,2350,375,33405,605,285893,35111,38179,39737,115040,85529,30565,235763,33046,14326988000,1263762000,1436121000,1706288000,4429738000,4535447000,1849195000,10971268000,2241894000
Kansas,Educational Services,2013,3391,1500,565,395,2460,525,218,3203,188,3675,1500,565,405,2470,540,325,3335,340,104058,2008,3604,4673,10659,19035,32501,65808,31760,2733219000,58427000,67709000,89757000,224994000,452153000,705066000,1529033000,918288000
Kansas,Finance and Insurance,2013,18129,11805,2035,1055,14895,1281,551,16727,1402,29515,11815,2115,1445,15375,3425,2645,21445,8070,291510,19664,11229,13248,45611,43510,45062,136110,143568,18786379000,783378000,534860000,727153000,2082690000,2323373000,2844438000,7379634000,9970345000
Kansas,Health Care and Social Assistance,2013,29446,13190,5790,3801,22781,3940,1637,28358,1088,39385,13205,5825,3975,23005,5490,4620,33115,6270,950955,18958,37350,49404,112435,157006,245793,526505,399839,37457371000,1151103000,1500738000,2152528000,4822502000,5927751000,8322726000,19336578000,17153049000
Kansas,Information,2013,3582,1375,495,380,2250,469,213,2932,650,6685,1380,495,405,2280,620,545,3445,3240,186943,1256,2405,4092,9566,14509,8447,40010,139690,13549663000,91876000,106661000,173051000,396190000,725141000,500073000,1811769000,11550317000
Kansas,Management of Companies and Enterprises,2013,2292,145,55,60,260,445,580,1285,1007,2950,145,55,60,260,485,615,1360,1590,98980,112,180,0,628,5390,17350,23445,75503,9690500000,21490000,18787000,20563000,62440000,371105000,1238930000,1672475000,8013475000
Kansas,Manufacturing,2013,13258,4250,2230,1829,8309,2347,1176,11832,1426,14180,4250,2240,1835,8325,2515,1405,12245,1935,709840,5084,11972,18776,40741,74882,115716,264560,402039,36271971000,238194000,436013000,794234000,1631323000,3134931000,5158461000,11344321000,23085520000
Kansas,"Mining, Quarrying, and Oil and Gas Extraction",2013,4969,2935,745,515,4195,441,108,4744,225,5300,2935,750,540,4225,520,145,4890,410,50401,4948,4760,6629,16618,12926,7187,38896,10347,2961652000,224391000,239419000,346409000,813823000,790335000,398452000,2107962000,794699000
Kansas,Other,2013,127,125,2,0,127,0,0,127,0,127,125,2,0,127,0,0,127,0,0,0,0,0,0,0,0,0,0,1973000,1903000,0,0,1973000,0,0,1973000,0
Kansas,Other Services (except Public Administration),2013,37413,24460,7158,2980,34598,2075,381,37054,359,39735,24485,7225,3070,34780,2720,840,38340,1395,250352,42776,45051,36359,128675,67217,26374,232985,13177,6268223000,992012000,992586000,908262000,2910340000,1682301000,769084000,5781608000,389814000
Kansas,"Professional, Scientific, and Technical Services",2013,33034,22250,4685,2552,29487,1677,699,31863,1171,35645,22250,4720,2610,29580,2070,1180,32830,2815,300849,30312,29303,32381,93680,49191,42983,204503,65485,18864804000,1479882000,1279602000,1600513000,4412496000,3020205000,2786631000,10980373000,5343075000
Kansas,Real Estate and Rental and Leasing,2013,12239,9268,1270,567,11105,457,238,11800,439,15230,9310,1305,600,11215,805,1030,13050,2180,72011,12051,7526,6642,27860,9512,12573,52110,16383,2652775000,445716000,280065000,244026000,1006795000,417850000,392511000,1873705000,706597000
Kansas,Retail Trade,2013,35540,17613,7838,4356,29807,2947,852,33606,1934,52165,17640,7955,4670,30265,4370,2425,37060,15105,674020,29633,48178,54316,138808,82508,53308,287667,360139,16024191000,764161000,1068122000,1299551000,3149706000,2652549000,1780865000,7849793000,7475319000
Kansas,Total,2013,58068,32856,9917,6088,48861,5490,1644,55995,2073,73816,32893,10035,6411,49339,7706,4516,61561,12255,1150401,56528,65022,80632,202182,201085,193012,596279,554122,47715601000,1883035000,1993333000,2724505000,6600873000,7271301000,7746320000,21618494000,26097107000
Kansas,Transportation and Warehousing,2013,10507,6015,1482,920,8417,848,359,9624,883,12460,6015,1490,955,8460,960,545,9965,2495,223212,8797,8783,10463,29639,23422,15881,76060,136204,8973235000,322927000,296620000,422329000,1077311000,864490000,803538000,2985959000,5542889000
Kansas,Utilities,2013,354,55,25,35,115,100,38,253,101,1170,55,25,35,115,150,265,530,640,33995,0,126,531,666,3626,1141,8096,20003,2933125000,0,4229000,31933000,41800000,250046000,295408000,616060000,1817818000
Kansas,Wholesale Trade,2013,16764,6819,2387,1938,11144,2599,1243,14986,1778,22505,6835,2440,2080,11355,4085,2810,18250,4255,305034,9794,14218,20819,48526,70071,48115,183705,110529,16878404000,554395000,707787000,1153115000,2533010000,3561606000,2699789000,9482582000,6663188000
Kentucky,Accommodation and Food Services,2013,27599,8820,5145,5465,19430,6156,1023,26609,990,39045,8825,5150,5510,19485,7210,3835,30530,8515,795599,13080,34743,75085,124125,221786,138572,485732,305745,11175575000,340184000,416324000,966798000,1727760000,2780361000,1831864000,6360275000,4446209000
Kentucky,Administrative and Support and Waste Management and Remediation Services,2013,16781,9495,2470,1480,13445,1500,660,15605,1176,19910,9505,2470,1495,13470,1640,870,15980,3930,480701,13815,14987,19233,50768,53535,64166,175329,290919,12468778000,541759000,471038000,595177000,1647564000,1675351000,1538080000,5045760000,7066319000
Kentucky,"Agriculture, Forestry, Fishing and Hunting",2013,1105,755,175,85,1015,40,35,1090,15,1105,755,175,85,1015,40,35,1090,15,6392,989,1025,698,3063,966,1899,6117,66,201348000,30848000,34470000,26504000,94216000,27785000,71561000,197100000,1000000
Kentucky,"Arts, Entertainment, and Recreation",2013,6057,3285,945,774,5004,799,122,5925,132,6370,3285,955,805,5045,895,170,6110,260,84868,4102,5353,9059,20722,30358,11213,65900,15606,2041742000,187043000,109788000,177569000,505429000,599739000,305391000,1509784000,322181000
Kentucky,Construction,2013,35420,22290,6280,3479,32049,2690,419,35158,262,35905,22290,6280,3495,32065,2800,565,35430,475,302060,34739,40339,45861,125655,97483,39721,271285,15870,14139080000,1265270000,1392055000,1922805000,4605525000,5064074000,2371641000,12359485000,1085835000
Kentucky,Educational Services,2013,3844,1725,660,475,2860,537,228,3625,219,4505,1730,660,490,2880,555,425,3860,645,146921,2462,4345,5925,13513,18889,35722,75214,64137,3631987000,67972000,73471000,108345000,260905000,476540000,969201000,1866492000,1578551000
Kentucky,Finance and Insurance,2013,15530,9560,2273,780,12613,1107,511,14231,1299,31500,9575,2335,1035,12945,2915,3530,19390,12110,320922,16896,13338,9133,40459,39348,45042,130874,181923,19672126000,673552000,581079000,468228000,1773698000,1912140000,2117801000,6084650000,12502432000
Kentucky,Health Care and Social Assistance,2013,46143,23600,9432,5757,38789,4317,1555,44661,1482,61635,23615,9465,6010,39090,5840,4635,49565,12070,1277918,37963,62086,76204,179697,155395,196735,538781,721441,51670494000,1581727000,2218563000,2793183000,6624793000,6318641000,5983486000,19166719000,32233916000
Kentucky,Information,2013,3892,1640,550,450,2640,437,228,3305,587,7290,1640,550,465,2655,650,395,3700,3590,148786,2051,2959,5566,11421,12379,7378,39378,107438,6289587000,93350000,109777000,169498000,387828000,604625000,445196000,1560031000,4525751000
Kentucky,Management of Companies and Enterprises,2013,2316,155,60,51,266,385,680,1331,985,3380,155,60,55,270,385,745,1400,1980,140125,0,226,0,67,4411,17430,22920,117169,12374180000,19116000,15531000,13984000,54615000,283515000,1140505000,1478635000,10892313000
Kentucky,Manufacturing,2013,17021,5140,2670,2205,10015,2975,1559,14549,2472,18580,5140,2670,2215,10025,3280,1920,15225,3355,987394,6894,14931,24395,51326,97311,122399,312668,598251,47594075000,289195000,469827000,918146000,1834279000,3969622000,5443034000,13088387000,31075380000
Kentucky,"Mining, Quarrying, and Oil and Gas Extraction",2013,2178,860,270,295,1425,414,134,1973,205,2760,860,270,295,1425,440,250,2115,645,91533,764,1642,3656,6888,14297,13631,35557,55836,5976491000,72030000,67537000,201971000,347889000,861287000,758467000,1999393000,3976562000
Kentucky,Other,2013,416,407,9,0,416,0,0,416,0,416,407,9,0,416,0,0,416,0,501,0,44,0,501,0,0,501,0,7575000,7322000,253000,0,7575000,0,0,7575000,0
Kentucky,Other Services (except Public Administration),2013,43256,27705,8487,3685,39877,2454,407,42738,518,46895,27745,8565,3900,40210,3295,1285,44790,2105,331500,51014,54139,46433,154960,81037,17497,261663,38273,8020581000,1154353000,1215788000,1093991000,3488998000,2081739000,516196000,6238699000,1590402000
Kentucky,"Professional, Scientific, and Technical Services",2013,37741,25515,5255,3140,33910,2103,656,36669,1072,40820,25530,5265,3200,33995,2585,985,37565,3255,334805,39578,33135,39716,115025,64754,40525,230102,92919,15631856000,1583011000,1343149000,1752787000,4712302000,3489342000,2016189000,10487165000,4989858000
Kentucky,Real Estate and Rental and Leasing,2013,14211,10405,1623,670,12698,592,364,13654,557,18000,10430,1715,765,12910,1115,855,14880,3120,90223,16168,9838,7602,35259,15924,7319,63416,24147,3273974000,476623000,316406000,281069000,1110605000,502193000,327162000,2259375000,952367000
Kentucky,Retail Trade,2013,47119,24555,10211,5524,40290,3888,939,45117,2002,76050,24595,10400,6115,41110,6230,3170,50510,25540,934363,42353,64572,69254,178938,126868,54460,378406,430476,22054273000,1004065000,1467982000,1794582000,4286136000,4069094000,1751913000,10364503000,9029285000
Kentucky,Total,2013,68574,38220,12143,7441,57804,6548,1808,66160,2414,90675,38263,12274,7855,58392,8803,5245,72440,18235,1507375,66520,80139,99093,245752,236337,206451,688540,818835,57541159000,2083701000,2305776000,3061764000,7451241000,8155871000,7437636000,23044748000,34496411000
Kentucky,Transportation and Warehousing,2013,11914,6180,1680,1155,9015,1078,464,10557,1357,14130,6180,1680,1180,9040,1160,575,10775,3355,321760,8442,9220,12970,33879,29567,22638,96224,202193,14795419000,315266000,319670000,472942000,1156231000,1222938000,1035566000,3707917000,10114456000
Kentucky,Utilities,2013,473,145,35,65,245,80,60,385,88,1695,145,35,65,245,160,245,650,1045,41011,232,170,695,1231,4652,6303,12677,5990,3320603000,10787000,5880000,22760000,45622000,301383000,386484000,749712000,1546199000
Kentucky,Wholesale Trade,2013,17392,7270,2582,1886,11738,2371,1104,15213,2179,21720,7280,2625,2095,12000,2820,1735,16555,5165,329189,9303,15562,22072,50452,61277,44053,175601,140529,18264191000,533389000,632790000,1008043000,2267925000,3016478000,2369675000,8508365000,8973897000
Louisiana,Accommodation and Food Services,2013,34356,11515,6428,7005,24948,7637,945,33530,826,46155,11525,6440,7120,25085,8520,3670,37275,8880,991459,20461,43305,94949,158823,280835,146973,587916,375972,16818495000,480520000,566189000,1254919000,2303425000,4328413000,2560355000,9210231000,7552893000
Louisiana,Administrative and Support and Waste Management and Remediation Services,2013,20304,10980,3220,2037,16237,2206,751,19194,1110,23330,10980,3250,2075,16305,2435,1005,19745,3585,514955,14675,19893,25988,64845,82656,88748,243273,257797,17340308000,676958000,639222000,915321000,2319376000,2779803000,2565234000,7900929000,9024751000
Louisiana,"Agriculture, Forestry, Fishing and Hunting",2013,2916,1566,735,330,2631,235,10,2876,40,2980,1570,735,330,2635,235,10,2880,100,18585,1791,4799,3644,11094,5939,0,17706,644,816585000,102275000,180133000,131995000,428479000,248931000,0,700451000,45158000
Louisiana,"Arts, Entertainment, and Recreation",2013,6500,3600,1030,717,5347,865,170,6382,118,6925,3600,1030,720,5350,995,285,6630,295,110656,4801,6310,8389,21348,30581,11438,70793,37531,2806786000,185224000,147500000,145778000,493648000,582495000,223926000,1640708000,773062000
Louisiana,Construction,2013,39184,22365,7477,4430,34272,3594,724,38590,594,39725,22365,7480,4435,34280,3645,870,38795,930,645053,37796,48535,59007,147394,136405,94996,388405,249705,33985062000,1377875000,1747677000,2421210000,5555375000,6729480000,5606187000,18512040000,14891713000
Louisiana,Educational Services,2013,5367,2095,765,640,3500,1323,350,5173,194,5930,2110,765,650,3525,1460,505,5490,440,205063,2807,4857,8562,17165,59823,48691,127909,67841,7211859000,140633000,151577000,175034000,477213000,1750971000,1739440000,3998315000,2942324000
Louisiana,Finance and Insurance,2013,19673,12060,3479,1173,16712,1274,531,18517,1156,38615,12070,3650,1570,17290,3985,4385,25660,12955,324747,18093,21067,14369,57715,46257,53104,162682,145991,18700219000,927829000,982653000,743443000,2686571000,2409047000,2955235000,8249125000,10074629000
Louisiana,Health Care and Social Assistance,2013,49349,22010,11450,6334,39794,6148,2233,48175,1174,60070,22045,11520,6565,40130,7830,5020,52980,7090,1434975,39240,74756,82520,200409,251552,343011,798694,601359,55929505000,2418966000,2846744000,3066033000,8358598000,7610805000,10104885000,26396384000,29340329000
Louisiana,Information,2013,3358,1430,485,333,2248,472,182,2902,456,6910,1430,490,355,2275,590,485,3350,3560,114679,1503,2671,3329,8987,14209,2052,34837,72722,6267366000,97047000,94029000,152236000,374921000,706315000,313763000,1647203000,4053511000
Louisiana,Management of Companies and Enterprises,2013,2348,140,55,60,255,515,679,1449,899,3095,140,55,60,255,520,705,1480,1615,110940,35,259,312,91,6785,22809,30362,79418,10805660000,14385000,13860000,14588000,43325000,394850000,1794476000,2231317000,8506839000
Louisiana,Manufacturing,2013,14972,5310,2605,2135,10050,2608,858,13516,1456,16260,5310,2605,2135,10050,2800,1190,14040,2220,516836,7740,13804,23099,50071,87238,68244,230687,254106,33020478000,362231000,551939000,1031078000,2145560000,4416589000,3900790000,11539992000,19219692000
Louisiana,"Mining, Quarrying, and Oil and Gas Extraction",2013,6757,3480,755,614,4849,935,385,6169,588,8285,3485,760,625,4870,1075,510,6455,1830,262833,3942,4865,8316,18413,36120,44325,99270,163510,21790840000,438604000,287782000,507513000,1236275000,2624750000,3896836000,7766949000,14021484000
Louisiana,Other,2013,126,119,4,3,126,0,0,126,0,126,119,4,3,126,0,0,126,0,150,0,0,32,150,0,0,150,0,3191000,2605000,441000,145000,3191000,0,0,3191000,0
Louisiana,Other Services (except Public Administration),2013,44548,26450,9450,4452,40352,3112,532,43996,552,47485,26460,9480,4775,40715,3900,950,45565,1920,364169,50845,61214,57187,171018,110896,39010,326993,21823,10101735000,1242274000,1425783000,1522738000,4204870000,2993228000,1327076000,8700470000,987044000
Louisiana,"Professional, Scientific, and Technical Services",2013,55881,38913,7690,4103,50706,3225,772,54703,1178,59910,38930,7710,4220,50860,3915,1245,56020,3890,476263,57495,49928,51663,163968,104138,68116,342654,107397,28282141000,3109053000,2314871000,2968508000,8428116000,6826145000,4901151000,20431807000,7297245000
Louisiana,Real Estate and Rental and Leasing,2013,18077,12760,2194,1020,15974,1001,500,17475,602,23155,12760,2240,1175,16175,1510,1685,19370,3785,155213,18894,13287,12410,46157,29659,31662,111368,38006,7745144000,688648000,482408000,532379000,1722895000,1418553000,1565023000,4828485000,2401824000
Louisiana,Retail Trade,2013,52903,27717,11384,6161,45262,4854,900,51016,1887,82780,27785,11595,6780,46160,7175,3000,56335,26445,999052,52268,69444,76115,203052,168984,71705,458444,471496,25223480000,1289543000,1720014000,2062624000,5165192000,5513690000,2670406000,13491741000,11118491000
Louisiana,Total,2013,81117,43926,15038,9159,68123,8675,2125,78923,2194,104375,43975,15186,9673,68834,11314,5855,86003,18372,1687956,78129,98865,122077,299071,328581,275629,903281,784675,72069585000,3027215000,3218185000,4171524000,10416924000,12093514000,11926457000,34436895000,37632690000
Louisiana,Transportation and Warehousing,2013,15085,7840,2075,1507,11422,1629,706,13757,1328,19150,7845,2075,1535,11455,1785,1025,14265,4885,325572,9926,11815,17241,43188,49360,48747,160637,143710,18586415000,497005000,491479000,860499000,1883532000,2538358000,3293020000,8533723000,9276841000
Louisiana,Utilities,2013,1095,625,215,65,905,60,43,1008,87,2570,625,220,65,910,95,160,1165,1405,3951,768,1266,703,3267,1368,4931,11616,204,353730000,30252000,38819000,23645000,95767000,106613000,294373000,542904000,210985000
Louisiana,Wholesale Trade,2013,21576,8230,3780,2958,14968,3273,1334,19575,2001,27915,8245,3810,3160,15215,4100,2570,21885,6030,381047,11608,23331,36204,76935,94496,59238,245124,120588,21037146000,685275000,1131082000,1805919000,3685564000,4912400000,3318064000,12573138000,7670106000
Maine,Accommodation and Food Services,2013,18002,8835,3160,2980,14975,2487,243,17705,297,20410,8865,3165,3010,15040,2980,1025,19045,1365,239360,8962,21203,41207,71826,87941,30423,193368,42119,4619672000,575343000,448619000,732794000,1765849000,1590170000,481564000,3889490000,732714000
Maine,Administrative and Support and Waste Management and Remediation Services,2013,9382,6295,1205,600,8100,633,190,8923,459,10070,6300,1205,620,8125,760,250,9135,935,105914,7953,7579,7381,24210,20342,14830,65645,27088,3233771000,339477000,217059000,252328000,835600000,642199000,410043000,2143199000,779959000
Maine,"Agriculture, Forestry, Fishing and Hunting",2013,4030,3275,365,180,3820,180,15,4015,15,4075,3275,365,180,3820,195,35,4050,25,15055,1999,2259,0,8107,5297,0,14580,475,659002000,131334000,77601000,90228000,302145000,220489000,0,625487000,33515000
Maine,"Arts, Entertainment, and Recreation",2013,4174,2765,580,365,3710,362,57,4129,45,4250,2765,580,365,3710,390,105,4205,45,34191,2009,3653,3952,11719,11212,5414,32406,2583,773933000,174048000,107192000,98114000,396817000,220788000,52818000,721924000,46577000
Maine,Construction,2013,23343,18070,2860,1357,22287,883,80,23250,93,23425,18070,2860,1360,22290,915,85,23290,135,107154,25271,17506,17077,62885,27955,6282,101126,2963,4960273000,990323000,708025000,775615000,2512284000,1504489000,359406000,4581425000,194879000
Maine,Educational Services,2013,2324,1125,390,280,1795,313,115,2223,101,2415,1125,390,280,1795,335,140,2270,145,89177,1375,2291,3312,7630,12517,15143,37336,50678,2451342000,52961000,55209000,77852000,203161000,331676000,480590000,1105003000,1312247000
Maine,Finance and Insurance,2013,4602,2425,570,300,3295,491,205,3991,611,9550,2425,590,370,3385,1325,1445,6155,3395,122627,3417,2719,3576,10879,17964,20323,50979,65433,8358186000,174109000,150021000,206365000,547008000,999570000,1125021000,2830647000,4914666000
Maine,Health Care and Social Assistance,2013,16237,7780,3105,1869,12754,1756,951,15461,776,23510,7790,3130,1925,12845,2890,3575,19310,4200,531278,12697,19315,23487,57906,70967,113961,245019,271984,21878030000,501884000,791485000,962659000,2298245000,2251500000,3809399000,8475957000,12987326000
Maine,Information,2013,2673,1270,400,230,1900,299,133,2332,341,4030,1270,400,235,1905,355,265,2525,1505,44501,1510,2162,2555,6816,7973,5865,27569,16684,2665881000,60118000,59733000,82802000,227811000,352780000,314847000,1225210000,832295000
Maine,Management of Companies and Enterprises,2013,847,65,20,30,115,140,296,551,296,1060,65,20,30,115,140,310,565,495,40857,0,0,0,208,1714,7123,9045,31530,3133839000,5558000,0,0,19153000,85086000,339576000,444054000,2684081000
Maine,Manufacturing,2013,7821,3510,1275,934,5719,1203,409,7331,490,8110,3515,1275,935,5725,1280,475,7480,630,173637,3703,6055,8058,20580,36189,26164,99495,60838,8479074000,193917000,213787000,329892000,879097000,1618480000,1136606000,4204651000,3533815000
Maine,"Mining, Quarrying, and Oil and Gas Extraction",2013,116,95,0,0,95,15,0,110,6,120,95,0,0,95,15,0,110,10,0,81,0,0,81,0,0,195,0,16002000,6321000,0,0,6321000,0,0,12123000,0
Maine,Other,2013,60,59,0,0,59,1,0,60,0,60,59,0,0,59,1,0,60,0,0,0,0,0,0,0,0,0,0,1493000,1390000,0,0,1390000,0,0,1493000,0
Maine,Other Services (except Public Administration),2013,17328,12020,3170,1138,16328,607,153,17088,240,18325,12030,3215,1205,16450,890,380,17720,605,89725,21370,19149,13734,56146,16787,5274,83399,3525,2370345000,548603000,480667000,369586000,1416045000,492271000,108087000,2142707000,128968000
Maine,"Professional, Scientific, and Technical Services",2013,16526,11345,2423,1090,14858,840,200,15898,628,17440,11345,2435,1115,14895,1055,260,16210,1230,110387,14981,14847,13304,43110,24417,9116,82162,18331,6256324000,735267000,701379000,671670000,2136780000,1455569000,719955000,4566441000,1157320000
Maine,Real Estate and Rental and Leasing,2013,7181,5625,715,323,6663,209,65,6937,244,7970,5625,730,390,6745,375,120,7240,730,29734,6675,4136,3335,15551,4446,1091,23909,4025,1143484000,284584000,159180000,124403000,583724000,165766000,44019000,881441000,191499000
Maine,Retail Trade,2013,22607,11652,4538,2893,19083,1865,416,21364,1243,31750,11675,4650,3115,19440,2740,1705,23885,7865,361863,15572,27191,32799,79681,56067,28503,181894,89021,9071804000,523723000,641635000,836765000,2042094000,1645768000,1124433000,5137015000,2394498000
Maine,Total,2013,33237,20671,5258,3103,29032,2542,614,32188,1049,40257,20700,5324,3258,29282,3598,2237,35117,5140,487313,31963,34454,41497,107914,93935,77147,278996,208317,18739108000,1159890000,1080964000,1316244000,3557098000,3225944000,2949905000,9732947000,9006161000
Maine,Transportation and Warehousing,2013,5504,3460,684,490,4634,380,139,5153,351,5975,3460,705,500,4665,435,195,5295,680,54034,3942,3407,5168,14515,11196,4195,32273,11979,2116076000,155842000,127711000,175195000,505861000,404177000,185468000,1254602000,518040000
Maine,Utilities,2013,229,100,15,10,125,20,35,180,49,485,100,15,20,135,20,135,290,195,707,143,0,0,337,0,0,323,3776,547868000,9932000,0,0,16873000,0,0,235349000,308816000
Maine,Wholesale Trade,2013,6996,3405,880,593,4878,781,420,6079,917,8015,3410,890,635,4935,890,680,6505,1510,80743,3659,4626,5134,16508,16210,13227,52871,18820,4101769000,219429000,192934000,248668000,755864000,733271000,668294000,2508529000,1188922000
Maryland,Accommodation and Food Services,2013,45521,18675,8680,7236,34591,8865,1067,44523,998,57770,18675,8725,7280,34680,9720,2655,47055,10715,1052289,31911,57363,98490,188536,334576,124078,646458,375525,18869066000,894814000,893214000,1504923000,3296809000,5683187000,2127625000,11162405000,7661260000
Maryland,Administrative and Support and Waste Management and Remediation Services,2013,35590,19715,5355,3635,28705,4017,1254,33976,1614,40160,19725,5365,3665,28755,4175,1620,34550,5610,896066,27615,34436,47269,111800,152888,137247,415876,473902,32885241000,1215882000,1204563000,1802607000,4270494000,5593225000,4682015000,14958594000,17672139000
Maryland,"Agriculture, Forestry, Fishing and Hunting",2013,918,710,105,60,875,15,10,900,18,930,710,105,60,875,15,10,900,30,4527,771,240,746,2333,0,0,2920,636,167979000,32874000,16402000,26773000,80725000,0,0,106625000,24302000
Maryland,"Arts, Entertainment, and Recreation",2013,9333,5180,1290,1025,7495,1315,273,9083,250,10165,5180,1295,1035,7510,1425,360,9295,870,186769,6167,7752,12877,29458,50607,36065,120502,37320,5414506000,366753000,225571000,255147000,870078000,1151000000,1165325000,3310298000,614013000
Maryland,Construction,2013,68342,43030,10710,7015,60755,5947,1029,67731,611,68790,43030,10710,7025,60765,5990,1145,67900,890,700945,69525,69600,94844,234791,225203,137481,606715,64281,38335400000,2900305000,2928068000,4647228000,10483885000,12534687000,8260817000,31654570000,4723190000
Maryland,Educational Services,2013,9424,4425,1440,1165,7030,1498,576,9104,320,10185,4430,1450,1215,7095,1665,720,9480,705,394211,6442,9196,15382,30881,59629,74852,171001,223502,16977754000,247539000,248929000,343525000,851093000,1814600000,3065721000,5872566000,11213940000
Maryland,Finance and Insurance,2013,20695,12475,3135,1347,16957,1296,762,19015,1680,37755,12485,3170,1565,17220,2770,2680,22670,15085,465101,20601,19534,16878,59593,45071,55235,167513,262374,41506956000,1227510000,1198739000,1391151000,3881799000,3599577000,4837749000,12963083000,26287745000
Maryland,Health Care and Social Assistance,2013,62599,30465,13985,8031,52481,6244,2206,60931,1668,80160,30555,14130,8590,53275,9240,7705,70220,9940,1747981,56115,91948,104088,254972,232484,318664,817349,899495,81892598000,2813811000,4333919000,5049662000,12213802000,10778671000,11162181000,34506385000,45842797000
Maryland,Information,2013,7014,3400,755,595,4750,925,325,6000,1014,12335,3405,755,615,4775,1025,450,6250,6085,254188,4123,4092,7021,17641,27205,25682,77698,173429,19558272000,350845000,297263000,453372000,1165705000,1774301000,2251363000,5506394000,13776456000
Maryland,Management of Companies and Enterprises,2013,3058,195,55,120,370,502,851,1723,1335,6035,195,55,120,370,520,890,1780,4255,257026,0,22,714,1096,6973,26652,34844,222182,24433537000,34563000,11630000,79950000,126143000,571145000,1844483000,2541771000,21891766000
Maryland,Manufacturing,2013,14401,5785,2339,1825,9949,2406,858,13213,1188,14970,5785,2340,1830,9955,2485,1005,13445,1525,432136,8395,11910,19611,44760,71835,55880,201752,170561,26095319000,403209000,510611000,879639000,1993964000,3520636000,3054282000,9962360000,12574068000
Maryland,"Mining, Quarrying, and Oil and Gas Extraction",2013,315,95,60,30,185,60,20,265,50,375,95,60,30,185,60,40,285,90,5740,7,182,0,606,1528,0,2141,1969,341112000,6460000,12186000,0,34354000,103879000,0,159772000,117889000
Maryland,Other,2013,184,181,3,0,184,0,0,184,0,184,181,3,0,184,0,0,184,0,0,0,0,0,0,0,0,0,0,4271000,4153000,0,0,4271000,0,0,4271000,0
Maryland,Other Services (except Public Administration),2013,63732,37910,12631,7027,57568,4766,763,63097,635,67965,37925,12680,7180,57785,5475,1520,64780,3185,558861,70247,81572,91639,247070,167875,63218,485803,55019,20158314000,2199922000,2331100000,2772870000,7325991000,5782719000,2962179000,16278546000,2841025000
Maryland,"Professional, Scientific, and Technical Services",2013,90323,60972,11263,6645,78880,6867,2290,88037,2286,100575,60985,11320,6790,79095,7415,2975,89485,11090,1315126,69407,72956,86317,249680,239390,209409,706348,587235,107935493000,5671673000,4624696000,5841680000,16168197000,19526524000,16992179000,53082409000,54257580000
Maryland,Real Estate and Rental and Leasing,2013,21912,15503,2315,1305,19123,1351,642,21116,796,30320,15520,2330,1465,19315,1935,2575,23825,6495,210140,16423,14270,16908,52554,39946,36882,132235,57886,11922128000,995197000,657538000,841814000,2508118000,2544282000,2175427000,7417423000,3763641000
Maryland,Retail Trade,2013,57752,31459,11838,6415,49712,4182,1347,55241,2511,91240,31585,12055,6995,50635,5810,4120,60565,30675,1382452,50595,69598,73967,197212,135826,99862,467680,814072,36358853000,1491297000,1907556000,2190647000,5681953000,4794434000,4193307000,15198030000,20042196000
Maryland,Total,2013,108071,62117,18304,11470,91891,10681,2754,105326,2745,135421,62193,18449,11946,92588,13025,6657,112270,23151,2182260,104879,120283,152989,378151,397424,326241,1101816,1080444,108758652000,4500044000,4672552000,6251989000,15424585000,17914532000,16136827000,49475944000,59282708000
Maryland,Transportation and Warehousing,2013,15355,8310,2250,1519,12079,1475,528,14082,1273,16965,8310,2250,1535,12095,1595,665,14355,2610,300382,11562,13837,18757,46583,46476,23543,123053,126668,12446195000,434546000,456367000,630449000,1562307000,1747507000,909740000,4459320000,5721689000
Maryland,Utilities,2013,282,80,20,15,115,30,25,170,112,720,80,20,15,115,35,65,215,505,49040,61,71,0,281,0,1800,2325,42960,5438802000,7412000,4633000,0,16537000,0,167928000,280553000,4810052000
Maryland,Wholesale Trade,2013,24225,11370,3403,2623,17396,3243,1375,22014,2211,28770,11385,3415,2720,17520,3770,2085,23375,5395,428849,14401,20798,30795,71460,97933,75521,262499,146855,28559465000,996611000,1198480000,1856526000,4152333000,5978277000,4643026000,15529465000,11518965000
Massachusetts,Accommodation and Food Services,2013,68221,27721,13704,12054,53479,12654,1120,67253,968,85980,27760,13730,12200,53690,14270,4400,72360,13620,1361380,46862,90410,165535,303043,456482,156210,916846,430044,27864090000,1672253000,1490450000,2711329000,5882240000,8379890000,3101220000,17377155000,9246710000
Massachusetts,Administrative and Support and Waste Management and Remediation Services,2013,45475,29655,5905,3496,39056,3401,1336,43793,1682,51175,29660,5925,3530,39115,3620,1500,44235,6940,918972,35087,38104,45523,121210,127507,173183,436060,471274,41392960000,2350943000,1746831000,2084893000,6207498000,5845956000,6458233000,18983876000,21587801000
Massachusetts,"Agriculture, Forestry, Fishing and Hunting",2013,1755,1420,190,105,1715,35,0,1750,5,1755,1420,190,105,1715,35,0,1750,5,5163,1517,748,909,3707,212,0,4951,0,173711000,66121000,18624000,21590000,120921000,10722000,0,171275000,0
Massachusetts,"Arts, Entertainment, and Recreation",2013,14746,8040,2140,1836,12016,2074,406,14496,250,15995,8040,2150,1865,12055,2315,810,15180,815,259196,9538,13500,23198,49220,77465,52392,185364,62636,9492775000,638090000,423253000,739812000,1860573000,1844640000,1780299000,5952552000,1468199000
Massachusetts,Construction,2013,84411,60780,12380,5955,79115,4333,569,84017,394,84675,60780,12380,5960,79120,4350,625,84095,580,552655,89152,79766,78562,251920,161616,73241,495220,47751,37948770000,4830440000,4198608000,4942154000,13996540000,12232678000,6229782000,33220990000,4012906000
Massachusetts,Educational Services,2013,13817,6190,2325,1708,10223,2085,942,13250,567,14825,6190,2325,1770,10285,2235,1350,13870,955,1058400,9586,15501,22417,48353,85075,143955,278641,777067,42625783000,358772000,427778000,584865000,1394374000,2885292000,5742631000,10056473000,32474312000
Massachusetts,Finance and Insurance,2013,26719,14819,3991,2035,20845,2400,1377,24622,2097,47170,14825,4200,2350,21375,4055,5490,30920,16250,973105,22741,24781,23666,77408,79271,125256,286654,664086,116475224000,2258394000,2286083000,2574603000,7258253000,8931987000,11303427000,27563763000,88501723000
Massachusetts,Health Care and Social Assistance,2013,66211,28895,14513,9369,52777,7582,3452,63811,2400,92890,28940,14625,9815,53380,10340,10945,74665,18225,2953041,54323,95557,124709,277583,289387,524516,1096678,1689681,145306467000,2938927000,4472254000,6322004000,13774751000,13206485000,19994349000,47115143000,94714330000
Massachusetts,Information,2013,11386,5085,1605,1070,7760,1526,713,9999,1387,18565,5085,1605,1075,7765,1635,805,10205,8360,543431,5271,10370,13037,31937,53813,68933,158960,378571,54174193000,554647000,652450000,889768000,2133411000,4691961000,7489234000,14609881000,38882233000
Massachusetts,Management of Companies and Enterprises,2013,3872,275,85,105,465,575,1027,2067,1805,6020,275,85,105,465,590,1065,2120,3900,438617,440,350,63,1521,7874,35768,45210,393454,49268840000,47081000,36487000,38485000,124330000,552001000,3395864000,4075795000,45176405000
Massachusetts,Manufacturing,2013,32532,11625,6000,4655,22280,6362,1847,30489,2043,33495,11625,6005,4670,22300,6505,2025,30830,2665,1064094,17798,35332,57031,118950,228331,179725,580267,410411,71369497000,959098000,1658570000,2869879000,5807850000,12471205000,11520443000,32567493000,33387814000
Massachusetts,"Mining, Quarrying, and Oil and Gas Extraction",2013,336,115,70,45,230,59,22,311,25,390,115,70,45,230,75,55,360,30,3218,133,234,515,993,894,0,2801,0,223755000,19218000,14856000,29631000,63267000,70620000,0,182402000,0
Massachusetts,Other,2013,375,354,14,4,372,3,0,375,0,375,354,14,4,372,3,0,375,0,0,0,92,43,0,98,0,0,0,14458000,10623000,2253000,675000,13551000,907000,0,14458000,0
Massachusetts,Other Services (except Public Administration),2013,81040,50030,17265,8210,75505,4215,670,80390,650,87410,50050,17475,8600,76125,5145,1840,83110,4300,590860,94082,111893,105612,315055,136998,55784,518451,59778,18290645000,2870894000,3086640000,2995637000,8980791000,4537915000,1923057000,15978709000,2105599000
Massachusetts,"Professional, Scientific, and Technical Services",2013,101658,68537,13605,7475,89617,6910,2198,98725,2933,107370,68555,13615,7610,89780,7370,2540,99690,7680,1310095,93623,87534,96789,287482,231864,204261,738896,556436,129536609000,6999835000,5787942000,7492515000,20324831000,23082992000,20000937000,64046266000,64546381000
Massachusetts,Real Estate and Rental and Leasing,2013,25299,18533,2895,1430,22858,1229,520,24607,692,32465,18620,3050,1515,23185,1890,1960,27035,5430,216102,25366,18369,17852,65724,39076,39985,148643,57153,13418159000,1467834000,930560000,1015740000,3449001000,2208150000,2185633000,8009749000,4423004000
Massachusetts,Retail Trade,2013,81125,47146,16122,8208,71476,5616,1511,78603,2522,121015,47310,16550,8980,72840,8125,5045,86010,35005,1706479,72514,95861,95199,264194,173262,100939,572624,718643,46473191000,2479139000,2798805000,3131010000,8402043000,7343924000,4169822000,20900243000,18370397000
Massachusetts,Total,2013,139399,81039,24097,14635,119771,13093,3421,136285,3114,172534,81134,24376,15214,120724,15930,8766,145420,27114,3070703,136904,158347,194963,490214,485565,447827,1423606,1647097,178589899000,6630658000,6643418000,8697072000,21971148000,24791567000,24870812000,71633527000,106956372000
Massachusetts,Transportation and Warehousing,2013,15821,8280,2200,1709,12189,1686,761,14636,1185,17765,8280,2205,1730,12215,1805,895,14915,2850,382542,11486,12760,21319,46981,55696,55600,162503,200982,16609557000,498240000,519508000,818161000,1858354000,2103603000,1781133000,5907426000,9746394000
Massachusetts,Utilities,2013,478,175,45,15,235,60,65,360,118,1420,175,45,15,235,60,120,415,1005,36265,106,177,86,531,1776,3110,6572,21730,4070494000,12146000,12817000,3354000,36816000,255798000,341084000,715423000,3320743000
Massachusetts,Wholesale Trade,2013,34928,16180,5560,3991,25731,4609,1848,32188,2740,40415,16195,5580,4110,25885,5215,2360,33460,6955,679807,27309,35012,49779,116441,147718,109072,388049,267273,56262566000,1821033000,2261450000,3399956000,7546489000,10364782000,8615129000,27448131000,27483987000
Michigan,Accommodation and Food Services,2013,75294,28000,14431,14865,57296,15507,1327,74130,1164,98225,28020,14515,15005,57540,18165,5530,81235,16990,1740836,43704,96848,204017,344970,558549,200705,1106647,621937,26553720000,1139679000,1144153000,2456475000,4743754000,7716374000,2671072000,15168863000,11359435000
Michigan,Administrative and Support and Waste Management and Remediation Services,2013,49548,31125,6165,4027,41317,4511,1763,47591,1957,57870,31140,6195,4115,41450,4800,2300,48550,9320,1549857,37159,40185,52789,133953,175820,277182,593963,933145,47909412000,2151451000,1365209000,1921210000,5473083000,6340662000,8645042000,20650312000,26423494000
Michigan,"Agriculture, Forestry, Fishing and Hunting",2013,2684,1910,430,160,2500,119,35,2654,30,2690,1910,430,160,2500,120,35,2655,35,15897,2877,2659,1836,7568,2862,2420,14649,776,619690000,104567000,87401000,64046000,270309000,114475000,94206000,538611000,55744000
Michigan,"Arts, Entertainment, and Recreation",2013,16060,9600,2175,1855,13630,1864,355,15849,211,16665,9610,2190,1885,13685,2005,465,16155,510,213918,11138,14136,24500,50457,67631,39541,167192,31324,7224012000,702331000,371366000,466203000,1550642000,1388794000,3227500000,6341777000,609358000
Michigan,Construction,2013,90323,65140,12923,6700,84763,4647,518,89928,395,91005,65140,12925,6710,84775,4790,710,90275,730,574260,92818,83813,86799,266770,167959,67442,508025,58528,33106735000,4518845000,3825650000,4614704000,12961965000,10493567000,4686543000,28540165000,4182803000
Michigan,Educational Services,2013,10405,4960,1670,1375,8005,1596,457,10058,347,11755,4960,1675,1410,8045,1785,740,10570,1185,371030,6873,11318,18389,37589,65982,69980,175215,194824,10186446000,230637000,213264000,405891000,858552000,1554672000,2255607000,4750986000,5396625000
Michigan,Finance and Insurance,2013,34894,22535,5324,2173,30032,2213,1014,33259,1635,66070,22555,5390,2520,30465,5265,5565,41295,24775,746516,40033,33210,26887,103167,80744,102874,292231,336649,50076460000,1792748000,1590745000,1668092000,5106803000,4399490000,5849171000,15698185000,32137633000
Michigan,Health Care and Social Assistance,2013,102935,46610,25558,15165,87333,10214,3344,100891,2044,130975,46665,25705,15785,88155,14355,11695,114205,16770,2947641,87207,170387,199163,460750,389169,515395,1374750,1540740,129114339000,4146360000,6813097000,8755292000,19721286000,16251295000,17241771000,53407393000,74071545000
Michigan,Information,2013,10050,5360,1290,917,7567,980,395,8942,1108,17240,5360,1295,940,7595,1185,605,9385,7855,340345,4000,7298,10916,25720,32536,25708,94586,239052,23842252000,319885000,312853000,526268000,1172155000,1636508000,1482929000,5025189000,18680751000
Michigan,Management of Companies and Enterprises,2013,5352,305,75,135,515,1055,1575,3145,2207,7885,305,75,140,520,1080,1665,3265,4620,532260,0,17,940,1641,13545,49180,64370,467888,53714115000,41135000,959000,67345000,148595000,825655000,3327350000,4301600000,49412333000
Michigan,Manufacturing,2013,58468,20095,9796,9079,38970,11737,4236,54943,3525,62140,20100,9805,9140,39045,12255,5305,56605,5535,2536530,33048,60487,116992,220144,455422,509476,1239483,1201510,138865118000,1583148000,2462557000,5396730000,9738030000,22521138000,26065096000,60346577000,72686415000
Michigan,"Mining, Quarrying, and Oil and Gas Extraction",2013,1676,850,245,145,1240,204,61,1505,171,1820,850,260,145,1255,225,70,1550,270,23632,400,1525,1786,4808,5637,2265,13522,8982,1635976000,82352000,87128000,135257000,308672000,391514000,131977000,881190000,696328000
Michigan,Other,2013,326,312,12,0,324,2,0,326,0,326,312,12,0,324,2,0,326,0,368,0,79,0,0,0,0,368,0,5170000,4530000,406000,0,4936000,0,0,5170000,0
Michigan,Other Services (except Public Administration),2013,105810,64405,23480,10394,98279,6010,861,105150,660,113960,64450,23630,11085,99165,8175,2450,109790,4170,766540,123540,150769,134677,411561,198853,75422,699185,45838,20325333000,2919243000,3374393000,3234837000,9538259000,5305828000,2500537000,17789213000,1750557000
Michigan,"Professional, Scientific, and Technical Services",2013,99971,67858,14268,7576,89702,6005,1821,97528,2443,107665,67910,14350,7765,90025,7375,3165,100565,7100,1197942,98103,92183,98537,294952,210272,162303,671454,490606,82222275000,5169564000,4837412000,5740352000,15778325000,14158837000,11377437000,41546197000,38569601000
Michigan,Real Estate and Rental and Leasing,2013,29742,21120,3997,1888,27005,1415,635,29055,687,37965,21160,4160,2040,27360,2425,2520,32305,5660,240311,31056,24317,22127,79325,43909,41265,167353,61757,9556413000,1165851000,798491000,785586000,2820128000,1754719000,1502993000,6234378000,2771420000
Michigan,Retail Trade,2013,113680,67046,22898,10961,100905,8374,1800,111079,2601,174100,67170,23330,12370,102870,13345,8255,124470,49630,2237000,114016,143192,135794,379458,295989,166945,913806,1215144,54865201000,2946722000,3290408000,3581195000,9916976000,9803058000,5336640000,25695301000,27797537000
Michigan,Total,2013,172359,99393,30986,18834,149213,16237,3766,169216,3143,217494,99494,31298,19791,150583,21433,11363,183379,34115,3535685,166363,204251,252227,622841,614797,537317,1774955,1760730,156830488000,6449847000,6820932000,9038902000,22309681000,24089546000,22915767000,69314994000,87515494000
Michigan,Transportation and Warehousing,2013,24760,15015,3109,2069,20193,2266,892,23351,1409,28670,15020,3135,2095,20250,2480,1235,23965,4705,464247,11149,19817,26256,67375,75015,57654,207292,186320,21093338000,792057000,749922000,998198000,2576473000,3070195000,2717480000,8593022000,9234251000
Michigan,Utilities,2013,546,190,40,55,285,55,52,392,154,2005,190,40,80,310,65,175,550,1455,11907,103,0,173,786,1732,4179,7239,10402,9089063000,12781000,9656000,28448000,59907000,124007000,326394000,527803000,7311665000
Michigan,Wholesale Trade,2013,47397,23369,7248,5294,35911,5826,2481,44218,3179,57135,23395,7325,5565,36285,7260,4330,47875,9260,836368,29062,44683,66459,151517,184325,144277,502507,302308,52359394000,2206334000,2447950000,3780979000,8492159000,10916422000,8425045000,28756660000,22271912000
Minnesota,Accommodation and Food Services,2013,42422,14068,7438,9167,30673,9755,1035,41463,959,56865,14080,7470,9300,30850,11165,3175,45190,11675,1132700,19932,51040,127165,198911,363821,131135,698253,424911,17858465000,590625000,608970000,1484191000,2683915000,5290347000,2045917000,10086394000,7690151000
Minnesota,Administrative and Support and Waste Management and Remediation Services,2013,32461,20675,4160,2695,27530,2646,871,31047,1414,36550,20695,4185,2720,27600,2910,1120,31630,4920,801800,26453,25756,34130,89496,98926,103359,308399,481744,27908727000,1244079000,871107000,1177581000,3315383000,3459759000,2929932000,10475284000,16979074000
Minnesota,"Agriculture, Forestry, Fishing and Hunting",2013,2555,1715,455,215,2385,110,20,2515,40,2605,1715,455,215,2385,115,40,2540,65,12804,2083,2676,2263,7969,3309,154,12170,519,467943000,88929000,92051000,77231000,269790000,142871000,6656000,434026000,28184000
Minnesota,"Arts, Entertainment, and Recreation",2013,13120,8230,1885,1179,11294,1351,280,12925,195,13805,8230,1885,1195,11310,1485,340,13135,670,209182,7694,11162,14910,37065,47976,36645,126731,41994,6227452000,387788000,247725000,258652000,912433000,865227000,823252000,2649416000,2644284000
Minnesota,Construction,2013,79416,60235,9890,4964,75089,3401,508,78998,418,79950,60240,9890,4965,75095,3530,590,79215,735,500475,78881,63268,64328,209467,123739,63551,403310,55424,33306190000,4223960000,3195608000,3847820000,11287710000,8711085000,4952967000,25353095000,4627315000
Minnesota,Educational Services,2013,8892,3955,1235,1195,6385,1862,320,8567,325,9650,3955,1235,1245,6435,2060,405,8900,750,357091,5580,7795,16001,30503,75189,50470,160082,188816,9658628000,175579000,174134000,335434000,690755000,1988886000,1664236000,4391934000,5167165000
Minnesota,Finance and Insurance,2013,30282,20140,3806,1761,25707,1971,806,28484,1798,46630,20160,3910,2175,26245,4400,3595,34240,12390,757700,27455,22919,21797,70518,66778,66096,214518,489967,63118059000,1543177000,1242617000,1412983000,4239511000,4537797000,4254310000,13590964000,47661194000
Minnesota,Health Care and Social Assistance,2013,51519,23200,9424,6668,39292,7232,3267,49791,1728,76125,23230,9515,7075,39820,10240,11640,61700,14425,2212190,32759,63375,90158,192229,296120,520283,1015816,1157540,92518163000,1662753000,2482548000,3217937000,7392420000,10176760000,15196148000,33011798000,56883516000
Minnesota,Information,2013,8182,3805,1075,955,5835,963,379,7177,1005,12860,3815,1075,960,5850,1235,825,7910,4950,270795,5166,6638,11280,25040,32327,38786,98982,138212,19051854000,274072000,250029000,589497000,1150047000,1776243000,2408935000,5478729000,13113087000
Minnesota,Management of Companies and Enterprises,2013,3879,155,100,130,385,655,1177,2217,1662,5860,155,100,130,385,695,1230,2310,3550,703890,0,364,0,1092,8270,38390,48025,655642,63964240000,0,24768000,27753000,92865000,486655000,2741800000,3339240000,60573800000
Minnesota,Manufacturing,2013,34000,12735,5700,4440,22875,6303,2311,31489,2511,36185,12735,5700,4440,22875,6550,2945,32370,3815,1384434,17995,31618,53036,113757,244131,244627,653702,635343,76419853000,878069000,1365671000,2472206000,4959396000,12197415000,12744038000,32447612000,38830487000
Minnesota,"Mining, Quarrying, and Oil and Gas Extraction",2013,651,345,100,65,510,40,36,586,65,760,345,100,70,515,45,45,605,155,27872,379,359,566,1839,699,1122,5064,22645,2691560000,42801000,35122000,56978000,165497000,71037000,65974000,389304000,2230064000
Minnesota,Other,2013,205,202,2,1,205,0,0,205,0,205,202,2,1,205,0,0,205,0,0,0,0,0,0,0,0,0,0,3863000,3654000,0,0,3863000,0,0,3863000,0
Minnesota,Other Services (except Public Administration),2013,71006,42405,14614,7835,64854,4882,702,70438,568,76615,42435,14805,8285,65525,6360,1875,73760,2855,572007,77309,94070,102621,276744,160542,62289,505782,40176,14506546000,1906019000,2110998000,2416209000,6452656000,4066342000,1969934000,12651037000,1360025000
Minnesota,"Professional, Scientific, and Technical Services",2013,78470,57615,8535,5137,71287,4084,1238,76609,1861,82580,57615,8590,5350,71555,4800,1565,77920,4660,682395,60890,54756,65691,193959,139610,103095,444562,225616,48661649000,4056520000,2891375000,3695596000,10693545000,10344863000,8423960000,29743700000,18370021000
Minnesota,Real Estate and Rental and Leasing,2013,26012,20310,2325,1087,23722,1081,601,25404,608,31925,20330,2365,1245,23940,1835,2315,28090,3835,176839,20724,14740,13575,53394,34988,34090,124344,34142,7737910000,1044708000,528317000,550854000,2134621000,1299424000,1145702000,4888929000,2628154000
Minnesota,Retail Trade,2013,62450,31000,13567,8016,52583,5865,1630,60078,2372,95785,31065,13740,8870,53675,9175,6110,68960,26825,1368730,49045,81799,101079,241644,200318,120485,588914,699776,34754619000,1387512000,1889876000,2513868000,5827145000,5955317000,4024131000,16075889000,17250166000
Minnesota,Total,2013,117503,70194,18313,12166,100673,11306,2854,114833,2670,146354,70254,18504,12825,101583,14837,8419,124839,21515,2518268,107469,120596,162486,390551,431760,384511,1206822,1311446,120890874000,4369473000,4153365000,5659824000,14182662000,16947194000,16340937000,47470793000,73420081000
Minnesota,Transportation and Warehousing,2013,20968,12705,2495,1835,17035,2006,722,19763,1205,23100,12705,2510,1865,17080,2175,950,20205,2895,336744,8996,15678,22877,53876,68505,55574,186736,133945,13421335000,647607000,628427000,812789000,2127330000,2308840000,2104763000,6695257000,6228042000
Minnesota,Utilities,2013,662,140,40,65,245,196,71,512,150,1720,140,45,65,250,255,120,625,1095,16855,0,122,772,1212,6177,4692,12206,456,1552083000,6638000,10244000,54206000,82128000,451161000,379177000,925594000,43720000
Minnesota,Wholesale Trade,2013,34523,16584,4880,3794,25258,4419,2011,31688,2835,41175,16615,4935,3950,25500,5155,3210,33865,7310,626914,23595,29981,45997,103391,140654,104229,362988,224650,44060994000,1455894000,1833114000,2742438000,6111602000,8868073000,6768088000,22379753000,18522255000
Mississippi,Accommodation and Food Services,2013,19013,6565,3875,3708,14148,3676,496,18320,693,26190,6570,3880,3755,14205,4225,1710,20140,6050,590997,11018,25844,50250,87300,129003,63224,280922,309955,9474305000,252268000,298647000,623108000,1178153000,1638420000,755413000,3590793000,5871981000
Mississippi,Administrative and Support and Waste Management and Remediation Services,2013,9585,5225,1545,961,7731,763,318,8812,773,10980,5225,1545,965,7735,855,450,9040,1940,250458,6681,9556,11879,31524,27654,26839,92018,148608,6377817000,277289000,261374000,326391000,887722000,702109000,679147000,2424119000,3652777000
Mississippi,"Agriculture, Forestry, Fishing and Hunting",2013,3338,1735,900,450,3085,185,20,3290,48,3430,1735,900,450,3085,185,30,3300,130,22615,2655,6012,5527,14852,5420,0,21745,333,841976000,114374000,189526000,182299000,494887000,200572000,0,750764000,22998000
Mississippi,"Arts, Entertainment, and Recreation",2013,3095,1700,445,425,2570,385,80,3035,60,3240,1705,445,430,2580,405,180,3165,75,51521,2585,2025,4885,10761,12304,1728,33788,13886,1063287000,74888000,42927000,84912000,223261000,196638000,15748000,605073000,389374000
Mississippi,Construction,2013,19022,11475,3420,2105,17000,1590,240,18830,192,19215,11475,3420,2105,17000,1620,280,18900,315,204132,19095,21778,26683,70246,56559,28124,160734,26336,9017760000,615796000,693970000,996413000,2317240000,2491627000,1480876000,6548587000,1476399000
Mississippi,Educational Services,2013,2456,945,375,275,1595,556,150,2301,155,3005,945,375,275,1595,575,305,2475,530,91159,1236,2269,3342,7390,22667,16164,47521,43131,2024894000,31497000,44887000,50218000,132716000,489607000,438915000,1084389000,895900000
Mississippi,Finance and Insurance,2013,11338,7560,1405,531,9496,657,357,10510,828,23400,7580,1550,890,10020,2220,2885,15125,8275,165643,13761,8361,5800,29761,21038,26057,80045,82150,8405960000,499288000,311829000,294850000,1152637000,1018196000,1161449000,3441675000,4903758000
Mississippi,Health Care and Social Assistance,2013,24602,10755,6160,3565,20480,2442,881,23803,799,30715,10755,6170,3720,20645,3265,2425,26335,4380,802441,19871,40338,46217,108141,95560,114407,324656,433978,34325799000,1008396000,1512812000,1857648000,4402513000,3564586000,3768132000,11866406000,21674293000
Mississippi,Information,2013,1979,740,370,225,1335,201,109,1645,334,4490,740,375,235,1350,285,215,1850,2640,55328,1156,2017,2552,6224,5347,1861,17031,33952,2284913000,42875000,47546000,75487000,181954000,172633000,97926000,600569000,1664832000
Mississippi,Management of Companies and Enterprises,2013,1287,55,26,76,157,230,366,753,534,1655,55,35,80,170,230,395,795,860,39965,0,0,352,499,1979,7535,10045,29912,2887625000,11410000,5754000,21070000,38569000,91408000,505010000,636715000,2250255000
Mississippi,Manufacturing,2013,9895,2955,1555,1240,5750,1777,913,8440,1455,10900,2960,1555,1245,5760,1820,1145,8725,2175,550734,3033,7542,12286,27262,53764,65653,168876,335085,22783795000,178712000,238183000,400846000,962217000,2037600000,2314424000,6219085000,15017216000
Mississippi,"Mining, Quarrying, and Oil and Gas Extraction",2013,1772,1049,185,95,1329,184,80,1593,179,1940,1050,185,95,1330,190,110,1630,310,29437,346,1146,909,3579,5977,4996,16134,8603,2307846000,66998000,62433000,45951000,183087000,420262000,352792000,1089166000,1032931000
Mississippi,Other,2013,84,82,1,1,84,0,0,84,0,84,82,1,1,84,0,0,84,0,0,0,0,0,0,0,0,0,0,1825000,1432000,0,0,1825000,0,0,1825000,0
Mississippi,Other Services (except Public Administration),2013,30404,19190,6655,2475,28320,1511,255,30086,318,32095,19200,6705,2585,28490,1965,585,31040,1055,191479,37596,42421,30515,113375,46602,13062,180303,7616,4319812000,805776000,859319000,693400000,2387132000,1066718000,271913000,3921229000,298666000
Mississippi,"Professional, Scientific, and Technical Services",2013,21589,14520,3177,1605,19302,1206,383,20891,698,23810,14525,3205,1670,19400,1770,495,21665,2145,152017,22728,19614,19295,63983,34364,15564,118394,29704,7603578000,926987000,784969000,857778000,2607450000,1749508000,961270000,5565189000,1934337000
Mississippi,Real Estate and Rental and Leasing,2013,9144,6955,958,353,8266,366,188,8820,324,11690,6955,960,445,8360,585,580,9525,2165,47946,10803,5558,3441,21345,7825,2538,36436,8173,1538572000,301025000,156736000,131613000,612359000,261233000,71818000,1096325000,381736000
Mississippi,Retail Trade,2013,36929,20115,7962,3902,31979,2796,549,35324,1605,57645,20140,8090,4260,32490,4380,2430,39300,18345,605445,34253,50813,48304,139020,92151,38940,278898,299539,14245070000,817947000,1167875000,1279571000,3296005000,2853718000,979066000,7374496000,6443530000
Mississippi,Total,2013,44519,24470,8433,4784,37687,4022,1107,42816,1703,58435,24492,8529,5094,38115,5494,3269,46878,11557,902638,44954,55176,63019,163149,145267,117157,425573,477065,31697424000,1372044000,1513847000,1863841000,4749732000,4643122000,4035818000,13428672000,18268752000
Mississippi,Transportation and Warehousing,2013,8728,4505,1350,785,6640,793,349,7782,946,10150,4505,1355,785,6645,865,480,7990,2160,155988,5678,8292,8765,25466,23844,15993,68141,67126,6628193000,249439000,273173000,304741000,856244000,886808000,667189000,2586211000,3184922000
Mississippi,Utilities,2013,1813,1170,355,60,1585,95,62,1742,71,2955,1170,355,80,1605,170,250,2025,930,42424,2698,2070,700,5585,5104,8594,20242,0,3211164000,62948000,61755000,26292000,156971000,288123000,545741000,1026785000,0
Mississippi,Wholesale Trade,2013,11340,4750,1515,1290,7555,1462,814,9831,1509,14250,4760,1535,1395,7690,1860,1395,10945,3305,165767,7081,8470,13752,30915,35655,28620,107130,51790,7880926000,308666000,342774000,653481000,1366302000,1666947000,1402400000,4868884000,2687978000
Missouri,Accommodation and Food Services,2013,44780,15975,7630,8409,32014,10292,1241,43547,1233,62275,15985,7645,8495,32125,11860,4625,48610,13665,1212590,25285,50590,114293,190982,368534,171866,733277,476947,18487670000,604243000,617655000,1432151000,2655641000,5066450000,2396900000,10131796000,8332504000
Missouri,Administrative and Support and Waste Management and Remediation Services,2013,32584,20080,4635,2703,27418,2668,859,30945,1639,36895,20080,4640,2720,27440,2845,1180,31465,5430,761089,26711,29184,34603,94775,94073,86653,288045,462481,23848214000,971459000,870561000,1110268000,2990098000,2986509000,2573916000,8899232000,14636695000
Missouri,"Agriculture, Forestry, Fishing and Hunting",2013,1335,970,185,80,1235,45,25,1305,30,1350,970,185,80,1235,50,25,1310,40,8078,1429,1172,582,3560,1444,708,6853,1054,247872000,44186000,33529000,22058000,106641000,39742000,17060000,192672000,44964000
Missouri,"Arts, Entertainment, and Recreation",2013,9834,5580,1365,1167,8112,1259,237,9608,226,10420,5580,1370,1200,8150,1355,355,9860,560,190685,7296,8527,13864,32193,44811,17802,105272,67713,7144135000,291426000,156533000,252099000,723578000,894915000,727518000,2854496000,1564238000
Missouri,Construction,2013,64345,42300,10995,5511,58806,4441,626,63873,472,64950,42300,10995,5525,58820,4550,845,64215,735,523698,70132,70650,73408,214859,152904,64672,440308,53531,28089070000,2439469000,2692997000,3409399000,8544901000,8599434000,4544900000,22108770000,3930128000
Missouri,Educational Services,2013,7168,2960,1085,1050,5095,1390,363,6848,320,7990,2960,1085,1065,5110,1465,435,7010,980,375098,4093,6755,13438,26276,59351,58423,146819,222488,13773637000,121178000,117877000,229746000,482314000,1503321000,1863657000,3891389000,9714460000
Missouri,Finance and Insurance,2013,28501,19450,3070,1389,23909,1951,823,26683,1818,54115,19455,3175,1775,24405,5415,4695,34515,19600,595305,33469,18597,17168,71936,67573,73123,222981,357594,39773044000,1305551000,889866000,824526000,3056172000,3595889000,4366704000,11489146000,27788748000
Missouri,Health Care and Social Assistance,2013,92710,61360,12090,7905,81355,7093,2415,90863,1847,113465,61385,12145,8220,81750,9285,7685,98720,14745,1994964,49810,80233,103692,240543,300516,337246,908845,1058089,80088155000,2349437000,3194016000,4035057000,9593159000,9839821000,10238900000,29890385000,49312710000
Missouri,Information,2013,6352,2935,810,749,4494,757,318,5569,783,11800,2935,810,785,4530,980,575,6085,5715,269542,3818,3973,7794,18158,21185,20386,65294,189433,16846618000,234595000,177335000,301655000,769809000,1148409000,984665000,3034415000,13230415000
Missouri,Management of Companies and Enterprises,2013,4039,220,65,136,421,741,1183,2345,1694,5930,220,65,140,425,745,1235,2405,3525,374905,0,0,512,968,7780,33397,42445,332324,34588235000,17830000,42265000,31732000,99246000,453315000,2192517000,2750290000,31828372000
Missouri,Manufacturing,2013,27912,10345,4785,4138,19268,4610,1777,25655,2257,29785,10345,4790,4155,19290,4885,2210,26385,3400,1066357,16169,27323,47926,100733,158890,164759,475673,501529,50762561000,599849000,916194000,1869172000,3619498000,6936906000,7978497000,20681733000,25169123000
Missouri,"Mining, Quarrying, and Oil and Gas Extraction",2013,841,320,170,75,565,112,65,742,99,1360,320,170,85,575,270,170,1015,345,14653,138,996,988,2771,2805,2288,8266,5273,835615000,26048000,39905000,41366000,116579000,145792000,136345000,429365000,332994000
Missouri,Other,2013,1354,1347,4,3,1354,0,0,1354,0,1354,1347,4,3,1354,0,0,1354,0,0,0,29,0,0,0,0,0,0,7649000,7305000,211000,0,7649000,0,0,7649000,0
Missouri,Other Services (except Public Administration),2013,71125,44790,13942,6587,65319,4398,752,70469,656,76785,44805,14055,6995,65855,5810,2165,73830,2955,545325,86095,88972,85561,261678,148924,44024,472437,45419,14057650000,1918388000,2050635000,2067490000,6051394000,3879072000,1353607000,11626754000,1703450000
Missouri,"Professional, Scientific, and Technical Services",2013,61386,41105,8806,4880,54791,3536,1268,59595,1791,66965,41125,8830,5020,54975,4385,1960,61320,5645,779812,58916,56814,62762,182968,112285,88909,388190,355362,49331293000,2785983000,2495338000,3122965000,8446179000,7410052000,5875898000,21917882000,25690872000
Missouri,Real Estate and Rental and Leasing,2013,24566,18347,2645,1204,22196,1096,525,23817,749,30505,18370,2695,1305,22370,1715,1495,25580,4925,166069,24331,16307,15213,59872,32038,25297,119863,40939,6435949000,846349000,565098000,515480000,1943810000,1302243000,934588000,4234829000,2092120000
Missouri,Retail Trade,2013,64589,34227,12806,7692,54725,5741,1433,61899,2690,106605,34315,13040,8660,56015,9470,5225,70710,35895,1367077,57668,79911,97623,240372,187065,99519,544049,758476,33721205000,1416193000,1867952000,2475577000,5783532000,6197749000,3413064000,15711226000,17542039000
Missouri,Total,2013,117319,70761,18404,11779,100944,10822,2654,114420,2899,150290,70823,18572,12418,101813,14607,7894,124314,25976,2355336,114945,120514,156562,392021,402480,315682,1110183,1245153,98487068000,3595629000,3789928000,5066635000,12452192000,14322670000,12612726000,39387588000,59099480000
Missouri,Transportation and Warehousing,2013,19690,11485,2560,1850,15895,1710,707,18312,1378,22395,11485,2565,1855,15905,1885,930,18720,3675,386331,15390,16765,22367,57411,51945,41942,158747,194377,15371959000,583084000,543878000,801520000,1961210000,1930077000,1645514000,5676306000,8347175000
Missouri,Utilities,2013,569,175,50,25,250,180,49,479,90,1815,175,50,25,250,285,255,790,1025,72107,273,276,47,900,9138,4159,14257,40556,6455853000,8895000,8134000,10384000,31943000,628459000,306693000,1017953000,3799504000
Missouri,Wholesale Trade,2013,32179,14544,4484,3747,22775,4624,1995,29394,2785,39275,14570,4530,3970,23070,5780,3405,32255,7020,601426,22142,26907,45538,102543,135895,93468,348378,222260,30881724000,1184654000,1433551000,2223524000,4923243000,7382375000,5115308000,18011373000,10988093000
Montana,Accommodation and Food Services,2013,15696,5865,3320,3212,12397,2813,245,15455,241,17325,5875,3335,3310,12520,3140,670,16330,995,236727,9275,22017,43750,75594,95305,30270,202033,19327,3626380000,243821000,278782000,579713000,1111445000,1427152000,463435000,3025350000,534827000
Montana,Administrative and Support and Waste Management and Remediation Services,2013,8099,5675,1120,515,7310,390,113,7813,286,8570,5675,1125,520,7320,475,170,7965,605,74155,7033,6653,5655,21141,12374,8623,45059,1944,1978716000,249870000,171418000,170975000,625466000,339592000,180912000,1195362000,56348000
Montana,"Agriculture, Forestry, Fishing and Hunting",2013,1765,1470,170,55,1695,30,20,1745,20,1800,1470,170,55,1695,30,45,1770,30,4218,1301,782,549,2899,769,0,3981,0,198217000,70220000,28933000,19479000,127950000,30020000,0,183152000,945000
Montana,"Arts, Entertainment, and Recreation",2013,5066,2995,960,583,4538,389,87,5014,52,5705,2995,960,630,4585,500,125,5210,495,50632,3257,6025,7485,17994,13250,9936,42476,4290,884625000,122652000,102768000,118305000,350421000,213001000,122474000,709773000,93822000
Montana,Construction,2013,24555,19330,3090,1245,23665,685,90,24440,115,24675,19330,3090,1245,23665,705,100,24470,205,104709,26876,18764,16067,62633,23204,6272,98042,3393,5309820000,1043108000,785750000,752323000,2601162000,1406067000,434037000,4843985000,243068000
Montana,Educational Services,2013,1835,985,320,180,1485,225,70,1780,55,1900,985,320,180,1485,225,115,1825,75,30045,1276,1871,2059,5793,7549,10722,24879,1920,646248000,38902000,27679000,30500000,108805000,153628000,269266000,557503000,83648000
Montana,Finance and Insurance,2013,6305,4200,760,362,5322,377,137,5836,469,9805,4200,770,440,5410,1030,615,7055,2750,76049,6371,4407,3638,14995,12607,6491,38359,34679,3896962000,249211000,178578000,173676000,626133000,569120000,334812000,1677335000,2141999000
Montana,Health Care and Social Assistance,2013,15002,7975,3040,1620,12635,1257,687,14579,423,17575,7975,3040,1695,12710,1600,1915,16225,1350,325305,11516,19349,18443,53944,48869,84026,190029,115613,12868186000,516981000,670459000,801188000,2036339000,1651865000,2724999000,6459609000,5479454000
Montana,Information,2013,2046,990,280,225,1495,138,107,1740,306,3210,990,280,225,1495,160,435,2090,1120,43308,1007,1550,2611,5646,1797,6081,17640,23453,2024499000,47626000,52466000,84432000,198227000,64001000,354293000,802569000,1200909000
Montana,Management of Companies and Enterprises,2013,615,75,5,25,105,160,135,400,215,685,75,5,25,105,160,135,400,285,18388,0,0,0,128,0,5219,7122,11266,1142156000,5800000,0,5239000,11414000,58387000,322880000,400848000,741308000
Montana,Manufacturing,2013,6049,3125,1170,720,5015,625,200,5840,209,6155,3125,1170,720,5015,660,215,5890,265,69076,3037,5066,6880,18415,13632,10270,52465,8787,3022840000,131364000,176494000,228280000,638008000,488815000,414362000,1864283000,734558000
Montana,"Mining, Quarrying, and Oil and Gas Extraction",2013,1870,1135,195,160,1490,125,60,1675,195,2020,1135,195,160,1490,130,60,1680,340,23011,10,952,1556,3958,3243,3876,12298,10432,2050361000,104269000,67539000,106445000,264024000,276309000,256687000,946457000,1070629000
Montana,Other,2013,48,48,0,0,48,0,0,48,0,48,48,0,0,48,0,0,48,0,36,36,0,0,36,0,0,36,0,787000,787000,0,0,787000,0,0,787000,0
Montana,Other Services (except Public Administration),2013,15300,10150,3065,1187,14402,648,95,15145,155,15955,10150,3075,1230,14455,900,130,15485,470,77329,16071,19241,14417,52620,16630,1826,74270,686,1944829000,433755000,467862000,354172000,1275723000,444736000,79000000,1864919000,30588000
Montana,"Professional, Scientific, and Technical Services",2013,17240,12875,2100,970,15945,640,184,16769,471,18210,12875,2115,995,15985,915,410,17310,900,86499,16517,12289,11732,43964,13651,7856,72642,9183,4203632000,767415000,511862000,640597000,1935543000,836190000,537088000,3518273000,600727000
Montana,Real Estate and Rental and Leasing,2013,7922,6580,600,338,7518,168,60,7746,176,8775,6590,635,465,7690,320,175,8185,590,26104,6123,3493,3901,15766,3398,1200,22808,2708,875513000,257791000,90906000,115780000,484691000,106607000,49759000,720001000,114520000
Montana,Retail Trade,2013,18432,9270,4236,2202,15708,1491,391,17590,842,23995,9290,4295,2490,16075,2055,1295,19425,4570,261138,14767,24626,24733,71416,43039,20419,144074,94666,6579867000,426232000,632113000,713817000,1829601000,1330585000,690616000,4051671000,2148875000
Montana,Total,2013,31636,20053,5225,2884,28162,2142,499,30803,833,36529,20065,5264,3078,28407,2910,1536,32853,3676,350196,31278,34274,38546,104098,74708,57129,235935,114261,12446590000,1041145000,965235000,1163882000,3170262000,2342724000,2041152000,7554138000,4892452000
Montana,Transportation and Warehousing,2013,6441,4300,899,340,5539,419,150,6108,333,7170,4300,900,345,5545,445,265,6255,915,60577,5170,5000,4004,15189,11986,6455,39323,10552,2470777000,232552000,185720000,166709000,598933000,490735000,265263000,1542258000,549984000
Montana,Utilities,2013,416,180,25,50,255,85,25,365,51,1010,180,25,55,260,120,50,430,580,13611,116,101,600,893,2038,0,4668,3912,1123895000,4309000,6982000,36666000,60605000,145735000,0,307553000,353778000
Montana,Wholesale Trade,2013,6097,2870,808,576,4254,722,354,5330,767,7865,2870,815,605,4290,980,755,6025,1840,68962,2367,3908,5571,13647,16502,7737,46470,17178,3366929000,164578000,187393000,231851000,659391000,709298000,416133000,2101168000,941480000
Nebraska,Accommodation and Food Services,2013,16830,6250,3174,3198,12622,3165,484,16271,559,21835,6250,3190,3230,12670,3920,1965,18555,3280,354646,10270,21390,43639,75569,109160,60168,245627,103836,4723134000,210831000,216040000,488524000,918680000,1411189000,812282000,3150231000,1559232000
Nebraska,Administrative and Support and Waste Management and Remediation Services,2013,11681,7330,1690,910,9930,770,301,11001,680,13015,7335,1690,915,9940,835,375,11150,1865,291817,7908,10112,10474,31421,22876,32214,94175,188089,9404623000,349164000,289181000,342096000,1024556000,719187000,855733000,2727975000,6270528000
Nebraska,"Agriculture, Forestry, Fishing and Hunting",2013,870,655,100,45,800,20,20,840,30,910,655,100,45,800,20,30,850,60,5218,595,585,462,1929,126,198,2645,2465,292006000,43470000,25550000,24910000,104629000,10076000,7092000,131441000,156255000
Nebraska,"Arts, Entertainment, and Recreation",2013,4173,2570,545,380,3495,465,95,4055,118,4365,2575,545,380,3500,505,125,4130,235,63195,3638,3304,4504,12174,17504,7735,42854,14601,1012895000,105376000,58543000,78778000,263066000,308608000,110642000,766714000,165627000
Nebraska,Construction,2013,29613,20205,4825,2500,27530,1644,224,29398,215,29835,20205,4825,2500,27530,1675,320,29525,310,196915,29869,30922,32434,95683,61173,14188,177392,12990,9247780000,1123669000,1124761000,1436874000,3701130000,3144830000,951112000,8061482000,798764000
Nebraska,Educational Services,2013,2471,1005,415,325,1745,495,125,2365,106,2745,1005,415,325,1745,585,255,2585,160,91738,1521,2649,3952,8734,20302,11304,42905,47644,2553328000,36305000,36218000,61779000,145729000,431657000,320607000,981641000,1534767000
Nebraska,Finance and Insurance,2013,12907,8570,1507,695,10772,853,310,11935,972,21350,8590,1585,910,11085,2315,1635,15035,6315,259162,13844,9034,7311,31301,26737,24437,86406,161414,17137931000,522226000,413405000,355140000,1348710000,1436560000,1351205000,4288366000,12364724000
Nebraska,Health Care and Social Assistance,2013,21786,10310,4285,2690,17285,2815,967,21067,719,26905,10350,4300,2780,17430,3850,2410,23690,3215,595813,14839,27858,35011,82142,106691,111372,308080,261763,24703923000,837130000,1114771000,1469391000,3460270000,4279526000,4033184000,11915455000,11180927000
Nebraska,Information,2013,2760,978,380,319,1677,412,189,2278,482,4545,980,380,320,1680,540,265,2485,2060,101083,903,2201,3074,7516,12667,4944,30805,40410,6389691000,43769000,81933000,131754000,276759000,730856000,267174000,1634806000,3569106000
Nebraska,Management of Companies and Enterprises,2013,1374,65,46,55,166,270,370,806,568,1905,65,55,55,175,275,380,830,1075,89910,0,230,144,449,3114,8917,12345,77018,7279975000,7301000,12044000,21661000,45270000,166120000,660889000,862652000,6350567000
Nebraska,Manufacturing,2013,8273,3045,1340,1010,5395,1363,630,7388,885,8900,3045,1340,1015,5400,1455,740,7595,1305,389587,3897,6392,9640,22791,40200,43025,122980,214699,16972275000,142791000,223301000,372259000,847929000,1729391000,2028729000,5471731000,9116771000
Nebraska,"Mining, Quarrying, and Oil and Gas Extraction",2013,537,325,80,50,455,20,32,507,30,580,325,80,50,455,20,35,510,70,3797,84,386,339,1277,0,1095,2831,246,253554000,25338000,15673000,17428000,80962000,0,73853000,176509000,15409000
Nebraska,Other,2013,71,69,2,0,71,0,0,71,0,71,69,2,0,71,0,0,71,0,0,0,0,0,0,0,0,0,0,1108000,876000,0,0,1108000,0,0,1108000,0
Nebraska,Other Services (except Public Administration),2013,26623,17708,4730,2167,24605,1426,307,26338,285,28760,17725,4790,2305,24820,1880,1045,27745,1015,177403,29482,29242,28117,90329,46938,17561,160985,9499,4323676000,732049000,659540000,654067000,2071156000,1143478000,439970000,3836122000,432376000
Nebraska,"Professional, Scientific, and Technical Services",2013,21071,13935,3115,1622,18672,1179,386,20237,834,22595,13935,3120,1675,18730,1460,640,20830,1765,274444,15821,18869,19303,57992,33673,26178,127258,23894,14442042000,814984000,861089000,1005569000,2730835000,2001598000,1576948000,6651681000,7764409000
Nebraska,Real Estate and Rental and Leasing,2013,8737,6670,790,350,7810,332,216,8358,379,10130,6690,820,380,7890,370,650,8910,1220,51819,2050,4487,3562,14455,7544,9422,35330,10771,2113512000,277711000,140097000,113535000,567601000,273502000,381690000,1451509000,638802000
Nebraska,Retail Trade,2013,24781,11798,5260,3123,20181,2323,784,23288,1493,36200,11815,5345,3415,20575,3560,2380,26515,9685,497006,18194,32905,36973,93345,70517,40905,217898,219306,12142847000,500797000,729868000,896742000,2159515000,2123418000,1537686000,6118485000,5270513000
Nebraska,Total,2013,42189,24631,7036,4227,35894,3813,1006,40713,1476,52585,24664,7122,4474,36260,5287,3182,44729,7856,830073,40880,46192,56068,143140,137713,113156,394009,436064,33113578000,1302331000,1385378000,1793324000,4481033000,4847530000,4386157000,13714720000,19398858000
Nebraska,Transportation and Warehousing,2013,10502,6995,1309,645,8949,602,278,9829,673,11465,6995,1310,650,8955,650,405,10010,1455,132325,7757,7392,7521,25428,17648,17931,68162,46560,5550636000,320784000,263136000,269619000,880654000,721852000,751693000,2530682000,2346296000
Nebraska,Utilities,2013,165,35,15,10,60,20,15,95,70,605,35,15,10,60,25,20,105,500,979,0,0,0,21,450,0,809,354,276061000,267000,0,0,16396000,27325000,0,55139000,70463000
Nebraska,Wholesale Trade,2013,11491,4396,1645,1308,7349,1833,923,10105,1386,15925,4400,1695,1410,7505,2495,2235,12235,3690,198018,5933,9627,13747,31586,46498,35059,127247,66481,10839268000,288365000,395076000,671610000,1443724000,2323226000,1935064000,6162923000,4390701000
Nevada,Accommodation and Food Services,2013,20733,6885,4230,3810,14925,3973,811,19709,1024,30005,6905,4245,3940,15090,4830,2430,22350,7655,1486509,10586,27853,50221,89068,144061,123813,359054,1111650,43557877000,401407000,420396000,814853000,1643879000,2758491000,2639321000,7139962000,36132437000
Nevada,Administrative and Support and Waste Management and Remediation Services,2013,19017,10993,2515,1851,15359,1830,693,17882,1135,21045,10995,2515,1890,15400,1995,780,18175,2870,493997,14486,15291,23151,54456,62815,60084,185792,283244,14689484000,625926000,480976000,804088000,1928593000,1967570000,1398617000,5567351000,8632665000
Nevada,"Agriculture, Forestry, Fishing and Hunting",2013,230,180,30,15,225,5,0,230,0,230,180,30,15,225,5,0,230,0,11,7,0,0,136,0,0,11,0,27637000,6393000,2594000,0,24607000,0,0,27637000,0
Nevada,"Arts, Entertainment, and Recreation",2013,6055,3765,583,510,4858,795,227,5880,175,6755,3765,585,515,4865,850,620,6335,420,142838,2002,3411,6465,14138,33523,30917,86673,40992,4129607000,357498000,103513000,198362000,694920000,859402000,828296000,2610603000,1149099000
Nevada,Construction,2013,22448,12270,3950,2835,19055,2362,517,21934,514,22725,12275,3950,2840,19065,2395,565,22025,700,259587,18465,25675,37172,83316,85142,44532,218482,36010,12805727000,902467000,1038843000,1726469000,3678652000,3870720000,2204222000,9963368000,2519555000
Nevada,Educational Services,2013,3163,1715,415,345,2475,370,135,2980,183,3440,1715,415,345,2475,405,170,3050,390,51083,2340,2473,4364,9658,11608,9305,34545,10777,1779940000,95055000,55751000,106984000,279979000,398310000,373235000,1198145000,389977000
Nevada,Finance and Insurance,2013,12474,8200,1260,635,10095,613,500,11208,1266,20130,8220,1270,670,10160,980,1190,12330,7800,169378,9841,7424,7001,26345,10546,6677,48442,111023,9817603000,583871000,349221000,376957000,1332028000,709773000,411632000,2714529000,6993345000
Nevada,Health Care and Social Assistance,2013,27642,14535,5835,3435,23805,2348,593,26746,896,31950,14540,5860,3565,23965,3180,1485,28630,3320,535560,22795,38073,43173,105398,82726,73770,270075,249618,25396330000,1817521000,1590718000,1934446000,5364509000,3524500000,2787688000,11827214000,13016696000
Nevada,Information,2013,4277,2500,555,290,3345,255,110,3710,567,5950,2500,555,300,3355,280,130,3765,2185,75581,1928,2384,3266,7945,5921,2933,22468,44019,4602896000,215341000,130036000,202068000,615728000,322221000,173064000,1424800000,2822836000
Nevada,Management of Companies and Enterprises,2013,2123,520,55,60,635,245,428,1308,815,2610,525,60,60,645,255,490,1390,1220,78959,0,180,506,1265,2157,9024,12601,66358,7780560000,59951000,8895000,86769000,157400000,200331000,572712000,930443000,6850117000
Nevada,Manufacturing,2013,8275,3470,1340,1100,5910,1203,511,7624,651,8525,3470,1340,1100,5910,1240,550,7700,825,152134,3297,6600,10673,23672,30171,19095,93341,38216,7543365000,221988000,264038000,431254000,1040076000,1363623000,875794000,4056857000,2286738000
Nevada,"Mining, Quarrying, and Oil and Gas Extraction",2013,1082,520,135,98,753,129,80,962,120,1150,520,135,100,755,130,90,975,175,70729,510,259,724,2425,3285,5916,13005,49468,6288335000,101180000,52995000,66299000,297076000,224291000,522539000,1485510000,4547600000
Nevada,Other,2013,93,89,1,3,93,0,0,93,0,93,89,1,3,93,0,0,93,0,100,0,0,0,100,0,0,100,0,3604000,2760000,0,0,3604000,0,0,3604000,0
Nevada,Other Services (except Public Administration),2013,19069,11855,3615,1575,17045,1212,348,18605,464,21350,11855,3650,1670,17175,1730,765,19670,1680,156606,18098,22027,18343,63120,39736,18773,125578,17570,4633818000,589917000,632247000,553667000,1801724000,1065931000,508212000,3508851000,749830000
Nevada,"Professional, Scientific, and Technical Services",2013,39073,28725,4220,2295,35240,2027,735,38002,1071,41715,28750,4220,2345,35315,2300,920,38535,3180,269721,33182,25811,28325,90106,56996,26008,182818,56606,16537840000,2381322000,1370745000,1626406000,5467338000,3718593000,1628988000,11138239000,4203153000
Nevada,Real Estate and Rental and Leasing,2013,16240,12248,1598,730,14576,640,430,15646,594,19600,12275,1630,790,14695,820,940,16455,3145,118073,15902,9664,9003,36747,17272,19235,74588,40842,4712387000,686839000,334259000,325249000,1372855000,650173000,765456000,2847056000,1699925000
Nevada,Retail Trade,2013,24915,12194,4764,2751,19709,2004,860,22573,2342,41445,12230,4810,3100,20140,2950,2020,25110,16335,614526,16338,28183,32790,80709,53001,30257,183437,389815,17341969000,566706000,762165000,863968000,2287697000,1842979000,1520821000,5953771000,10386392000
Nevada,Total,2013,48244,28066,7466,4802,40334,4293,1491,46118,2126,60306,28101,7518,5016,40635,5316,2982,48933,11373,1047657,43075,49132,62999,155206,147106,125862,428174,619483,41600674000,2123865000,1709427000,2295043000,6128335000,5487189000,4643096000,16258620000,25342054000
Nevada,Transportation and Warehousing,2013,6153,2955,685,590,4230,577,401,5208,945,7015,2955,685,610,4250,595,455,5300,1715,200083,3578,2960,5784,14740,13733,25848,63108,121371,7263859000,175436000,123665000,226583000,558811000,557735000,891572000,2402263000,4299788000
Nevada,Utilities,2013,272,97,30,10,137,35,41,213,59,635,100,30,15,145,55,85,285,350,633,89,0,0,372,723,789,1979,0,43273000,6627000,3378000,0,22346000,66783000,79962000,170744000,0
Nevada,Wholesale Trade,2013,13148,6285,1599,1157,9041,1453,1028,11522,1626,14790,6285,1600,1195,9080,1585,1225,11890,2900,154013,7714,8332,12671,31283,29456,17638,86019,54749,9192885000,490317000,444191000,590922000,1618490000,1701093000,1015521000,4628939000,3305875000
New Hampshire,Accommodation and Food Services,2013,15102,5755,2970,2968,11693,2748,325,14766,336,18100,5760,3000,2985,11745,3170,830,15745,2355,261398,8208,19903,40322,68562,94507,27392,193046,56647,4660621000,291208000,305734000,612656000,1211015000,1670276000,489543000,3418678000,1206987000
New Hampshire,Administrative and Support and Waste Management and Remediation Services,2013,10407,6575,1525,775,8875,710,237,9822,585,11285,6575,1530,785,8890,800,265,9955,1330,183689,8089,9283,9733,29089,22842,22599,81266,99077,7593039000,436220000,353700000,364700000,1193971000,1034319000,812974000,3306672000,4146770000
New Hampshire,"Agriculture, Forestry, Fishing and Hunting",2013,715,530,120,40,690,20,0,710,5,720,530,120,40,690,25,0,715,5,2666,718,683,98,2125,237,0,2578,0,112952000,33198000,25401000,19787000,82248000,9570000,0,110182000,0
New Hampshire,"Arts, Entertainment, and Recreation",2013,3476,1930,530,380,2840,435,104,3379,97,3665,1930,530,380,2840,475,150,3465,200,56059,2129,2993,4876,10636,12655,11946,37951,12779,1188124000,241508000,105492000,105336000,465929000,291622000,142506000,944419000,125078000
New Hampshire,Construction,2013,19061,13865,2470,1430,17765,1063,140,18968,93,19150,13865,2470,1430,17765,1085,190,19040,110,112383,20844,15753,18466,56891,33551,9632,107488,2216,6283691000,938632000,754552000,987870000,2697701000,2173730000,603652000,5971361000,136782000
New Hampshire,Educational Services,2013,2786,1285,495,336,2116,410,145,2671,115,2990,1285,500,395,2180,445,165,2790,200,109574,1656,3157,2961,10084,13781,20596,46241,61953,4445965000,62265000,66144000,108080000,257372000,370075000,865208000,1525563000,2841180000
New Hampshire,Finance and Insurance,2013,5140,2755,625,284,3664,395,326,4385,755,9500,2755,630,370,3755,635,1490,5880,3620,104774,4565,3463,2883,11468,10088,21886,43498,53590,7815815000,256157000,235807000,227042000,757927000,772103000,1249667000,3088091000,4437203000
New Hampshire,Health Care and Social Assistance,2013,13638,5610,3255,1920,10785,1547,669,13001,637,18125,5620,3260,2010,10890,2130,1725,14745,3380,414147,10446,21040,23663,56613,55107,88367,206802,195913,19247458000,442787000,898552000,1255027000,2649435000,2287264000,3214989000,8359337000,10486012000
New Hampshire,Information,2013,2346,865,375,235,1475,304,140,1919,427,3845,865,375,235,1475,385,185,2045,1800,52190,512,1460,2059,5137,7750,8918,27388,18399,5354491000,75342000,90767000,164484000,368263000,482162000,580578000,1724053000,1664769000
New Hampshire,Management of Companies and Enterprises,2013,787,45,10,30,85,120,175,380,407,1025,45,10,30,85,120,180,385,640,34931,0,0,138,281,1785,4804,6921,28010,3014090000,28510000,0,9017000,43210000,142640000,307570000,493420000,2520670000
New Hampshire,Manufacturing,2013,8704,3305,1500,1115,5920,1667,421,8008,696,9020,3305,1500,1120,5925,1700,485,8110,910,255024,4432,6680,10392,25969,54654,23225,126493,92186,15229197000,212451000,327591000,546541000,1259701000,2766062000,1466941000,6506952000,6135514000
New Hampshire,"Mining, Quarrying, and Oil and Gas Extraction",2013,192,110,20,30,160,5,15,180,12,215,110,20,30,160,5,25,190,25,953,12,0,176,91,0,0,840,0,64360000,6705000,2631000,12576000,32990000,0,14217000,52290000,0
New Hampshire,Other,2013,44,42,2,0,44,0,0,44,0,44,42,2,0,44,0,0,44,0,0,0,0,0,0,0,0,0,0,1312000,1009000,0,0,1312000,0,0,1312000,0
New Hampshire,Other Services (except Public Administration),2013,17035,10635,3795,1445,15875,708,177,16760,275,18105,10645,3810,1470,15925,960,310,17195,910,104868,19158,23583,17321,62314,20767,4916,92359,6404,2991529000,562403000,598926000,467962000,1656514000,639747000,177883000,2612655000,207340000
New Hampshire,"Professional, Scientific, and Technical Services",2013,17962,11690,2545,1595,15830,1110,315,17255,707,19025,11695,2545,1645,15885,1310,400,17595,1430,150048,15684,15906,19399,54501,31867,13495,104893,43576,9115734000,1128035000,934703000,1311289000,3399778000,2265056000,1092181000,7053539000,1970919000
New Hampshire,Real Estate and Rental and Leasing,2013,5666,4025,735,318,5078,214,142,5434,232,6565,4055,770,355,5180,415,230,5825,740,33366,5919,4155,3559,14368,5299,6084,28148,4789,1495210000,281197000,163089000,142514000,612469000,266863000,313692000,1260528000,223769000
New Hampshire,Retail Trade,2013,19881,9632,3999,2300,15931,1894,543,18368,1513,30440,9650,4030,2495,16175,2545,1635,20355,10085,409313,13521,20399,25058,62961,53980,29853,161041,181888,12004452000,511998000,695859000,816720000,2072517000,2119177000,1443004000,5848345000,4031503000
New Hampshire,Total,2013,30427,16904,5356,3253,25513,2854,777,29144,1283,37185,16929,5391,3392,25712,3537,1849,31098,6087,551793,29312,35097,42953,107362,100022,79324,286708,265085,24905652000,1241323000,1291208000,1701129000,4233660000,4255727000,3543820000,12033207000,12872445000
New Hampshire,Transportation and Warehousing,2013,3658,1915,615,372,2902,290,138,3330,328,4020,1915,615,375,2905,305,160,3370,650,57881,2508,3510,3511,9780,6786,4093,27175,12271,2180273000,115076000,127331000,136354000,415682000,275591000,148246000,1046377000,559177000
New Hampshire,Utilities,2013,251,85,25,5,115,15,56,186,65,625,85,25,5,115,20,200,335,290,12037,0,135,0,61,0,3616,4700,8413,1127907000,12161000,5986000,0,20826000,17748000,304509000,380314000,840397000
New Hampshire,Wholesale Trade,2013,8352,3730,1204,802,5736,1031,494,7261,1091,9285,3745,1205,805,5755,1155,620,7530,1755,109305,5275,6165,8481,22157,23286,13157,68950,30362,7864020000,395097000,395013000,575910000,1474782000,1501738000,824660000,4338687000,2660707000
New Jersey,Accommodation and Food Services,2013,88452,46142,16359,12352,74853,11666,1002,87521,931,102310,46180,16380,12420,74980,12535,2480,89995,12315,1486457,78165,107298,167485,354174,427918,123900,907917,578188,28776774000,2130565000,1781935000,2586003000,6507120000,7246457000,2124500000,15924064000,12844377000
New Jersey,Administrative and Support and Waste Management and Remediation Services,2013,62237,40560,8085,5162,53807,4823,1678,60308,1929,69905,40565,8090,5220,53875,4975,2240,61090,8815,1515306,53506,52612,68411,178093,182228,231112,598893,906908,53544041000,2946776000,2065106000,2970902000,8024752000,7278379000,8050066000,23563714000,29442346000
New Jersey,"Agriculture, Forestry, Fishing and Hunting",2013,1115,805,160,70,1035,60,5,1100,15,1115,805,160,70,1035,60,5,1100,15,6058,856,865,628,2768,1555,0,4561,0,211967000,34921000,26684000,20448000,97860000,61419000,0,166878000,0
New Jersey,"Arts, Entertainment, and Recreation",2013,16250,9453,1932,1885,13270,2219,514,16003,247,17380,9475,1935,1900,13310,2245,705,16260,1120,279471,10403,12078,24193,49025,92026,80268,226994,44788,8095065000,709763000,325188000,532513000,1609113000,2036478000,3317376000,7070131000,772764000
New Jersey,Construction,2013,103152,73685,15160,7825,96670,5331,616,102617,535,103625,73685,15160,7840,96685,5375,680,102740,885,694085,115069,98511,104237,320310,197791,78995,609140,70223,44119225000,5205905000,4934530000,5945592000,16091805000,13733954000,6520807000,37291655000,5597448000
New Jersey,Educational Services,2013,17031,7775,3135,2210,13120,2885,646,16651,380,18325,7775,3135,2250,13160,3110,870,17140,1185,493633,12745,20475,29350,63004,121162,91937,279610,176700,17616383000,417355000,446603000,581112000,1452285000,3783473000,3840472000,9246522000,7429980000
New Jersey,Finance and Insurance,2013,31446,19615,4438,1940,25993,2258,1077,29328,2118,60885,19645,4550,2200,26395,4055,3920,34370,26515,974435,29092,27613,24180,82818,77297,71265,239731,734672,102145981000,1950131000,1904966000,2094510000,5988198000,6559758000,5841447000,18843198000,83343370000
New Jersey,Health Care and Social Assistance,2013,111478,54376,25485,14645,94506,11630,3288,109424,2054,135370,54530,25660,15385,95575,14770,9975,120320,15050,2765250,109681,166145,192181,470621,429372,485776,1389823,1333351,128010121000,5308873000,7298639000,9363897000,21984334000,20048924000,17433489000,59610365000,66338212000
New Jersey,Information,2013,10234,5489,1185,865,7539,1222,422,9183,1051,18785,5490,1185,875,7550,1395,500,9445,9340,443039,7394,7050,10594,25363,38056,36895,103613,318941,41855758000,564766000,492825000,752651000,1850714000,2912651000,3514500000,8660783000,31561109000
New Jersey,Management of Companies and Enterprises,2013,4656,380,115,125,620,656,1001,2277,2379,7305,380,115,125,620,670,1040,2330,4975,653818,1,595,840,2039,10514,37580,50648,603170,81947190000,110285000,81820000,81784000,275030000,832362000,3395736000,4543556000,77403634000
New Jersey,Manufacturing,2013,36904,14239,6360,5002,25601,6975,2211,34787,2117,37935,14250,6365,5020,25635,7110,2445,35190,2745,1054101,22058,37361,60350,130902,252793,240297,673991,287389,64961897000,1112500000,1711358000,2982084000,6119412000,13400185000,13196834000,35281073000,23148339000
New Jersey,"Mining, Quarrying, and Oil and Gas Extraction",2013,325,125,40,45,210,41,26,277,48,385,125,40,45,210,50,30,290,95,4639,77,66,418,710,1068,52,2791,1128,307629000,10852000,3636000,26848000,57056000,66025000,3242000,190519000,120920000
New Jersey,Other,2013,287,279,7,1,287,0,0,287,0,287,279,7,1,287,0,0,287,0,219,167,0,0,219,0,0,219,0,6036000,5561000,322000,0,6036000,0,0,6036000,0
New Jersey,Other Services (except Public Administration),2013,111935,75081,19703,9849,104633,5794,786,111213,722,116015,75135,19775,10095,105005,6445,1570,113020,2995,750996,136569,127015,128962,394758,202658,60566,671318,61233,22085982000,3500090000,3222911000,3599926000,10342695000,5626509000,2097146000,18696070000,2838181000
New Jersey,"Professional, Scientific, and Technical Services",2013,141012,100398,16945,9640,126983,8664,2639,138286,2726,148255,100425,16970,9775,127170,9520,3390,140080,8175,1536657,148158,109334,125199,384926,292641,232273,919075,585483,131636375000,8711720000,6476170000,8482375000,23722736000,23808400000,19331492000,67333395000,63295712000
New Jersey,Real Estate and Rental and Leasing,2013,35708,25303,4967,2434,32704,1733,483,34920,788,43255,25340,5085,2610,33035,2395,1110,36540,6715,261925,40695,31643,30297,105127,56469,25109,188216,64914,14569380000,1662177000,1333104000,1423107000,4445677000,3082284000,1408695000,9028340000,4765379000
New Jersey,Retail Trade,2013,112990,73496,18981,9573,102050,6596,1586,110232,2758,158555,73645,19390,10225,103260,8620,3835,115715,42840,2171615,103657,112624,109884,334554,212221,121227,688113,1246318,62857918000,3452269000,3183041000,3600034000,10162410000,8985807000,6140486000,25607619000,34289015000
New Jersey,Total,2013,194184,120376,31580,18672,170628,16400,3880,190908,3276,230281,120513,31825,19258,171596,19068,8108,198772,31509,3492216,203893,206742,248202,658837,606512,484055,1749404,1742812,195072595000,8580231000,8186766000,10602968000,27369965000,28680869000,24990663000,81041497000,114031098000
New Jersey,Transportation and Warehousing,2013,32345,18810,4269,2910,25989,3248,1363,30600,1745,35855,18815,4305,2930,26050,3505,1755,31310,4545,744661,25749,26293,37186,93207,113872,114414,330250,385925,34877354000,1082019000,1106293000,1431221000,3683479000,4463413000,4636641000,13127556000,20105479000
New Jersey,Utilities,2013,555,200,85,30,315,70,22,407,148,1935,200,90,35,325,75,65,465,1470,93066,23,32,211,724,2199,0,4832,80742,10044945000,12976000,8714000,15531000,65980000,186769000,0,425003000,8816251000
New Jersey,Wholesale Trade,2013,66560,34690,10642,7106,52438,7835,2938,63211,3349,72775,34705,10700,7265,52670,8430,3925,65025,7750,1275120,56655,68216,91536,224643,259984,227712,728274,532840,111614441000,3592505000,4136198000,5821373000,13680902000,17093576000,16260386000,47856001000,62897902000
New Mexico,Accommodation and Food Services,2013,15639,5030,2865,2933,10828,3672,550,15050,589,20920,5060,2880,2985,10925,4345,1940,17210,3710,405255,7311,18954,40777,68571,134292,73637,277288,126069,6436603000,210826000,243595000,549699000,1015657000,2018829000,1256088000,4304875000,2123375000
New Mexico,Administrative and Support and Waste Management and Remediation Services,2013,8370,4730,1290,715,6735,678,188,7601,769,9210,4730,1290,735,6755,760,260,7775,1435,156522,6794,7544,8837,25349,19844,19521,68292,78338,4627296000,233928000,222293000,247802000,734475000,688802000,390685000,1904956000,2466907000
New Mexico,"Agriculture, Forestry, Fishing and Hunting",2013,446,315,70,45,430,6,5,441,5,460,315,75,45,435,15,5,455,5,1715,382,138,240,1455,0,0,1595,0,67220000,16623000,10674000,11456000,56556000,0,0,64275000,0
New Mexico,"Arts, Entertainment, and Recreation",2013,3187,1875,440,300,2615,375,110,3100,87,3345,1875,445,310,2630,430,150,3210,135,63864,1949,2248,3042,7814,12458,14497,38770,21015,1384476000,85975000,56767000,60839000,216889000,217092000,383690000,866444000,440353000
New Mexico,Construction,2013,21532,13262,3700,2340,19302,1727,297,21326,206,21700,13265,3705,2340,19310,1760,360,21430,270,187675,21661,22426,31519,77787,60440,27998,177675,5153,7859630000,708536000,752887000,1223533000,2713347000,2752508000,1391716000,7308365000,322937000
New Mexico,Educational Services,2013,2728,1370,415,320,2105,390,125,2620,108,2840,1370,415,320,2105,395,150,2650,190,45180,1803,2597,2822,9267,14044,13681,39137,2130,1338459000,65565000,55150000,65480000,239245000,375997000,491551000,1170708000,112681000
New Mexico,Finance and Insurance,2013,7432,4630,990,310,5930,490,264,6684,748,13575,4645,1015,385,6045,1345,1325,8715,4860,100684,8058,5500,3148,17523,14798,21070,54011,32623,5552879000,305067000,243761000,138383000,705940000,712118000,1090414000,2527342000,2767536000
New Mexico,Health Care and Social Assistance,2013,20295,9310,4075,2884,16269,2325,838,19432,863,24910,9330,4095,2940,16365,3060,1780,21205,3705,573507,15362,25206,37376,80719,88718,102789,280500,278830,23381597000,735603000,1069535000,1492523000,3336530000,3161874000,3277892000,10028881000,12797275000
New Mexico,Information,2013,2271,1175,227,180,1582,218,104,1904,367,3755,1175,230,185,1590,280,260,2130,1625,55510,1200,260,1517,4515,5493,6598,19133,30247,2584050000,71294000,21917000,70978000,195991000,250830000,265047000,746930000,1762442000
New Mexico,Management of Companies and Enterprises,2013,895,35,15,45,95,175,250,520,375,1100,35,15,45,95,175,270,540,560,34478,0,0,0,365,1244,6143,8085,26474,2136678000,4425000,2088000,0,18610000,71447000,313949000,406485000,1734868000
New Mexico,Manufacturing,2013,6615,3040,1275,900,5215,730,245,6190,425,6755,3040,1280,900,5220,765,270,6255,500,105903,3810,5800,8140,20509,16369,7170,54083,39289,5400034000,143626000,201314000,304835000,752216000,654209000,361180000,2248299000,2475242000
New Mexico,"Mining, Quarrying, and Oil and Gas Extraction",2013,3232,1320,360,434,2114,581,161,2856,376,3615,1320,360,440,2120,590,200,2910,705,85019,1519,2476,5757,10362,20952,13435,47920,35952,6507952000,133117000,130906000,352990000,618737000,1384589000,994637000,3221720000,3203882000
New Mexico,Other,2013,54,52,2,0,54,0,0,54,0,54,52,2,0,54,0,0,54,0,0,0,0,0,0,0,0,0,0,1058000,1005000,0,0,1058000,0,0,1058000,0
New Mexico,Other Services (except Public Administration),2013,19088,11400,4005,1940,17345,1240,182,18767,321,20405,11410,4015,2020,17445,1620,500,19565,840,130816,20065,25626,24538,72228,39250,4099,121581,4523,3362622000,512904000,622466000,616826000,1771250000,938494000,179180000,3040239000,191251000
New Mexico,"Professional, Scientific, and Technical Services",2013,21722,14747,2865,1638,19250,1131,484,20865,857,23565,14750,2875,1670,19295,1340,625,21260,2305,185108,21544,18248,19766,61860,30997,17207,115188,65939,10735975000,1034087000,858648000,1056469000,2968654000,1957690000,1174304000,6287171000,4518671000
New Mexico,Real Estate and Rental and Leasing,2013,9305,7020,1007,360,8387,320,183,8890,415,11765,7035,1025,400,8460,550,890,9900,1865,46630,9578,6137,3999,20677,7429,1096,34591,10333,1890059000,338607000,195956000,141218000,688106000,420961000,117983000,1327921000,551878000
New Mexico,Retail Trade,2013,20729,10497,4051,2231,16779,1790,574,19143,1586,32855,10510,4125,2375,17010,2790,1735,21535,11320,384533,15542,24558,26481,72187,52430,28985,164299,199645,10204632000,470978000,628356000,770533000,1896309000,1658549000,1113522000,4855923000,4536608000
New Mexico,Total,2013,34866,19340,5936,3775,29051,3362,909,33322,1544,43736,19366,5989,3922,29277,4410,2336,36023,7713,597988,33441,38943,50219,122603,118251,90776,331630,266358,22920528000,1121327000,1195425000,1650859000,3967611000,3995171000,3424900000,11387682000,11532846000
New Mexico,Transportation and Warehousing,2013,5934,3275,765,535,4575,504,253,5332,602,6945,3275,765,540,4580,530,320,5430,1515,82683,2624,3945,5989,15282,14668,8450,43704,20842,3501494000,173664000,135031000,227573000,569540000,578650000,446302000,1666430000,1131665000
New Mexico,Utilities,2013,733,440,90,30,560,70,20,650,83,1155,440,90,30,560,135,35,730,425,18841,837,536,337,1823,3041,0,6419,2227,1474752000,19882000,16161000,16203000,57421000,179923000,0,323954000,206226000
New Mexico,Wholesale Trade,2013,7945,2989,1234,885,5108,1018,477,6603,1342,9535,2990,1235,945,5170,1165,605,6940,2595,116103,3420,6440,7849,21829,17535,8094,55600,47433,6988604000,225779000,301891000,369384000,1005116000,888048000,378265000,2533339000,3403872000
New York,Accommodation and Food Services,2013,224541,113264,42751,33351,189366,30682,3001,223049,1492,254890,113280,42820,33500,189600,33200,8180,230980,23910,3527401,198098,281039,453413,934845,1124177,460432,2521260,1002816,77651194000,5060695000,4519335000,7869787000,17456830000,23644210000,10828698000,51944350000,25646632000
New York,Administrative and Support and Waste Management and Remediation Services,2013,120051,81113,14737,8954,104804,9083,3337,117224,2827,131180,81155,14775,9070,105000,9480,4305,118785,12395,2723555,106414,92172,117847,319243,353641,499077,1180310,1516994,136268872000,5602307000,4042704000,5449368000,15126927000,15581942000,17300861000,48170354000,87555603000
New York,"Agriculture, Forestry, Fishing and Hunting",2013,2985,2345,375,165,2885,65,15,2965,20,2990,2345,375,165,2885,70,15,2970,20,11930,3389,2178,1926,7901,1586,0,10873,441,437287000,107714000,63909000,78969000,266093000,56942000,0,391646000,16970000
New York,"Arts, Entertainment, and Recreation",2013,55544,38345,6212,4405,48962,4858,1103,54923,621,59400,38350,6225,4445,49020,5075,1555,55650,3750,811555,38607,40362,58113,145544,191538,160595,506215,294376,36841752000,6314830000,1978159000,2028040000,10331675000,6349386000,5474835000,22557540000,14021702000
New York,Construction,2013,228859,165270,30710,17884,213864,12631,1769,228264,595,230095,165270,30715,17915,213900,12825,2020,228745,1350,1558345,237891,201083,240580,686405,465500,262560,1417275,132931,98235925000,10633860000,9224072000,13377100000,33238020000,31590035000,21093635000,86008465000,11449667000
New York,Educational Services,2013,36740,17955,4845,4250,27050,6847,1827,35724,1016,39665,17985,4895,4310,27190,7325,2695,37210,2455,1986060,27286,32210,56603,116935,286724,294385,699486,1281754,80824610000,1189472000,839210000,1511592000,3543360000,10067219000,11956818000,25636445000,55157638000
New York,Finance and Insurance,2013,80212,51030,11824,5422,68276,6031,2640,76947,3265,140800,51095,12105,6075,69275,8920,8510,86705,54095,2626132,83278,74527,67128,229991,208706,275571,721002,1882760,497217612000,7861598000,7233587000,9154309000,24404177000,39002242000,55268175000,119766521000,374909763000
New York,Health Care and Social Assistance,2013,228707,126425,44745,24235,195405,19263,8459,223127,5580,283850,126730,45090,25310,197130,25825,24935,247890,35960,7226017,225095,293161,321552,845363,735496,1361062,2950458,4266013,336948036000,12041265000,13035676000,15157566000,40247386000,32529278000,48425864000,121345210000,215312561000
New York,Information,2013,38425,23081,4410,3524,31015,3880,1366,36261,2164,56430,23090,4420,3590,31100,4405,1770,37275,19155,1328789,29161,26875,42276,102681,136621,136919,392491,916717,136883662000,2850888000,1602376000,2408315000,7022533000,9530828000,12361615000,30394205000,102710411000
New York,Management of Companies and Enterprises,2013,9255,1070,201,251,1522,1616,2425,5563,3692,14685,1075,205,255,1535,1645,2550,5730,8955,905430,3,832,1643,3985,23864,93156,121070,784318,119890665000,312389000,79812000,136421000,543005000,2218469000,8638156000,11411410000,108456379000
New York,Manufacturing,2013,78476,35000,13434,10681,59115,12862,3590,75567,2909,80825,35005,13435,10745,59185,13145,4165,76495,4330,2048122,57047,82853,136477,290444,482395,409735,1245276,664193,106001962000,2366240000,3129614000,5414188000,11217597000,21912194000,20334710000,56086453000,41677176000
New York,"Mining, Quarrying, and Oil and Gas Extraction",2013,1298,660,195,145,1000,95,85,1180,118,1550,660,195,145,1000,115,160,1275,275,19257,402,930,1363,3858,2988,5061,13935,3463,1340424000,68344000,52230000,90234000,230097000,240513000,340258000,903621000,221053000
New York,Other,2013,851,831,19,1,851,0,0,851,0,851,831,19,1,851,0,0,851,0,682,0,125,0,682,0,0,682,0,21454000,19651000,1727000,0,21454000,0,0,21454000,0
New York,Other Services (except Public Administration),2013,267330,186420,44170,20957,251547,12903,1847,266297,1033,281395,186545,44340,21385,252270,14930,4485,271685,9710,1835371,323997,287838,275226,901098,442228,234666,1587081,193625,63056130000,8631208000,8186236000,8683773000,25512133000,15798099000,11118668000,52665647000,8064420000
New York,"Professional, Scientific, and Technical Services",2013,286236,209441,34255,19417,263113,15127,4139,282379,3857,302030,209490,34325,19780,263595,16845,6145,286585,15445,3016936,293808,221029,251122,777324,515767,417029,1725846,1240410,261040875000,18599437000,13578951000,17907271000,50110510000,41053692000,35592449000,127435155000,131219251000
New York,Real Estate and Rental and Leasing,2013,145828,113714,16289,8037,138040,5466,1190,144696,1132,160725,113825,16540,8730,139095,7590,3985,150670,10055,819235,143357,105903,104289,386691,182468,95980,669542,140630,46239664000,6833092000,4876507000,5132938000,16857895000,10250213000,6270375000,33542196000,12173388000
New York,Retail Trade,2013,295454,202061,47883,22680,272624,16476,2996,292096,3358,390260,202285,48480,24480,275245,22045,10180,307470,82790,4463816,290097,296248,282832,896040,569607,269741,1793337,2376309,125129763000,9386017000,8727229000,8926476000,27061410000,20223179000,10857920000,58747154000,62489993000
New York,Total,2013,455727,299813,69246,40512,409571,34209,7507,451287,4440,532669,300084,69726,41898,411708,40900,19025,471633,61036,7688492,490872,452111,538895,1481878,1280592,1131204,3893674,3794818,466815127000,21593895000,18172010000,23433815000,63199720000,63703736000,63005970000,189909426000,276905701000
New York,Transportation and Warehousing,2013,55441,34612,7322,4848,46782,4856,1785,53423,2018,61820,34655,7350,4865,46870,5470,2755,55095,6725,1156453,40969,46605,60735,158593,168023,153018,509099,634947,50369743000,1809143000,1752267000,2331344000,5943391000,6841641000,5738904000,19487755000,30024301000
New York,Utilities,2013,1069,460,125,105,690,112,72,874,195,3125,460,130,105,695,140,335,1170,1955,193313,453,660,1282,2881,3492,3431,11292,171476,19265193000,58944000,38282000,90013000,208115000,323279000,396373000,1018954000,17238224000
New York,Wholesale Trade,2013,150259,92872,22025,14170,129067,13655,3966,146688,3571,163375,92965,22115,14615,129695,15450,6380,151525,11850,1823630,152747,142966,182958,483407,459944,353236,1306064,453235,124334226000,7647505000,7653977000,10501734000,25824550000,29395375000,24329000000,80051105000,41823769000
North Carolina,Accommodation and Food Services,2013,71207,25140,13624,14877,53641,14656,1530,69827,1380,99115,25150,13675,15080,53905,17390,5695,76990,22125,1785104,40126,92424,204187,337045,516076,219009,1075090,715642,27033191000,1107045000,1238000000,2754252000,5100245000,7500412000,3145515000,15799310000,10969377000
North Carolina,Administrative and Support and Waste Management and Remediation Services,2013,51599,30990,8325,4323,43638,4408,1501,49547,2052,60325,31010,8335,4370,43715,5105,2100,50920,9405,1356029,48075,53676,56990,162395,155366,188063,512558,839431,40885939000,1612357000,1646325000,1721240000,5016323000,5111131000,5921746000,16231349000,24491925000
North Carolina,"Agriculture, Forestry, Fishing and Hunting",2013,3893,2425,835,400,3660,135,40,3835,58,3935,2425,835,410,3670,135,60,3865,70,22741,3982,5321,4975,14917,2903,1312,20615,1001,827986000,141860000,185303000,183719000,523206000,102063000,46786000,715958000,39549000
North Carolina,"Arts, Entertainment, and Recreation",2013,16619,9726,2398,1689,13813,2112,401,16326,293,17600,9735,2400,1700,13835,2285,575,16695,905,286903,12016,15294,22972,50218,82638,50442,191656,85289,8131805000,545605000,387446000,473342000,1422413000,1713766000,1493528000,4758644000,3025801000
North Carolina,Construction,2013,102745,69065,16225,9124,94414,6672,950,102036,709,104315,69065,16245,9135,94445,6805,1285,102535,1780,815160,109822,105810,120140,337559,243481,104236,687185,114684,35077904000,3626842000,3540292000,4614375000,11783495000,10625150000,5090328000,27556645000,6799428000
North Carolina,Educational Services,2013,12180,6405,1685,1510,9600,1698,506,11804,376,12935,6405,1685,1525,9615,1750,685,12050,885,467454,8310,10654,19672,39306,67820,80168,194391,259795,17317373000,300326000,216951000,398398000,920776000,1861468000,2518703000,5532547000,11253873000
North Carolina,Finance and Insurance,2013,32033,21820,4309,1643,27772,1519,763,30054,1979,65155,21845,4460,2070,28375,3730,3780,35885,29270,835072,31602,25931,19426,82180,46517,48336,185899,626711,66655756000,1665027000,1311896000,1243470000,4301663000,2950090000,3684325000,11357712000,54228926000
North Carolina,Health Care and Social Assistance,2013,86528,36769,20188,13132,70089,11447,3010,84546,1982,114930,36810,20290,13455,70555,15445,9825,95825,19105,2752325,63674,134688,172905,376029,438568,434437,1254844,1465140,115607617000,3055756000,5533395000,6943902000,15528349000,15290521000,14873785000,45930467000,67667940000
North Carolina,Information,2013,9129,4930,1105,770,6805,855,388,8048,1081,16940,4940,1105,800,6845,1160,840,8845,8095,392626,6152,6393,8592,24274,27977,34315,92182,299472,25685732000,363222000,286957000,444906000,1122427000,1568868000,2498512000,5438233000,20175603000
North Carolina,Management of Companies and Enterprises,2013,4985,245,105,110,460,1010,1381,2851,2134,8810,245,105,110,460,1025,1520,3005,5805,406475,340,432,487,1325,12830,42699,56854,349372,40233980000,30195000,28690000,27675000,87515000,825140000,2764981000,3677636000,36539613000
North Carolina,Manufacturing,2013,40352,14980,6275,5165,26420,7069,2850,36339,4013,43935,14995,6280,5180,26455,7285,3590,37330,6605,1903682,22196,36840,63602,131181,262767,276054,731308,1057353,87945209000,905325000,1306616000,2301046000,4774508000,10424739000,11399746000,28962624000,54238645000
North Carolina,"Mining, Quarrying, and Oil and Gas Extraction",2013,576,205,105,60,370,82,46,498,78,1010,205,105,60,370,105,85,560,450,15153,88,542,647,1773,2106,2909,7451,6942,817132000,13015000,20308000,31225000,76939000,90141000,163496000,393998000,349721000
North Carolina,Other,2013,304,292,10,2,304,0,0,304,0,304,292,10,2,304,0,0,304,0,0,0,59,0,0,0,0,0,0,5357000,4147000,722000,0,5357000,0,0,5357000,0
North Carolina,Other Services (except Public Administration),2013,105577,68615,20841,8679,98135,5817,891,104843,734,113515,68670,21015,9070,98755,7740,2760,109255,4260,736304,125864,133980,112161,376158,199724,73433,661880,52010,18314260000,2927666000,3094101000,2729309000,8770280000,4911699000,2027168000,15915727000,1776055000
North Carolina,"Professional, Scientific, and Technical Services",2013,106750,76870,13046,6985,96901,5380,1902,104183,2567,115775,76885,13125,7170,97180,6700,3025,106905,8870,997393,103709,84341,89367,287356,169538,116813,583129,393725,66803032000,5373853000,4006315000,4620725000,14036740000,10595110000,8577674000,33692233000,32199451000
North Carolina,Real Estate and Rental and Leasing,2013,38610,30563,3455,1526,35544,1449,753,37746,864,51635,30620,3515,1740,35875,2650,3415,41940,9695,231163,31492,21577,18152,80788,41274,35269,162641,64417,9817565000,1560852000,782398000,690132000,3052743000,1736628000,1550818000,6459628000,3373172000
North Carolina,Retail Trade,2013,100446,58610,20114,9780,88504,7528,1642,97674,2772,170990,58745,20570,11325,90640,13870,7940,112450,58540,2063028,98657,126284,121296,350404,247344,119562,752047,1206965,50266531000,2597047000,3088232000,3369964000,9078283000,8301068000,4282680000,22069329000,26694919000
North Carolina,Total,2013,167548,99397,28470,17214,145081,15261,3657,163999,3549,218285,99516,28780,18083,146379,20450,10621,177450,40835,3421195,165426,187150,228595,581171,558238,434842,1574251,1846944,143341880000,5737238000,5939649000,7402190000,19079077000,19213545000,17089330000,55381952000,87959928000
North Carolina,Transportation and Warehousing,2013,23153,13924,3038,1747,18709,1759,961,21429,1724,27035,13935,3055,1805,18795,1935,1300,22030,5005,479371,17984,19076,21134,60963,53371,45773,169829,255196,19425554000,725486000,606205000,727948000,2098642000,1978406000,1780946000,6121365000,11244275000
North Carolina,Utilities,2013,790,280,130,50,460,120,113,693,97,2700,280,130,50,460,180,270,910,1790,75208,307,783,593,1899,6101,9034,17462,0,6135588000,14464000,28924000,24125000,72726000,374498000,650282000,1124462000,0
North Carolina,Wholesale Trade,2013,47619,24087,6836,5043,35966,5571,2570,44107,3512,59250,24155,6920,5350,36425,6955,4355,47735,11515,863190,35774,41503,61383,146285,161781,126704,448229,362728,54373858000,1957577000,2121395000,3193616000,7356260000,8314093000,7203409000,23366738000,29314119000
North Dakota,Accommodation and Food Services,2013,8538,2925,1655,1570,6150,1878,279,8307,231,9905,2925,1660,1585,6170,2120,730,9020,885,181595,4671,10893,21452,37480,65626,35714,140338,33325,2835101000,128849000,125151000,271240000,532259000,973062000,553120000,2081283000,630251000
North Dakota,Administrative and Support and Waste Management and Remediation Services,2013,4619,2685,700,445,3830,376,92,4298,321,5100,2690,705,455,3850,425,140,4415,685,67852,2760,4076,4855,13590,10995,8115,37455,25420,2328935000,135353000,157392000,173824000,514258000,402271000,372560000,1370033000,771038000
North Dakota,"Agriculture, Forestry, Fishing and Hunting",2013,620,480,85,20,585,15,5,605,15,630,480,85,20,585,15,5,605,25,2348,472,473,0,1257,0,0,1670,0,114045000,28475000,27712000,0,65898000,0,0,83475000,0
North Dakota,"Arts, Entertainment, and Recreation",2013,1966,1210,250,210,1670,200,64,1934,32,2170,1210,250,225,1685,275,175,2135,35,24174,893,1010,1931,5190,6340,6343,18722,0,372960000,45863000,19124000,35769000,120217000,94205000,61276000,294928000,0
North Dakota,Construction,2013,14933,9860,2465,1344,13669,1000,150,14819,114,15105,9860,2465,1350,13675,1065,190,14930,175,109929,13856,15658,16886,47444,37531,11230,102444,4602,6899321000,718299000,754895000,948459000,2437336000,2350120000,921364000,6145366000,465354000
North Dakota,Educational Services,2013,770,300,100,75,475,180,60,715,55,800,300,100,75,475,190,60,725,75,23231,292,569,930,2059,6688,7439,16341,0,531181000,13547000,8235000,10355000,33482000,137607000,214373000,396295000,0
North Dakota,Finance and Insurance,2013,5487,3740,475,325,4540,370,165,5075,412,8695,3740,525,505,4770,1105,1040,6915,1780,75672,5496,2553,3712,12666,11042,12974,39411,27821,3989547000,239945000,126610000,181524000,589319000,610276000,728244000,2015716000,1826809000
North Dakota,Health Care and Social Assistance,2013,7863,3475,1538,1135,6148,919,454,7521,342,9565,3475,1550,1185,6210,1150,1025,8385,1180,292339,5465,8860,13847,29319,34747,48638,119294,165308,12806521000,225795000,379180000,489444000,1162545000,1035914000,1439924000,3803017000,8749866000
North Dakota,Information,2013,1161,335,205,170,710,182,82,974,187,1740,335,205,200,740,285,90,1115,625,31571,258,1009,1413,3537,6718,3331,15117,11479,1941530000,14307000,31605000,64416000,123418000,379286000,195633000,757912000,681795000
North Dakota,Management of Companies and Enterprises,2013,455,35,20,20,75,80,90,245,210,520,35,20,20,75,80,95,250,270,20710,0,16,0,27,742,1475,2415,18193,1518635000,4104000,4800000,0,13787000,34242000,122900000,172665000,1340366000
North Dakota,Manufacturing,2013,3358,1240,570,470,2280,521,272,3073,285,3650,1240,570,470,2280,540,335,3155,495,84986,974,1918,3761,9044,11723,15161,46727,17469,3815357000,58206000,83808000,156025000,375020000,507739000,662310000,2037854000,909800000
North Dakota,"Mining, Quarrying, and Oil and Gas Extraction",2013,2201,910,240,240,1390,350,105,1845,356,2620,910,240,240,1390,380,115,1885,735,106386,354,1498,2880,5624,13865,11138,31539,72874,10394879000,131328000,98419000,272949000,519116000,1242268000,913034000,2722654000,7522695000
North Dakota,Other,2013,36,36,0,0,36,0,0,36,0,36,36,0,0,36,0,0,36,0,17,17,0,0,17,0,0,17,0,455000,455000,0,0,455000,0,0,455000,0
North Dakota,Other Services (except Public Administration),2013,11867,7672,2320,984,10976,647,55,11678,189,12340,7675,2340,1015,11030,850,90,11970,370,67566,11563,14208,12074,40764,18141,390,62747,2736,1728479000,327237000,375557000,320494000,1040717000,487120000,8717000,1588204000,83333000
North Dakota,"Professional, Scientific, and Technical Services",2013,8245,5290,1155,660,7105,548,253,7906,339,8860,5290,1155,700,7145,720,405,8270,590,68187,997,6876,7548,22782,14501,9293,49921,10621,4314806000,380793000,345237000,423207000,1189802000,995036000,841409000,3211869000,699625000
North Dakota,Real Estate and Rental and Leasing,2013,4417,3300,430,195,3925,183,122,4230,187,4935,3300,435,200,3935,235,365,4535,400,22324,3165,1765,1855,8837,4093,2724,18232,4680,1286731000,191358000,90877000,75373000,389848000,259786000,87797000,829104000,374499000
North Dakota,Retail Trade,2013,11702,4690,2570,1748,9008,1423,439,10870,832,16015,4695,2605,1915,9215,2035,1360,12610,3405,230205,5880,15145,19768,45680,39574,31787,125655,87954,6166665000,235597000,428824000,601873000,1319388000,1421911000,1007080000,3938237000,1788309000
North Dakota,Total,2013,19894,11052,3344,2138,16534,1992,539,19065,829,24088,11058,3380,2282,16720,2754,1499,20973,3115,342747,17757,22114,28529,68400,72263,58954,199617,143130,15559617000,701903000,771110000,1054101000,2527114000,2983055000,2500320000,8010489000,7549128000
North Dakota,Transportation and Warehousing,2013,7704,4940,1169,520,6629,475,231,7335,369,8415,4945,1170,520,6635,525,335,7495,920,90480,6551,7423,6095,21060,16014,13516,54509,33946,5440114000,380172000,339543000,343378000,1085805000,1053866000,674294000,2949461000,2349376000
North Dakota,Utilities,2013,245,80,0,15,95,85,5,185,60,675,80,0,20,100,165,10,275,400,5062,142,0,102,295,3790,0,5372,0,980991000,8642000,0,5290000,18057000,295169000,0,425860000,0
North Dakota,Wholesale Trade,2013,5834,1925,794,613,3332,1091,492,4915,919,8520,1925,820,710,3455,1610,930,5995,2525,108992,2475,4110,5702,14240,28135,16198,63099,35202,6522668000,154339000,229396000,351568000,880163000,1635302000,1035430000,3811873000,2293929000
Ohio,Accommodation and Food Services,2013,84262,30559,15980,16879,63418,17391,1906,82715,1547,118375,30580,16030,17010,63620,20985,8785,93390,24985,2221038,49635,107088,229710,387255,635140,301831,1325737,877529,30543950000,1133672000,1251812000,2767488000,5160705000,8542365000,3819756000,17535725000,12692210000
Ohio,Administrative and Support and Waste Management and Remediation Services,2013,56128,32850,8175,5630,46655,5165,1913,53733,2395,66180,32860,8195,5680,46735,5565,2625,54925,11255,1837667,45071,52410,74953,175281,198396,267929,650529,1180727,54624364000,1997892000,1785700000,2482988000,6276416000,6342607000,7112489000,19984527000,34510909000
Ohio,"Agriculture, Forestry, Fishing and Hunting",2013,1365,990,185,80,1255,65,15,1335,30,1375,990,185,80,1255,65,15,1335,40,6263,759,1006,906,3426,1650,0,5397,699,201546000,41921000,25191000,25621000,100364000,55921000,0,164902000,29976000
Ohio,"Arts, Entertainment, and Recreation",2013,17669,9865,2697,2095,14657,2231,469,17357,312,18840,9865,2715,2110,14690,2475,705,17870,970,301430,14200,17251,26612,60254,85283,61617,210791,82864,9927604000,590931000,400044000,501386000,1524447000,1696789000,3335820000,6627188000,3178484000
Ohio,Construction,2013,96329,63040,15370,9609,88019,6747,893,95659,670,97710,63040,15370,9625,88035,7055,1245,96335,1375,825504,101330,100035,126109,328310,239636,119085,696440,102128,45545192000,4211215000,4233065000,6125333000,14577345000,13883071000,8098683000,37046765000,7085714000
Ohio,Educational Services,2013,13377,5175,2345,1797,9317,2916,652,12885,492,15345,5185,2350,1855,9390,3425,1080,13895,1450,590799,8141,15458,23691,48783,121925,95826,269764,310585,16131083000,244346000,334069000,536371000,1118564000,3253103000,3040584000,7442580000,8249248000
Ohio,Finance and Insurance,2013,41715,27472,6067,2496,36035,2609,928,39572,2143,86600,27530,6295,3110,36935,6190,4865,47990,38610,1259007,48322,37218,31676,117662,91361,73633,297667,941177,86851491000,2028341000,1799844000,1939751000,5845623000,5542003000,4599196000,16299001000,68964835000
Ohio,Health Care and Social Assistance,2013,102160,40854,23961,15492,80307,13846,5008,99161,2999,142760,40950,24220,16455,81625,19950,15420,116995,25765,4070706,80909,159401,205197,447845,547209,744120,1746493,2314687,171417011000,3513180000,6119497000,8389989000,18025498000,20040191000,22004779000,60400254000,110829839000
Ohio,Information,2013,8749,3745,1294,970,6009,1243,464,7716,1033,18045,3745,1305,1005,6055,1445,1005,8505,9540,401641,4952,7588,11541,26578,41620,39217,110633,287864,26454664000,434766000,295031000,565612000,1459151000,2167632000,2257714000,6029101000,18471169000
Ohio,Management of Companies and Enterprises,2013,6522,365,165,195,725,1140,1902,3767,2755,10325,365,170,195,730,1160,1990,3880,6445,781625,91,49,1270,2464,13865,54581,71670,709952,67311830000,100845000,39598000,74795000,219990000,825845000,3981770000,5027605000,62284038000
Ohio,Manufacturing,2013,66023,20429,11385,9756,41570,13842,5270,60682,5341,71185,20435,11395,9820,41650,14485,6610,62745,8440,3060277,36334,71226,124941,241558,525295,600776,1425804,1495360,164011542000,1471986000,2630997000,5213893000,9596017000,24130727000,29674544000,65764295000,90585207000
Ohio,"Mining, Quarrying, and Oil and Gas Extraction",2013,2941,1450,525,349,2324,240,115,2679,262,3680,1450,525,355,2330,305,235,2870,810,52380,2292,3369,4311,10177,5423,9058,26606,23281,3511236000,111896000,154583000,222085000,495767000,299310000,564469000,1491882000,1873530000
Ohio,Other,2013,266,255,7,2,264,2,0,266,0,266,255,7,2,264,2,0,266,0,299,0,48,0,258,0,0,299,0,5508000,4167000,455000,0,5402000,0,0,5508000,0
Ohio,Other Services (except Public Administration),2013,123522,71925,28373,13250,113548,7857,1194,122599,923,138160,72000,28665,13985,114650,10615,3360,128625,9535,1023879,145108,185171,172024,503467,265125,96892,873250,104155,26864377000,3184917000,3936052000,3955485000,11087624000,6606731000,2951028000,20799058000,3850059000
Ohio,"Professional, Scientific, and Technical Services",2013,109399,71698,16095,9568,97361,7206,2240,106807,2592,119935,71715,16130,9935,97780,8535,3495,109810,10125,1167750,111349,105508,124016,344057,241063,174359,770957,385150,74589798000,5403711000,4917664000,6587318000,17000795000,15051350000,12293781000,44762527000,29588488000
Ohio,Real Estate and Rental and Leasing,2013,35019,24808,4511,2117,31436,1849,872,34157,862,49260,24905,4590,2480,31975,3410,3650,39035,10225,299791,38150,27979,25913,94055,52334,41759,193498,89065,13048080000,1372144000,962735000,978373000,3368040000,2188425000,2221830000,7956315000,4593858000
Ohio,Retail Trade,2013,103424,56004,21996,11401,89401,8910,2139,100450,2974,182040,56170,22675,12690,91535,14500,8855,114890,67150,2709506,84554,136940,143358,378985,313075,187246,914979,1591557,67848185000,2441788000,3131608000,3674131000,9309452000,10162959000,6303810000,26115678000,39568859000
Ohio,Total,2013,186026,100699,34397,22252,157348,20004,4799,182151,3875,250117,100854,34828,23464,159146,26702,14448,200296,49821,4587136,178334,227189,297105,702628,755603,660597,2118828,2468308,195630962000,6405686000,7242534000,10222486000,23870706000,28005601000,26618228000,78494535000,117136427000
Ohio,Transportation and Warehousing,2013,29077,15436,3999,3167,22602,3034,1180,26816,2261,35000,15445,4025,3235,22705,3530,1690,27925,7075,751677,22876,24469,40065,90554,102808,69267,269255,395687,31501760000,951403000,907970000,1580118000,3495831000,3946217000,2641695000,10328734000,18045546000
Ohio,Utilities,2013,861,280,110,80,470,220,33,723,138,3245,280,120,80,480,290,90,860,2385,71227,352,523,819,2142,8171,2090,15370,10329,8491428000,18836000,29116000,55281000,125613000,527222000,140394000,990606000,1026668000
Ohio,Wholesale Trade,2013,56579,25445,9025,7130,41600,7611,3376,52587,3992,71195,25485,9145,7605,42235,9515,6520,58270,12925,1113897,42762,57865,90062,196872,243185,208628,659089,429053,64254786000,2344365000,2970168000,4836841000,10214220000,13101468000,11675279000,35590553000,27826833000
Oklahoma,Accommodation and Food Services,2013,26506,9740,4800,4910,19450,5514,704,25668,838,37505,9760,4810,4980,19550,6465,2960,28975,8530,704568,16722,31628,66412,115263,198175,101761,415380,270298,10008308000,371996000,381185000,848526000,1609189000,2689621000,1339840000,5649375000,4092575000
Oklahoma,Administrative and Support and Waste Management and Remediation Services,2013,20098,11780,3055,1835,16670,1568,629,18867,1231,22275,11785,3065,1865,16715,1695,900,19310,2965,471272,17365,18536,22315,62081,57626,70559,197695,265601,15107784000,610770000,557452000,697928000,1929289000,1890757000,1831487000,5900529000,8953787000
Oklahoma,"Agriculture, Forestry, Fishing and Hunting",2013,781,540,115,75,730,10,16,756,25,790,540,115,75,730,10,25,765,25,4226,788,105,773,2459,0,0,3759,122,163896000,28493000,15348000,31202000,85603000,0,0,138622000,6574000
Oklahoma,"Arts, Entertainment, and Recreation",2013,4835,2625,675,555,3855,650,210,4715,120,5275,2630,685,555,3870,720,310,4900,375,129764,3781,3976,6855,15402,26008,30361,76513,0,3508535000,113299000,81132000,119217000,331319000,468956000,817833000,1795664000,17227000
Oklahoma,Construction,2013,40181,25565,6940,4015,36520,2880,435,39835,346,40510,25565,6940,4020,36525,2925,505,39955,555,340860,40977,45134,52039,140927,102569,52392,302910,34372,15693961000,1463055000,1528250000,2018293000,5042986000,4736842000,3172737000,13229711000,2282119000
Oklahoma,Educational Services,2013,3428,1720,445,475,2640,410,189,3239,189,3695,1720,445,475,2640,425,245,3310,385,105174,2448,2582,5800,11629,14631,23684,51539,51139,2915903000,66265000,55665000,103291000,230675000,366728000,661288000,1352514000,1521967000
Oklahoma,Finance and Insurance,2013,20151,13750,2440,1013,17203,1355,479,19037,1114,33900,13755,2495,1385,17635,3715,2670,24020,9880,279045,22644,14384,12238,50198,47505,49293,152638,117292,15331503000,934008000,608644000,658222000,2258829000,2281352000,2490661000,7375036000,7068136000
Oklahoma,Health Care and Social Assistance,2013,42263,20893,9105,5009,35007,4717,1427,41151,1112,53410,20910,9115,5140,35165,6435,4410,46010,7400,1070494,35458,59677,65325,163074,201031,187310,560559,495333,43633171000,2072026000,2397764000,2513985000,6996117000,6475208000,5728103000,19459831000,23885067000
Oklahoma,Information,2013,3918,1785,550,459,2794,416,181,3391,527,7190,1785,555,495,2835,540,440,3815,3375,138346,975,3176,5122,11767,11764,5923,34786,95894,6879086000,111161000,115843000,214212000,450549000,598950000,353097000,1653526000,4885887000
Oklahoma,Management of Companies and Enterprises,2013,2212,130,55,75,260,415,638,1313,899,2840,130,60,75,265,415,705,1385,1455,167770,0,148,29,53,4825,18145,23725,143044,14864150000,14574000,11460000,2387000,52920000,240845000,1156520000,1459250000,13347397000
Oklahoma,Manufacturing,2013,16499,5900,2815,2339,11054,2904,987,14945,1554,17705,5900,2815,2360,11075,3035,1230,15340,2365,577177,8942,14857,26379,56581,97607,79401,261714,281176,28151102000,361876000,547911000,1052746000,2156421000,4393259000,3881213000,11675634000,15230492000
Oklahoma,"Mining, Quarrying, and Oil and Gas Extraction",2013,13898,8845,1825,1154,11824,1138,349,13311,587,15630,8845,1825,1155,11825,1180,500,13505,2125,289748,8455,11465,15527,41001,43279,40266,125063,162797,25017375000,758469000,733665000,937815000,2435132000,2985697000,2960319000,8412150000,16553764000
Oklahoma,Other,2013,96,91,5,0,96,0,0,96,0,96,91,5,0,96,0,0,96,0,0,62,0,0,0,0,0,0,0,2387000,2099000,0,0,2387000,0,0,2387000,0
Oklahoma,Other Services (except Public Administration),2013,41774,26508,8180,3665,38353,2554,415,41322,452,44730,26560,8245,3800,38605,3325,1235,43165,1565,306475,48834,52281,46940,149657,84592,33008,280176,14466,7491360000,1119106000,1173458000,1114221000,3426837000,2070294000,819537000,6642780000,620723000
Oklahoma,"Professional, Scientific, and Technical Services",2013,44827,31862,6270,2993,41125,1988,701,43814,1013,48025,31885,6280,3115,41280,2305,1625,45210,2815,340917,43337,40459,37180,122191,63722,49500,247959,71327,20261888000,2115400000,1673013000,1937964000,5771978000,3960504000,3439168000,13603553000,5600862000
Oklahoma,Real Estate and Rental and Leasing,2013,16548,12399,1765,798,14962,674,315,15951,597,20050,12430,1785,965,15180,970,735,16885,3165,106116,13221,10982,9489,39859,21479,11615,76844,22516,4607444000,577796000,400066000,309806000,1319956000,864538000,607219000,2953166000,1259381000
Oklahoma,Retail Trade,2013,42391,22354,9083,4681,36118,3450,844,40412,1979,65805,22405,9265,5150,36820,5530,2955,45305,20500,766933,38826,55149,57743,159239,108429,55950,338364,389566,19329866000,1005971000,1341214000,1532495000,3895340000,3724285000,1965621000,9893279000,8804596000
Oklahoma,Total,2013,72599,42298,12481,7411,62190,6572,1702,70464,2135,91717,42350,12583,7818,62751,8823,4894,76468,15249,1325927,72494,82005,98712,253211,245938,200499,699648,626279,54712621000,2584656000,2588868000,3296914000,8470438000,8848205000,8111042000,25429685000,29282936000
Oklahoma,Transportation and Warehousing,2013,11407,6545,1347,1060,8952,931,474,10357,1050,13425,6545,1360,1080,8985,980,785,10750,2675,200220,8998,7799,12291,29954,28233,23030,84677,89901,9505904000,335130000,285058000,485870000,1143683000,1221363000,1103510000,3539827000,4864665000
Oklahoma,Utilities,2013,654,220,95,25,340,135,55,530,124,1855,220,95,25,340,190,155,685,1170,38941,433,288,0,1204,7086,2178,12574,2133,3385740000,17534000,8748000,23806000,66434000,454285000,186822000,838697000,184982000
Oklahoma,Wholesale Trade,2013,18771,7915,2903,2180,12998,2501,1282,16781,1990,23490,7925,2935,2375,13235,3255,2080,18570,4920,294935,11413,17349,25199,57203,64932,41982,182809,98970,16426301000,656527000,808052000,1278499000,2850092000,3274431000,2633365000,9312719000,6420780000
Oregon,Accommodation and Food Services,2013,43244,14924,10235,9593,34752,6988,893,42633,611,53935,14975,10275,9870,35120,8900,3510,47530,6405,765222,24763,66193,129097,219500,228756,107265,563286,192763,13365465000,556932000,923596000,1938981000,3427470000,3947468000,1883825000,9284716000,3809269000
Oregon,Administrative and Support and Waste Management and Remediation Services,2013,24201,15007,3520,2105,20632,1888,617,23137,1064,27150,15015,3530,2160,20705,2050,835,23590,3560,440185,22278,21246,26227,74348,67248,68479,215214,218695,13175840000,739975000,634253000,805376000,2226652000,2174980000,1896717000,6438302000,6510186000
Oregon,"Agriculture, Forestry, Fishing and Hunting",2013,6386,4255,725,605,5585,650,105,6340,46,6550,4255,725,605,5585,675,155,6415,135,56516,5697,4521,8390,18580,22584,8482,53107,2912,2316163000,305002000,181675000,347677000,841645000,876685000,302373000,2096648000,187714000
Oregon,"Arts, Entertainment, and Recreation",2013,8167,4710,1245,930,6885,985,180,8050,117,8610,4710,1255,930,6895,1145,295,8335,275,123058,5927,7346,11637,26900,36842,20380,94769,18363,2920231000,214052000,156439000,240269000,629645000,634327000,635614000,2269338000,314221000
Oregon,Construction,2013,55415,40010,8040,4065,52115,2590,338,55043,372,55945,40015,8040,4070,52125,2770,415,55310,635,340643,60470,51921,52695,167090,88304,28964,292632,34801,17902652000,2149547000,1888842000,2407151000,6461596000,4774407000,2183055000,13918129000,3400775000
Oregon,Educational Services,2013,6816,3310,1050,925,5285,1075,240,6600,216,7535,3310,1055,950,5315,1290,595,7200,335,174090,4741,6534,12437,24359,39348,33097,98359,71465,4489606000,139560000,120852000,240816000,500849000,1007155000,862708000,2414023000,1858241000
Oregon,Finance and Insurance,2013,16398,11040,1955,694,13689,794,570,15053,1345,29285,11060,2005,770,13835,1620,2190,17645,11640,290864,17182,11380,7740,38422,24218,20226,101960,172295,18909759000,744184000,531830000,499462000,1796657000,1567404000,2166384000,5873866000,12498473000
Oregon,Health Care and Social Assistance,2013,50156,27145,10350,5655,43150,4260,1670,49080,1076,63445,27155,10460,5875,43490,6155,6295,55940,7505,1089030,40391,68627,73637,190944,168468,183161,549486,506945,50245020000,2046066000,2541661000,2847911000,7453410000,6274911000,6303557000,20234851000,28585545000
Oregon,Information,2013,6426,3310,846,630,4786,670,292,5748,678,9750,3310,860,660,4830,745,590,6165,3585,177738,3749,5061,7513,18052,21186,20250,69101,79237,11344176000,216137000,209611000,383678000,828921000,1295477000,1369824000,3955867000,7082722000
Oregon,Management of Companies and Enterprises,2013,2635,160,80,105,345,562,786,1693,942,3745,160,80,105,345,580,835,1760,1985,219160,0,43,0,1109,6337,26689,34135,184435,23133230000,23537000,17178000,0,69795000,348850000,1961257000,2380365000,20752865000
Oregon,Manufacturing,2013,24913,10465,4615,3193,18273,3847,1298,23418,1495,26110,10465,4620,3215,18300,4030,1570,23900,2210,689368,15147,23644,35794,85756,133357,109587,371580,245426,35112245000,614999000,951870000,1489615000,3353940000,5910016000,5395216000,16550972000,14987489000
Oregon,"Mining, Quarrying, and Oil and Gas Extraction",2013,585,265,110,95,470,50,15,535,50,710,265,110,95,470,55,15,540,170,6152,351,550,1067,2051,920,0,3418,0,343812000,19399000,23028000,50741000,92050000,48001000,0,183973000,60284000
Oregon,Other,2013,212,206,4,1,211,1,0,212,0,212,206,4,1,211,1,0,212,0,205,0,0,0,0,0,0,205,0,3807000,3406000,174000,0,3620000,0,0,3807000,0
Oregon,Other Services (except Public Administration),2013,44472,28090,8922,4220,41232,2391,409,44032,440,48635,28105,8955,4415,41475,3360,2305,47140,1495,310104,49778,57235,53490,164927,77791,27673,279357,18945,8247372000,1264341000,1356275000,1376913000,4011995000,2119213000,847583000,7273256000,734800000
Oregon,"Professional, Scientific, and Technical Services",2013,56197,39970,7355,3957,51282,2707,852,54841,1356,59000,39975,7360,4090,51425,3110,1095,55630,3370,419779,58594,46247,50567,157244,83079,42294,288195,106709,28930501000,2726191000,2145114000,2583844000,7537855000,5361414000,2932975000,16150993000,11547153000
Oregon,Real Estate and Rental and Leasing,2013,23449,18159,2350,1043,21552,916,414,22882,567,28385,18185,2470,1165,21820,1365,1895,25080,3305,134110,26633,14283,12509,54903,25079,19207,103080,23952,4698375000,829965000,483196000,383453000,1712409000,888660000,652045000,3433854000,1052207000
Oregon,Retail Trade,2013,46795,23780,10305,5513,39598,4005,1173,44776,2019,69575,23830,10490,6205,40525,6730,4630,51885,17690,931832,37514,63560,68042,172103,126557,77437,389017,491979,24431281000,1029595000,1499438000,1715002000,4290890000,4047952000,2303957000,10971559000,12769486000
Oregon,Total,2013,88678,52792,15298,9301,77391,7311,1821,86523,2155,108527,52841,15444,9768,78053,9855,6055,93963,14564,1396563,87986,100258,123262,311506,261102,205047,777655,618908,61062097000,3002917000,3057013000,3973427000,10033357000,9736816000,8358617000,28128790000,32933307000
Oregon,Transportation and Warehousing,2013,12895,7340,1750,1150,10240,1108,548,11896,999,14700,7340,1770,1200,10310,1225,765,12300,2400,244084,8603,10341,13214,35956,34397,24309,98491,108565,10530247000,372680000,407793000,489398000,1315138000,1431618000,1035248000,3933449000,5290195000
Oregon,Utilities,2013,671,390,40,30,460,100,35,595,76,1450,390,40,30,460,160,45,665,785,17774,747,0,361,813,3969,135,5665,14564,2150272000,18671000,0,28677000,58687000,330579000,17051000,424115000,1857284000
Oregon,Wholesale Trade,2013,22519,10645,3069,2328,16042,2813,1469,20324,2195,27060,10655,3100,2425,16180,3305,2240,21725,5335,382724,11108,17702,27345,63964,74389,54783,209409,139263,25364713000,834857000,876059000,1374040000,3205773000,4082837000,3003191000,10996250000,11276707000
Pennsylvania,Accommodation and Food Services,2013,113003,50630,22236,19088,91954,17888,1802,111644,1359,142255,50665,22310,19260,92235,20345,6120,118700,23555,2148274,87132,146739,257441,491245,646821,258813,1399335,716295,33362135000,1778391000,1836450000,3216351000,6832185000,9290648000,3613766000,19753630000,12722609000
Pennsylvania,Administrative and Support and Waste Management and Remediation Services,2013,65589,39550,9825,6118,55493,5650,2047,63190,2399,76405,39585,9845,6215,55645,6260,2995,64900,11505,1532905,52835,64119,81925,204508,211498,257963,678510,834345,51223945000,2504387000,2194922000,3042014000,7749452000,7371036000,7378696000,22615143000,27875352000
Pennsylvania,"Agriculture, Forestry, Fishing and Hunting",2013,2400,1780,370,110,2260,100,25,2385,15,2400,1780,370,110,2260,100,25,2385,15,12543,2782,2166,1217,6523,2407,901,12303,0,415838000,80895000,60928000,43565000,193285000,95159000,34731000,396873000,3793000
Pennsylvania,"Arts, Entertainment, and Recreation",2013,21211,11732,3290,2255,17277,2935,607,20819,392,22510,11735,3295,2290,17320,3120,880,21320,1190,495884,14419,21340,28716,68044,114240,83402,271394,166081,14424037000,614269000,494669000,577444000,1706528000,2294983000,3643519000,7853655000,6369549000
Pennsylvania,Construction,2013,129589,87365,20380,11354,119099,8471,1287,128857,732,130755,87365,20380,11400,119145,8660,1565,129370,1385,1089600,140781,132236,151785,426155,308120,173247,913635,148013,61835215000,5699480000,5613000000,7627290000,18939770000,18357125000,11593385000,49279070000,10805486000
Pennsylvania,Educational Services,2013,16538,6660,2455,2130,11245,3624,920,15789,749,18770,6660,2455,2185,11300,3950,1485,16735,2035,1289020,8979,16220,27893,55777,159110,124398,358812,928679,50231715000,472929000,322799000,666562000,1462361000,4977748000,4621619000,11727880000,38461832000
Pennsylvania,Finance and Insurance,2013,46431,29225,7485,3003,39713,2886,1353,43952,2479,88025,29265,7730,3500,40495,5860,6895,53250,34775,1288623,55060,45831,38293,142462,97665,112930,365206,873734,102975757000,2597870000,2514198000,2821511000,7963850000,7140771000,7181744000,23570388000,72708793000
Pennsylvania,Health Care and Social Assistance,2013,123454,53230,27713,17621,98564,15560,5609,119733,3721,181935,53325,28035,18665,100025,23875,19425,143325,38610,4797925,108929,181726,236366,527306,583519,840998,1954605,2826862,206129750000,4317705000,6989962000,9545771000,20825043000,22781939000,26738462000,70466676000,135537244000
Pennsylvania,Information,2013,12729,5735,1915,1460,9110,1754,541,11405,1324,25490,5745,1920,1545,9210,2120,895,12225,13265,558918,8840,11516,18312,40974,58121,46099,153702,402932,44632619000,442692000,469604000,841301000,1787102000,3337107000,2858882000,8458107000,35783085000
Pennsylvania,Management of Companies and Enterprises,2013,7043,315,85,185,585,1267,2040,3892,3151,11540,315,95,185,595,1290,2200,4085,7455,871435,467,396,1055,2072,17798,69964,89834,781540,84655180000,86935000,47265000,110325000,265150000,958414000,5732716000,6961670000,77693510000
Pennsylvania,Manufacturing,2013,64420,21558,10674,9501,41733,13429,4410,59572,4848,68550,21575,10675,9560,41810,14030,5370,61210,7340,2588149,36313,65687,122543,237264,509937,481135,1292118,1166836,137033768000,1446674000,2437518000,5086998000,9294152000,23665607000,23616858000,59506652000,71687628000
Pennsylvania,"Mining, Quarrying, and Oil and Gas Extraction",2013,4286,1935,645,514,3094,531,258,3883,403,5540,1935,645,525,3105,605,425,4135,1405,164692,2487,4043,6469,14168,19227,21665,56621,101493,13690905000,170746000,183454000,365451000,731716000,1094913000,1448772000,3328942000,9818211000
Pennsylvania,Other,2013,235,230,5,0,235,0,0,235,0,235,230,5,0,235,0,0,235,0,0,0,0,0,0,0,0,0,0,4322000,3938000,384000,0,4322000,0,0,4322000,0
Pennsylvania,Other Services (except Public Administration),2013,167637,104757,36390,15292,156439,8988,1292,166719,918,179245,104820,36600,15910,157330,10955,4040,172325,6920,1191808,207876,232964,198441,641757,307198,115649,1075885,92721,30733328000,4625485000,5068172000,4725632000,14431613000,8141743000,4116675000,26865855000,3408486000
Pennsylvania,"Professional, Scientific, and Technical Services",2013,135704,90045,18930,11532,120507,9456,2608,132571,3133,147155,90090,19015,11830,120935,11410,4075,136420,10735,1602365,137557,122815,149548,414451,320053,215898,962215,613806,116453995000,7187453000,6582795000,9213119000,23019665000,23379489000,16544812000,63299895000,51887665000
Pennsylvania,Real Estate and Rental and Leasing,2013,34993,23465,5168,2463,31096,2061,810,33967,1026,47175,23545,5355,2835,31735,2950,2995,37680,9495,291171,37959,32578,31218,103475,65511,41654,214547,75574,13799024000,1485877000,1200818000,1342019000,4040350000,3139685000,2015915000,9431157000,4394354000
Pennsylvania,Retail Trade,2013,133312,73263,27183,14652,115098,11937,2983,130018,3294,219500,73435,27695,16315,117445,17830,10185,145460,74040,3134577,112864,156797,181211,452368,417005,284854,1189100,1626598,76293636000,3217485000,3930623000,4854031000,12008151000,13844820000,8674838000,35142000000,36796143000
Pennsylvania,Total,2013,229492,129796,41880,25492,197168,22931,5298,225397,4095,297692,129949,42310,26745,199004,29667,15471,244142,53550,5180805,230669,274928,340898,846495,860823,722008,2429326,2751479,237620227000,8156739000,9001438000,12343088000,29501265000,34339897000,30615553000,94456715000,143163512000
Pennsylvania,Transportation and Warehousing,2013,34679,18360,4697,3600,26657,4320,1322,32299,2380,41135,18370,4715,3670,26755,4895,1710,33360,7775,987890,23801,29766,47693,107688,147860,99099,362028,517067,38605453000,1046258000,989933000,1623085000,3693858000,5115780000,3540688000,12598029000,21458263000
Pennsylvania,Utilities,2013,1026,350,120,80,550,180,50,780,246,4060,350,120,80,550,245,125,920,3140,77525,15,427,746,1789,6565,1032,10966,68089,10842039000,24223000,24896000,45069000,121591000,457120000,92477000,775187000,9974149000
Pennsylvania,Wholesale Trade,2013,61131,28006,10158,7326,45490,8179,3428,57097,4034,74840,28035,10270,7645,45950,9835,5945,61730,13110,1224395,45334,64356,94693,212599,254585,210580,696654,493839,79966569000,2622288000,3478725000,5255362000,11388519000,14313116000,11526160000,38278838000,40710499000
Rhode Island,Accommodation and Food Services,2013,12905,5205,2250,2505,9960,2394,188,12542,363,15065,5215,2265,2525,10005,2645,490,13140,1925,216008,7956,14414,34327,57168,82063,21454,160972,55686,3762514000,268687000,205600000,477993000,958871000,1398880000,366218000,2729524000,1038800000
Rhode Island,Administrative and Support and Waste Management and Remediation Services,2013,8049,5410,875,540,6825,520,240,7585,464,8495,5410,880,540,6830,540,255,7625,870,106785,5377,4914,5690,17583,16260,24365,61814,36187,3459620000,338991000,174601000,220459000,769896000,592526000,538313000,2003237000,1100289000
Rhode Island,"Agriculture, Forestry, Fishing and Hunting",2013,220,190,15,5,210,10,0,220,0,220,190,15,5,210,10,0,220,0,311,57,0,0,340,0,0,311,0,24839000,8230000,666000,0,16684000,0,0,24839000,0
Rhode Island,"Arts, Entertainment, and Recreation",2013,2517,1375,410,275,2060,317,65,2442,75,2740,1375,410,280,2065,325,175,2565,175,39861,1461,2318,3209,7929,10425,5038,25752,0,993931000,85489000,94767000,118425000,312635000,248406000,94035000,732930000,0
Rhode Island,Construction,2013,14625,11015,1925,945,13885,575,95,14555,70,14635,11015,1925,945,13885,575,95,14555,80,76531,14036,11721,11462,40609,16617,8417,71622,0,4688453000,767827000,526592000,668959000,2025109000,1114400000,554562000,4201983000,40668000
Rhode Island,Educational Services,2013,1990,990,230,190,1410,330,140,1880,110,2085,995,230,200,1425,380,145,1950,135,131464,1389,1179,2160,4947,11761,12560,31503,96537,4735944000,49487000,25830000,54621000,137488000,403176000,525116000,1117640000,3479016000
Rhode Island,Finance and Insurance,2013,3962,2065,555,245,2865,220,239,3324,638,6515,2065,555,250,2870,295,655,3820,2695,89276,2762,3170,2558,9373,5839,14303,32766,42260,6914469000,188070000,206468000,188326000,616529000,434735000,926752000,2296747000,3746015000
Rhode Island,Health Care and Social Assistance,2013,12438,5100,2900,1675,9675,1430,788,11893,545,16270,5110,2910,1765,9785,1925,2550,14260,2010,422060,9713,18442,21403,50904,58733,105714,220997,183098,17947965000,422317000,812934000,965460000,2218172000,2291516000,3942112000,8641343000,8856771000
Rhode Island,Information,2013,1395,590,200,120,910,180,60,1150,245,2275,590,200,120,910,235,65,1210,1065,31092,406,1065,713,2469,5774,932,12460,16554,1836044000,43021000,46154000,49045000,153062000,281781000,44486000,591889000,1211684000
Rhode Island,Management of Companies and Enterprises,2013,616,30,15,20,65,65,165,295,321,930,30,15,20,65,70,185,320,610,385,76,0,0,224,842,7683,8800,336,25920000,6939000,3000000,5620000,15034000,67232000,383548000,468370000,23311000
Rhode Island,Manufacturing,2013,7095,2704,1295,1066,5065,1391,346,6802,293,7210,2705,1310,1075,5090,1420,380,6890,320,155627,3044,6214,10655,23189,42971,20469,111195,26361,8253512000,171033000,251668000,440312000,975178000,1942149000,1087606000,5127182000,1848540000
Rhode Island,"Mining, Quarrying, and Oil and Gas Extraction",2013,80,35,15,20,70,5,0,75,5,85,35,15,20,70,5,0,75,10,237,0,60,0,83,0,0,416,0,39814000,2003000,5490000,14490000,24070000,0,0,29586000,0
Rhode Island,Other,2013,40,38,1,0,39,1,0,40,0,40,38,1,0,39,1,0,40,0,0,0,0,0,0,0,0,0,0,726000,600000,0,0,714000,0,0,726000,0
Rhode Island,Other Services (except Public Administration),2013,13606,8815,2720,1081,12616,655,105,13376,230,14320,8820,2725,1095,12640,915,120,13675,645,81753,15353,16764,12368,46780,19835,473,73105,5569,2445048000,455680000,455432000,357380000,1301393000,644115000,22134000,2179781000,167561000
Rhode Island,"Professional, Scientific, and Technical Services",2013,14382,9780,1985,975,12740,777,260,13777,605,14985,9780,1985,985,12750,810,280,13840,1145,108782,13543,12305,10691,39187,21019,10088,76145,23053,6619728000,757649000,688041000,751765000,2247138000,1436893000,698674000,4747983000,1703326000
Rhode Island,Real Estate and Rental and Leasing,2013,4462,3155,493,260,3908,233,88,4229,233,5300,3155,520,270,3945,370,210,4525,775,25791,2335,2928,2749,10674,6003,1818,20041,2672,1066652000,196372000,120710000,131386000,480180000,236664000,40323000,789227000,169226000
Rhode Island,Retail Trade,2013,14208,7975,2529,1314,11818,799,354,12971,1237,18805,7990,2610,1390,11990,955,735,13680,5125,223575,10381,13933,14182,42810,18050,10091,80346,92161,6042296000,373654000,404067000,404695000,1251296000,765054000,494455000,2727974000,2175326000
Rhode Island,Total,2013,23965,13823,3941,2414,20178,2155,597,22930,1035,28026,13834,3980,2478,20292,2532,1351,24175,3851,408489,23137,25800,32108,81045,77257,65349,223651,184838,17783511000,941882000,931602000,1188774000,3062258000,3019318000,2812909000,8894485000,8889026000
Rhode Island,Transportation and Warehousing,2013,2877,1735,345,213,2293,249,85,2627,250,3045,1735,345,220,2300,260,90,2650,395,40743,1692,1684,1814,5541,5710,2712,18164,9328,1482627000,95754000,60061000,67991000,262376000,224479000,123449000,723392000,434663000
Rhode Island,Utilities,2013,94,30,10,20,60,0,0,60,34,200,30,10,25,65,0,0,65,135,2748,0,0,224,294,0,0,294,1852,303451000,1190000,0,33635000,37878000,0,0,37878000,195484000
Rhode Island,Wholesale Trade,2013,6323,2735,970,650,4355,872,303,5530,793,6750,2735,970,660,4365,920,325,5610,1140,87091,3527,4693,6843,17699,20613,8331,56936,24022,5924386000,233851000,286298000,415157000,1029787000,1175125000,528958000,3368712000,1977332000
South Carolina,Accommodation and Food Services,2013,36745,12590,6860,7616,27066,7553,1161,35780,965,49580,12620,6885,7680,27185,8550,4315,40050,9530,937548,20129,46204,104468,171248,275884,161471,611622,316246,14541142000,479552000,570597000,1385711000,2436882000,4107347000,2232413000,8824709000,5237786000
South Carolina,Administrative and Support and Waste Management and Remediation Services,2013,24122,14250,3635,2189,20074,2054,754,22882,1240,27460,14255,3645,2210,20110,2205,950,23265,4195,780134,22314,22542,27508,75890,74753,97383,255772,504198,22674376000,682555000,645415000,826265000,2198659000,2220001000,2363154000,7072150000,14926993000
South Carolina,"Agriculture, Forestry, Fishing and Hunting",2013,2460,1220,630,380,2230,165,35,2430,30,2475,1220,630,380,2230,165,45,2440,35,17652,1990,4065,4434,11103,4452,1188,18110,51,671565000,78323000,151253000,166343000,411150000,174166000,47519000,660273000,12059000
South Carolina,"Arts, Entertainment, and Recreation",2013,7151,3875,935,803,5613,1110,294,7017,134,7810,3880,945,820,5645,1230,585,7460,350,123985,4973,6002,10408,22089,42883,31805,100586,13967,2261134000,167476000,121342000,190402000,489034000,787184000,620949000,1944053000,238566000
South Carolina,Construction,2013,42961,27570,7340,4445,39355,2875,375,42605,356,43625,27575,7340,4455,39370,2935,520,42825,800,329819,44040,47310,58002,152065,99356,30440,290805,24607,13892774000,1522146000,1604577000,2168518000,5313265000,4199724000,1600478000,11561060000,1456107000
South Carolina,Educational Services,2013,5308,2585,813,705,4103,825,160,5088,220,5675,2590,815,725,4130,865,245,5240,435,152603,3197,4590,8623,17889,33054,25942,79242,72311,3749800000,108377000,81384000,174149000,371190000,794196000,829716000,2043793000,1676690000
South Carolina,Finance and Insurance,2013,16191,10311,2412,912,13635,772,515,14922,1269,35715,10340,2570,1240,14150,2245,3270,19665,16050,328474,15955,14698,11018,43642,23768,36028,107390,213309,18807307000,767834000,601299000,577039000,1978699000,1195896000,1836948000,5193316000,13342246000
South Carolina,Health Care and Social Assistance,2013,37940,16525,9118,5548,31191,4319,1226,36736,1204,49040,16550,9165,5775,31490,5610,3520,40620,8420,1061497,30570,59854,73834,165143,163739,162594,496330,559518,44995727000,1498972000,2347021000,2931563000,6802544000,6344762000,4822530000,18149450000,26622400000
South Carolina,Information,2013,3502,1675,400,265,2340,365,172,2877,625,6630,1675,400,280,2355,470,315,3140,3490,150085,1684,1771,3090,7624,10169,3850,26118,116100,8176082000,127664000,61994000,125206000,340500000,523225000,315488000,1327003000,6500048000
South Carolina,Management of Companies and Enterprises,2013,2167,125,40,66,231,342,632,1205,962,3200,125,40,70,235,350,650,1235,1965,131740,152,20,401,779,3356,16747,20991,110665,10589350000,14929000,22056000,15370000,55294000,203955000,1030974000,1290223000,9294015000
South Carolina,Manufacturing,2013,17713,6080,2495,2335,10910,2938,1468,15316,2397,19060,6080,2495,2335,10910,3110,1690,15710,3350,920921,7090,13235,26302,53239,98229,136050,335263,523164,46353745000,355887000,457502000,1048074000,2068518000,4180569000,6114153000,14555348000,27796042000
South Carolina,"Mining, Quarrying, and Oil and Gas Extraction",2013,279,115,30,35,180,30,15,225,54,390,115,30,35,180,30,15,225,165,4507,43,72,344,575,603,0,1860,2058,245115000,8047000,13504000,15745000,40430000,30716000,0,98939000,127331000
South Carolina,Other,2013,121,118,3,0,121,0,0,121,0,121,118,3,0,121,0,0,121,0,0,0,17,0,0,0,0,0,0,2145000,1920000,225000,0,2145000,0,0,2145000,0
South Carolina,Other Services (except Public Administration),2013,52145,31985,11306,4681,47972,3144,513,51629,516,55565,31985,11360,4815,48160,4055,955,53170,2395,396276,61125,72698,60474,195657,108580,38699,350416,36555,9690148000,1358073000,1554389000,1450892000,4387245000,2440972000,991603000,7995655000,1572622000
South Carolina,"Professional, Scientific, and Technical Services",2013,45524,32090,6010,3198,41298,2166,793,44257,1267,49530,32090,6030,3310,41430,2795,1395,45620,3910,407761,45306,38123,40011,130861,66776,47283,250667,146160,25294714000,2185868000,1689242000,1958822000,5861325000,4141492000,3263061000,13492054000,11494874000
South Carolina,Real Estate and Rental and Leasing,2013,18994,14695,1600,864,17159,704,480,18343,651,23755,14725,1695,965,17385,1120,1050,19555,4200,114595,19056,9425,9423,39833,20317,20038,81985,27060,4328771000,762137000,344992000,394402000,1520724000,728741000,715707000,3018480000,1249851000
South Carolina,Retail Trade,2013,53075,31464,10196,4900,46560,3479,947,50986,2089,88385,31570,10480,5625,47675,5780,3585,57040,31345,1035231,52423,61283,54951,178477,114893,53119,354959,617595,24475752000,1326278000,1481766000,1581884000,4503800000,3929483000,1613587000,10241335000,13609974000
South Carolina,Total,2013,77942,44606,13628,8327,66561,7039,1928,75528,2414,101545,44666,13808,8755,67229,9117,5198,81544,20001,1583213,77426,89216,110418,277060,255732,210470,743262,839951,59301204000,2526569000,2630521000,3422363000,8579453000,8382846000,7346957000,24309256000,34991948000
South Carolina,Transportation and Warehousing,2013,10560,5722,1325,800,7847,878,611,9336,1224,12360,5725,1335,820,7880,950,815,9645,2715,255500,6344,7307,8898,26576,23346,25423,80266,147537,10293888000,288991000,255440000,320825000,888540000,899273000,1028126000,2926512000,6236455000
South Carolina,Utilities,2013,459,125,60,50,235,90,70,395,64,1805,125,60,50,235,130,180,545,1260,48454,86,225,506,1182,4285,6874,12411,0,3916271000,6290000,12587000,23165000,45411000,252390000,440021000,743085000,59873000
South Carolina,Wholesale Trade,2013,20357,9484,3080,2109,14673,2434,1188,18295,2062,25060,9495,3105,2185,14785,2990,1890,19665,5395,318625,14543,18425,23110,61809,62864,41530,181941,118795,16847559000,777689000,863917000,1146361000,2917993000,3200316000,2133539000,8787655000,7651390000
South Dakota,Accommodation and Food Services,2013,10151,3910,1740,2024,7674,1900,305,9879,272,11860,3910,1760,2085,7755,2190,810,10755,1105,193898,5452,11296,27342,44768,66514,37595,149340,42403,2850938000,168975000,124814000,321282000,621182000,929531000,605213000,2169458000,679977000
South Dakota,Administrative and Support and Waste Management and Remediation Services,2013,5111,3250,860,312,4422,263,100,4785,326,5370,3250,860,335,4445,285,120,4850,520,48338,3546,5074,3159,13587,7953,3717,28314,13151,1479394000,169541000,145769000,69769000,410121000,253851000,85162000,858427000,432550000
South Dakota,"Agriculture, Forestry, Fishing and Hunting",2013,735,625,55,35,715,5,10,730,5,735,625,55,35,715,5,10,730,5,1763,573,258,0,1610,0,0,1728,0,67072000,34497000,10460000,9295000,60476000,0,0,66197000,0
South Dakota,"Arts, Entertainment, and Recreation",2013,3103,1920,510,320,2750,243,55,3048,55,3325,1920,510,335,2765,325,60,3150,175,27048,2079,3117,3184,9294,7787,2206,23643,1063,494957000,84984000,51961000,56778000,216597000,150133000,29990000,452936000,27279000
South Dakota,Construction,2013,15966,11235,2645,1165,15045,740,116,15901,65,16075,11235,2645,1170,15050,740,175,15965,110,89092,16270,16365,13568,50020,23519,5125,85812,1598,4130363000,703820000,635652000,616167000,2025895000,1284350000,267577000,3929093000,95445000
South Dakota,Educational Services,2013,1100,505,145,115,765,195,85,1045,55,1145,505,145,115,765,205,85,1055,90,37814,555,627,839,2682,7421,14013,25792,11995,905671000,16835000,12508000,14289000,51173000,143703000,395753000,634922000,269579000
South Dakota,Finance and Insurance,2013,6190,3950,747,403,5100,348,196,5644,546,9755,3955,770,605,5330,770,1145,7245,2510,125604,5895,4030,4759,15246,8870,15367,43165,73197,6187965000,245011000,168373000,216052000,650428000,440597000,861082000,2102146000,3669704000
South Dakota,Health Care and Social Assistance,2013,9055,4105,1730,1195,7030,1163,554,8747,308,11465,4135,1745,1245,7125,1810,1580,10515,950,318697,6501,10379,14019,33575,42514,61454,145109,167024,13519830000,305025000,375510000,614062000,1335052000,1551659000,2014861000,5039149000,8129175000
South Dakota,Information,2013,1524,655,215,160,1030,188,87,1305,219,2235,655,220,160,1035,280,275,1590,645,27246,637,1159,1278,3503,5198,2475,11531,7079,1303669000,30631000,29457000,49140000,119454000,207338000,94196000,637840000,451847000
South Dakota,Management of Companies and Enterprises,2013,646,20,15,10,45,145,235,425,221,735,20,15,10,45,150,235,430,305,24255,0,110,0,187,1338,4229,5880,18213,1907870000,0,3495000,0,6846000,106632000,314527000,439300000,1441632000
South Dakota,Manufacturing,2013,4717,1795,725,585,3105,789,326,4220,497,5060,1795,725,590,3110,830,450,4390,670,162298,1939,3226,4404,12056,25142,19905,72487,70129,6911518000,89854000,111461000,183355000,448224000,1035262000,748498000,2824544000,3059308000
South Dakota,"Mining, Quarrying, and Oil and Gas Extraction",2013,280,135,35,20,190,37,19,246,34,330,135,35,20,190,40,45,275,55,4121,170,48,32,447,244,772,2936,0,242458000,9738000,5763000,1879000,27846000,13467000,53770000,181377000,24694000
South Dakota,Other,2013,41,40,0,0,40,1,0,41,0,41,40,0,0,40,1,0,41,0,45,25,0,0,25,0,0,45,0,497000,426000,0,0,426000,0,0,497000,0
South Dakota,Other Services (except Public Administration),2013,13118,8710,2545,1075,12330,572,105,13007,111,13605,8715,2555,1140,12410,770,160,13340,265,70976,15053,15720,13196,47010,17202,2221,68812,1010,1613666000,350723000,369957000,304082000,1048450000,374859000,55192000,1551978000,31850000
South Dakota,"Professional, Scientific, and Technical Services",2013,9077,6005,1375,745,8125,450,129,8704,373,9555,6005,1390,770,8165,590,160,8915,640,55028,7514,8418,8749,27156,10367,3022,44110,9137,2472415000,361482000,329668000,384231000,1110187000,529069000,187226000,1955125000,450548000
South Dakota,Real Estate and Rental and Leasing,2013,4194,3155,428,200,3783,163,98,4044,150,4915,3155,455,210,3820,235,510,4565,350,17285,1233,2352,2006,9290,3572,2009,15651,1356,581359000,125102000,70629000,65642000,283757000,123710000,64522000,494921000,68608000
South Dakota,Retail Trade,2013,14686,6649,3339,1987,11975,1309,466,13750,936,19445,6670,3410,2105,12185,1970,1505,15660,3785,226175,9736,19192,23966,57203,37507,23953,130089,81068,5525501000,313438000,492490000,574961000,1422451000,1142585000,670647000,3506439000,1725558000
South Dakota,Total,2013,21746,12531,3707,2276,18514,1863,543,20920,826,26021,12546,3757,2420,18723,2613,1669,23005,3016,340485,21014,24277,30023,75314,66486,58280,200080,140405,12355238000,685524000,688604000,893429000,2267557000,2170303000,2079673000,6517533000,5837705000
South Dakota,Transportation and Warehousing,2013,5514,3655,695,460,4810,276,157,5243,271,5925,3655,695,480,4830,300,210,5340,585,44642,5024,3636,4642,14629,7464,3651,29753,12997,1766561000,186588000,131248000,173260000,540884000,280524000,147455000,1100215000,572325000
South Dakota,Utilities,2013,363,60,50,70,180,95,10,285,78,795,60,50,70,180,170,50,400,395,9676,0,180,809,1453,2751,0,5356,56,742492000,0,8400000,59035000,80543000,183676000,0,347290000,3946000
South Dakota,Wholesale Trade,2013,5677,2130,740,584,3454,998,457,4909,768,7570,2130,745,620,3495,1395,760,5650,1920,89019,2708,3156,5222,13611,22902,15037,61089,19072,4346125000,131937000,160912000,249642000,601271000,1000361000,832041000,2832907000,1070590000
Tennessee,Accommodation and Food Services,2013,41575,14046,7973,8094,30113,9080,1144,40337,1238,60830,14125,8005,8225,30355,10895,4715,45965,14865,1235837,22476,53024,109953,186735,324615,160806,673557,551688,19061849000,552890000,693878000,1502851000,2750690000,4874102000,2308209000,9950855000,8911886000
Tennessee,Administrative and Support and Waste Management and Remediation Services,2013,27403,14820,4235,2750,21805,2790,1013,25608,1795,33605,14825,4270,2805,21900,3015,1380,26295,7310,1130447,22772,26321,35601,86343,107889,119045,325124,792022,33708260000,912008000,843298000,1196672000,3018500000,3910832000,3577666000,10855578000,22538463000
Tennessee,"Agriculture, Forestry, Fishing and Hunting",2013,1170,760,225,90,1075,45,30,1150,20,1180,760,225,95,1080,45,30,1155,25,7329,1135,1371,962,3812,915,0,6924,0,232929000,47434000,41669000,28504000,125064000,23993000,32374000,221037000,2703000
Tennessee,"Arts, Entertainment, and Recreation",2013,11421,6545,1880,1365,9790,1168,257,11215,206,11975,6545,1885,1365,9795,1235,375,11405,570,154471,7183,10789,17497,40602,42578,21546,111065,36225,6185519000,563475000,446810000,1005512000,2082055000,1290848000,945248000,4856412000,730655000
Tennessee,Construction,2013,45825,27080,8380,4969,40429,4296,650,45375,450,46640,27080,8380,4975,40435,4390,860,45685,955,499860,45669,55283,66683,170582,159529,73705,407835,71058,23252660000,1664080000,2015715000,2756189000,6436360000,7983336000,3892612000,18573110000,3688839000
Tennessee,Educational Services,2013,6151,2665,910,800,4375,1036,415,5826,325,6600,2670,910,835,4415,1125,455,5995,605,274908,3867,5853,10442,21038,42816,70757,136214,139709,9268203000,148592000,138535000,214111000,512918000,1182208000,2354261000,4125950000,5201848000
Tennessee,Finance and Insurance,2013,22438,13830,2988,1235,18053,1702,920,20675,1763,48515,13845,3230,1735,18810,5130,5380,29320,19195,534953,23159,17888,14966,59038,60224,70984,200299,324260,35748452000,1152125000,884626000,1012713000,3084326000,4684032000,4044416000,12688909000,22517101000
Tennessee,Health Care and Social Assistance,2013,55595,23995,13781,7891,45667,6105,2062,53834,1761,76045,24040,13845,8240,46125,8250,6400,60775,15270,1949236,49633,90161,103695,245324,229571,306265,786033,1126152,84637384000,2325660000,3526266000,4423850000,10325710000,10255969000,11441916000,32200093000,51506818000
Tennessee,Information,2013,7011,3290,1105,706,5101,714,336,6151,860,11940,3295,1105,720,5120,815,650,6585,5355,243059,3383,6089,7466,17632,21315,12650,61299,153906,12640629000,236276000,282513000,321264000,883396000,1174548000,599967000,3160698000,8973829000
Tennessee,Management of Companies and Enterprises,2013,3700,160,25,105,290,600,1051,1941,1759,7230,160,25,105,290,605,1070,1965,5265,410025,14,100,510,906,5870,34815,41690,368334,42776325000,19888000,7175000,52465000,79768000,608870000,2415703000,3114495000,39661786000
Tennessee,Manufacturing,2013,26351,8845,4120,3460,16425,4657,2104,23186,3165,28250,8845,4125,3475,16445,4880,2500,23825,4425,1323516,13415,22741,40288,83937,163651,170787,467991,749975,64328332000,550726000,830072000,1618611000,3207936000,7111951000,7411340000,19717378000,39083608000
Tennessee,"Mining, Quarrying, and Oil and Gas Extraction",2013,666,255,105,75,435,75,50,560,106,1045,255,105,75,435,80,105,620,425,7667,283,266,714,1537,1529,2490,6400,0,546461000,16110000,18705000,28790000,82259000,88656000,158776000,325996000,0
Tennessee,Other,2013,150,145,4,1,150,0,0,150,0,150,145,4,1,150,0,0,150,0,132,98,23,0,132,0,0,132,0,3521000,2963000,342000,0,3521000,0,0,3521000,0
Tennessee,Other Services (except Public Administration),2013,64889,39800,13320,5972,59092,4445,759,64296,593,70480,39805,13360,6385,59550,5695,1585,66830,3650,536910,72202,84709,77412,239412,160843,64657,470079,39943,13628537000,1775326000,1933095000,1932335000,5659377000,3898305000,1537967000,11275516000,1851188000
Tennessee,"Professional, Scientific, and Technical Services",2013,49796,32440,7180,4270,43890,3172,1115,48177,1619,54540,32445,7200,4415,44060,3845,1610,49515,5025,506310,46410,45797,54588,157489,95750,73445,333102,162826,31163265000,2482935000,2169828000,2890455000,7599142000,6090492000,4784143000,18751026000,11793105000
Tennessee,Real Estate and Rental and Leasing,2013,19126,13160,2608,1098,16866,971,566,18403,723,27475,13190,2660,1185,17035,1555,2410,21000,6475,150127,20234,15624,12529,50190,28205,22046,107531,38247,6241608000,744012000,584713000,526940000,1892694000,1073797000,903666000,4149544000,1876627000
Tennessee,Retail Trade,2013,68028,38971,13523,6642,59136,5176,1162,65474,2554,111745,39070,13880,7345,60295,8095,4420,72810,38935,1440436,67945,86882,82898,243712,172662,88806,518812,844630,36532970000,1648216000,2051991000,2352724000,6094639000,6191779000,3229401000,15892178000,19370188000
Tennessee,Total,2013,96308,51945,17744,10812,80501,9941,2761,93203,3105,130819,52020,17956,11404,81380,13229,7646,102255,28564,2394068,95306,116715,143800,355821,364527,316812,1037160,1356908,99010880000,3344425000,3732092000,5073088000,12149605000,14035849000,12935728000,39121182000,59889698000
Tennessee,Transportation and Warehousing,2013,15169,6970,2422,1655,11047,1517,893,13457,1712,19940,6975,2430,1675,11080,1650,1150,13880,6060,496019,10007,14862,19813,47925,48513,51487,153756,316179,21918615000,411134000,542529000,715309000,1703776000,1852080000,2305702000,6276712000,14948024000
Tennessee,Utilities,2013,294,45,15,20,80,100,50,230,64,720,45,15,20,80,205,225,510,210,14203,0,0,225,337,5211,6155,11941,1655,903923000,1726000,0,10057000,13230000,311777000,410181000,756736000,116628000
Tennessee,Wholesale Trade,2013,27364,11393,4046,3211,18650,3818,1935,24403,2961,34590,11400,4105,3340,18845,4635,2910,26390,8200,543092,18077,24966,37504,86172,106839,82090,292184,236887,31206871000,1126249000,1289208000,2123242000,4742989000,5885969000,5076481000,16289953000,14374445000
Texas,Accommodation and Food Services,2013,172360,62988,32992,32521,128501,37567,3994,170062,2298,250470,63340,33260,33045,129645,44125,18340,192110,58360,5108700,102565,218181,440490,761309,1391061,647266,2802750,2192177,82236850000,2854520000,2965260000,6187700000,12007480000,21244443000,9933954000,43205150000,39028589000
Texas,Administrative and Support and Waste Management and Remediation Services,2013,111206,61770,17185,11260,90215,12310,4597,107122,4084,133630,61800,17245,11480,90525,13415,6050,109990,23640,4696890,95767,112621,148820,363584,483637,702508,1559112,3135979,164614675000,4568571000,4164247000,5767806000,14569140000,17969640000,22611372000,55290116000,109212713000
Texas,"Agriculture, Forestry, Fishing and Hunting",2013,5095,3555,845,345,4745,215,95,5055,40,5310,3555,845,345,4745,220,270,5235,75,31406,5128,5178,4272,14767,6861,5242,27536,3776,1128059000,202894000,200425000,160699000,576173000,223711000,160512000,1001844000,120730000
Texas,"Arts, Entertainment, and Recreation",2013,29146,16060,4595,3806,24461,3417,812,28690,456,32565,16060,4625,3905,24590,3660,1215,29465,3100,622078,19537,29697,44960,94023,129628,119024,364570,221509,16790706000,948836000,657161000,1011361000,2627096000,2591544000,4812503000,10322356000,4467877000
Texas,Construction,2013,192743,112565,34115,21430,168110,19462,3466,191038,1705,197040,112585,34120,21470,168175,20020,4665,192860,4180,2939210,192985,224885,288194,706840,763510,535996,2011485,922864,151885845000,8417780000,8719790000,12499985000,29637555000,37422600000,29730930000,96950880000,54569722000
Texas,Educational Services,2013,28642,13713,4660,3915,22288,4493,1151,27932,710,32090,13720,4665,3975,22360,5060,1945,29365,2725,858737,19481,30308,53690,107359,180490,163523,455737,387810,30065582000,684035000,644136000,1046734000,2392885000,4990277000,5794115000,13246618000,16164951000
Texas,Finance and Insurance,2013,97714,66503,13603,5504,85610,5908,2665,94183,3531,199450,66610,13990,6745,87345,13320,13685,114350,85100,2439189,114256,84963,70366,273934,212104,277040,772718,1609024,176594586000,5790400000,4447823000,4895340000,15225318000,15675988000,19213773000,51136113000,123932570000
Texas,Health Care and Social Assistance,2013,255869,124658,58864,35108,218630,26805,7055,252490,3379,314015,124765,59095,36260,220120,34900,18670,273690,40325,6804056,218167,389397,465718,1081132,1034915,1136506,3260536,3471909,285794301000,14920100000,16538744000,18744161000,50239842000,38005140000,35231596000,123731616000,161536697000
Texas,Information,2013,22851,11715,3170,2178,17063,2734,1159,20956,1895,44725,11725,3180,2235,17140,3230,2200,22570,22155,1129832,17304,20180,26597,67033,93115,99558,270198,849422,81584712000,1028830000,1003833000,1476873000,3552323000,6036692000,7184848000,17062093000,63999324000
Texas,Management of Companies and Enterprises,2013,12775,1076,326,455,1857,2373,3454,7684,5091,22975,1085,330,455,1870,2460,3680,8010,14965,1487555,1397,1595,3286,6278,31885,114280,152455,1335100,188826660000,240577000,127495000,298826000,666898000,2327305000,11721795000,14717290000,174109370000
Texas,Manufacturing,2013,89237,33350,15105,12765,61220,16029,5662,82911,6326,97685,33355,15110,12830,61295,16560,6780,84635,13050,3845256,54367,94678,163949,328604,622325,636275,1650205,2029127,223739015000,2543724000,3501084000,6981986000,13433112000,29478981000,31135383000,76992550000,137069732000
Texas,"Mining, Quarrying, and Oil and Gas Extraction",2013,35403,20072,4659,3514,28245,4671,1366,34282,1121,42230,20090,4665,3545,28300,4970,1990,35260,6970,1174039,31282,30827,47037,109357,180305,185529,477189,694450,119551745000,2613037000,2118704000,3249913000,8002671000,14525967000,17931424000,40554794000,78978468000
Texas,Other,2013,797,770,22,5,797,0,0,797,0,797,770,22,5,797,0,0,797,0,819,0,0,0,819,0,0,819,0,21342000,18447000,0,0,21342000,0,0,21342000,0
Texas,Other Services (except Public Administration),2013,223196,132650,45746,24016,202412,16787,2518,221717,1479,246575,132855,45955,25205,204015,21835,6030,231880,14695,2159611,249814,297156,316355,864841,612724,296159,1780491,320743,61956200000,6482305000,7325565000,7956046000,21770425000,15457470000,8359449000,45796030000,14241793000
Texas,"Professional, Scientific, and Technical Services",2013,293672,209508,36853,21322,267683,16794,4607,289084,4588,319900,209570,37045,21975,268590,19610,8495,296695,23205,3235525,312156,240955,280566,837880,591473,446244,1884970,1317920,256296560000,19275775000,13471975000,17288630000,50052520000,44415882000,34738826000,129625165000,125879362000
Texas,Real Estate and Rental and Leasing,2013,98509,73298,11976,5258,90532,4541,1858,96931,1578,134800,73415,12195,5860,91470,7470,8160,107100,27700,857026,112989,75627,67330,255977,151741,140758,553845,297866,42040433000,4509646000,2954876000,3020416000,10499665000,7430521000,7515234000,25550395000,16016267000
Texas,Retail Trade,2013,226102,133615,45376,23533,202524,15768,4079,222371,3731,395420,134245,46590,26130,206965,26290,17205,250460,144960,5441642,225583,280364,296717,809752,546786,431778,1840003,3351391,141222868000,6698957000,7160513000,8348980000,22257968000,19398859000,18067705000,60187095000,78907504000
Texas,Total,2013,411538,237169,72447,45592,355208,41076,9661,405945,5593,547190,237620,73245,47854,358719,53101,27589,439409,107781,9663567,407844,475380,609173,1492397,1560419,1354315,4407131,5256436,468417086000,18373851000,17266701000,22834597000,58475149000,63674085000,62048711000,184197945000,284219141000
Texas,Transportation and Warehousing,2013,68246,37360,10344,7166,54870,6668,2912,64450,3796,87505,37410,10395,7345,55150,7565,5410,68125,19380,1712892,54694,65525,92031,218387,221596,223757,683861,860628,83703586000,2614485000,2508882000,3792640000,8974590000,10094262000,11305726000,31130430000,47073045000
Texas,Utilities,2013,4944,2665,870,360,3895,473,220,4588,356,9865,2665,875,360,3900,580,640,5120,4745,247532,5342,5344,4502,15582,20625,27536,64968,182025,22521508000,221849000,253018000,273783000,777860000,1410486000,2311017000,4662532000,17790037000
Texas,Wholesale Trade,2013,129175,65274,21517,14961,101752,15346,6048,123146,6029,165715,65400,21930,16080,103410,20215,12515,136140,29575,2503520,109598,139359,191733,446454,485515,409922,1356117,1077085,167327375000,6765807000,7204147000,10576419000,24740795000,28311271000,24834889000,78218433000,86272854000
United States,Accommodation and Food Services,2013,2525168,1008516,500101,478333,1986950,480135,46158,2513243,11925,3369050,1010755,502050,484785,1997590,560810,205485,2763885,605165,61976935,1689146,3336640,6510215,11536045,17576970,8154561,37273940,23156208,1081694080000,43224480000,46048620000,92016746000,181290010000,281099525000,134422963000,597001550000,484613043000
United States,Administrative and Support and Waste Management and Remediation Services,2013,1650302,1062662,240916,145540,1449118,138879,40861,1628858,21444,1966770,1063410,241730,148685,1453825,156890,70025,1680740,286030,50926485,1581523,1580231,1956590,5137005,5500645,6981196,17619010,33188935,1829823620000,65262290000,53252185000,69760615000,188275090000,198777205000,218855137000,605919130000,1223283101000
United States,"Agriculture, Forestry, Fishing and Hunting",2013,107098,74346,17360,8280,99986,5608,1047,106641,457,110555,74360,17370,8315,100045,5950,2250,108245,2310,772359,100909,113401,107887,330014,197822,133529,663939,102567,29130066000,4394235000,3998705000,4113090000,12506030000,7669478000,4332600000,24530291000,4425868000
United States,"Arts, Entertainment, and Recreation",2013,585967,371733,75555,57123,504411,63426,13618,581455,4512,634760,371955,75960,58210,506125,69805,23200,599130,35630,10560000,425027,497644,770055,1753185,2534820,2290600,6578605,3889325,339907950000,41553705000,14306440000,18661815000,74524580000,56200735000,86906000000,217631315000,119904971000
United States,Construction,2013,3235731,2209370,498200,282744,2990314,212426,26615,3229355,6376,3292415,2209485,498375,283350,2991210,219900,40130,3251240,41175,27350905,3437185,3258710,3772985,10468880,7930110,4232955,22631945,4690135,1469997450000,139153615000,132573280000,177806985000,449533880000,435859680000,264844095000,1150237655000,318900889000
United States,Educational Services,2013,433254,212983,67529,55245,335757,72738,17681,426176,7078,490520,213170,67810,56755,337735,82265,30245,450245,40275,17567345,335290,453410,753115,1541815,3035450,3083805,7661070,9895367,622357685000,11104080000,10062320000,16482275000,37648675000,88258970000,110001755000,235909400000,386391968000
United States,Finance and Insurance,2013,1184176,846895,166492,67899,1081286,67883,22075,1171244,12932,2361210,848470,172175,83915,1104560,166510,177500,1448570,912640,30313751,1408146,1053103,892567,3390315,2692804,3458769,9590160,20671227,2687983593000,73590892000,60167407000,67175745000,200930856000,219087809000,284295468000,704435694000,1982422631000
United States,Health Care and Social Assistance,2013,3279105,1669011,724529,415462,2809002,324125,104654,3237781,41324,4218015,1671420,729695,435475,2836590,456055,341525,3634170,583845,92887390,2980076,4799508,5519480,13360317,12697686,16515118,42575530,50288027,4161534710000,155234790000,196798290000,233003982000,585110055000,500669595000,564487636000,1650292800000,2511241910000
United States,Information,2013,362846,218267,50428,36679,305374,38778,11129,355281,7565,678135,218595,50790,38370,307755,51935,30310,390000,288135,16330420,310880,331680,490141,1139710,1501325,1709598,4355325,11938987,1366483755000,22926730000,16397670000,26368960000,65776580000,97343240000,132120822000,295567330000,1068980895000
United States,Management of Companies and Enterprises,2013,134178,13619,3597,5249,22465,29360,44054,95879,38299,264545,13720,3695,5320,22735,30350,48660,101745,162800,15493810,16957,16539,32970,66965,366140,1449430,1882535,13611275,1628995680000,2417705000,1371770000,2577770000,6367245000,24827870000,111336610000,142531725000,1486463955000
United States,Manufacturing,2013,1290465,523432,232056,189612,945100,238227,69046,1252373,38092,1460470,523625,232335,190840,946800,253290,104065,1304155,156315,56307553,963426,1546086,2586937,5109282,9629001,10539669,25297822,30812779,3056166865000,38900135000,56198732000,105366787000,200557172000,440730214000,516189531000,1158377073000,1890955233000
United States,"Mining, Quarrying, and Oil and Gas Extraction",2013,110869,63136,16020,12018,91174,13378,3871,108423,2446,143600,63200,16135,12380,91715,15690,7885,115290,28310,3654162,98363,106090,161764,367781,509490,558564,1441772,2207259,323373725000,6856703000,6296417000,10490291000,23680938000,37012440000,46722152000,107828018000,215351489000
United States,Other,2013,12145,11759,303,66,12128,17,0,12145,0,12145,11759,303,66,12128,17,0,12145,0,0,0,1887,799,0,454,0,0,0,266500000,226023000,27046000,10646000,263715000,2785000,0,266500000,0
United States,Other Services (except Public Administration),2013,3361156,2154876,666390,313363,3134629,196864,22406,3353899,7257,3672030,2156665,671210,328405,3156280,259350,85365,3500995,171035,26383609,4046360,4321077,4117495,12493160,7051415,3131570,22681700,3407636,766541735000,100642405000,106193185000,109350600000,316186190000,200024770000,110544785000,626940560000,136142902000
United States,"Professional, Scientific, and Technical Services",2013,3914563,2881195,500414,275569,3657178,199704,37311,3894193,20370,4347225,2882475,503475,287770,3673720,262475,104910,4041105,306120,41376750,3895366,3264515,3661925,11207175,7433405,5705805,24346385,16866237,3140073370000,235879385000,175895825000,224145920000,635921130000,546588790000,454612005000,1637121925000,1498646606000
United States,Real Estate and Rental and Leasing,2013,1387723,1091689,153587,69959,1315235,52037,13356,1380628,7095,1787665,1093905,158085,79160,1331150,92420,94980,1518550,269115,9576268,1550031,981755,909100,3474101,1822865,1490705,6806760,2641957,458004092000,62750120000,37818565000,38277695000,138846380000,85575490000,72537988000,297376940000,155341705000
United States,Retail Trade,2013,3279531,1969369,664661,345968,2979998,240984,43416,3264398,15133,5318080,1975085,679910,386080,3041075,392915,230875,3664865,1653215,73775799,3421902,4321508,4496897,12301717,8730165,5526206,26778090,44552912,1902165219000,91815801000,105111861000,120966735000,318120445000,293313515000,202738252000,814299750000,1067945509000
United States,Total,2013,5775055,3575290,992281,600551,5168122,503033,85264,5756419,18636,7488353,3580637,1003971,634233,5218841,684963,360590,6264394,1223959,118266253,5926660,6523516,8058077,20508253,19697707,16617417,56823377,61442876,5621697325000,241347624000,228080290000,297246083000,766673997000,799075150000,752414284000,2318163431000,3303533894000
United States,Transportation and Warehousing,2013,856365,542795,122740,81101,746636,73850,20619,841105,15260,1077735,543375,123835,83965,751175,90710,51255,893140,184595,21417548,815860,805735,1075003,2699900,2704146,2517965,7925466,11972620,967167690000,30271637000,28585617000,39938599000,98821514000,108592571000,106005823000,313624391000,590359714000
United States,Utilities,2013,30049,15364,4805,2396,22565,4557,1587,28709,1340,90020,15380,4905,2630,22915,7420,7115,37450,52570,3192875,29812,30834,32357,93343,199882,256214,550342,2640909,300894000000,1146679000,1380292000,1864988000,4394323000,14103845000,19773345000,38434355000,262404400000
United States,Wholesale Trade,2013,1579890,893116,264037,181565,1338718,176590,43781,1559089,20801,2098240,895340,268800,196425,1360565,249990,147170,1757725,340515,29543815,1521110,1739460,2405250,5666590,6364635,5277823,17318110,11845127,1931734485000,78125575000,87745250000,127655070000,293525895000,359329060000,318059067000,971018390000,960365421000
Utah,Accommodation and Food Services,2013,18812,6065,3473,3990,13528,4188,504,18220,592,26130,6075,3495,4050,13620,5050,2105,20775,5355,499978,7668,23315,54828,87335,145863,75866,311743,182952,7415090000,234095000,282123000,659542000,1182725000,1985333000,1166172000,4387015000,3018713000
Utah,Administrative and Support and Waste Management and Remediation Services,2013,18965,12150,2575,1420,16145,1265,515,17925,1040,20740,12150,2575,1430,16155,1335,550,18040,2700,586709,13286,15998,17338,49854,45426,53469,163713,404963,18922080000,570032000,484407000,570312000,1676587000,1590122000,1606486000,5288925000,12696760000
Utah,"Agriculture, Forestry, Fishing and Hunting",2013,400,295,55,25,375,10,10,395,5,410,295,55,25,375,10,10,395,15,1791,38,74,118,931,0,0,1403,0,82310000,11299000,2805000,6624000,36659000,0,0,78158000,0
Utah,"Arts, Entertainment, and Recreation",2013,4720,3015,520,410,3945,530,137,4612,108,4940,3015,520,410,3945,565,185,4695,245,101058,2237,2640,4336,10218,19016,13945,52400,40520,1989559000,123517000,68162000,80849000,290355000,337866000,215557000,1005762000,670275000
Utah,Construction,2013,41668,28620,6409,3410,38439,2512,373,41324,344,41915,28620,6420,3410,38450,2550,420,41420,495,311190,38915,41608,45318,129695,90927,41052,271500,31868,14473945000,1567742000,1472830000,1817407000,4877085000,4267035000,2163915000,11722045000,2171177000
Utah,Educational Services,2013,4948,2495,740,585,3820,795,180,4795,153,5245,2495,740,590,3825,835,185,4845,400,136280,2706,4561,7517,16229,30676,18973,70442,0,3717771000,108750000,75780000,154208000,354834000,874094000,526448000,1874471000,1483706000
Utah,Finance and Insurance,2013,16134,11490,1627,673,13790,789,301,14880,1254,24620,11495,1675,760,13930,1580,1260,16770,7850,281052,17301,8950,7329,34762,25742,27213,95062,163020,17680850000,684896000,402445000,398979000,1556238000,1825900000,1792356000,5796765000,11006808000
Utah,Health Care and Social Assistance,2013,31904,17395,6760,3940,28095,2544,624,31263,641,37270,17400,6775,4025,28200,3325,2005,33530,3740,632520,21558,45175,49233,123757,93549,80693,314411,307789,25378712000,1633838000,1369775000,1514614000,4542549000,2993307000,2740894000,10752988000,14288239000
Utah,Information,2013,4955,2475,490,411,3376,583,299,4258,697,6835,2475,500,420,3395,635,330,4360,2475,166348,1946,2324,3115,10391,18615,26488,61804,88020,10601631000,151407000,111341000,191412000,504882000,1195639000,2232881000,4171845000,5552481000
Utah,Management of Companies and Enterprises,2013,1825,305,30,50,385,325,385,1095,730,2370,305,30,50,385,325,385,1095,1275,92309,299,143,362,824,4254,13272,18754,73555,8212574000,16994000,8531000,14431000,40789000,217880000,737888000,1006304000,7206270000
Utah,Manufacturing,2013,15407,6110,2595,2304,11009,2383,801,14193,1214,15845,6110,2600,2305,11015,2420,860,14295,1550,470485,6619,12721,24895,50081,78013,58696,219555,198587,24892729000,345649000,472828000,914829000,1951002000,3240730000,2855129000,9425284000,12491760000
Utah,"Mining, Quarrying, and Oil and Gas Extraction",2013,2261,1160,285,220,1665,240,81,1986,275,2410,1160,285,220,1665,240,85,1990,420,46713,305,1767,2660,6335,6768,3080,17103,28406,3753735000,81561000,99641000,186192000,388347000,448179000,199994000,1186949000,2514930000
Utah,Other,2013,63,59,4,0,63,0,0,63,0,63,59,4,0,63,0,0,63,0,0,0,0,0,0,0,0,0,0,1277000,1178000,99000,0,1277000,0,0,1277000,0
Utah,Other Services (except Public Administration),2013,21264,13680,3840,1990,19510,1158,203,20871,393,23625,13695,3845,2095,19635,2025,495,22155,1470,165395,20428,23593,22689,69839,33917,8150,118250,9507,5138885000,618934000,648981000,625258000,1944450000,886357000,349273000,3522239000,1034659000
Utah,"Professional, Scientific, and Technical Services",2013,44661,33120,4555,2550,40225,2386,826,43437,1224,47030,33120,4570,2585,40275,2825,1020,44120,2910,420090,32717,27843,32390,100398,78694,62733,250364,142223,21510291000,1934451000,1249977000,1725133000,4943930000,4892377000,3901320000,13991571000,6829458000
Utah,Real Estate and Rental and Leasing,2013,20879,17088,1816,717,19621,572,236,20429,450,23405,17090,1830,800,19720,880,590,21190,2215,86103,18179,10653,8762,38911,15625,6906,66059,9789,3388093000,706120000,348208000,334249000,1406759000,574498000,361124000,2433151000,582763000
Utah,Retail Trade,2013,30231,15535,5634,3942,25111,2661,666,28438,1793,45755,15550,5750,4225,25525,4005,2375,31905,13850,666689,18578,34161,48092,107694,86588,50035,259558,357268,17407070000,707212000,869644000,1210573000,2822135000,2484124000,1798347000,7418916000,9356234000
Utah,Total,2013,59900,36963,8936,5764,51663,5001,1284,57948,1952,71887,36983,9019,5963,51965,6393,2955,61313,10574,1101557,53907,58910,76641,189458,183315,147593,520366,581191,45172354000,2094563000,1813001000,2462504000,6370068000,6783908000,6257067000,19411043000,25761311000
Utah,Transportation and Warehousing,2013,10155,6080,1180,865,8125,857,338,9320,835,11025,6080,1180,875,8135,895,400,9430,1595,229000,1781,7245,9856,26825,24429,23734,80628,142880,10123929000,290582000,241874000,402407000,957649000,1011852000,906792000,2997253000,7035772000
Utah,Utilities,2013,403,265,30,20,315,32,15,362,41,1085,265,30,20,315,85,25,425,660,556,393,255,98,857,1165,0,4047,0,20906000,9805000,10720000,11113000,31638000,86081000,0,336906000,0
Utah,Wholesale Trade,2013,16047,7212,2185,1486,10883,2131,1073,14087,1960,18465,7225,2200,1520,10945,2380,1490,14815,3650,262323,7380,12805,16277,41187,55364,47137,154827,88779,15643144000,468576000,562259000,849914000,1983698000,2851191000,2510681000,7603119000,6600703000
Vermont,Accommodation and Food Services,2013,8703,3680,1540,1710,6930,1400,147,8477,226,9785,3680,1545,1730,6955,1640,315,8910,875,150706,5375,10196,23318,39313,44404,18331,103859,47244,2636511000,171662000,151967000,370839000,704820000,796295000,339404000,1862250000,758493000
Vermont,Administrative and Support and Waste Management and Remediation Services,2013,5182,3630,610,330,4570,245,55,4870,312,5420,3630,610,340,4580,280,55,4915,505,33537,4024,3671,3451,11919,6623,1209,22626,8799,1090564000,202585000,108959000,105194000,465788000,221039000,30532000,789900000,222238000
Vermont,"Agriculture, Forestry, Fishing and Hunting",2013,700,570,90,20,680,10,10,700,0,700,570,90,20,680,10,10,700,0,1889,713,439,48,1565,0,0,1889,0,59745000,22329000,11978000,1659000,45093000,0,0,59745000,0
Vermont,"Arts, Entertainment, and Recreation",2013,2209,1395,360,200,1955,165,54,2174,35,2285,1395,360,205,1960,185,100,2245,40,39851,263,1964,2295,6444,2815,6032,19935,12072,657247000,95812000,50077000,71432000,236497000,83802000,77762000,478727000,111582000
Vermont,Construction,2013,13430,10195,1880,775,12850,460,65,13375,55,13450,10195,1880,780,12855,470,70,13395,55,61159,13692,11545,8929,35744,14604,2718,58200,157,3098952000,640558000,493070000,480460000,1668109000,804575000,175327000,2923017000,8221000
Vermont,Educational Services,2013,1745,805,310,170,1285,280,110,1675,70,1845,825,310,170,1305,340,125,1770,75,74435,921,1715,1877,5507,9938,20277,37241,36838,2188125000,44944000,42556000,35802000,144037000,269761000,665792000,1135700000,1043494000
Vermont,Finance and Insurance,2013,2567,1395,265,145,1805,190,130,2125,442,4780,1400,285,210,1895,495,815,3205,1575,39621,2212,1014,1426,5163,2173,8877,20723,7716,2692752000,125514000,83966000,69277000,319273000,283618000,446781000,1426201000,1195129000
Vermont,Health Care and Social Assistance,2013,8732,3960,1950,1035,6945,1089,377,8411,321,10610,3965,1950,1050,6965,1485,995,9445,1165,227273,6733,10725,12776,32706,36712,36093,113420,97707,9361907000,311737000,454825000,460596000,1281394000,1210409000,1171602000,3755127000,5043144000
Vermont,Information,2013,1841,795,340,185,1320,227,75,1622,219,2480,795,340,185,1320,310,95,1725,755,22838,843,1559,1792,5273,6558,901,14408,4654,1198027000,49255000,54429000,73747000,198723000,308404000,64948000,641491000,431077000
Vermont,Management of Companies and Enterprises,2013,395,15,10,25,50,80,85,215,180,440,15,10,25,50,80,85,215,225,12190,0,0,0,12,0,2749,3865,8316,760480000,0,0,6458000,15995000,0,143693000,226755000,532946000
Vermont,Manufacturing,2013,4732,2110,735,600,3445,715,324,4484,248,4925,2110,735,605,3450,730,440,4620,305,90850,1912,2974,5518,12804,20016,13874,62577,23415,4612213000,97165000,101417000,203565000,485369000,955411000,621239000,2809364000,1312212000
Vermont,"Mining, Quarrying, and Oil and Gas Extraction",2013,216,130,25,15,170,25,5,200,16,250,130,25,15,170,40,15,225,25,1527,0,0,0,452,306,0,1012,0,122816000,10653000,0,0,30068000,17253000,0,70260000,0
Vermont,Other,2013,47,46,1,0,47,0,0,47,0,47,46,1,0,47,0,0,47,0,41,36,0,0,41,0,0,41,0,991000,969000,0,0,991000,0,0,991000,0
Vermont,Other Services (except Public Administration),2013,9702,6525,1980,662,9167,320,88,9575,127,10125,6530,2005,710,9245,515,140,9900,225,44336,10808,12364,7337,32751,5862,129,43217,471,1217935000,318723000,300875000,201360000,833556000,215341000,10148000,1182000000,19097000
Vermont,"Professional, Scientific, and Technical Services",2013,10251,7155,1500,710,9365,450,103,9918,333,10555,7155,1505,725,9385,560,130,10075,480,103528,9109,8938,7885,28118,11884,2684,49266,40163,5349923000,515134000,470766000,471117000,1505380000,851929000,204814000,2934884000,1321054000
Vermont,Real Estate and Rental and Leasing,2013,3379,2535,395,145,3075,113,35,3223,156,3745,2535,395,180,3110,160,120,3390,355,15145,2485,1952,1544,7718,2106,310,11820,1811,580503000,140801000,87797000,52085000,288585000,86915000,9938000,435694000,76449000
Vermont,Retail Trade,2013,12592,5630,2844,1701,10175,1215,308,11698,894,17120,5645,2880,1830,10355,2040,1335,13730,3390,176952,8472,16012,18421,46391,30886,14275,101138,34885,4874434000,274429000,427385000,522417000,1256541000,1154059000,540440000,3303482000,798226000
Vermont,Total,2013,18176,10721,3117,1770,15608,1486,360,17454,722,21119,10732,3139,1855,15726,2058,1058,18842,2277,262474,17796,20471,23258,61525,51422,42497,155444,107030,10074054000,659296000,651539000,753202000,2064037000,1945510000,1683255000,5692802000,4381252000
Vermont,Transportation and Warehousing,2013,2216,1310,310,150,1770,210,76,2056,160,2445,1310,310,150,1770,225,105,2100,345,25727,1170,1660,1592,5414,4477,1367,14163,3718,981081000,65407000,61864000,53176000,188969000,168726000,57428000,517057000,251899000
Vermont,Utilities,2013,132,45,5,5,55,15,20,90,42,330,45,5,5,55,20,55,130,200,35,16,0,0,82,0,602,1660,0,785412000,1874000,0,0,5774000,0,52558000,140560000,0
Vermont,Wholesale Trade,2013,3641,1500,445,335,2280,572,236,3088,553,4070,1500,450,340,2290,705,285,3280,790,48063,724,1673,2643,7531,11779,5346,33176,7095,2654543000,84920000,87770000,116210000,359517000,597725000,332541000,1730614000,567401000
Virginia,Accommodation and Food Services,2013,62414,22685,12666,12616,47967,11679,1309,60955,1459,85680,22715,12705,12775,48195,13100,5455,66750,18930,1562855,34690,84432,168722,291328,410561,186070,889875,678603,26001800000,1014585000,1240587000,2462918000,4725989000,6652302000,2747530000,14153205000,11567499000
Virginia,Administrative and Support and Waste Management and Remediation Services,2013,45404,26060,7130,4030,37220,4416,1760,43396,2008,52795,26065,7135,4060,37260,4785,2860,44905,7890,1210356,38965,46140,53385,142236,161664,217723,531027,673740,46887328000,1452207000,1477219000,1902147000,4872315000,6445775000,7769226000,19368213000,27389371000
Virginia,"Agriculture, Forestry, Fishing and Hunting",2013,3280,2270,620,205,3095,130,20,3245,35,3295,2270,620,205,3095,130,20,3245,50,18631,3031,3874,2466,10329,1513,320,15282,0,819155000,115238000,126196000,76584000,324252000,116727000,8710000,529181000,0
Virginia,"Arts, Entertainment, and Recreation",2013,12956,7595,1675,1275,10545,1748,359,12652,304,14130,7595,1685,1280,10560,1815,600,12975,1155,247315,9016,10663,16967,37494,69265,41113,156245,78324,5549789000,387765000,233984000,341100000,982698000,1309733000,963956000,3497618000,1399526000
Virginia,Construction,2013,94378,62235,14625,8975,85835,6749,1115,93699,679,95645,62235,14625,8985,85845,6855,1480,94180,1465,837315,103122,96700,119427,320635,250220,128668,704835,111168,41011160000,3648591000,3622685000,5262337000,12535225000,12480070000,7000368000,32322365000,7321890000
Virginia,Educational Services,2013,13442,6780,1920,1705,10405,2056,548,13009,433,14755,6785,1925,1755,10465,2200,715,13380,1375,376018,10411,12177,23365,46941,79891,84871,213569,155784,12660135000,346282000,311279000,555399000,1216810000,2454928000,3113589000,6838567000,5676983000
Virginia,Finance and Insurance,2013,28290,18533,3835,1420,23788,1686,901,26375,1915,55885,18550,3970,1700,24220,3500,4580,32300,23585,752293,29682,23054,17340,72870,50856,68144,200345,537707,58348704000,1468529000,1258241000,1276401000,4045883000,4239383000,4794796000,13618955000,42797331000
Virginia,Health Care and Social Assistance,2013,72582,32125,17133,10621,59879,8740,2073,70692,1890,94570,32185,17325,11300,60810,12210,6505,79525,15045,2061258,58884,114220,140115,315642,331011,292435,957971,1056554,94885228000,2934065000,5095150000,6490656000,14554075000,14094146000,11700512000,40787649000,51521077000
Virginia,Information,2013,10014,4555,1260,985,6800,1297,603,8700,1314,19470,4565,1260,1000,6825,1535,935,9295,10175,461239,5657,7724,12685,27669,41823,53382,129351,320881,38951285000,460571000,435546000,725314000,1678023000,3198352000,4307134000,9783766000,28458031000
Virginia,Management of Companies and Enterprises,2013,4102,240,105,100,445,655,1141,2241,1861,6445,240,105,100,445,670,1210,2325,4120,328055,319,539,0,1140,7315,35226,43685,284337,31623845000,26614000,33730000,13150000,73800000,547020000,2620762000,3242015000,28381830000
Virginia,Manufacturing,2013,23207,8560,4185,2950,15695,3807,1534,21036,2171,24880,8560,4185,2975,15720,4015,2010,21745,3135,938873,11266,24063,34390,79332,126258,129187,366877,506020,48570999000,560510000,860223000,1303509000,2953302000,5428004000,5907531000,15737027000,28484923000
Virginia,"Mining, Quarrying, and Oil and Gas Extraction",2013,917,280,95,140,515,161,107,783,134,1375,280,95,140,515,180,200,895,480,41699,137,307,1222,2402,4320,3547,12474,26363,2691748000,20947000,26036000,78583000,146215000,287626000,180031000,688522000,1833851000
Virginia,Other,2013,310,301,7,2,310,0,0,310,0,310,301,7,2,310,0,0,310,0,0,0,0,0,0,0,0,0,0,7498000,6973000,0,0,7498000,0,0,7498000,0
Virginia,Other Services (except Public Administration),2013,98760,60031,20136,10116,90283,6622,1018,97923,837,106715,60070,20230,10485,90785,7835,3040,101660,5055,810980,110525,130381,132751,379039,227876,87500,706444,78450,28529146000,2948681000,3428760000,4113311000,10503035000,8500581000,4568101000,23908074000,3483464000
Virginia,"Professional, Scientific, and Technical Services",2013,127274,86605,14662,9740,111007,9900,3346,124253,3021,149155,86640,14720,9960,111320,11590,4990,127900,21255,2189874,101074,94581,126860,349724,346383,357367,1063222,1105881,191723855000,8058517000,6003484000,9188458000,23280047000,28648861000,32407637000,84633738000,105745321000
Virginia,Real Estate and Rental and Leasing,2013,32301,24263,3154,1661,29078,1454,781,31313,988,44775,24310,3330,1840,29480,2960,3065,35505,9270,242937,27170,19421,20590,76376,41191,39592,163654,71424,12317844000,1463479000,857585000,905643000,3239805000,2051754000,1914416000,7492690000,4300326000
Virginia,Retail Trade,2013,79391,43274,15932,9275,68481,6039,1876,76396,2995,135845,43435,16315,10165,69915,9225,6360,85500,50345,1937522,71283,98129,116892,295168,195594,135221,643290,1184785,50935416000,2030995000,2444273000,2999633000,7489784000,6482283000,5643330000,19814484000,29644240000
Virginia,Total,2013,148827,86598,25164,16094,127856,14063,3531,145450,3377,193907,86699,25439,16802,128940,17849,9688,156477,37430,3131723,146850,165911,213923,526684,511464,429441,1467589,1664134,154472464000,5763348000,5910857000,8231858000,19906063000,22550137000,21908385000,64364585000,90107879000
Virginia,Transportation and Warehousing,2013,20612,11452,2779,1865,16096,1933,855,18884,1728,24005,11455,2800,1920,16175,2155,1145,19475,4530,414588,14801,16929,23433,59526,58339,38218,164158,215702,17689072000,578017000,551144000,803601000,1981817000,2443270000,1674144000,6435161000,9669414000
Virginia,Utilities,2013,477,130,50,15,195,70,55,320,157,1600,130,50,15,195,100,180,475,1125,67471,21,0,64,93,2082,7442,9845,28579,6554949000,7032000,10513000,6238000,33803000,158120000,591631000,813440000,5701148000
Virginia,Wholesale Trade,2013,29045,13900,4010,3193,21103,3540,1759,26402,2643,36965,13905,4080,3340,21325,4385,3090,28800,8165,508128,20586,25039,38745,89759,93988,86339,285081,199571,31177088000,1137893000,1264394000,2183914000,4648833000,4965091000,5289782000,15429988000,14723400000
Washington,Accommodation and Food Services,2013,65600,25845,14873,12912,53630,10018,1131,64779,821,82510,25895,14950,13240,54085,12255,4955,71295,11215,1184267,42805,95039,170245,308329,333333,159902,811243,354149,23496875000,1026905000,1439512000,2932485000,5401170000,6497105000,3247085000,15184125000,7469037000
Washington,Administrative and Support and Waste Management and Remediation Services,2013,40816,26055,6350,3360,35765,2854,736,39355,1461,45760,26065,6355,3420,35840,3105,955,39900,5860,661578,38603,40937,43243,122601,100901,76631,316175,315338,27468279000,1306557000,1315415000,1533276000,4146558000,3939643000,3000712000,11538813000,14472357000
Washington,"Agriculture, Forestry, Fishing and Hunting",2013,6955,5205,690,425,6320,425,135,6880,75,7085,5205,690,425,6320,435,160,6915,170,62094,4701,3938,4974,13906,15124,20097,52901,3649,2821214000,400295000,166615000,257752000,873095000,699689000,724948000,2355185000,272855000
Washington,"Arts, Entertainment, and Recreation",2013,13075,7365,1825,1375,10565,1790,504,12859,216,13980,7365,1825,1385,10575,1890,755,13220,760,298398,8603,11240,17341,38465,69644,76975,195767,93250,8564021000,362836000,256903000,335790000,1008729000,1318711000,1746023000,4265041000,3208466000
Washington,Construction,2013,98674,70378,14105,7370,91853,5415,804,98072,602,99420,70380,14110,7370,91860,5535,1010,98405,1015,689155,101036,92405,98224,294220,196391,94606,593253,87901,40185860000,4274170000,3960830000,5121475000,13390285000,11680393000,7242415000,32763261000,6884160000
Washington,Educational Services,2013,12422,6325,2040,1715,10080,1698,315,12093,329,13285,6325,2045,1760,10130,1965,435,12530,755,265475,9503,13716,22778,46650,66490,39854,156955,107335,7339225000,291363000,308360000,488536000,1105958000,1713067000,1412083000,4384645000,2916011000
Washington,Finance and Insurance,2013,25074,17015,3040,1140,21195,1260,812,23267,1807,49165,17030,3105,1280,21415,2170,4020,27605,21560,487496,28497,18310,13245,60220,36879,67766,176989,292423,36964230000,1452248000,1000788000,1035372000,3561838000,2824695000,4410043000,11706771000,24779038000
Washington,Health Care and Social Assistance,2013,82305,43235,18750,9949,71934,6531,2294,80759,1546,99385,43250,18840,10420,72510,9175,6925,88610,10775,1873084,73782,124569,130261,333605,247552,324583,912490,942111,90607221000,3014937000,4689076000,5067916000,12852649000,9515114000,13505770000,36103671000,53756197000
Washington,Information,2013,10473,4965,1492,1160,7617,1200,513,9330,1143,16340,4965,1505,1200,7670,1345,630,9645,6695,586048,4265,9210,12736,27210,39745,46464,120486,228009,80225162000,382127000,488190000,834787000,1813124000,2869556000,5332450000,10132527000,24209268000
Washington,Management of Companies and Enterprises,2013,3636,300,110,140,550,610,1056,2216,1420,5135,300,110,140,550,615,1110,2275,2860,357975,3,469,597,1388,7399,34330,43228,314715,40714715000,38328000,44867000,52639000,139388000,467937000,2248260000,2864975000,37849082000
Washington,Manufacturing,2013,33228,14420,5960,4143,24523,5014,1744,31281,1947,34660,14420,5965,4190,24575,5115,2055,31745,2915,996341,19342,34722,49086,112030,181329,169658,510126,347082,55094131000,903818000,1359133000,2147662000,4672542000,8773179000,9103641000,24791365000,21499556000
Washington,"Mining, Quarrying, and Oil and Gas Extraction",2013,681,290,151,55,496,69,25,590,91,850,290,155,55,500,90,75,665,185,10462,292,703,0,1858,1713,0,4769,3686,768296000,24385000,42141000,29319000,105395000,109933000,29087000,311812000,274028000
Washington,Other,2013,375,364,10,1,375,0,0,375,0,375,364,10,1,375,0,0,375,0,0,0,66,0,0,0,0,0,0,9062000,7150000,1551000,0,9062000,0,0,9062000,0
Washington,Other Services (except Public Administration),2013,75737,47840,15465,7026,70331,4082,688,75101,636,83325,47845,15515,7415,70775,5555,2415,78745,4580,547044,87185,98279,89446,277362,128241,49341,467669,53924,16643865000,2261935000,2565567000,2496593000,7358335000,3879167000,1556251000,12990378000,2569692000
Washington,"Professional, Scientific, and Technical Services",2013,95586,68095,11630,6550,86275,5291,1852,93418,2168,101835,68095,11680,6710,86485,6050,2575,95110,6725,965987,85047,74518,85736,259253,173082,138704,581546,295934,78870611000,5588390000,4223706000,5374184000,15238210000,14544200000,10835947000,41176863000,29041498000
Washington,Real Estate and Rental and Leasing,2013,38146,29612,4099,1752,35463,1346,631,37440,706,48745,29665,4205,1945,35815,2330,3225,41370,7375,220021,41236,25350,21591,90077,37156,29168,163059,49212,9912450000,1534439000,922971000,920989000,3400783000,1708445000,1381070000,6688335000,3151920000
Washington,Retail Trade,2013,72620,39156,15434,8024,62614,6129,1512,70255,2365,107820,39375,15715,8945,64035,9520,5035,78590,29230,1519075,54998,95552,100187,259075,206338,108047,597662,799647,43957657000,1776820000,2468728000,2855371000,7203840000,7400780000,4583970000,19612384000,22445011000
Washington,Total,2013,144705,87900,24871,14460,127231,11618,2990,141839,2866,176815,88002,25079,15181,128262,15039,8378,151679,25136,2444098,142576,163194,191633,497403,416974,349238,1263615,1180483,130764584000,5507616000,5649675000,7147420000,18304711000,17985940000,17281039000,53571690000,77192894000
Washington,Transportation and Warehousing,2013,21326,12235,2710,1862,16807,1853,1038,19698,1628,24415,12250,2735,1935,16920,2065,1565,20550,3865,414754,16308,16804,22933,58378,52704,38078,160082,224598,21064832000,740375000,639570000,998982000,2408317000,2220262000,1894089000,6954415000,12853544000
Washington,Utilities,2013,994,595,145,50,790,82,33,905,89,1545,595,150,50,795,130,70,995,550,2040,1198,783,591,2797,1144,0,4701,0,161944000,29056000,30837000,32367000,103469000,200205000,0,307772000,20031000
Washington,Wholesale Trade,2013,38055,18840,5608,3771,28219,4681,2261,35161,2894,46940,18875,5690,4015,28580,5850,3920,38350,8590,614581,29497,33866,45382,111734,134378,113663,376730,215410,38070931000,1727906000,1899216000,2524683000,6249547000,7842491000,6593530000,21255924000,15242551000
West Virginia,Accommodation and Food Services,2013,13311,4690,2815,2410,9915,2412,517,12844,467,18270,4690,2820,2430,9940,3030,2115,15085,3185,320547,7795,18337,32688,58865,87154,56027,203697,116011,4461769000,158727000,216723000,406634000,784528000,1159272000,690147000,2655879000,1791754000
West Virginia,Administrative and Support and Waste Management and Remediation Services,2013,6465,3470,1045,605,5120,570,178,5868,597,7365,3470,1045,605,5120,640,250,6010,1355,161158,4790,5720,6687,19322,17925,25143,67426,87388,4490607000,149732000,167791000,230798000,585206000,619951000,858985000,2215278000,2099859000
West Virginia,"Agriculture, Forestry, Fishing and Hunting",2013,1110,900,145,35,1080,20,5,1105,5,1110,900,145,35,1080,20,5,1105,5,3741,1484,856,317,2931,720,0,3701,0,119579000,38334000,19110000,10015000,73764000,40500000,0,115634000,0
West Virginia,"Arts, Entertainment, and Recreation",2013,3383,1675,780,435,2890,335,75,3300,83,3805,1675,790,490,2955,615,125,3695,110,45297,2577,4501,5358,13753,9971,5914,32171,12924,867419000,70792000,72581000,93601000,246365000,179060000,53681000,513920000,345677000
West Virginia,Construction,2013,16242,10485,2745,1645,14875,990,229,16094,148,16360,10485,2745,1645,14875,1000,280,16155,205,127077,15654,17201,20630,56636,34173,19325,116624,6062,6131930000,503230000,581068000,838043000,1945852000,1910269000,1269383000,5473426000,381479000
West Virginia,Educational Services,2013,1313,565,220,165,950,233,55,1238,75,1360,565,220,165,950,245,70,1265,95,48862,770,1395,1970,4435,7361,8540,22879,25678,1274826000,18935000,19414000,38578000,80536000,149323000,186848000,470877000,788389000
West Virginia,Finance and Insurance,2013,5794,3410,845,335,4590,466,148,5204,590,10660,3410,885,440,4735,1360,665,6760,3900,86567,5983,5004,4021,15841,15596,8057,42907,16723,3936312000,220847000,182378000,177150000,601684000,632494000,331016000,1668817000,2194726000
West Virginia,Health Care and Social Assistance,2013,17183,6395,4295,2598,13288,2199,1003,16490,693,24465,6395,4310,2720,13425,3105,2850,19380,5085,644451,13061,27300,33450,75858,84235,125874,290535,337690,25194592000,489891000,934105000,1322351000,2764298000,2828117000,3493854000,9217805000,15398568000
West Virginia,Information,2013,1383,455,190,185,830,167,59,1056,327,3280,455,190,185,830,235,90,1155,2125,53286,408,983,2068,4061,3869,1106,9581,34708,2611165000,34534000,23952000,44372000,119622000,134332000,43759000,339761000,2065720000
West Virginia,Management of Companies and Enterprises,2013,806,40,10,25,75,170,250,495,311,1140,40,10,25,75,170,255,500,640,26707,0,0,136,240,1903,4887,7252,19438,1653075000,1232000,0,39820000,42616000,86119000,374807000,529345000,1117721000
West Virginia,Manufacturing,2013,5665,1800,945,833,3578,1021,399,4998,667,6080,1800,950,835,3585,1120,495,5200,880,184824,2219,3824,7944,17465,28595,16761,80204,81752,9775204000,67564000,146868000,273362000,572484000,1133478000,766706000,3143762000,5376989000
West Virginia,"Mining, Quarrying, and Oil and Gas Extraction",2013,2477,1040,325,300,1665,332,175,2172,305,3265,1040,325,300,1665,350,200,2215,1050,166476,1000,2058,3953,8023,11821,19643,40523,125667,12787050000,95400000,104127000,253215000,457052000,743087000,1477470000,2719265000,10046312000
West Virginia,Other,2013,52,49,2,1,52,0,0,52,0,52,49,2,1,52,0,0,52,0,68,0,0,0,68,0,0,68,0,1060000,716000,0,0,1060000,0,0,1060000,0
West Virginia,Other Services (except Public Administration),2013,20668,13090,4410,1746,19246,962,208,20416,252,22135,13095,4445,1820,19360,1285,455,21100,1035,124025,24702,27326,21796,75581,28163,5731,113856,6145,2858044000,475408000,534002000,520817000,1546582000,670302000,197160000,2560370000,202624000
West Virginia,"Professional, Scientific, and Technical Services",2013,13272,7990,2120,1170,11280,956,405,12641,631,14850,7995,2125,1210,11330,1205,635,13170,1680,122860,12588,13260,14317,42490,30257,14556,92774,22443,5934266000,520035000,502253000,667777000,1713780000,1591628000,736313000,4370302000,1348897000
West Virginia,Real Estate and Rental and Leasing,2013,5726,4085,775,310,5170,183,94,5447,279,7005,4105,790,315,5210,270,300,5780,1225,27867,6635,4316,3417,15890,2613,428,21553,6131,1041663000,211102000,136226000,115360000,484976000,98590000,23859000,765327000,268922000
West Virginia,Retail Trade,2013,18253,8452,3879,2331,14662,1972,393,17027,1226,31350,8505,3990,2540,15035,3030,1615,19680,11670,353820,13689,23824,27656,67262,59207,23637,158836,166768,8202878000,341417000,534995000,709575000,1608361000,1733159000,683191000,4242111000,3758466000
West Virginia,Total,2013,28211,14761,5462,3259,23482,2711,767,26960,1251,37573,14781,5527,3416,23724,3881,2269,29874,7699,575987,27671,35719,43194,106584,98341,86025,290950,285037,21498704000,754587000,941694000,1329179000,3025460000,3257236000,3002160000,9284856000,12213848000
West Virginia,Transportation and Warehousing,2013,5243,2855,875,480,4210,443,160,4813,430,6025,2855,875,485,4215,485,195,4895,1130,60564,4294,5475,4728,16025,11984,3662,34188,11813,2402419000,150255000,163516000,187770000,531455000,438067000,129064000,1175105000,645388000
West Virginia,Utilities,2013,299,100,25,50,175,25,25,225,74,1205,100,25,60,185,75,125,385,820,1494,179,96,54,806,600,1120,2189,0,84699000,4313000,2808000,1530000,22588000,25473000,92072000,129557000,0
West Virginia,Wholesale Trade,2013,6143,2080,910,725,3715,923,406,5044,1099,7875,2080,940,770,3790,1165,620,5575,2300,90872,2748,4897,7148,17035,19070,11218,54165,29984,4636457000,143476000,195369000,293906000,689748000,866535000,605097000,2506636000,1654442000
Wisconsin,Accommodation and Food Services,2013,58276,23401,11515,10720,45636,10807,966,57409,867,71385,23485,11515,10815,45815,12800,3750,62365,9020,1116284,38041,76985,145117,260964,385348,133239,782299,304964,15078315000,809290000,844213000,1616229000,3272265000,4993402000,1863588000,10154720000,4805045000
Wisconsin,Administrative and Support and Waste Management and Remediation Services,2013,28484,17530,3948,2500,23978,2267,918,27163,1321,33915,17530,3950,2545,24025,2490,1365,27880,6035,724953,24022,25531,31553,83144,82913,118242,290888,417184,20912100000,977164000,797136000,1019637000,2823556000,2433584000,2985436000,8466249000,11753442000
Wisconsin,"Agriculture, Forestry, Fishing and Hunting",2013,2660,2100,315,115,2530,80,25,2635,25,2675,2100,315,115,2530,80,30,2640,35,14228,3181,1774,1064,6598,1085,0,11748,198,595009000,99863000,53678000,50600000,209934000,51732000,0,485149000,5904000
Wisconsin,"Arts, Entertainment, and Recreation",2013,12820,7427,1757,1535,10719,1586,347,12652,168,13415,7435,1800,1540,10775,1705,555,13035,380,208279,9902,10890,19781,42828,57723,51823,154849,33180,5621482000,378845000,252336000,313010000,961367000,1001636000,790474000,2816283000,803915000
Wisconsin,Construction,2013,66212,47570,9755,4742,62067,3376,440,65883,329,66995,47570,9765,4765,62100,3590,600,66290,705,465713,70735,62626,61013,196651,116613,50537,370088,91134,30156880000,3314352000,2939833000,3410195000,9688669000,7548479000,3863643000,21523735000,8178171000
Wisconsin,Educational Services,2013,7342,2995,1245,1115,5355,1445,232,7032,310,7870,2995,1255,1120,5370,1540,310,7220,650,279900,4186,7957,14833,28055,53084,26785,107665,166156,8862339000,132739000,146562000,272147000,562050000,1304117000,754108000,2650846000,6085186000
Wisconsin,Finance and Insurance,2013,23665,15330,2910,1195,19435,1924,815,22174,1491,45720,15335,2995,1425,19755,5000,4825,29580,16140,686195,23043,17012,14795,57459,68751,87228,215577,441547,46715178000,1089428000,852502000,878652000,2876862000,3755068000,4710687000,11604707000,34473375000
Wisconsin,Health Care and Social Assistance,2013,51277,21857,11013,7241,40111,6932,2431,49474,1803,73525,21885,11170,7655,40710,10770,7755,59235,14290,1925499,34473,72344,96302,207945,263779,356531,834716,1069628,83828552000,2008529000,2728556000,3732764000,8483247000,9642864000,10401859000,28697227000,54147549000
Wisconsin,Information,2013,5462,2165,815,670,3650,741,304,4695,767,11085,2165,830,710,3705,1075,505,5285,5800,267262,3439,4091,8914,18019,22447,23754,67550,196168,15190478000,148700000,202232000,375595000,751757000,1058744000,1344016000,3308894000,11855189000
Wisconsin,Management of Companies and Enterprises,2013,3490,220,30,145,395,700,1069,2164,1326,5260,220,30,145,395,710,1155,2260,3000,357285,237,211,744,1270,8050,34034,43210,314075,31367051000,40941000,19256000,37116000,100125000,432090000,2198220000,2726836000,28640215000
Wisconsin,Manufacturing,2013,40430,12404,6300,5825,24529,8958,3721,37208,3222,44150,12405,6310,5845,24560,9425,4750,38735,5415,2060030,18871,37127,73201,138752,350154,459381,1000155,945014,104573980000,821387000,1419158000,3108910000,5575225000,16072137000,22240391000,46332913000,51354492000
Wisconsin,"Mining, Quarrying, and Oil and Gas Extraction",2013,712,330,85,85,500,90,37,627,85,815,330,85,95,510,95,75,680,135,11226,9,514,691,1652,1124,1581,6104,4341,835844000,40547000,36075000,48390000,127033000,156725000,114001000,503073000,291547000
Wisconsin,Other,2013,271,264,6,1,271,0,0,271,0,271,264,6,1,271,0,0,271,0,0,0,36,0,0,0,0,0,0,3754000,2936000,365000,0,3754000,0,0,3754000,0
Wisconsin,Other Services (except Public Administration),2013,68244,40185,15217,7270,62672,4436,579,67687,557,73560,40230,15355,7560,63145,6055,1665,70865,2695,524152,77761,98264,93222,272044,152496,42331,473844,42851,12943793000,1828556000,2122310000,2056871000,6047087000,3733089000,1356920000,11478473000,1328487000
Wisconsin,"Professional, Scientific, and Technical Services",2013,52576,34495,7571,4570,46636,3552,950,51138,1438,56940,34520,7645,4745,46910,4535,1510,52955,3985,504442,51211,47741,59054,161508,115916,73783,359320,133861,29900275000,2387855000,2152548000,3027079000,7613099000,6837340000,5669368000,20549032000,8886777000
Wisconsin,Real Estate and Rental and Leasing,2013,18461,13530,2140,1110,16780,844,428,18052,409,22505,13555,2220,1160,16935,1255,2135,20325,2180,121372,20111,13184,13395,48132,27481,15891,99776,17406,4154174000,689784000,459153000,469607000,1639244000,1016258000,653646000,3420446000,658024000
Wisconsin,Retail Trade,2013,62315,30699,13398,7839,51936,6430,1596,59962,2353,96225,30790,13735,8770,53295,10085,6215,69595,26630,1344329,46945,86349,100583,246017,223179,131793,611648,611343,32236338000,1407329000,1937637000,2475500000,5867007000,6507962000,3678671000,16249679000,14447899000
Wisconsin,Total,2013,108110,59780,19051,12400,91231,11619,2736,105586,2524,137983,59864,19280,13028,92172,15827,8403,116402,21581,2401032,100747,125323,166117,392187,439066,384895,1216148,1184884,102083261000,3617570000,3860551000,5386237000,12864358000,15706684000,15446412000,44017454000,58065807000
Wisconsin,Transportation and Warehousing,2013,22965,13095,3070,2409,18574,2330,740,21644,1321,25855,13100,3070,2450,18620,2605,1195,22420,3435,457967,17497,18755,29702,69619,77854,63303,217151,234395,18292660000,724059000,685591000,1112284000,2582419000,2905656000,2269600000,7918278000,9996596000
Wisconsin,Utilities,2013,381,65,20,25,110,125,15,250,131,1500,65,20,35,120,240,25,385,1115,66305,73,50,285,469,4072,0,5123,60854,6037703000,3261000,1924000,17491000,24854000,246856000,0,320140000,5704318000
Wisconsin,Wholesale Trade,2013,28594,12258,4285,3470,20013,4153,2056,26222,2372,35165,12285,4305,3640,20230,5080,3595,28905,6260,561925,18339,26309,42718,91475,128016,119395,361949,174456,32271590000,1082850000,1359978000,2306809000,4809287000,6902743000,6475534000,18946844000,11219904000
Wyoming,Accommodation and Food Services,2013,7887,3035,1495,1480,6010,1390,260,7660,227,9005,3040,1500,1490,6030,1705,665,8400,605,138361,4410,9733,19780,34140,47569,30690,112944,13008,2516649000,153605000,151474000,287563000,596154000,801296000,534182000,1940914000,396350000
Wyoming,Administrative and Support and Waste Management and Remediation Services,2013,4710,3170,660,365,4195,208,50,4453,257,4945,3180,660,375,4215,230,55,4500,445,31068,3484,3728,4325,13181,4054,1089,20085,9104,1024588000,178721000,120123000,129320000,444946000,142229000,24441000,691988000,276941000
Wyoming,"Agriculture, Forestry, Fishing and Hunting",2013,440,365,55,10,430,5,0,435,5,440,365,55,10,430,5,0,435,5,849,362,233,0,677,0,0,777,0,28171000,12518000,6105000,0,25015000,0,0,27135000,0
Wyoming,"Arts, Entertainment, and Recreation",2013,2105,1450,280,195,1925,135,35,2095,10,2130,1450,280,195,1925,145,45,2115,15,16827,1168,1317,2237,5874,4093,1428,12748,0,368443000,69832000,34775000,37668000,151128000,89940000,32953000,311776000,0
Wyoming,Construction,2013,13146,8830,2240,1130,12200,713,115,13028,118,13245,8830,2240,1130,12200,770,130,13100,145,85962,13131,13923,14123,43168,23043,4295,77577,5677,4577130000,584676000,571064000,746461000,1950382000,1428769000,250477000,3991000000,385919000
Wyoming,Educational Services,2013,823,445,100,130,675,68,40,783,40,870,445,100,130,675,75,75,825,45,9194,409,462,1493,2558,2038,2969,8229,0,236996000,15034000,6613000,22163000,52336000,36441000,104821000,204773000,0
Wyoming,Finance and Insurance,2013,3189,2080,345,120,2545,261,67,2873,316,5030,2080,365,150,2595,790,235,3620,1410,31442,2775,1737,1243,6422,9085,2025,20069,2405,1680949000,130709000,64602000,44583000,268800000,456658000,110641000,964652000,637940000
Wyoming,Health Care and Social Assistance,2013,8650,4265,1900,1075,7240,846,260,8346,304,9555,4265,1910,1090,7265,1190,520,8975,580,157440,5889,12020,13642,33636,29028,32255,101500,51300,6816885000,425317000,455902000,497081000,1402359000,1175608000,1209580000,4003368000,2701122000
Wyoming,Information,2013,1110,395,190,130,715,179,65,959,151,1785,395,200,140,735,245,145,1125,660,13943,247,736,1029,3078,4641,1971,11385,156,778934000,16387000,17947000,46182000,99686000,151509000,104059000,401651000,90304000
Wyoming,Management of Companies and Enterprises,2013,395,60,0,30,90,85,60,235,160,485,60,0,30,90,85,65,240,245,6107,0,0,217,291,843,1091,2237,0,502576000,6759000,0,18986000,25745000,45492000,110555000,183101000,0
Wyoming,Manufacturing,2013,2677,1375,410,285,2070,250,97,2417,260,2810,1375,410,300,2085,260,105,2450,360,35683,1066,1683,1969,5799,4909,1731,17413,11140,2251899000,61410000,50172000,88057000,242653000,244775000,108302000,874285000,924223000
Wyoming,"Mining, Quarrying, and Oil and Gas Extraction",2013,3450,1660,490,365,2515,349,143,3007,443,4080,1660,490,365,2515,380,195,3090,990,131582,2602,2701,4838,10628,11612,8395,32741,97192,11126712000,159188000,143696000,289426000,615767000,854696000,633172000,2303171000,8748883000
Wyoming,Other,2013,51,49,1,1,51,0,0,51,0,51,49,1,1,51,0,0,51,0,55,37,0,0,55,0,0,55,0,2059000,1488000,0,0,2059000,0,0,2059000,0
Wyoming,Other Services (except Public Administration),2013,8676,5635,1815,725,8175,265,80,8520,156,9000,5635,1820,775,8230,370,95,8695,305,42374,9805,11410,8168,30310,4237,29,37545,1066,1568745000,281940000,321626000,232795000,868644000,129368000,7304000,1102833000,184635000
Wyoming,"Professional, Scientific, and Technical Services",2013,10599,7835,1230,660,9725,397,157,10279,320,11030,7840,1230,695,9765,495,220,10480,550,45539,9793,7419,6920,26249,8685,2427,42117,2051,2528464000,620849000,325247000,430663000,1439648000,577552000,155190000,2341135000,129908000
Wyoming,Real Estate and Rental and Leasing,2013,4873,3810,450,210,4470,130,50,4650,223,5490,3810,460,210,4480,265,220,4965,525,19505,3893,2266,2119,9565,2795,308,13458,5813,1006430000,184231000,76585000,96244000,371550000,156129000,21535000,580352000,420854000
Wyoming,Retail Trade,2013,9947,4770,2129,1205,8104,835,298,9237,710,13200,4775,2175,1320,8270,1165,790,10225,2975,120399,6975,12296,13706,35234,21824,8152,70900,40006,3419555000,221128000,315699000,396272000,984625000,730405000,327037000,2139055000,1038021000
Wyoming,Total,2013,17741,10607,2973,1735,15315,1304,373,16992,749,20629,10613,2999,1817,15429,1821,849,18099,2530,212635,17275,19364,22825,59464,43306,29315,132085,80550,9773125000,694078000,636307000,807433000,2137818000,1761813000,1227270000,5126901000,4646224000
Wyoming,Transportation and Warehousing,2013,3979,2365,615,310,3290,298,87,3675,304,4825,2365,615,310,3290,320,175,3785,1040,39424,3124,3745,3459,10195,7093,3108,23339,12469,2345084000,144299000,167716000,188568000,512109000,367942000,162196000,1146481000,1054532000
Wyoming,Utilities,2013,241,65,20,25,110,40,15,165,76,670,65,20,25,110,85,50,245,425,56,4,52,0,0,1443,0,2646,50,5033000,283000,2226000,0,1583000,98977000,0,190230000,3073000
Wyoming,Wholesale Trade,2013,3263,1185,450,313,1948,433,272,2653,610,4295,1185,460,340,1985,525,460,2970,1325,40488,1375,2041,2606,7224,6636,3852,20663,16647,2438922000,95203000,122318000,117535000,381378000,398328000,272994000,1207947000,1114211000
