state_name,industry_name,YEAR,firms_01: Total,firms_02: <5,firms_03: 5-9,firms_04: 10-19,firms_05: <20,firms_06: 20-99,firms_07: 100-499,firms_08: <500,firms_09: 500+,establishments_01: Total,establishments_02: <5,establishments_03: 5-9,establishments_04: 10-19,establishments_05: <20,establishments_06: 20-99,establishments_07: 100-499,establishments_08: <500,establishments_09: 500+,employment_01: Total,employment_02: <5,employment_03: 5-9,employment_04: 10-19,employment_05: <20,employment_06: 20-99,employment_07: 100-499,employment_08: <500,employment_09: 500+,annual_payroll_01: Total,annual_payroll_02: <5,annual_payroll_03: 5-9,annual_payroll_04: 10-19,annual_payroll_05: <20,annual_payroll_06: 20-99,annual_payroll_07: 100-499,annual_payroll_08: <500,annual_payroll_09: 500+
Alabama,Accommodation and Food Services,2008,27791,10585,5105,5190,20880,5316,801,26997,794,40400,10600,5120,5240,20960,6485,3040,30485,9915,797752,17104,33498,70070,122846,198303,115044,438172,359298,9494762000,359139000,369055000,771884000,1504797000,2233243000,1280084000,5036597000,4453755000
Alabama,Administrative and Support and Waste Management and Remediation Services,2008,18433,9660,3190,1785,14635,1845,715,17195,1238,21065,9695,3210,1810,14715,2000,890,17605,3460,651497,15098,19757,22769,60572,64878,92568,227092,409480,15388373000,507869000,475765000,666921000,1697871000,1756210000,1915505000,5609298000,9443959000
Alabama,"Agriculture, Forestry, Fishing and Hunting",2008,4367,2165,1295,560,4020,248,25,4293,74,4450,2165,1295,560,4020,260,40,4320,130,30981,3591,8175,7218,19710,7197,1004,28601,1364,1039508000,125992000,238417000,235811000,606189000,244255000,31548000,943261000,73392000
Alabama,"Arts, Entertainment, and Recreation",2008,5310,2870,870,630,4370,724,124,5218,92,5630,2870,870,635,4375,795,180,5350,280,83741,4308,5328,7605,18312,25412,13864,61888,10588,1567967000,109948000,97444000,106047000,336810000,424193000,254419000,1102778000,218862000
Alabama,Construction,2008,48799,28250,8980,5750,42980,4760,611,48351,448,49400,28250,8980,5760,42990,4820,670,48480,920,562310,47273,58740,76635,186746,180013,89242,466315,77370,21865730000,1550020000,1661850000,2448587000,5686325000,7042086000,4087314000,17152760000,3882068000
Alabama,Educational Services,2008,4046,1785,710,540,3035,665,186,3886,160,4315,1795,710,565,3070,720,225,4015,300,135797,2122,4597,6998,14743,27186,26006,69417,60679,3528126000,66806000,66757000,100630000,246820000,546564000,667566000,1484433000,1904364000
Alabama,Finance and Insurance,2008,17031,10910,2107,995,14012,1289,538,15839,1192,37075,10965,2260,1505,14730,3445,3125,21300,15775,363521,18255,12280,12243,44258,44530,37226,132674,131184,21392102000,699583000,518054000,518886000,1766221000,1869607000,1705840000,5625874000,14611334000
Alabama,Health Care and Social Assistance,2008,41162,16485,10780,6549,33814,4720,1526,40060,1102,51915,16520,10850,6820,34190,6440,5235,45865,6050,1193219,32685,70726,85578,191821,174916,206355,574487,607867,46392909000,1835964000,2988558000,3539431000,8404718000,7318664000,6759258000,22561111000,23404571000
Alabama,Information,2008,4159,1595,720,495,2810,467,295,3572,587,8505,1600,725,505,2830,540,505,3875,4630,189473,2295,2798,5341,12719,13687,10271,50370,118928,8898757000,89827000,130436000,225971000,470626000,600391000,720654000,2147017000,6564957000
Alabama,Management of Companies and Enterprises,2008,2264,85,40,90,215,462,664,1341,923,2990,90,40,90,220,470,735,1425,1565,90660,100,140,455,753,4130,17736,22655,68005,6498625000,22496000,17966000,16430000,59463000,204150000,930410000,1194295000,5304330000
Alabama,Manufacturing,2008,22567,7350,3660,2910,13920,4295,1756,19971,2596,24630,7350,3660,2920,13930,4365,2030,20325,4305,1285245,11731,20048,32841,71902,155493,175087,433925,756597,53117743000,456893000,614078000,1087125000,2328227000,5716000000,6291012000,15458949000,34239796000
Alabama,"Mining, Quarrying, and Oil and Gas Extraction",2008,1045,315,115,135,565,160,85,810,235,1305,315,115,135,565,165,115,845,460,38049,312,392,1473,2779,5920,3069,13828,20594,2362306000,18369000,20450000,58221000,115989000,316401000,151806000,685071000,1592985000
Alabama,Other,2008,125,118,5,2,125,0,0,125,0,125,118,5,2,125,0,0,125,0,155,94,35,0,155,0,0,155,0,2493000,1806000,585000,0,2493000,0,0,2493000,0
Alabama,Other Services (except Public Administration),2008,52319,31605,11375,4918,47898,3481,439,51818,501,56340,31615,11500,5070,48185,4370,760,53315,3025,407020,59561,73566,63821,201151,118542,29036,358361,33177,8566690000,1238500000,1373891000,1283072000,3921972000,2310982000,650195000,7056394000,1215633000
Alabama,"Professional, Scientific, and Technical Services",2008,43498,28380,6750,3710,38840,2710,874,42424,1074,47125,28390,6760,3780,38930,3365,1195,43490,3635,477169,45797,42840,47138,140095,90810,67930,304147,156004,27136200000,1819957000,1753624000,2228718000,5850291000,5342694000,4715114000,16128115000,10396802000
Alabama,Real Estate and Rental and Leasing,2008,17110,12623,1897,995,15515,742,407,16664,446,22355,12630,2010,1155,15795,1355,1205,18355,4000,133883,19179,11610,11997,44113,20749,26300,93911,30655,4135676000,566791000,328827000,351118000,1261504000,694700000,884369000,2895088000,1040745000
Alabama,Retail Trade,2008,60787,33166,12689,6610,52465,5078,1176,58719,2068,95655,33220,12965,7310,53495,8465,4360,66320,29335,1082256,53337,78540,83332,222027,165430,95607,497879,533027,23577500000,1281424000,1721540000,1987517000,5037675000,4441075000,2489734000,12140613000,10564780000
Alabama,Total,2008,79812,43194,15160,9107,67461,7987,2017,77465,2347,103875,43259,15349,9588,68196,10723,5503,84422,19453,1714692,80104,100066,121129,301299,297858,247136,846293,868399,59827325000,2419258000,2791861000,3623405000,8834524000,9652355000,8472136000,26959015000,32868310000
Alabama,Transportation and Warehousing,2008,13421,7610,1740,1078,10428,1335,566,12329,1092,15605,7620,1740,1100,10460,1460,785,12705,2900,293110,11011,10254,13373,37735,41095,36738,121402,145644,10894549000,360659000,300049000,427739000,1120697000,1314077000,1339132000,3998758000,5940664000
Alabama,Utilities,2008,535,155,150,25,330,95,25,450,85,1885,155,150,25,330,195,75,600,1285,30832,293,931,234,1458,5114,2695,9312,51,2648625000,7760000,29409000,9879000,47048000,296190000,156760000,501916000,2409688000
Alabama,Wholesale Trade,2008,23040,9835,3723,2826,16384,3069,1374,20827,2213,28105,9860,3760,2945,16565,3900,2345,22810,5295,386600,15013,22844,33527,75144,88196,60476,241720,125951,18329135000,788133000,977465000,1563745000,3382043000,3891318000,2861101000,11030436000,6656936000
Alaska,Accommodation and Food Services,2008,8755,4543,1710,1197,7450,968,178,8596,159,10065,4550,1715,1215,7480,1265,695,9440,625,124054,5659,11200,15584,32749,34872,22771,91534,29451,2859543000,245219000,195849000,247554000,692209000,671816000,499340000,1883483000,932194000
Alaska,Administrative and Support and Waste Management and Remediation Services,2008,4736,2780,765,410,3955,271,158,4384,352,5420,2780,765,470,4015,330,275,4620,800,107955,3210,4420,3844,12926,5615,8682,33947,61887,5006713000,151819000,152369000,160160000,494665000,276607000,375308000,1489121000,3193685000
Alaska,"Agriculture, Forestry, Fishing and Hunting",2008,1555,1445,50,15,1510,35,0,1545,10,1565,1445,50,15,1510,40,0,1550,15,3600,592,202,0,1288,1092,0,2515,0,198006000,60895000,7721000,0,79157000,59870000,0,150681000,0
Alaska,"Arts, Entertainment, and Recreation",2008,2575,1790,310,250,2350,195,10,2555,20,2725,1795,320,290,2405,200,10,2615,110,18396,1250,1583,2610,6811,5120,0,13072,0,380807000,97283000,38820000,57901000,220753000,90666000,0,324399000,0
Alaska,Construction,2008,12543,8890,1760,975,11625,654,88,12367,176,12755,8890,1760,980,11630,680,130,12440,315,87375,9176,10958,12062,35867,21071,5469,65802,19518,7380095000,817858000,661851000,835227000,2380690000,1752330000,555338000,4980465000,2148552000
Alaska,Educational Services,2008,1105,560,220,125,905,110,50,1065,40,1250,560,220,125,905,120,170,1195,55,13136,388,1028,1301,3819,2768,3917,12385,320,320785000,18425000,26950000,28981000,95392000,65101000,113189000,303511000,8852000
Alaska,Finance and Insurance,2008,2208,1160,315,135,1610,131,125,1866,342,3945,1160,325,145,1630,265,390,2285,1660,33470,1537,1531,1206,4653,2991,0,11336,15927,2046069000,82147000,75613000,66012000,256366000,135648000,176384000,834644000,988948000
Alaska,Health Care and Social Assistance,2008,9273,4480,2235,1200,7915,760,385,9060,213,10635,4480,2245,1240,7965,1050,885,9900,735,189321,7277,14146,14338,37245,26150,42003,111718,62610,9098021000,463639000,728526000,819596000,2071669000,1156397000,1540145000,4896301000,3504793000
Alaska,Information,2008,1067,470,140,113,723,126,85,934,133,1875,470,150,130,750,210,230,1190,685,32141,455,419,411,1371,2375,1459,6076,7130,1846433000,23804000,18059000,18455000,93192000,109600000,120712000,385294000,1214698000
Alaska,Management of Companies and Enterprises,2008,518,60,10,25,95,105,125,325,193,655,60,10,25,95,105,145,345,310,28404,0,0,0,0,617,0,4213,23275,2913767000,0,0,1531000,8520000,30130000,0,257458000,2602848000
Alaska,Manufacturing,2008,2374,1215,425,265,1905,268,30,2203,171,2805,1220,425,270,1915,280,45,2240,565,53086,822,1549,1923,6158,5513,0,18253,34084,2134809000,78054000,91802000,84721000,306753000,225787000,0,751030000,1310888000
Alaska,"Mining, Quarrying, and Oil and Gas Extraction",2008,563,255,35,40,330,50,55,435,128,660,255,35,45,335,50,65,450,210,41491,63,132,40,558,80,3798,6606,33831,4493008000,23433000,9320000,7819000,70181000,7370000,468088000,712132000,3625782000
Alaska,Other,2008,35,33,2,0,35,0,0,35,0,35,33,2,0,35,0,0,35,0,0,0,0,0,0,0,0,0,0,850000,744000,0,0,850000,0,0,850000,0
Alaska,Other Services (except Public Administration),2008,8301,5085,1795,778,7658,377,100,8135,166,8775,5085,1805,830,7720,495,240,8455,320,50503,7027,10948,8722,30103,11756,2606,47675,859,1487912000,272910000,303978000,280417000,885831000,352167000,73067000,1379365000,63888000
Alaska,"Professional, Scientific, and Technical Services",2008,8536,5665,985,745,7395,526,192,8113,423,9300,5665,995,785,7445,685,235,8365,935,63828,7453,5989,8098,24133,13815,4661,45143,15516,4309226000,445011000,317946000,586776000,1392881000,1124794000,284778000,2942579000,1198335000
Alaska,Real Estate and Rental and Leasing,2008,3806,2740,470,205,3415,152,97,3664,142,4260,2745,475,240,3460,265,125,3850,410,24585,3043,2521,1556,8902,2243,3366,17256,1385,906231000,145091000,83747000,94879000,339775000,87312000,164419000,707352000,122445000
Alaska,Retail Trade,2008,9983,5035,1960,1394,8389,904,214,9507,476,12890,5055,2050,1575,8680,1410,510,10600,2290,161800,5679,10267,14024,32737,22141,10209,74878,48516,4563357000,245371000,319732000,472504000,1116481000,754540000,333312000,2431022000,1311666000
Alaska,Total,2008,16529,10029,2802,1662,14493,1172,316,15981,548,19934,10049,2846,1823,14718,1711,1017,17446,2488,248387,15238,18511,22077,55826,41209,35987,133022,115365,12113049000,717380000,702159000,912131000,2331670000,1814435000,1593795000,5739900000,6373149000
Alaska,Transportation and Warehousing,2008,4299,2560,503,295,3358,285,241,3884,415,5665,2565,510,310,3385,455,560,4400,1265,74070,1968,2483,1637,7548,6175,10955,30849,38535,4217676000,168872000,107342000,104280000,439045000,321341000,473357000,1498004000,2329563000
Alaska,Utilities,2008,282,100,40,37,177,65,35,277,5,445,105,40,80,225,90,115,430,15,8098,170,159,361,719,1849,3562,7682,0,633224000,4134000,13887000,21165000,41787000,133894000,295144000,591204000,0
Alaska,Wholesale Trade,2008,2944,1190,320,320,1830,408,166,2404,540,3805,1195,325,345,1865,560,260,2685,1120,37941,860,1044,2439,5692,7187,2796,19323,13794,2134635000,75822000,68648000,112006000,336078000,349984000,158440000,1030692000,832510000
Arizona,Accommodation and Food Services,2008,40146,13669,7710,7600,28979,8709,1285,38973,1173,58015,13685,7715,7720,29120,10165,4360,43645,14370,1296903,22341,51166,102449,177189,329534,191289,699543,595134,19797945000,564955000,567086000,1209998000,2343955000,4346416000,2657131000,9374199000,10373960000
Arizona,Administrative and Support and Waste Management and Remediation Services,2008,37371,21230,5430,3710,30370,3715,1476,35561,1810,42675,21260,5440,3820,30520,3895,1850,36265,6410,1224030,31147,34811,46738,114097,135197,207590,482288,740707,36971079000,1101962000,927843000,1274621000,3360954000,3974893000,5106813000,12820941000,24204789000
Arizona,"Agriculture, Forestry, Fishing and Hunting",2008,945,635,145,65,845,70,20,935,10,970,635,145,65,845,95,20,960,10,6781,632,750,292,2516,2019,0,6431,0,183761000,29896000,27081000,8795000,74420000,50246000,30100000,173376000,0
Arizona,"Arts, Entertainment, and Recreation",2008,8050,4540,1005,783,6328,1052,411,7791,259,8990,4540,1015,805,6360,1090,735,8185,805,202744,5015,4429,9721,18740,40876,62062,133405,60596,6129508000,245473000,95004000,167363000,537158000,712836000,2871970000,4293655000,1522987000
Arizona,Construction,2008,77184,43935,13705,8965,66605,8369,1380,76354,830,77995,43940,13720,8965,66625,8425,1545,76595,1400,1041280,74316,89669,120298,285345,330407,191369,807425,209208,41721520000,2465829000,2707020000,3860855000,9030960000,12360816000,7693280000,29276876000,11227439000
Arizona,Educational Services,2008,8230,3875,1285,1030,6190,1435,328,7953,277,9350,3880,1285,1035,6200,1530,510,8240,1110,240082,4975,8188,13413,26825,56446,32382,120149,107317,8465343000,246271000,173095000,301542000,738170000,1649105000,1015089000,3546714000,4525389000
Arizona,Finance and Insurance,2008,28172,19685,3003,1204,23892,1299,908,26099,2073,51635,19830,3070,1345,24245,2095,2455,28795,22840,688802,29718,17000,13459,61543,36746,45239,148515,525665,37445209000,1285956000,711907000,753694000,2773033000,2024743000,2165282000,7207250000,29724901000
Arizona,Health Care and Social Assistance,2008,64116,35500,13225,6904,55629,5274,1748,62651,1465,79275,35540,13350,7105,55995,7200,5530,68725,10550,1431625,55729,86788,87095,231059,194206,231290,668965,703534,63761363000,3872377000,3659999000,3866159000,11557180000,8272113000,9697856000,29346011000,32250467000
Arizona,Information,2008,6804,3350,880,590,4820,744,338,5902,902,11470,3350,885,590,4825,845,475,6145,5325,254043,3268,4777,7042,16959,21141,24914,67947,124126,15115382000,248120000,225685000,312879000,810229000,1177886000,1564385000,3828008000,8034461000
Arizona,Management of Companies and Enterprises,2008,3031,245,35,40,320,500,800,1620,1411,4245,245,35,40,320,515,845,1680,2565,254907,0,0,8,679,6862,23575,31132,223775,20449837000,30672000,0,249000,61120000,335605000,1400565000,1796942000,18652895000
Arizona,Manufacturing,2008,23567,9125,4120,3269,16514,4056,1232,21802,1765,24795,9125,4120,3270,16515,4140,1445,22100,2695,758277,11554,21934,35711,76541,131615,95321,345845,341458,39447927000,570316000,775601000,1271356000,2832736000,5315622000,3783354000,13295766000,22919551000
Arizona,"Mining, Quarrying, and Oil and Gas Extraction",2008,900,340,140,100,580,160,31,771,129,1235,340,140,100,580,180,55,815,420,31853,37,655,886,2112,5280,1204,9958,21452,2066885000,26459000,26030000,40362000,111895000,257161000,92943000,495713000,1542397000
Arizona,Other,2008,169,161,5,3,169,0,0,169,0,169,161,5,3,169,0,0,169,0,194,0,34,39,194,0,0,194,0,3476000,2810000,238000,428000,3476000,0,0,3476000,0
Arizona,Other Services (except Public Administration),2008,48480,29099,9315,5380,43794,3264,753,47811,669,54570,29125,9375,5550,44050,4340,2275,50665,3905,451702,52055,61119,69123,184800,112883,68006,374219,53678,11121786000,1331881000,1412829000,1693976000,4449069000,2686474000,1639792000,8971969000,1562084000
Arizona,"Professional, Scientific, and Technical Services",2008,77711,56365,9020,5347,70732,3795,1313,75840,1871,82915,56460,9055,5425,70940,4320,2020,77280,5635,630265,71709,57040,68810,206412,120508,80660,414982,197941,36376095000,4146426000,2650423000,3531776000,10327286000,6874582000,4771732000,22524190000,13439222000
Arizona,Real Estate and Rental and Leasing,2008,34415,27025,3039,1470,31534,1434,610,33578,837,43420,27045,3150,1685,31880,2300,1510,35690,7730,243197,33096,18833,17966,71576,42352,27975,149549,78445,9417778000,1343730000,593641000,644368000,2586642000,1707340000,1090012000,5590225000,3264379000
Arizona,Retail Trade,2008,56342,30250,11220,6462,47932,4243,1622,53797,2545,95560,30375,11530,7240,49145,6945,5425,61515,34045,1662062,44778,62506,71397,178555,133601,132922,467792,1082278,38460389000,1300441000,1436016000,1890233000,4661901000,3939224000,4788465000,13975552000,23117661000
Arizona,Total,2008,109823,64447,17851,11399,93697,10293,2813,106803,3020,140081,64568,18042,11826,94436,12711,6886,114033,26048,2334061,104115,117705,151618,373438,382771,338058,1094267,1239794,89799018000,4207062000,3586390000,4742176000,12535628000,12623249000,11977795000,37136672000,52662346000
Arizona,Transportation and Warehousing,2008,13952,7455,1995,1240,10690,1258,676,12624,1328,16490,7460,2000,1255,10715,1360,855,12930,3560,324219,7735,11014,14621,33562,37905,37807,120280,199710,11661467000,355743000,362709000,478036000,1231939000,1240158000,1231524000,3821206000,7738876000
Arizona,Utilities,2008,812,455,100,40,595,50,67,712,100,1290,455,105,40,600,105,175,880,410,5454,0,238,383,0,0,7636,11420,0,321147000,25862000,18667000,17175000,61704000,0,539604000,724712000,59937000
Arizona,Wholesale Trade,2008,29560,14730,3990,2983,21703,3480,1618,26801,2759,34665,14745,4050,3060,21855,4010,2345,28210,6455,502622,20174,23236,33882,82268,91526,64781,258820,224404,26475890000,1149228000,1099324000,1565098000,3922583000,4309343000,3087974000,11846980000,13817848000
Arkansas,Accommodation and Food Services,2008,19958,6960,3745,3795,14500,4266,596,19362,596,25890,6970,3775,3845,14590,4910,2145,21645,4245,467467,10577,24416,50849,86767,150566,75334,319552,147035,5370771000,225335000,267561000,530833000,1031224000,1616066000,780265000,3534831000,1834389000
Arkansas,Administrative and Support and Waste Management and Remediation Services,2008,11176,6435,1730,980,9145,967,359,10471,705,12510,6435,1745,990,9170,1120,495,10785,1725,293006,8905,10405,11427,33398,33921,36466,116463,168513,6821250000,285887000,274163000,274432000,889381000,818812000,700374000,2620678000,3929878000
Arkansas,"Agriculture, Forestry, Fishing and Hunting",2008,3528,2010,875,370,3255,160,30,3445,83,3660,2010,875,370,3255,175,30,3460,200,25906,3702,5367,4528,14033,3947,527,20894,2697,785961000,120544000,180577000,136413000,447077000,136921000,4746000,613929000,105722000
Arkansas,"Arts, Entertainment, and Recreation",2008,3969,2405,590,425,3420,417,67,3904,65,4070,2405,595,435,3435,460,95,3990,80,40686,3135,3456,4714,12331,13027,6602,35622,2115,727393000,89468000,55869000,72897000,228196000,233008000,119134000,621081000,42806000
Arkansas,Construction,2008,30253,18935,5370,3160,27465,2255,301,30021,232,30510,18935,5370,3160,27465,2295,380,30140,370,254512,30571,35110,41637,108540,83217,27703,229115,20319,9224860000,950880000,937438000,1376900000,3281645000,3033478000,1269814000,7939302000,1030132000
Arkansas,Educational Services,2008,2435,1260,330,275,1865,360,115,2340,95,2730,1260,330,275,1865,385,325,2575,155,66037,1823,1697,3205,7311,13543,13855,36592,24029,1287840000,49194000,32134000,59229000,144015000,274419000,301642000,881915000,381337000
Arkansas,Finance and Insurance,2008,12629,8680,1480,463,10623,724,420,11767,862,22875,8685,1530,605,10820,2115,2220,15155,7720,188853,13622,8346,5399,30166,26124,25904,86842,97404,8714200000,428719000,335443000,202588000,1030392000,1103343000,947870000,3301188000,5182244000
Arkansas,Health Care and Social Assistance,2008,29123,13930,6650,3570,24150,2797,1314,28261,862,36270,13930,6660,3680,24270,4075,3845,32190,4080,812484,22738,43941,45497,114353,117425,173390,409785,394537,29567345000,1368263000,1553129000,1785359000,4730797000,3684830000,4840043000,13584999000,15811912000
Arkansas,Information,2008,2736,1180,380,330,1890,345,110,2345,391,5195,1180,380,335,1895,425,180,2500,2695,105876,1080,1970,3889,8080,10349,3176,25629,56378,5059802000,50157000,56092000,112990000,236762000,425834000,200268000,961253000,2776318000
Arkansas,Management of Companies and Enterprises,2008,1597,95,50,40,185,335,451,971,626,5530,95,50,40,185,340,510,1035,4495,168540,0,0,201,60,4055,9868,14413,153629,12632780000,5196000,14022000,7168000,29871000,191355000,610459000,866145000,11766635000
Arkansas,Manufacturing,2008,13827,4645,2453,1815,8913,2169,1009,12091,1736,15085,4645,2460,1815,8920,2350,1220,12490,2595,800781,6250,12636,19741,43979,67671,68128,212970,524629,28062318000,226001000,349652000,571262000,1275895000,2230528000,2407321000,7018049000,18344597000
Arkansas,"Mining, Quarrying, and Oil and Gas Extraction",2008,1752,820,220,185,1225,210,68,1503,249,1985,820,220,185,1225,215,95,1535,450,35948,988,1028,2414,4929,5655,5539,18412,16202,2267374000,63788000,39644000,85688000,208990000,324296000,465154000,1062023000,1193908000
Arkansas,Other,2008,75,69,3,3,75,0,0,75,0,75,69,3,3,75,0,0,75,0,114,0,0,35,114,0,0,114,0,2249000,1625000,0,479000,2249000,0,0,2249000,0
Arkansas,Other Services (except Public Administration),2008,31701,20050,6507,2780,29337,1826,212,31375,326,33295,20065,6530,2880,29475,2410,395,32280,1015,213152,34606,41493,34933,115198,59983,11652,196223,13284,4485892000,729987000,800695000,707053000,2254568000,1095154000,278001000,3888806000,473658000
Arkansas,"Professional, Scientific, and Technical Services",2008,26919,19190,3956,1808,24954,1047,333,26334,585,28940,19195,3965,1910,25070,1375,800,27245,1695,169060,28300,25375,22488,77802,28058,18297,131784,28791,7453821000,1129924000,865111000,923642000,2961151000,1283991000,860137000,5387305000,1818645000
Arkansas,Real Estate and Rental and Leasing,2008,12464,9795,1205,508,11508,424,186,12118,346,15270,9800,1220,600,11620,875,545,13040,2230,65104,10685,7091,5663,23816,11204,4075,46313,11683,1809187000,345880000,175415000,169398000,713135000,319490000,141712000,1258654000,408475000
Arkansas,Retail Trade,2008,39110,20455,8855,4662,33972,2951,625,37548,1562,57335,20505,8985,5140,34630,4875,2920,42425,14910,567840,33352,56772,57378,154386,89629,41107,299055,259520,12518723000,772233000,1156617000,1349970000,3309936000,2425851000,1006329000,6967387000,5187188000
Arkansas,Total,2008,52699,30010,9624,5580,45214,4632,1189,51035,1664,66668,30034,9701,5860,45595,6433,3601,55629,11039,1026005,51807,63218,73640,188665,169552,143855,502072,523933,33809713000,1536677000,1616835000,2018889000,5172401000,4766425000,4371402000,14310228000,19499485000
Arkansas,Transportation and Warehousing,2008,11103,6565,1624,955,9144,850,272,10266,837,12765,6565,1625,990,9180,900,370,10450,2315,247518,9266,10185,11091,32426,27223,17014,79888,143491,9497140000,295521000,287358000,338856000,952799000,919414000,598244000,2581221000,6007736000
Arkansas,Utilities,2008,741,415,115,10,540,65,53,658,83,1755,415,115,10,540,145,165,850,905,32479,1005,0,0,1781,2909,8264,13365,559,2490994000,23890000,19003000,0,48117000,162800000,515684000,729937000,53136000
Arkansas,Wholesale Trade,2008,14436,5900,2034,1917,9851,2073,831,12755,1681,17295,5910,2060,2020,9990,2720,1270,13980,3315,228536,8454,11034,22443,45746,54664,25977,143823,75189,10072451000,368887000,441675000,903536000,1774742000,2279339000,1206501000,5992100000,3733673000
California,Accommodation and Food Services,2008,286729,115028,60451,52507,227986,50223,6337,284546,2183,380550,115265,60750,53640,229655,60080,23900,313635,66915,7047090,194532,395423,697442,1287397,1887710,1037111,4198887,2749511,121323930000,4241445000,5115551000,9582366000,18939362000,30581570000,18112724000,67886656000,52638505000
California,Administrative and Support and Waste Management and Remediation Services,2008,184436,108348,29071,18612,156031,18810,5702,180543,3893,216775,108455,29255,18900,156610,20950,8960,186520,30255,5653025,179034,190005,248534,619537,722252,859700,2249783,3376840,186264330000,7223103000,6169821000,8591221000,21997557000,25223617000,25115712000,72687339000,113182552000
California,"Agriculture, Forestry, Fishing and Hunting",2008,9518,6075,1345,860,8280,914,226,9420,98,9740,6075,1345,870,8290,985,310,9585,155,132465,8599,8321,10956,28555,38384,28946,97670,30703,4463631000,484855000,373199000,494009000,1365068000,1488063000,745229000,3657586000,684299000
California,"Arts, Entertainment, and Recreation",2008,94562,69080,9400,6174,84654,7130,1944,93728,834,100245,69115,9460,6230,84805,7855,2530,95190,5055,1526035,38334,59776,82495,216191,291154,300878,820967,679521,66017575000,18772447000,3003998000,3032288000,24843005000,6940188000,12847731000,45640575000,18965694000
California,Construction,2008,382679,231324,65995,42681,340000,36192,4936,381128,1551,387380,231330,66015,42745,340090,36645,6140,382875,4505,4205580,379289,435053,572574,1387054,1394015,796839,3582040,586110,209375330000,14943200000,16481625000,24693773000,56133490000,68871250000,42499528000,167522090000,39223802000
California,Educational Services,2008,51354,24315,8110,7028,39453,8761,2261,50475,879,58040,24335,8140,7165,39640,9935,3855,53430,4610,1682380,37309,52961,93856,184968,340843,354898,886015,793041,57387165000,1393605000,1242788000,2258201000,4906270000,10499676000,12296219000,27737470000,29594604000
California,Finance and Insurance,2008,149523,107222,18417,8661,134300,8322,3153,145775,3748,263790,108150,19055,9805,137010,13910,15205,166125,97665,3266847,170956,116009,111218,396504,284042,359658,1061124,2162197,283395796000,9139743000,7115027000,8906597000,25205965000,24993631000,30595463000,81464285000,200206748000
California,Health Care and Social Assistance,2008,419603,242006,91586,43692,377284,30160,8405,415849,3754,490170,242375,92480,45825,380680,42260,28390,451330,38840,8220627,436122,601912,573340,1620053,1157116,1190504,3975087,4217130,389884674000,24457961000,23990446000,23574267000,72047420000,43952269000,41305100000,157381115000,231957122000
California,Information,2008,72679,45813,8304,6122,60239,7327,2493,70059,2620,105420,45870,8350,6240,60460,8250,3890,72600,32820,2771402,53005,54287,79372,191019,273865,293111,764999,1912331,236693429000,8207111000,3496560000,5386370000,17209930000,20437472000,22563785000,60657295000,160306716000
California,Management of Companies and Enterprises,2008,16290,1420,420,565,2405,3377,4894,10676,5614,24715,1420,420,580,2420,3470,5330,11220,13495,1298405,1775,1844,3120,7189,41664,162450,211340,1087065,131623460000,229885000,139357000,317470000,686960000,2895800000,11243200000,14825960000,116797500000
California,Manufacturing,2008,205704,79310,37573,31627,148510,38711,10337,197558,8146,216200,79340,37610,31740,148690,39790,12275,200755,15445,6829728,139402,244048,420115,819319,1519794,1287878,3717501,2929245,365886984000,5983329000,8538110000,15670390000,30658647000,63986111000,62592667000,160539648000,194313036000
California,"Mining, Quarrying, and Oil and Gas Extraction",2008,3380,1545,390,450,2385,490,171,3046,334,4235,1545,390,465,2400,525,240,3165,1070,111575,2406,2506,3967,10965,15195,16580,43700,65824,9654996000,226031000,153092000,392326000,798527000,1040607000,1274879000,3189549000,6301594000
California,Other,2008,1687,1621,50,12,1683,4,0,1687,0,1687,1621,50,12,1683,4,0,1687,0,1864,0,290,0,1747,117,0,1864,0,46886000,39867000,4060000,0,45421000,1465000,0,46886000,0
California,Other Services (except Public Administration),2008,316444,201032,58643,29816,289491,22235,3187,314913,1531,351795,201150,58960,31160,291270,27520,9050,327840,23955,2884934,365312,380253,391937,1140134,781386,369579,2284581,536237,80651190000,9566652000,9694822000,10705854000,29973100000,21692473000,11789404000,63695284000,15999098000
California,"Professional, Scientific, and Technical Services",2008,526597,376003,70136,38365,484504,29197,7072,520773,5824,563685,376140,70415,39315,485870,34190,12605,532665,31020,5945795,561174,455388,505134,1528148,1031172,725205,3306860,2554717,439271365000,35194693000,25251865000,31852131000,92401365000,78118829000,57341629000,228730450000,208735389000
California,Real Estate and Rental and Leasing,2008,191257,144869,22923,10926,178718,8493,2308,189519,1738,240040,145220,23860,12615,181695,13830,10665,206190,33850,1488533,219338,144628,139426,503841,291808,230250,1031991,441485,68216783000,9122414000,5445103000,6032932000,20612224000,12995340000,10371823000,44186520000,23659467000
California,Retail Trade,2008,368055,215052,74732,39266,329050,28695,6316,364061,3994,556000,215795,76575,44030,336400,44100,25720,406220,149780,7997082,345108,474266,493816,1305563,1045808,725823,3140430,4526853,210261385000,9727035000,11242887000,13401686000,33994845000,32426664000,25809746000,93778045000,115056582000
California,Total,2008,717133,434466,123345,74972,632783,65362,13168,711313,5820,879025,435269,124809,78457,638535,82053,38041,758629,120396,13742925,723010,812028,1002297,2537335,2509871,1986743,7033949,6708976,659926263000,35083422000,29027641000,37885075000,101996138000,102935981000,89973740000,294905859000,365020404000
California,Transportation and Warehousing,2008,88996,48459,14325,9981,72765,9391,2907,85063,3933,108555,48485,14440,10225,73150,10935,5350,89435,19120,2333696,72417,90604,128874,296126,305653,226366,841187,1460234,97811274000,2774799000,3084949000,4673054000,10606512000,11966523000,10047958000,32979725000,64128352000
California,Utilities,2008,2461,1385,355,240,1980,164,70,2214,247,5515,1385,380,260,2025,205,185,2415,3100,19878,2602,2026,2806,7826,4446,7964,21110,10381,1503500000,100944000,102698000,174032000,388537000,320274000,584955000,1367662000,883270000
California,Wholesale Trade,2008,266410,146455,45289,29357,221101,29722,8579,259402,7008,303840,146790,45895,30415,223100,34810,15605,273515,30325,4438280,251340,293704,382992,932637,1033149,761391,2740867,1645394,291572260000,12541550000,13671740000,18909752000,45157628000,54427822000,45465988000,145490860000,144112474000
Colorado,Accommodation and Food Services,2008,46398,16640,8815,9183,34638,9646,975,45259,1139,61150,16655,8855,9280,34790,11310,3755,49855,11295,1189750,25582,57794,120704,205400,343009,147392,697726,479851,18708950000,695018000,725216000,1575390000,2987057000,5063387000,2322446000,10413195000,8215879000
Colorado,Administrative and Support and Waste Management and Remediation Services,2008,38307,23560,5665,3400,32625,3016,1013,36654,1653,42825,23575,5665,3425,32665,3245,1350,37260,5565,986792,30406,35800,43553,113215,110207,120890,354208,618531,36423605000,1321363000,1096845000,1418814000,3893927000,3737364000,3582402000,11512329000,24504206000
Colorado,"Agriculture, Forestry, Fishing and Hunting",2008,1440,1125,175,65,1365,55,10,1430,10,1440,1125,175,65,1365,55,10,1430,10,7021,1286,838,310,3155,1853,0,6981,0,211874000,46705000,33382000,15849000,111083000,53558000,0,207409000,0
Colorado,"Arts, Entertainment, and Recreation",2008,11575,7280,1580,945,9805,1181,317,11303,272,12260,7280,1580,945,9805,1290,400,11495,765,248664,7270,9976,11386,31690,44368,48456,130305,101372,6384892000,373808000,219628000,243323000,866905000,848507000,1111292000,3161141000,1756837000
Colorado,Construction,2008,96694,67055,13805,7880,88740,6227,988,95955,739,97450,67055,13810,7885,88750,6305,1125,96180,1270,862595,95505,90490,103443,296072,235684,131798,673700,159733,39641635000,3743010000,3322970000,4429298000,11528230000,10631941000,6618961000,29190175000,9880971000
Colorado,Educational Services,2008,10139,5880,1400,1015,8295,1300,304,9899,240,10635,5880,1400,1030,8310,1400,365,10075,560,212246,7667,9166,13606,31933,53339,31061,121986,80560,5844280000,296775000,240579000,336123000,878070000,1371208000,1148955000,3453515000,2067590000
Colorado,Finance and Insurance,2008,32841,23950,3302,1200,28452,1448,839,30739,2102,53825,24150,3420,1390,28960,2645,2995,34600,19225,519509,27773,20431,13247,72232,41081,52946,176222,332330,35021673000,1604525000,1040357000,929012000,3589337000,2506123000,2964657000,9826809000,24365918000
Colorado,Health Care and Social Assistance,2008,58226,31990,12159,6378,50527,4903,1572,57002,1224,69170,32005,12205,6645,50855,6435,4555,61845,7325,1211172,51617,79604,85184,218432,183520,231910,646034,538841,50794564000,2597849000,3277447000,3670407000,9558916000,7413505000,7963634000,25261294000,24351083000
Colorado,Information,2008,10064,5395,1310,850,7555,831,525,8911,1153,16015,5395,1310,880,7585,925,680,9190,6825,413694,5047,8235,9558,22017,21285,37496,99482,303892,27955609000,383068000,403994000,513673000,1354142000,1272622000,2339220000,5533888000,21682320000
Colorado,Management of Companies and Enterprises,2008,3323,245,105,85,435,582,838,1855,1468,4445,245,105,85,435,615,885,1935,2510,206250,0,0,53,1443,7072,21850,30470,175631,19253360000,39969000,75285000,42349000,173748000,551484000,2228015000,2957595000,16295765000
Colorado,Manufacturing,2008,25136,11120,4662,3198,18980,3499,1088,23567,1569,26125,11120,4670,3210,19000,3645,1230,23875,2250,604247,15639,26899,33902,84671,109923,65235,303738,254494,30327760000,692654000,947809000,1348564000,3255323000,4697373000,3033232000,12912815000,15051306000
Colorado,"Mining, Quarrying, and Oil and Gas Extraction",2008,5976,3505,655,610,4770,553,189,5512,464,6460,3505,655,620,4780,575,220,5575,885,125336,2964,3107,7581,12820,16432,17143,54232,70328,11711523000,436496000,342217000,661093000,1463488000,1823625000,1679093000,5165745000,6412102000
Colorado,Other,2008,167,160,6,1,167,0,0,167,0,167,160,6,1,167,0,0,167,0,168,109,43,0,168,0,0,168,0,4028000,3194000,811000,0,4028000,0,0,4028000,0
Colorado,Other Services (except Public Administration),2008,58522,37040,10978,5517,53535,3590,705,57830,692,64300,37055,11045,5760,53860,4635,1985,60480,3820,492504,64033,71373,70601,208745,122455,59148,396373,79363,13602355000,1747876000,1845882000,1860679000,5484032000,3251743000,1717830000,10643378000,2615902000
Colorado,"Professional, Scientific, and Technical Services",2008,110352,84400,11083,6385,101868,4594,1689,108151,2201,116305,84405,11130,6500,102035,5105,2380,109520,6785,821190,98159,71185,81258,266226,145841,95555,514384,291463,56014765000,5905775000,3632654000,4788465000,14348680000,9951770000,7441479000,32001755000,23502848000
Colorado,Real Estate and Rental and Leasing,2008,41648,33408,3787,1726,38921,1346,461,40728,920,48415,33430,3870,1860,39160,1870,950,41980,6435,257190,11166,23780,21823,89323,41310,17395,150683,73797,9853084000,1538807000,837701000,784932000,3179402000,1585683000,786247000,5695813000,3429612000
Colorado,Retail Trade,2008,63615,35260,13115,6962,55337,4499,1275,61111,2504,94950,35370,13405,7630,56405,6985,3880,67270,27680,1187719,52267,74755,78013,205668,140763,77039,452286,507363,30384447000,1511974000,1893764000,2250158000,5742522000,4666247000,2861700000,13812685000,12524447000
Colorado,Total,2008,130297,83112,19698,11848,114658,10017,2589,127264,3033,156684,83207,19883,12302,115392,12454,6030,133876,22808,2121718,127672,129831,157198,414701,362551,277417,1054669,1067049,91175156000,4996636000,4369670000,5593079000,14959385000,13618589000,11809857000,40387831000,50787325000
Colorado,Transportation and Warehousing,2008,15564,9780,1780,1054,12614,1144,554,14312,1252,17840,9785,1785,1060,12630,1215,750,14595,3245,305164,10873,10326,12070,36725,34724,21424,100548,197576,12038459000,472544000,385275000,431376000,1308220000,1337363000,811663000,3707714000,8227033000
Colorado,Utilities,2008,1016,590,90,55,735,137,40,912,104,1925,590,90,55,735,225,125,1085,840,48667,937,584,577,2261,5215,4869,12935,1995,3179144000,28338000,18020000,46497000,122551000,371210000,327266000,831842000,189510000
Colorado,Wholesale Trade,2008,31792,16580,4158,3115,23853,3124,1771,28748,3044,37050,16610,4210,3180,24000,3790,2510,30300,6750,516512,22350,24391,35031,87035,93707,57345,257902,245628,31750327000,1281186000,1254394000,1875118000,4462584000,4894420000,3330466000,13264799000,17938411000
Connecticut,Accommodation and Food Services,2008,32630,13915,6300,5980,26195,5211,620,32026,604,39650,13925,6320,6015,26260,5895,1825,33980,5670,650421,24566,41476,80746,147360,183699,82559,414936,234481,11358760000,582789000,606028000,1208718000,2401038000,3025796000,1036140000,6482864000,4858898000
Connecticut,Administrative and Support and Waste Management and Remediation Services,2008,24917,15585,3615,2040,21240,1909,658,23807,1110,27470,15585,3630,2065,21280,2040,825,24145,3325,472621,21106,23012,25472,71432,66126,73238,219544,252877,17484091000,1141113000,874342000,1038359000,3122623000,3496921000,2052203000,9046447000,7369612000
Connecticut,"Agriculture, Forestry, Fishing and Hunting",2008,425,305,85,20,410,10,0,420,5,425,305,85,20,410,10,0,420,5,1573,440,394,0,1155,0,0,1575,0,50901000,10643000,9396000,0,29340000,0,0,48765000,0
Connecticut,"Arts, Entertainment, and Recreation",2008,7807,4260,1062,1040,6362,1091,215,7668,139,8230,4260,1065,1050,6375,1140,305,7820,410,114635,4586,6414,12888,25836,45090,25979,102378,12788,3297679000,409477000,198723000,321289000,953060000,1255117000,426150000,2743810000,501649000
Connecticut,Construction,2008,46778,32575,7020,3775,43370,2849,322,46541,237,46945,32575,7020,3780,43375,2880,340,46595,350,309964,48611,45399,48999,147228,101155,35374,291915,8509,17858730000,2389695000,2125783000,2741824000,7279474000,6393890000,2301807000,16413049000,941555000
Connecticut,Educational Services,2008,5891,2615,1080,790,4485,878,353,5716,175,6220,2615,1095,790,4500,905,415,5820,400,320636,3463,6194,10208,21314,35535,55257,117131,193477,13000437000,163412000,163159000,234139000,571879000,1170422000,2306543000,4194402000,8452932000
Connecticut,Finance and Insurance,2008,19220,11100,2623,1595,15318,1493,765,17576,1644,33145,11145,2695,1730,15570,2380,2195,20145,13000,619594,19230,16081,18029,54767,47731,61154,170655,382949,81281262000,1470163000,1669649000,3382056000,6569264000,7463351000,12163237000,27793600000,47684795000
Connecticut,Health Care and Social Assistance,2008,38769,16010,9030,5729,30769,4629,2272,37670,1099,50690,16035,9160,6195,31390,6770,6230,44390,6300,1294055,31788,59506,76038,168093,170762,310506,659985,612375,55934733000,1557189000,2572810000,3669749000,7840923000,7742277000,11048224000,26814945000,28486343000
Connecticut,Information,2008,5344,2310,725,630,3665,669,314,4648,696,9020,2310,725,635,3670,730,385,4785,4235,186087,2887,3478,7330,15127,22868,20618,63881,116614,12755307000,286393000,227819000,371554000,935791000,1443448000,1076273000,3702864000,8988857000
Connecticut,Management of Companies and Enterprises,2008,2522,185,85,100,370,390,561,1321,1201,3670,185,85,100,370,390,620,1380,2290,190192,238,451,649,1338,4500,19437,25562,164630,22100290000,69502000,62659000,61942000,194103000,305488000,1452346000,1961435000,20138832000
Connecticut,Manufacturing,2008,23456,8204,4115,3510,15829,4786,1411,22026,1430,24130,8205,4115,3525,15845,4900,1495,22240,1890,744626,11573,23370,41105,82935,169414,125411,424309,227903,42399504000,716527000,1048619000,1928079000,3963442000,8718195000,6527143000,21515816000,14962287000
Connecticut,"Mining, Quarrying, and Oil and Gas Extraction",2008,277,115,50,50,215,20,10,245,32,370,115,50,50,215,20,25,260,110,3745,129,228,590,1105,345,0,1894,1282,239635000,16499000,16765000,28860000,69273000,32481000,0,134222000,69094000
Connecticut,Other,2008,124,120,4,0,124,0,0,124,0,124,120,4,0,124,0,0,124,0,0,0,26,0,0,0,0,0,0,4122000,3782000,340000,0,4122000,0,0,4122000,0
Connecticut,Other Services (except Public Administration),2008,43939,26380,9705,4577,40662,2465,382,43509,430,46590,26400,9765,4750,40915,2885,785,44585,2005,328251,49664,62135,57550,172658,80280,25603,286051,23499,9229574000,1350024000,1638166000,1606949000,4626002000,2202233000,866232000,7970712000,803770000
Connecticut,"Professional, Scientific, and Technical Services",2008,46330,30430,7065,3998,41493,2651,866,45010,1320,49030,30445,7090,4070,41605,2950,1090,45645,3385,485086,45334,43704,50285,141322,84727,57639,293323,180980,37028156000,2797632000,2634073000,3398449000,8882920000,6695212000,5382436000,21351576000,14622908000
Connecticut,Real Estate and Rental and Leasing,2008,13059,9115,1885,753,11753,562,286,12601,458,17155,9160,1965,820,11945,805,1310,14060,3095,108254,14700,11509,9197,36504,17528,11618,69865,16850,5162483000,679037000,481294000,408173000,1591541000,855649000,538898000,3143149000,1829467000
Connecticut,Retail Trade,2008,47564,26194,9081,5259,40534,3922,1048,45504,2060,67425,26245,9230,5630,41105,5265,2715,49085,18340,931055,38305,53021,57649,156914,117458,65812,350112,391267,25203938000,1247485000,1534914000,1889899000,4819632000,4859664000,2504394000,12241857000,8671781000
Connecticut,Total,2008,75842,42525,13532,8559,64616,7189,1974,73779,2063,92597,42577,13669,8886,65132,8728,4532,78392,14205,1551305,74798,88577,113206,276581,264029,239203,779813,771492,82768724000,3363222000,3556029000,5091685000,12010936000,12906296000,12608826000,37526058000,45242666000
Connecticut,Transportation and Warehousing,2008,7097,3240,1035,794,5069,913,365,6347,750,8520,3245,1035,815,5095,975,470,6540,1980,211438,4243,5718,8984,20073,28690,14396,70514,134744,8550983000,255600000,291996000,503453000,1104797000,1587706000,506095000,3495439000,4857824000
Connecticut,Utilities,2008,339,80,35,45,160,30,45,235,104,785,80,35,50,165,30,110,305,480,5393,62,0,543,869,726,5296,8319,0,4849152000,7332000,0,35504000,62675000,68100000,457905000,781478000,11522000
Connecticut,Wholesale Trade,2008,20396,9435,3146,2290,14871,2471,1153,18495,1901,22895,9450,3160,2340,14950,2670,1520,19140,3755,388323,13789,17431,26932,61562,73616,56145,212671,126295,27514587000,1103181000,1192584000,1815511000,4182579000,4962524000,3487041000,13792552000,10122748000
Delaware,Accommodation and Food Services,2008,7584,3020,1290,1335,5645,1360,259,7264,320,9365,3025,1290,1360,5675,1490,670,7835,1530,167500,4179,8149,15644,30248,51769,30855,113922,53077,2591257000,162614000,123788000,242691000,532958000,800062000,373168000,1720022000,867832000
Delaware,Administrative and Support and Waste Management and Remediation Services,2008,6442,3490,1015,565,5070,550,208,5828,614,7000,3490,1015,570,5075,585,215,5875,1125,141507,4618,5299,6418,17044,17079,15412,57173,64363,4695355000,214273000,180470000,205789000,610261000,547193000,443081000,1800095000,2457544000
Delaware,"Agriculture, Forestry, Fishing and Hunting",2008,205,170,15,15,200,0,0,200,5,205,170,15,15,200,0,0,200,5,718,80,0,0,508,0,0,508,0,22403000,7833000,0,0,17443000,0,0,17443000,0
Delaware,"Arts, Entertainment, and Recreation",2008,1855,1065,243,210,1518,220,60,1798,57,1965,1065,245,210,1520,245,80,1845,120,31266,878,1196,2238,4860,7427,2481,20187,6747,663429000,44853000,28980000,36389000,132353000,176772000,78257000,495732000,99921000
Delaware,Construction,2008,13118,8175,2130,1345,11650,1164,170,12984,134,13165,8175,2135,1345,11655,1175,175,13005,160,119283,12567,13500,16947,45233,42274,16696,108600,6531,5741080000,444324000,490187000,694690000,1655703000,2117446000,1038332000,5038861000,462197000
Delaware,Educational Services,2008,1313,550,223,155,928,205,95,1228,85,1375,550,225,155,930,225,95,1250,125,32581,549,1215,1871,4153,8645,12794,27188,3030,1076198000,21328000,20702000,33177000,88093000,205141000,458958000,795107000,138699000
Delaware,Finance and Insurance,2008,6551,3620,633,240,4493,378,338,5209,1342,11005,3645,655,270,4570,630,540,5740,5265,203109,2885,3437,2054,9773,7586,6027,27409,169155,14580051000,188934000,149474000,110131000,494095000,481857000,461969000,1885647000,12350253000
Delaware,Health Care and Social Assistance,2008,9296,3470,2125,1629,7224,1155,397,8776,520,12155,3475,2140,1735,7350,1645,1265,10260,1895,279252,6273,13709,20460,41398,38553,28852,122330,149169,12463613000,319069000,650526000,976823000,1975449000,1821702000,1151530000,5318751000,6935222000
Delaware,Information,2008,1101,505,120,128,753,115,45,913,188,1955,505,120,130,755,125,105,985,970,32212,203,380,978,2114,2678,1160,9509,18765,1681004000,16039000,29098000,57687000,133402000,136243000,42937000,431563000,983673000
Delaware,Management of Companies and Enterprises,2008,6321,3085,75,56,3216,316,771,4303,2018,7690,3100,75,75,3250,350,940,4540,3150,63672,0,0,0,3997,2104,5365,12186,49565,5013990000,55517000,0,0,137135000,117800000,250880000,524395000,4489595000
Delaware,Manufacturing,2008,3051,1095,420,465,1980,478,186,2644,407,3220,1095,420,470,1985,515,195,2695,525,115498,1002,1252,2534,7016,10541,7666,34164,72517,5445132000,50115000,62663000,138189000,297124000,486499000,366918000,1475436000,3570722000
Delaware,"Mining, Quarrying, and Oil and Gas Extraction",2008,57,25,5,5,35,15,0,50,7,75,25,5,5,35,15,0,50,25,186,0,0,0,0,138,0,162,0,16527000,242000,0,0,768000,15002000,0,15770000,0
Delaware,Other,2008,36,33,3,0,36,0,0,36,0,36,33,3,0,36,0,0,36,0,39,0,0,0,39,0,0,39,0,1002000,709000,293000,0,1002000,0,0,1002000,0
Delaware,Other Services (except Public Administration),2008,10294,6025,2210,944,9179,735,144,10058,236,10770,6025,2235,1000,9260,845,200,10305,465,76124,10060,13055,10898,36158,23613,5204,67562,4449,1976990000,281905000,325547000,264263000,929323000,542145000,136740000,1727897000,139556000
Delaware,"Professional, Scientific, and Technical Services",2008,11365,7370,1380,871,9621,846,310,10777,588,12030,7370,1380,920,9670,1025,365,11060,970,116726,7226,8241,10493,30016,24458,18546,75825,29232,8542661000,611487000,422871000,662369000,1743128000,1582892000,1762954000,5212449000,2469603000
Delaware,Real Estate and Rental and Leasing,2008,4885,3200,463,230,3893,273,178,4344,541,5890,3200,485,245,3930,460,315,4705,1185,29214,4098,2068,2056,9628,5868,3518,21415,4256,1135699000,238972000,99169000,84424000,442270000,232457000,153395000,894172000,192479000
Delaware,Retail Trade,2008,13651,6745,2385,1363,10493,1172,420,12085,1566,19020,6770,2410,1455,10635,1770,695,13100,5920,263044,9012,13186,13515,41783,34547,18022,105894,143837,6442919000,309282000,315493000,361821000,1051650000,1089341000,699220000,3064321000,3172667000
Delaware,Total,2008,20364,11172,3131,2013,16316,1891,715,18922,1442,25174,11193,3167,2115,16475,2400,1291,20166,5008,389510,18098,20535,26770,65403,66233,50869,182505,207005,17566447000,694196000,686873000,934687000,2315756000,2532502000,2103117000,6951375000,10615072000
Delaware,Transportation and Warehousing,2008,3249,1820,393,250,2463,317,130,2910,339,3470,1820,395,250,2465,345,135,2945,525,64855,1126,1675,1992,6165,7519,4636,23211,21808,2059795000,82147000,42757000,55636000,214172000,271144000,133874000,768516000,1038504000
Delaware,Utilities,2008,142,75,10,5,90,0,15,105,37,230,75,20,5,100,0,25,125,105,6250,0,0,0,0,0,0,0,0,548600000,5488000,0,0,4128000,0,0,0,0
Delaware,Wholesale Trade,2008,4632,2220,550,340,3110,500,360,3970,662,5105,2220,555,360,3135,555,440,4130,975,62447,1894,2433,2748,8377,7537,6725,30345,28365,4965428000,169633000,127116000,133177000,543985000,351279000,443139000,1603669000,2413309000
District of Columbia,Accommodation and Food Services,2008,8254,3140,1410,1225,5775,1640,360,7775,479,11095,3140,1410,1245,5795,1725,610,8130,2965,270060,5898,8839,15408,30232,62446,25581,120059,134449,6865938000,154748000,161717000,300928000,618277000,1332209000,562158000,2557546000,3836712000
District of Columbia,Administrative and Support and Waste Management and Remediation Services,2008,4039,1570,450,300,2320,575,514,3409,630,5505,1575,455,310,2340,580,590,3510,1995,186208,1401,2434,2538,7729,16926,50510,82405,97061,6687442000,166693000,136686000,156944000,546752000,771862000,1557873000,3125158000,3316691000
District of Columbia,"Agriculture, Forestry, Fishing and Hunting",2008,5,5,0,0,5,0,0,5,0,5,5,0,0,5,0,0,5,0,0,0,0,0,0,0,0,0,0,0,0,0,0,0,0,0,0,0
District of Columbia,"Arts, Entertainment, and Recreation",2008,1265,665,165,145,975,140,60,1175,90,1445,665,165,145,975,145,130,1250,195,36956,679,616,838,2241,4962,7757,18599,14267,1735668000,47996000,51488000,37670000,175772000,166379000,256602000,644416000,555275000
District of Columbia,Construction,2008,1970,900,345,275,1520,310,80,1910,60,2000,900,345,275,1520,310,85,1915,85,32094,934,1850,3131,6359,10425,5572,24970,1529,1958874000,62927000,102255000,195252000,381090000,607824000,310736000,1473541000,149823000
District of Columbia,Educational Services,2008,2462,830,350,320,1500,496,288,2284,178,2750,830,350,320,1500,590,330,2420,330,233819,408,1344,3169,6192,20976,32896,66301,165066,10443428000,65778000,91311000,121179000,302203000,896979000,1484470000,2897096000,7447095000
District of Columbia,Finance and Insurance,2008,3060,1075,285,205,1565,437,213,2215,845,5435,1075,285,215,1575,580,385,2540,2895,61356,700,997,1981,3321,7527,5007,19996,35436,8189477000,152736000,171693000,254573000,583886000,818335000,452475000,2193169000,5559186000
District of Columbia,Health Care and Social Assistance,2008,8894,4230,1645,1022,6897,1128,469,8494,400,10365,4245,1645,1115,7005,1380,920,9305,1060,300988,7347,10045,12141,30888,31813,51517,119519,165809,15300854000,490767000,559636000,632064000,1706634000,1386648000,1644119000,4795055000,9882882000
District of Columbia,Information,2008,2495,910,270,200,1380,340,199,1919,576,3700,910,275,200,1385,345,200,1930,1770,99580,872,640,1762,4051,5721,9153,27184,72083,10038575000,99252000,92754000,158257000,377050000,520872000,722237000,2173989000,7337302000
District of Columbia,Management of Companies and Enterprises,2008,812,35,0,25,60,75,161,296,516,970,35,0,25,60,75,165,300,670,39641,0,0,194,0,976,4494,6329,33312,4149560000,0,0,32999000,41163000,74630000,318159000,475636000,3669682000
District of Columbia,Manufacturing,2008,605,300,115,80,495,65,20,580,25,615,300,115,80,495,70,20,585,30,8168,331,452,566,1678,1247,428,4699,1112,329297000,18195000,19455000,22870000,71433000,47911000,14470000,167205000,53781000
District of Columbia,"Mining, Quarrying, and Oil and Gas Extraction",2008,10,5,0,0,5,0,5,10,0,10,5,0,0,5,0,5,10,0,0,0,0,0,0,0,0,0,0,0,0,0,0,0,0,0,0,0
District of Columbia,Other,2008,52,50,2,0,52,0,0,52,0,52,50,2,0,52,0,0,52,0,0,0,0,0,0,0,0,0,0,1384000,1215000,0,0,1384000,0,0,1384000,0
District of Columbia,Other Services (except Public Administration),2008,17945,7815,3580,2363,13758,2841,1014,17613,332,20435,7815,3595,2405,13815,2995,1395,18205,2230,355020,13603,22956,30154,69135,98701,108157,275990,57052,22159102000,850824000,1263364000,1759193000,3889596000,6614079000,7849672000,18460726000,2945295000
District of Columbia,"Professional, Scientific, and Technical Services",2008,20736,10825,2953,1875,15653,2125,1192,18970,1766,23035,10825,2955,1880,15660,2155,1370,19185,3850,443263,12937,16501,22155,53299,60342,64837,185909,248964,48788101000,1960533000,1755431000,2398509000,6284474000,6018577000,6207907000,19020249000,29475157000
District of Columbia,Real Estate and Rental and Leasing,2008,3704,2105,465,270,2840,331,204,3375,329,5520,2130,495,275,2900,560,375,3835,1685,48665,2862,2156,2805,10010,9490,10520,30789,15461,3200564000,188170000,151486000,139061000,500132000,554391000,730091000,1860646000,1195219000
District of Columbia,Retail Trade,2008,7402,3965,1355,555,5875,437,269,6581,821,9105,3975,1365,580,5920,565,440,6925,2180,90784,6074,6052,4507,17761,5465,3257,34830,44861,2487047000,196025000,175663000,128953000,547090000,189987000,77244000,1090023000,1132452000
District of Columbia,Total,2008,16865,7932,2740,1805,12477,2187,963,15627,1238,21081,7945,2757,1852,12554,2469,1445,16468,4613,466050,14202,17911,23583,55696,75171,87437,218304,247746,30292302000,982327000,1037874000,1400995000,3421196000,4334427000,4988467000,12744090000,17548212000
District of Columbia,Transportation and Warehousing,2008,755,325,70,35,430,85,76,591,164,875,325,70,35,430,90,85,605,270,9777,181,191,68,433,765,1030,3541,3395,456323000,31198000,19440000,2093000,58185000,23292000,45679000,167302000,139533000
District of Columbia,Utilities,2008,155,10,0,5,15,0,5,20,135,210,10,0,5,15,0,5,20,190,1,0,0,0,6,0,0,6,0,6103000,0,0,0,498000,0,0,1422000,5197000
District of Columbia,Wholesale Trade,2008,1696,705,245,145,1095,170,105,1370,326,2070,710,250,150,1110,180,115,1405,665,22039,762,797,1105,3620,2793,674,9335,9795,1641605000,56605000,47432000,68409000,242670000,180684000,51638000,631448000,728380000
Florida,Accommodation and Food Services,2008,130378,58545,23970,20516,103031,22132,3321,128484,1894,175550,58720,24070,20720,103510,24380,9495,137385,38165,3844637,95555,159493,276560,532190,847412,538675,1918839,1903775,60655725000,2339760000,1972865000,3406710000,7719335000,11634895000,8252434000,27611690000,32685494000
Florida,Administrative and Support and Waste Management and Remediation Services,2008,146800,103942,17619,10139,131700,8724,3001,143425,3375,164240,104030,17735,10275,132040,9330,4510,145880,18360,6969879,147133,113479,133884,406658,328158,405786,1158950,5752058,218149134000,4767699000,3224840000,4077296000,12073500000,9788132000,11200123000,33251317000,182809259000
Florida,"Agriculture, Forestry, Fishing and Hunting",2008,4992,3280,765,415,4460,336,121,4917,75,5105,3280,765,415,4460,385,135,4980,125,70032,4615,4898,5230,14948,10726,17336,45808,18723,1754491000,154564000,157152000,160929000,479699000,305533000,334337000,1166684000,515702000
Florida,"Arts, Entertainment, and Recreation",2008,35155,22835,4260,2760,29855,3473,1166,34494,661,37190,22840,4265,2785,29890,3620,1410,34920,2270,802144,22932,27227,36123,97881,151402,178068,431552,352905,21759751000,1484502000,744149000,675064000,2988401000,3055965000,7243398000,13386381000,7895711000
Florida,Construction,2008,263104,185234,34500,21714,241448,17771,2675,261894,1210,266155,185250,34500,21755,241505,18165,3305,262975,3180,2175420,239745,227330,291020,794931,674410,393116,1868915,277358,85017310000,7979710000,6925365000,10337676000,25248125000,27066510000,17168776000,69578945000,14760444000
Florida,Educational Services,2008,25328,14410,3138,2575,20123,3643,1023,24789,539,28065,14410,3150,2630,20190,4075,1535,25800,2265,679530,19069,20614,34130,75471,147802,141801,371405,304852,22292415000,638555000,419986000,756701000,1818595000,4041211000,4420666000,10425265000,11690848000
Florida,Finance and Insurance,2008,96920,69969,12543,4958,87470,4319,2003,93792,3128,169785,70360,12805,5645,88810,7535,9125,105470,64315,1924619,103152,78132,62022,244640,138067,178799,577550,1318039,114377186000,4733530000,3614296000,3375728000,11829514000,8243326000,10036084000,30754203000,82603890000
Florida,Health Care and Social Assistance,2008,221093,123917,49421,25106,198444,15052,4732,218228,2865,261185,124095,49690,25975,199760,20790,14770,235320,25865,4619691,207867,324213,329204,868085,561958,692969,2141272,2447873,194872475000,11470768000,13749034000,13949492000,39197548000,24544327000,24944276000,89035528000,104297849000
Florida,Information,2008,25086,16320,3015,1650,20985,1765,854,23604,1482,41820,16340,3015,1695,21050,1990,1515,24555,17265,814079,16645,17783,21718,60852,58197,62804,193497,617780,46377994000,1119454000,828247000,949938000,2945003000,3007153000,3297566000,9609267000,36643214000
Florida,Management of Companies and Enterprises,2008,8078,1190,235,270,1695,1350,1928,4973,3105,13230,1200,235,270,1705,1370,2060,5135,8095,739095,1809,1319,2713,5865,16360,64840,87065,652030,51191735000,217900000,81712000,265619000,569350000,1065520000,4813195000,6448065000,44743670000
Florida,Manufacturing,2008,65502,32415,10909,7745,51069,8598,2614,62281,3221,69335,32415,10925,7755,51095,8860,2865,62820,6515,1614371,50054,66592,94513,223730,308653,245782,836083,675381,69946733000,1822148000,2092384000,3245233000,7457159000,11652376000,9677545000,30737191000,34120571000
Florida,"Mining, Quarrying, and Oil and Gas Extraction",2008,1149,585,135,130,850,120,52,1022,127,1405,585,135,130,850,130,95,1075,330,24383,51,677,1524,2851,3668,1889,9262,14720,1425093000,43850000,26181000,50858000,136855000,161841000,89047000,400903000,1026127000
Florida,Other,2008,512,480,27,4,511,1,0,512,0,512,480,27,4,511,1,0,512,0,735,0,169,46,0,0,0,735,0,14278000,10635000,2800000,647000,14082000,0,0,14278000,0
Florida,Other Services (except Public Administration),2008,202574,137345,34222,17071,188638,11206,1615,201459,1115,219240,137465,34330,17365,189160,13115,4185,206460,12780,1553625,237949,221997,221839,683565,393299,169466,1256692,258411,36734140000,5459322000,4973017000,5120174000,15584050000,9178991000,3975812000,28903290000,7261463000
Florida,"Professional, Scientific, and Technical Services",2008,323462,249971,35760,18488,304219,12711,3365,320295,3167,342795,250100,35875,18895,304870,15215,6350,326435,16360,2181504,342484,230311,239271,828227,417720,261465,1518109,621454,126734947000,18130656000,10788366000,12479492000,41413383000,24660452000,16932952000,83285103000,42296636000
Florida,Real Estate and Rental and Leasing,2008,123453,102053,10897,4584,117534,3101,1337,121972,1481,151130,102260,11265,5160,118685,4415,5170,128270,22860,845296,100676,68475,55403,260371,97638,102611,463258,351967,31045326000,4410553000,2201680000,1918631000,8607545000,3583490000,3627508000,16034761000,14766360000
Florida,Retail Trade,2008,229755,154915,38656,17658,211229,11668,3269,226166,3589,360590,155340,39445,19935,214720,18685,10670,244075,116515,4537031,209241,230290,206984,680805,397921,297000,1408857,2237054,108981243000,6289713000,5542408000,5422274000,17365397000,12336216000,10162483000,40970834000,54256946000
Florida,Total,2008,414799,281649,61177,33904,376730,27114,6495,410339,4460,507027,282098,61711,35296,379105,33603,17356,430064,76963,7366571,446406,400160,448754,1295320,1010251,854824,3160395,4206176,267429672000,15969201000,12883768000,14916584000,43769553000,34993322000,31408251000,110171126000,157258546000
Florida,Transportation and Warehousing,2008,55612,38794,6145,3561,48500,3091,1496,53087,2525,64245,38850,6180,3640,48670,3435,2165,54270,9975,1057930,46266,38015,43641,138567,97691,91612,339928,669892,41056699000,1833767000,1289802000,1472159000,4629628000,3419875000,3564163000,11923121000,28881049000
Florida,Utilities,2008,1444,680,280,82,1042,129,102,1273,171,2945,680,280,95,1055,210,335,1600,1345,132962,1047,1721,600,3468,5320,16229,26262,104581,9926132000,43168000,68533000,27998000,144740000,257595000,1060600000,1500988000,8282852000
Florida,Wholesale Trade,2008,138486,89763,19614,10844,120221,10173,3763,134157,4329,158565,89870,19755,11320,120945,12305,7085,140335,18230,1569835,135663,123078,138310,407076,317963,242741,986658,539119,75348985000,6167910000,5288061000,6132473000,17627423000,15053117000,10666977000,43876114000,29660760000
Georgia,Accommodation and Food Services,2008,67548,26395,12080,12129,50604,13843,1700,66147,1401,93850,26410,12115,12285,50810,15580,6585,72975,20875,1852564,43166,80762,166927,291539,505841,253746,1052089,795872,25108737000,944547000,930765000,1918830000,3797272000,6063962000,3302775000,13177142000,11923063000
Georgia,Administrative and Support and Waste Management and Remediation Services,2008,53017,32530,7338,4550,44418,4499,1785,50702,2315,62475,32645,7365,4610,44620,4645,2455,51720,10755,1737340,46034,46991,58101,157527,170723,233309,573384,1128293,48989799000,2037491000,1471518000,1958683000,5507693000,5098535000,6664444000,17564094000,30523633000
Georgia,"Agriculture, Forestry, Fishing and Hunting",2008,4890,2545,1145,685,4375,421,50,4846,44,5005,2550,1145,685,4380,435,105,4920,85,38449,4083,7236,9062,21109,12469,520,36223,309,1304537000,153903000,234929000,295850000,692021000,414299000,56939000,1220702000,16767000
Georgia,"Arts, Entertainment, and Recreation",2008,12970,7765,1790,1310,10865,1550,302,12717,253,13785,7765,1790,1320,10875,1660,435,12970,815,214279,8747,11144,17034,39416,60640,42244,146552,34334,6269795000,388550000,201475000,324522000,942717000,1060399000,1307791000,3712672000,1116480000
Georgia,Construction,2008,106500,68185,17246,10464,95895,8578,1164,105637,863,107775,68190,17280,10465,95935,8680,1395,106010,1765,1068310,110865,113400,140060,366625,324300,174556,869035,186728,43971590000,3614325000,3670865000,4931725000,12216915000,13676380000,7629727000,33685575000,9540725000
Georgia,Educational Services,2008,11868,6415,1715,1300,9430,1600,483,11513,355,13010,6420,1725,1380,9525,1725,565,11815,1195,378421,8438,11174,17311,37720,68623,74334,184271,193439,13167083000,276729000,213885000,337604000,835550000,1767239000,2340955000,5022098000,8094256000
Georgia,Finance and Insurance,2008,41646,27652,5199,2218,35069,2795,1400,39264,2382,78700,27800,5395,2765,35960,5855,5795,47610,31090,871578,40077,30851,25357,94341,91050,101483,307468,442671,55387241000,1864327000,1473605000,1540826000,4935321000,4688131000,5777757000,15736607000,38571296000
Georgia,Health Care and Social Assistance,2008,87747,42335,20030,12375,74740,9206,1922,85868,1879,106030,42390,20155,12925,75470,11805,5945,93220,12810,2128260,72494,133562,162709,370194,335138,273139,989806,1091737,87414278000,4534057000,5555627000,6797041000,16933420000,13213810000,9430540000,39916455000,46646221000
Georgia,Information,2008,11368,5695,1525,970,8190,1250,591,10031,1337,21285,5710,1525,1045,8280,1385,1010,10675,10610,588471,7170,9126,11964,29424,42021,47146,122156,458154,38962494000,402040000,369413000,588680000,1431755000,2334233000,2917584000,6766216000,31320672000
Georgia,Management of Companies and Enterprises,2008,5648,510,160,155,825,856,1331,3012,2636,8435,510,160,155,825,875,1410,3110,5325,576515,0,123,1240,2364,10735,35775,49425,527090,50365155000,71053000,7993000,65320000,203805000,597600000,2334030000,3135435000,47229720000
Georgia,Manufacturing,2008,38782,14070,6205,5240,25515,6374,2706,34595,4187,42855,14070,6205,5250,25525,6670,3235,35430,7425,1904854,22105,36589,62878,130210,234176,249778,665277,1145944,76041133000,888227000,1158610000,2129958000,4481437000,8562330000,9193028000,24086853000,48171587000
Georgia,"Mining, Quarrying, and Oil and Gas Extraction",2008,632,180,160,55,395,90,42,527,105,1020,180,160,55,395,90,55,540,480,28471,195,776,642,1993,2240,1040,8561,17169,1502795000,26520000,30127000,26379000,103911000,88546000,58611000,446906000,907228000
Georgia,Other,2008,259,246,10,3,259,0,0,259,0,259,246,10,3,259,0,0,259,0,0,0,65,33,0,0,0,0,0,6245000,4638000,1047000,560000,6245000,0,0,6245000,0
Georgia,Other Services (except Public Administration),2008,97169,60825,18884,9223,88932,6241,1077,96250,919,104345,60855,18945,9410,89210,7670,1680,98560,5785,832472,108999,121463,120093,354762,221000,97414,681026,124651,20829745000,2570644000,2670680000,2810811000,8073757000,4969589000,2602495000,15883215000,4075775000
Georgia,"Professional, Scientific, and Technical Services",2008,132023,97094,15103,8240,120437,6632,2209,129278,2745,139540,97110,15135,8365,120610,7405,3060,131075,8465,1142664,120496,96902,107559,339787,222046,148534,721190,388136,69109845000,6819510000,4580807000,5593267000,17041040000,13375397000,8940277000,39754373000,27775331000
Georgia,Real Estate and Rental and Leasing,2008,44412,34713,4073,2035,40821,1652,822,43295,1117,58315,34800,4215,2290,41305,2520,2970,46795,11520,293551,30274,25276,25521,94389,50014,36922,192578,100217,12719436000,1498281000,840753000,976508000,3332532000,2287621000,1864064000,7702839000,5096980000
Georgia,Retail Trade,2008,113277,69525,21275,10348,101148,7202,1953,110303,2974,176855,69710,21650,11230,102590,10710,6380,119680,57175,2149434,112173,134946,130076,389442,240660,148215,802529,1305941,48300725000,2802626000,2955240000,3257647000,9064008000,7292405000,4756182000,21408247000,26371283000
Georgia,Total,2008,179576,108496,29082,17858,155436,15920,4218,175574,4002,227593,108679,29354,18567,156600,19620,10032,186252,41341,3633431,178649,191039,237778,607466,580402,466351,1654219,1979212,142779694000,6456452000,5964620000,7733624000,20154696000,19777345000,17530967000,57463008000,85316686000
Georgia,Transportation and Warehousing,2008,26021,15085,2860,2100,20045,2246,1317,23608,2413,31175,15110,2870,2135,20115,2480,1800,24395,6780,804539,18187,17832,26130,67702,62889,63599,201871,593855,32575625000,703347000,550916000,841650000,2131486000,2124889000,2359536000,6810915000,25597869000
Georgia,Utilities,2008,624,170,60,20,250,140,120,510,114,2775,170,60,20,250,225,330,805,1970,35755,0,344,132,434,6979,20169,28546,100,2601710000,18995000,7279000,16301000,38444000,369287000,1262211000,1707865000,4543000
Georgia,Wholesale Trade,2008,59377,29707,8712,6259,44678,6656,3534,54868,4509,69440,29770,8825,6430,45025,7685,4950,57660,11780,1025492,35197,55104,76097,181925,190348,172867,560115,436223,58072240000,2403055000,2523629000,3625618000,8605488000,9277537000,8866084000,27379335000,29771241000
Hawaii,Accommodation and Food Services,2008,13867,4953,2675,2529,10157,2811,472,13440,427,17695,4985,2685,2570,10240,3265,1180,14685,3010,494388,7772,16981,33278,58779,108190,67790,234572,253281,11440851000,200693000,242565000,448013000,894885000,1799275000,1453429000,4166579000,7200048000
Hawaii,Administrative and Support and Waste Management and Remediation Services,2008,8273,4380,1330,813,6523,940,369,7832,441,9450,4380,1335,845,6560,1125,690,8375,1075,236169,5780,8121,9059,24510,29885,47945,112232,59259,6493896000,228309000,212074000,272744000,740510000,907962000,1161096000,3017368000,1630367000
Hawaii,"Agriculture, Forestry, Fishing and Hunting",2008,205,160,15,5,180,20,5,205,0,205,160,15,5,180,20,5,205,0,1270,48,0,0,333,0,0,1270,0,25178000,2594000,478000,0,7352000,3016000,0,25178000,0
Hawaii,"Arts, Entertainment, and Recreation",2008,2306,1090,295,290,1675,382,164,2221,85,2470,1090,295,295,1680,405,250,2335,135,52255,1109,1447,2598,5683,14991,18928,44592,2917,1190756000,58981000,33605000,56575000,173741000,286320000,465260000,1024175000,86345000
Hawaii,Construction,2008,14429,7795,2930,1815,12540,1439,235,14214,215,14610,7795,2930,1815,12540,1465,295,14300,310,169372,11217,18158,23726,55686,50084,28800,144690,19373,9941890000,549560000,789077000,1146315000,2505252000,2975182000,2005485000,8099301000,1505770000
Hawaii,Educational Services,2008,2535,1080,460,330,1870,435,110,2415,120,2755,1085,460,330,1875,470,200,2545,210,95374,1495,2639,3960,8843,14891,17108,42449,51905,3065395000,40869000,49598000,84027000,187449000,378602000,654833000,1282570000,1761582000
Hawaii,Finance and Insurance,2008,4699,2796,470,315,3581,273,202,4056,643,8010,2830,490,360,3680,560,700,4940,3070,92447,3609,2321,3574,10730,7815,11746,31706,54564,5276044000,209312000,130391000,194162000,546855000,379536000,641340000,1694538000,3363930000
Hawaii,Health Care and Social Assistance,2008,14568,7749,3760,1357,12866,926,480,14272,296,17420,7755,3785,1495,13035,1420,1510,15965,1455,312309,14672,23637,16015,55343,35128,71965,170913,113738,13913099000,818063000,1033418000,739716000,2612473000,1367578000,2979033000,7232866000,5663578000
Hawaii,Information,2008,1771,825,280,150,1255,175,70,1500,271,3100,825,290,160,1275,220,140,1635,1465,48556,819,1144,573,3578,4661,951,13573,32193,2600359000,44697000,56090000,53029000,183898000,216523000,49280000,624046000,1798082000
Hawaii,Management of Companies and Enterprises,2008,947,15,35,60,110,225,256,591,356,1250,15,35,65,115,225,295,635,615,32345,0,88,327,443,2594,7277,10615,21655,1969765000,0,6947000,29864000,39145000,133069000,345715000,519515000,1437628000
Hawaii,Manufacturing,2008,4523,2175,795,655,3625,624,116,4365,158,4705,2175,795,665,3635,660,170,4465,240,56390,2155,3150,6341,14503,15607,3700,44179,5207,1810918000,91442000,90152000,182979000,410994000,478368000,111928000,1371869000,246999000
Hawaii,"Mining, Quarrying, and Oil and Gas Extraction",2008,46,10,5,10,25,0,5,30,16,50,10,5,10,25,0,5,30,20,799,0,0,0,0,0,0,0,0,64536000,0,0,0,2597000,0,0,0,0
Hawaii,Other,2008,42,42,0,0,42,0,0,42,0,42,42,0,0,42,0,0,42,0,0,0,0,0,0,0,0,0,0,794000,794000,0,0,794000,0,0,794000,0
Hawaii,Other Services (except Public Administration),2008,15790,10220,2615,1460,14295,1025,255,15575,215,17610,10250,2625,1495,14370,1405,665,16440,1170,130795,17485,15963,16902,53004,32046,17083,111045,8356,3423438000,480137000,445088000,495908000,1474228000,872878000,437737000,3004075000,208031000
Hawaii,"Professional, Scientific, and Technical Services",2008,15264,10060,2240,1127,13427,948,283,14658,606,16485,10060,2240,1170,13470,1095,380,14945,1540,117012,14157,13999,14114,42790,28544,12596,89747,23449,6498341000,789065000,682457000,765720000,2294018000,1824377000,722243000,5040619000,1314382000
Hawaii,Real Estate and Rental and Leasing,2008,8412,5873,1107,489,7469,416,224,8109,303,10185,5910,1155,540,7605,650,325,8580,1605,69855,7377,6059,4472,17663,10588,7530,44138,12162,2933754000,407003000,231944000,191050000,874669000,427503000,301189000,1749073000,571332000
Hawaii,Retail Trade,2008,16117,7829,3485,1933,13247,1308,496,15051,1066,24455,7870,3585,2190,13645,2410,2090,18145,6310,342126,9603,17802,20110,47345,35450,32122,131680,156635,8623391000,323852000,487671000,508500000,1356363000,974744000,1008083000,3629483000,4108251000
Hawaii,Total,2008,26360,14509,4876,2894,22279,2524,675,25478,882,32904,14556,4951,3077,22584,3446,2011,28041,4863,518168,25781,32022,38661,96464,94807,91141,282412,235756,18539010000,951874000,1024143000,1244128000,3220145000,3173911000,3249557000,9643613000,8895397000
Hawaii,Transportation and Warehousing,2008,3677,1450,545,445,2440,546,294,3280,397,4455,1455,555,455,2465,600,560,3625,830,131978,1591,2715,4821,9393,17560,16202,46505,61458,4914071000,83284000,88023000,140293000,335193000,577421000,572064000,1630986000,2482972000
Hawaii,Utilities,2008,125,35,10,10,55,10,20,85,40,255,35,10,10,55,50,60,165,90,6585,27,0,0,174,0,0,313,0,477979000,2620000,0,0,11115000,0,0,16750000,11027000
Hawaii,Wholesale Trade,2008,8142,3880,1391,876,6147,951,343,7441,701,9145,3885,1465,910,6260,1185,535,7980,1165,98899,5285,6479,8389,22706,25276,12263,72370,18463,4255588000,239595000,275299000,362299000,965757000,981664000,522214000,2831776000,1085625000
Idaho,Accommodation and Food Services,2008,14293,5100,2840,3030,10970,2582,349,13901,392,17535,5100,2895,3070,11065,3240,1240,15545,1990,281554,7847,18857,39620,67520,84606,35883,189034,90911,3447416000,159825000,191631000,393767000,751171000,972303000,416241000,2155868000,1263914000
Idaho,Administrative and Support and Waste Management and Remediation Services,2008,10358,6645,1455,840,8940,735,230,9905,453,11105,6645,1460,850,8955,810,290,10055,1050,186979,7752,7913,9566,28454,20700,23919,78303,100074,4528215000,310967000,197485000,262602000,828252000,532661000,511354000,2084134000,2321428000
Idaho,"Agriculture, Forestry, Fishing and Hunting",2008,2460,1805,320,175,2300,100,35,2435,25,2470,1805,320,175,2300,100,45,2445,25,15537,1885,2000,2037,6804,2541,2431,15232,0,514039000,111362000,61368000,89647000,280140000,123734000,43633000,502419000,11620000
Idaho,"Arts, Entertainment, and Recreation",2008,3427,2105,485,365,2955,357,50,3362,65,3515,2115,485,385,2985,380,50,3415,100,41799,2180,2692,3997,10211,11934,3262,29404,6301,678678000,86350000,44002000,64215000,207579000,230537000,63273000,563677000,64466000
Idaho,Construction,2008,39801,27885,6565,3215,37665,1824,180,39669,132,39925,27885,6565,3215,37665,1880,195,39740,185,217545,39660,42892,40719,127865,61974,13631,212130,2586,7620625000,1283300000,1183619000,1405695000,3921484000,2442728000,628993000,7334362000,139401000
Idaho,Educational Services,2008,1915,950,270,275,1495,300,45,1840,75,2030,950,270,275,1495,315,120,1930,100,47904,1245,1016,3278,6639,10320,2452,19337,26707,927460000,34635000,21069000,46481000,114548000,226901000,49781000,394079000,498872000
Idaho,Finance and Insurance,2008,8757,5985,945,400,7330,333,309,7972,785,15075,6065,975,535,7575,635,1355,9565,5510,112053,8267,5252,4527,19001,8596,18876,48400,53714,4905594000,290442000,175464000,216544000,713129000,375578000,796628000,1982955000,2760456000
Idaho,Health Care and Social Assistance,2008,20599,10170,4625,2605,17400,2108,556,20064,535,23045,10185,4645,2640,17470,2940,1310,21720,1325,378319,16302,29839,32821,81023,77387,68027,234402,136322,12970019000,830090000,1056254000,1078744000,3006136000,2583038000,1817000000,7501433000,5306133000
Idaho,Information,2008,2398,1095,320,235,1650,331,92,2073,325,3825,1095,325,245,1665,445,165,2275,1550,65764,1051,1467,1516,5981,9038,2605,21344,43023,2700585000,52200000,47049000,54906000,175770000,361864000,118478000,811369000,1792887000
Idaho,Management of Companies and Enterprises,2008,890,55,5,25,85,197,265,547,343,1180,55,5,25,85,210,265,560,620,43472,0,0,0,0,2612,4788,7578,35872,4147393000,6333000,0,0,9922000,157478000,297382000,466815000,3680578000
Idaho,Manufacturing,2008,9360,4050,1690,1310,7050,1363,447,8860,500,9670,4050,1695,1310,7055,1400,500,8955,715,239052,4024,8479,12778,31193,43827,21216,119747,101315,9381917000,186556000,244343000,438655000,969160000,1490695000,834276000,4038887000,4665510000
Idaho,"Mining, Quarrying, and Oil and Gas Extraction",2008,666,295,105,85,485,82,47,614,52,715,295,105,85,485,95,55,635,80,11718,330,328,723,1620,1651,1443,6375,2421,709954000,18628000,17675000,36004000,89388000,72407000,150988000,423028000,173161000
Idaho,Other,2008,38,36,2,0,38,0,0,38,0,38,36,2,0,38,0,0,38,0,45,0,0,0,45,0,0,45,0,611000,489000,0,0,611000,0,0,611000,0
Idaho,Other Services (except Public Administration),2008,15643,10075,3030,1400,14505,746,136,15387,256,16650,10075,3035,1490,14600,1070,250,15920,730,97132,15820,19177,16536,54867,22177,5411,85033,5300,2171332000,400833000,420437000,372140000,1224115000,449545000,125795000,1852744000,186503000
Idaho,"Professional, Scientific, and Technical Services",2008,19866,13920,2710,1395,18025,962,260,19247,619,21215,13920,2730,1425,18075,1215,430,19720,1495,144764,18902,16450,17010,54382,28050,5511,92998,47233,6916330000,736851000,625046000,707419000,2100454000,1259863000,299850000,3859240000,2849673000
Idaho,Real Estate and Rental and Leasing,2008,10671,8768,938,373,10079,240,128,10447,224,11975,8775,940,475,10190,380,485,11055,920,39158,8589,5236,4004,21430,5433,2118,32977,3938,1109800000,311145000,136732000,113955000,583846000,190633000,57966000,947753000,118905000
Idaho,Retail Trade,2008,22156,10535,4743,2937,18215,2138,508,20861,1295,31125,10555,4800,3180,18535,3480,2215,24230,6895,395291,15766,28498,34568,86111,64393,28264,192296,186394,9246639000,408458000,602124000,824689000,1866570000,1711884000,809942000,4677248000,4251933000
Idaho,Total,2008,39368,23770,6621,3980,34371,3093,739,38203,1165,46246,23804,6672,4159,34635,4170,2041,40846,5400,537952,38284,43705,52272,134261,109034,69789,313084,224868,17574245000,1162350000,1132180000,1427369000,3721899000,3212068000,2141697000,9075664000,8498581000
Idaho,Transportation and Warehousing,2008,7795,5210,920,510,6640,577,163,7380,415,8575,5215,920,515,6650,650,215,7515,1060,77169,5317,5406,5801,19042,18753,9033,50114,27381,2586860000,201889000,171993000,185194000,574844000,578494000,286653000,1515206000,1023595000
Idaho,Utilities,2008,581,350,45,60,455,50,5,510,71,940,350,45,60,455,85,30,570,370,16555,344,249,683,1593,1667,0,3441,0,1150591000,9895000,7555000,25272000,49540000,108584000,0,167215000,0
Idaho,Wholesale Trade,2008,8529,3700,1120,795,5615,1163,613,7391,1138,10470,3705,1135,840,5680,1520,990,8190,2280,115540,4407,6059,6518,19104,28367,19112,80140,32055,5319290000,208829000,243878000,283186000,841931000,1112481000,799531000,3067789000,1940229000
Illinois,Accommodation and Food Services,2008,102368,42975,19885,17274,80134,18623,2101,100858,1510,132900,43025,19995,17470,80490,20900,6395,107785,25115,2384487,76310,132086,233772,443198,691245,303336,1439835,940021,36627361000,1534207000,1582802000,2828802000,5954808000,9559935000,4645579000,20185428000,16360849000
Illinois,Administrative and Support and Waste Management and Remediation Services,2008,74845,46877,9795,6170,62842,6624,2687,72153,2692,85700,46900,9815,6215,62930,7055,3520,73505,12195,2597377,59240,63607,80924,208170,253800,402755,877381,1686329,72321959000,3132877000,2428608000,3040404000,8635336000,9020334000,11514425000,29572653000,40484256000
Illinois,"Agriculture, Forestry, Fishing and Hunting",2008,1490,1140,180,85,1405,30,25,1460,30,1600,1140,180,85,1405,30,50,1485,115,7087,826,802,720,3304,313,998,5313,0,310554000,47341000,40362000,19397000,117438000,9778000,49880000,197527000,0
Illinois,"Arts, Entertainment, and Recreation",2008,21463,12655,2985,2260,17900,2650,565,21115,348,22845,12660,2995,2265,17920,2765,860,21545,1300,389585,15484,18791,30724,68412,103474,81472,259738,114619,11678827000,681901000,406390000,623041000,1771611000,2306552000,3529401000,7769735000,2847757000
Illinois,Construction,2008,158664,110775,23120,12939,146834,9676,1454,157964,700,159630,110775,23120,12970,146865,9770,1715,158350,1280,1225415,159391,150705,171775,486251,360395,210136,1062725,149546,73232565000,7107580000,6647034000,9399527000,23181670000,23022395000,15239377000,61689420000,10811637000
Illinois,Educational Services,2008,16603,7895,2245,2015,12155,3209,701,16065,538,18360,7910,2250,2060,12220,3560,915,16695,1665,719684,10830,14866,27377,53525,133280,96390,288775,415597,25455675000,392195000,353033000,586941000,1365630000,3403133000,3149998000,8001640000,17042160000
Illinois,Finance and Insurance,2008,70017,45802,9207,4417,59426,5262,2180,66868,3149,121350,45955,9470,4975,60400,9450,8635,78485,42865,1726615,76206,56671,54613,189262,182057,196375,577405,1123746,152325717000,3840661000,2908840000,4155488000,10965413000,14591114000,15690785000,41415823000,108405365000
Illinois,Health Care and Social Assistance,2008,127964,64460,27153,16259,107872,12622,4864,125358,2606,156555,64605,27385,17200,109190,16885,13765,139840,16715,3632032,113946,178016,214149,513171,493219,694681,1704441,1908407,148703530000,6075478000,7984976000,10151397000,24264683000,19820143000,21202536000,65360304000,82371232000
Illinois,Information,2008,15995,8060,2038,1577,11675,1745,917,14337,1658,28335,8070,2055,1610,11735,1940,1215,14890,13445,655133,8001,11065,18842,36349,57867,74849,181808,472628,44095664000,606266000,542081000,959298000,2170419000,4008788000,4550108000,10910911000,33234979000
Illinois,Management of Companies and Enterprises,2008,7569,615,185,235,1035,1356,1942,4333,3236,11230,615,185,235,1035,1390,2135,4560,6670,902695,19,826,1533,3200,16295,60930,80425,821994,89456660000,110310000,64265000,127874000,306390000,1227900000,4369090000,5903380000,83553280000
Illinois,Manufacturing,2008,72797,24507,11990,10874,47371,14967,5349,67687,5110,76890,24515,12000,10950,47465,15470,6190,69125,7765,3062050,40488,74038,136918,263741,581476,626194,1555744,1370157,148821029000,1826857000,2693925000,5717650000,10585778000,25937429000,29008609000,68630479000,73399442000
Illinois,"Mining, Quarrying, and Oil and Gas Extraction",2008,2474,1410,361,260,2031,212,93,2336,138,2865,1410,370,260,2040,265,240,2545,320,40557,2343,2073,3284,8263,5582,4216,21464,14571,2623667000,137674000,96103000,163312000,442031000,345684000,305705000,1286300000,922934000
Illinois,Other,2008,293,282,8,2,292,1,0,293,0,293,282,8,2,292,1,0,293,0,0,0,0,0,0,0,0,0,0,9643000,7825000,0,0,8770000,0,0,9643000,0
Illinois,Other Services (except Public Administration),2008,147196,88337,30796,15584,134717,9920,1485,146122,1074,159860,88505,31135,16180,135820,12015,3140,150975,8885,1280230,163499,200821,202221,569196,335170,140367,1054035,208395,36719774000,4007913000,4745148000,5195968000,13959756000,9150059000,5461055000,28745863000,7528110000
Illinois,"Professional, Scientific, and Technical Services",2008,184456,133544,22226,12655,168425,9967,2931,181323,3133,194940,133630,22330,12925,168885,11615,3955,184455,10485,1876138,155892,139097,162751,486598,326420,249317,1073846,769361,136233737000,12051107000,7456668000,9689437000,29293021000,22439079000,19626509000,71708907000,63277498000
Illinois,Real Estate and Rental and Leasing,2008,52453,38591,6303,2850,47744,2581,932,51257,1196,65495,38635,6425,3160,48220,3670,2505,54395,11100,424312,51691,39439,35109,128463,80450,61877,279480,130767,20942169000,2047054000,1428073000,1519243000,5013750000,3668772000,3320266000,12316123000,8097903000
Illinois,Retail Trade,2008,132013,72933,26151,14710,113794,12026,2964,128784,3229,208715,73155,26715,16005,115875,17285,11510,144670,64045,3262906,120497,159232,181444,455968,436472,247866,1183715,1746685,78594510000,3096034000,3750771000,4520577000,11461297000,13514771000,7780254000,33092059000,44326884000
Illinois,Total,2008,260225,155837,42602,26574,225013,24523,6233,255769,4456,321942,156079,43070,27696,226845,30410,15323,272578,49364,5464130,252294,279777,353162,885233,919062,798415,2602710,2861420,250538255000,10517069000,9853543000,13593511000,33964123000,37736032000,35037605000,106737760000,143800495000
Illinois,Transportation and Warehousing,2008,53200,35050,5725,3863,44638,4078,1789,50505,2695,59865,35055,5730,3905,44690,4350,2330,51370,8495,1168121,43148,35991,49083,132571,124994,112405,381671,777731,48447553000,1601544000,1273782000,1875455000,4797252000,4973886000,4464309000,14572366000,33582342000
Illinois,Utilities,2008,889,320,105,75,500,192,20,712,177,2330,320,105,80,505,315,20,840,1490,72975,519,698,693,1966,7212,0,10703,51912,6789357000,39105000,40074000,43610000,130549000,467802000,0,717975000,5384368000
Illinois,Wholesale Trade,2008,84918,42002,12893,9517,64412,11006,4485,79903,5015,98780,42105,13050,9920,65075,13315,7520,85910,12870,1588585,65248,81727,118949,271928,350498,260430,898007,644050,97874045000,3749096000,4486332000,6535718000,14836180000,19389404000,14965722000,49768150000,44876686000
Indiana,Accommodation and Food Services,2008,46063,16650,8760,9068,34478,9174,1255,44907,1156,63850,16710,8785,9190,34685,10595,4815,50095,13755,1302050,28006,58916,124709,212475,343254,175941,734870,565860,16735720000,577221000,609000000,1290714000,2478485000,3826408000,1977465000,8308420000,8404688000
Indiana,Administrative and Support and Waste Management and Remediation Services,2008,31917,18885,4748,3045,26678,2826,961,30465,1452,37095,18905,4755,3140,26800,3130,1415,31345,5750,851868,24773,29198,38228,96059,101564,122388,330139,511271,22828529000,985934000,812816000,1028580000,2870975000,2911137000,2958834000,9023090000,13618121000
Indiana,"Agriculture, Forestry, Fishing and Hunting",2008,1236,970,130,50,1150,30,25,1205,31,1320,970,130,50,1150,30,30,1210,110,5763,732,188,224,2725,180,0,6257,0,245154000,35426000,10079000,15324000,72060000,16199000,0,187976000,0
Indiana,"Arts, Entertainment, and Recreation",2008,10401,5570,1720,1290,8580,1406,224,10210,191,10840,5570,1740,1310,8620,1535,355,10510,330,154194,7071,10969,16834,36478,51370,24248,118049,15295,4105788000,252628000,209309000,303098000,801828000,937395000,541742000,2529160000,394829000
Indiana,Construction,2008,75953,48090,13809,7400,69299,5324,822,75445,508,76630,48100,13810,7405,69315,5420,990,75725,905,698185,79632,89730,98915,270051,198680,113007,588295,92742,33404225000,2684520000,2934937000,3896638000,9522385000,9627268000,6618660000,26068935000,6203068000
Indiana,Educational Services,2008,7180,3305,1300,930,5535,1127,248,6910,270,7815,3305,1315,960,5580,1300,350,7230,585,285652,4540,8169,11931,24304,43235,33064,105761,176886,7350991000,125594000,144349000,231405000,521307000,941144000,920322000,2512020000,4709386000
Indiana,Finance and Insurance,2008,26283,17544,3375,1221,22140,1615,920,24675,1608,51730,17595,3465,1570,22630,3615,4735,30980,20750,501874,29340,20728,14801,66620,53930,78692,204686,295811,27475566000,1067664000,817044000,676922000,2585727000,2377255000,3716733000,8900040000,18034114000
Indiana,Health Care and Social Assistance,2008,54523,24115,12750,7497,44362,5857,2607,52826,1697,75035,24205,12855,7925,44985,8535,8130,61650,13385,1874163,43647,84735,99081,230635,224500,396114,860727,1004841,70424658000,1928834000,3244001000,4260238000,9450042000,8759242000,12977883000,31413377000,38893419000
Indiana,Information,2008,5671,2435,826,615,3876,781,293,4950,721,11380,2435,830,625,3890,985,550,5425,5955,224599,2513,4901,7223,17338,24266,19401,65018,157506,10651244000,145980000,157401000,297693000,612288000,891737000,809296000,2462029000,8095317000
Indiana,Management of Companies and Enterprises,2008,3305,155,60,95,310,601,966,1877,1428,4640,155,60,95,310,610,1085,2005,2635,250110,0,24,66,876,5484,29827,36290,213395,22783635000,46614000,11368000,4363000,108874000,367584000,1651407000,2127865000,20626905000
Indiana,Manufacturing,2008,40774,11449,6495,5960,23904,8880,3705,36489,4285,44335,11450,6495,5985,23930,9260,4435,37625,6710,2515906,17507,39530,72640,138650,335542,411542,945203,1465827,114005548000,739993000,1255978000,2656327000,4834135000,12607953000,15568876000,34984272000,74674710000
Indiana,"Mining, Quarrying, and Oil and Gas Extraction",2008,1031,405,145,130,680,144,72,896,135,1585,415,145,130,690,240,125,1055,530,28134,571,605,855,3093,3476,3933,11716,15140,1713245000,34269000,31967000,61942000,140100000,149035000,251852000,597920000,1019243000
Indiana,Other,2008,116,105,5,5,115,1,0,116,0,116,105,5,5,115,1,0,116,0,203,0,0,65,168,0,0,203,0,3201000,1356000,0,1453000,3103000,0,0,3201000,0
Indiana,Other Services (except Public Administration),2008,77074,45647,16525,8484,70656,4980,748,76384,690,84045,45675,16685,8885,71245,6760,2165,80170,3875,634000,88259,103969,111636,307992,168297,55688,543064,54708,14471849000,1851155000,2132868000,2316522000,6314293000,3821247000,1564242000,11983600000,1846267000
Indiana,"Professional, Scientific, and Technical Services",2008,60697,41180,8846,4803,54829,3627,1002,59458,1239,64985,41200,8870,4905,54975,4385,1450,60810,4175,512753,62856,56437,62049,185252,111227,64967,368134,125445,25904716000,2480387000,2153408000,2626277000,7286878000,5590541000,4199704000,17391818000,8007011000
Indiana,Real Estate and Rental and Leasing,2008,23230,17153,2650,1288,21091,1041,461,22593,637,30675,17195,2745,1425,21365,2185,1450,25000,5675,171310,23033,16713,15590,59073,29370,23913,118346,41344,5459551000,728454000,438870000,481009000,1660652000,950672000,805163000,3614885000,1681172000
Indiana,Retail Trade,2008,69049,34652,14966,8733,58351,6453,1716,66520,2529,114680,34725,15315,9795,59835,10565,7020,77420,37260,1651232,58011,93217,112547,274550,219417,128130,643273,950025,35610928000,1377903000,1999453000,2513704000,5918392000,6034189000,3540635000,15777110000,18863430000
Indiana,Total,2008,115466,63401,21016,13312,97729,11698,3086,112513,2953,150101,63498,21235,14003,98736,15463,8745,122944,27157,2619140,111167,138237,178256,427660,436640,402617,1266917,1352223,94838015000,3415794000,3821200000,5276082000,12513076000,14083974000,14298265000,40895315000,53942700000
Indiana,Transportation and Warehousing,2008,23173,12955,3135,2286,18376,2205,822,21403,1770,26280,12955,3140,2315,18410,2405,1060,21875,4405,554631,13681,19684,29665,71000,73321,59996,210090,322016,19728817000,703601000,654566000,1000876000,2376122000,2622419000,2181496000,7356351000,11946619000
Indiana,Utilities,2008,943,325,180,85,590,205,30,825,118,2835,325,180,100,605,245,75,925,1910,73557,648,1164,298,2742,7840,0,13260,59072,5484971000,21849000,35244000,31272000,96279000,471702000,128668000,778292000,4305580000
Indiana,Wholesale Trade,2008,33191,15040,4760,3979,23779,4460,2226,30465,2726,40170,15075,4830,4180,24085,5510,3490,33085,7085,579249,21308,28417,47745,102087,133072,96027,354954,201477,26957496000,1117155000,1254807000,2137094000,4580639000,6066244000,4383073000,15585468000,10401400000
Iowa,Accommodation and Food Services,2008,28018,10535,5458,5190,21183,5398,823,27404,614,34515,10540,5465,5230,21235,6410,2690,30335,4180,575247,16843,36511,70965,125165,187842,91431,405050,162009,6858945000,316251000,323802000,641061000,1284583000,1935362000,998558000,4226904000,2625822000
Iowa,Administrative and Support and Waste Management and Remediation Services,2008,15681,9585,2225,1352,13162,1162,525,14849,832,18120,9590,2235,1390,13215,1280,825,15320,2800,359066,12725,13082,16349,44104,39978,60597,155027,182253,8765123000,451466000,359046000,477889000,1319654000,1064577000,1312745000,4004342000,4245875000
Iowa,"Agriculture, Forestry, Fishing and Hunting",2008,1195,905,110,55,1070,70,40,1180,15,1370,905,110,55,1070,125,100,1295,75,7584,1042,536,363,2367,2113,517,5883,0,366504000,42041000,31152000,8302000,90673000,81755000,27221000,244919000,0
Iowa,"Arts, Entertainment, and Recreation",2008,7204,4290,1170,770,6230,705,155,7090,114,7425,4290,1170,785,6245,740,195,7180,245,104917,5409,7164,9835,24299,25749,18855,72413,22463,1796959000,158060000,113095000,136269000,425083000,351519000,279128000,1144052000,446644000
Iowa,Construction,2008,43390,29300,7255,3600,40155,2595,377,43127,263,43890,29300,7255,3610,40165,2765,490,43420,470,313079,44118,47330,47053,139693,96467,45669,287276,20719,14924748000,1706335000,1692078000,1986347000,5391883000,4903099000,2786892000,13303157000,1395971000
Iowa,Educational Services,2008,3241,1425,580,360,2365,520,185,3070,171,3705,1430,580,400,2410,570,370,3350,355,170167,2009,3526,4598,10527,20070,26715,59868,108746,3770988000,56129000,55844000,64459000,187245000,369274000,746214000,1363729000,2364000000
Iowa,Finance and Insurance,2008,18726,11985,2420,1222,15627,1414,617,17658,1068,30810,12015,2510,1695,16220,3860,3410,23490,7320,467058,18470,14842,15499,50421,47383,65715,168503,241358,25700839000,642082000,570571000,656422000,1899414000,2144455000,3379564000,7671668000,15418710000
Iowa,Health Care and Social Assistance,2008,28831,12823,5415,3753,21991,3997,1820,27808,1023,39465,12840,5445,3960,22245,5860,5785,33890,5575,1000424,23019,35032,49282,109800,164892,257342,541447,417984,34433137000,1044199000,1298581000,2072484000,4448623000,4767591000,7497317000,16810569000,17487061000
Iowa,Information,2008,4644,1865,835,649,3349,552,233,4134,510,7865,1865,845,670,3380,805,615,4800,3065,165850,2490,4760,7769,17115,17061,16443,53639,110819,7016286000,106956000,148261000,274059000,539483000,676365000,615485000,1894492000,5054037000
Iowa,Management of Companies and Enterprises,2008,1929,95,15,125,235,376,684,1295,634,2330,95,15,130,240,380,730,1350,980,105455,110,0,411,600,3574,19965,24220,81101,7233035000,9906000,0,23544000,37685000,183854000,1169890000,1396500000,5833163000
Iowa,Manufacturing,2008,17105,5435,2770,2180,10385,3232,1586,15203,1902,19130,5445,2770,2185,10400,3530,2155,16085,3045,944283,7116,13991,24547,51211,114358,145812,349484,534824,39635627000,302636000,468049000,844116000,1764931000,4415538000,5622613000,13055585000,23539788000
Iowa,"Mining, Quarrying, and Oil and Gas Extraction",2008,335,105,60,25,190,81,31,302,33,870,105,60,25,190,220,170,580,290,8235,90,299,273,922,3150,1750,5994,754,411635000,4840000,12654000,12450000,37893000,159723000,89054000,289815000,113887000
Iowa,Other,2008,408,402,5,0,407,1,0,408,0,408,402,5,0,407,1,0,408,0,297,249,0,0,279,0,0,297,0,3323000,2928000,333000,0,3261000,0,0,3323000,0
Iowa,Other Services (except Public Administration),2008,43280,28090,8960,3624,40674,1897,338,42909,371,46040,28130,9240,3955,41325,2555,735,44615,1425,263548,52023,56664,45216,156067,57734,18667,242510,13968,5579326000,1018505000,1058373000,880716000,2970380000,1303720000,343986000,4875971000,452248000
Iowa,"Professional, Scientific, and Technical Services",2008,29290,19505,4703,2367,26575,1659,379,28613,677,31315,19510,4720,2485,26715,2195,530,29440,1875,220024,28627,29024,28997,91096,52246,20712,169944,34895,10132542000,1110746000,983841000,1142784000,3275413000,2766951000,1173215000,7483164000,2197155000
Iowa,Real Estate and Rental and Leasing,2008,11591,8808,1135,541,10484,470,294,11248,343,14355,8815,1155,630,10600,995,790,12385,1970,70434,8920,5682,5575,25327,11875,6837,46722,15718,2402855000,320735000,166886000,159741000,688477000,416616000,267373000,1456824000,584629000
Iowa,Retail Trade,2008,42209,20418,9152,5980,35550,3856,1059,40465,1744,63900,20510,9290,6455,36255,5990,3700,45945,17955,833972,32321,58364,74475,172200,114816,61557,359474,362393,17423594000,756345000,1158564000,1620737000,3571148000,3143531000,1745744000,8663320000,7384743000
Iowa,Total,2008,65015,37067,11399,7060,55526,6066,1642,63234,1781,82353,37118,11547,7539,56204,8853,5534,70591,11762,1317121,62581,74809,93657,231047,227086,215965,674098,643023,45228724000,1823448000,1938288000,2656831000,6418567000,7051371000,7272440000,20742378000,24486346000
Iowa,Transportation and Warehousing,2008,16574,10770,2115,1250,14135,1160,398,15693,881,18645,10770,2125,1260,14155,1375,545,16075,2570,266154,13094,13601,16157,46745,37462,27966,115571,144357,9244996000,436393000,387986000,504766000,1357838000,1281163000,1052089000,3754035000,5222557000
Iowa,Utilities,2008,434,55,45,75,175,157,27,359,75,1330,55,45,75,175,315,80,570,760,1280,0,211,964,1309,6517,58,8785,0,88203000,1520000,8452000,47119000,60536000,329158000,38724000,447638000,32817000
Iowa,Wholesale Trade,2008,18505,7360,2655,2549,12564,2946,1395,16905,1600,24645,7370,2675,2700,12745,4290,3755,20790,3855,326164,9901,15886,29640,60040,85326,76568,234342,76362,14505546000,461477000,641067000,1265299000,2458070000,3596559000,3377542000,9892625000,4050994000
Kansas,Accommodation and Food Services,2008,21364,7580,3826,4096,15502,4337,698,20537,827,29215,7590,3830,4205,15625,4910,2125,22660,6555,538734,11766,25888,56209,94185,151907,82931,331362,206059,6303362000,235369000,232589000,543931000,1014119000,1611542000,933374000,3571298000,2716022000
Kansas,Administrative and Support and Waste Management and Remediation Services,2008,16024,9505,2255,1370,13130,1418,496,15044,980,17935,9505,2260,1390,13155,1520,645,15320,2615,363890,12480,14202,16792,46421,49273,51644,157978,191090,10259869000,488275000,388927000,497825000,1410669000,1368470000,1251228000,4387689000,5378648000
Kansas,"Agriculture, Forestry, Fishing and Hunting",2008,985,760,135,50,945,30,5,980,5,985,760,135,50,945,30,5,980,5,3385,851,807,487,2455,801,0,3360,0,106467000,34302000,28049000,16365000,82592000,19066000,0,104882000,0
Kansas,"Arts, Entertainment, and Recreation",2008,5095,2715,835,722,4272,580,123,4975,120,5310,2715,835,750,4300,640,140,5080,230,71643,3693,4826,9625,18474,21646,13688,57416,11878,1116628000,108280000,79759000,127651000,325697000,347171000,223745000,927289000,154237000
Kansas,Construction,2008,38800,24410,7010,3743,35163,2908,378,38449,351,39155,24410,7010,3765,35185,2945,405,38535,620,340350,39314,45035,48581,136696,108165,38893,293174,31140,14750365000,1350300000,1403450000,1797899000,4565987000,5250767000,1744151000,11951031000,1794062000
Kansas,Educational Services,2008,3198,1490,490,350,2330,570,155,3055,143,3460,1490,490,355,2335,600,260,3195,265,93578,2235,3041,4687,10558,23021,26828,62793,28890,2155298000,56440000,54391000,85991000,213890000,581135000,535078000,1423351000,697443000
Kansas,Finance and Insurance,2008,18927,12240,2113,1206,15559,1420,546,17525,1402,30050,12255,2245,1620,16120,3370,2490,21980,8070,287388,20197,12877,15044,50316,45628,45024,146959,128423,16210814000,704121000,531025000,635113000,1939788000,2309155000,2214863000,6761931000,8798533000
Kansas,Health Care and Social Assistance,2008,29384,13100,6130,3856,23086,3657,1638,28381,1003,38255,13125,6155,4050,23330,4855,4780,32965,5290,890217,22379,40114,50237,115131,147230,237725,504210,354467,32206415000,1080887000,1501638000,2178285000,4803517000,5324022000,6548651000,16779619000,14866136000
Kansas,Information,2008,3832,1530,545,441,2516,472,246,3234,598,7340,1535,545,455,2535,560,710,3805,3535,245016,1625,2944,5184,11590,14498,14860,44216,197544,15082988000,82244000,91441000,200323000,399366000,626596000,666504000,1863366000,13047735000
Kansas,Management of Companies and Enterprises,2008,2149,210,35,100,345,391,565,1301,848,2765,210,35,100,345,395,610,1350,1415,109495,193,105,435,815,3997,12521,17755,91688,9243280000,25267000,8686000,29249000,66150000,221661000,802202000,1112565000,8124883000
Kansas,Manufacturing,2008,14803,4680,2420,2170,9270,2715,1266,13251,1552,15855,4680,2420,2185,9285,2890,1530,13705,2150,805341,6337,12274,22849,46983,90600,119175,291119,455886,36639214000,240081000,381997000,816375000,1593770000,3471746000,4639820000,11014768000,23223051000
Kansas,"Mining, Quarrying, and Oil and Gas Extraction",2008,4905,2855,755,523,4133,426,130,4689,216,5235,2855,755,575,4185,455,225,4865,370,54477,4760,4555,6741,16195,13548,8996,39880,13405,3056499000,243084000,195064000,343508000,785291000,719758000,463104000,2026284000,936335000
Kansas,Other,2008,110,106,3,1,110,0,0,110,0,110,106,3,1,110,0,0,110,0,115,79,0,0,115,0,0,115,0,1673000,1467000,0,0,1673000,0,0,1673000,0
Kansas,Other Services (except Public Administration),2008,38130,24539,7570,3167,35276,2102,402,37780,350,40520,24550,7630,3265,35445,2610,870,38925,1595,263422,44000,47742,39263,134751,66144,25756,236571,16024,5887420000,898383000,950995000,890029000,2763680000,1477860000,683193000,5227248000,511748000
Kansas,"Professional, Scientific, and Technical Services",2008,33422,22758,4675,2550,29983,1806,724,32513,909,35665,22765,4700,2635,30100,2095,1145,33340,2325,283704,29691,29591,32502,99639,55684,49816,210396,42321,14431761000,1440838000,1112700000,1418105000,4023523000,2873766000,2816434000,10003503000,2728478000
Kansas,Real Estate and Rental and Leasing,2008,12957,9723,1380,688,11791,438,288,12517,440,16195,9730,1400,795,11925,790,1115,13830,2365,76852,12873,8335,8013,30314,9869,10970,54941,16589,2397808000,413966000,254102000,261732000,951377000,357536000,325441000,1700748000,610108000
Kansas,Retail Trade,2008,39110,19275,8917,4649,32841,3542,947,37330,1780,54890,19310,9060,5045,33415,5165,2770,41350,13540,683994,33685,57940,56387,153670,104708,63347,335249,310581,14765894000,760137000,1140837000,1257815000,3187793000,2937144000,1763587000,8159197000,6027936000
Kansas,Total,2008,60989,34397,10627,6506,51530,5805,1675,59010,1979,76096,34432,10736,6911,52079,7798,4596,64473,11623,1185777,59535,69735,86672,215942,211853,200364,628159,557618,43984689000,1840909000,1930118000,2628548000,6399575000,7077641000,6691036000,20168252000,23816437000
Kansas,Transportation and Warehousing,2008,11376,6820,1480,1001,9301,796,367,10464,912,13375,6820,1480,1040,9340,845,505,10690,2685,195168,8395,9096,12706,33014,21763,16788,76459,103847,7528543000,317566000,275056000,410010000,1012243000,788738000,679477000,2573683000,4495690000
Kansas,Utilities,2008,400,95,45,40,180,95,39,314,86,1220,95,45,40,180,150,230,560,660,31338,151,147,599,1030,3645,0,8762,15210,2554447000,3740000,4844000,31285000,44585000,227747000,242200000,540026000,1414123000
Kansas,Wholesale Trade,2008,17566,7212,2585,2100,11897,2768,1206,15871,1695,22505,7230,2635,2230,12095,4165,2420,18680,3825,290769,9631,14852,22839,49799,74435,45899,191974,88645,14781831000,575554000,756707000,1077624000,2498779000,3297543000,2376885000,8796726000,5472364000
Kentucky,Accommodation and Food Services,2008,26564,8900,4510,5210,18620,5850,1134,25604,960,36830,8995,4515,5230,18740,6730,3840,29310,7520,783289,13715,30604,71519,116420,222392,145969,486343,294835,9570345000,349775000,311247000,755274000,1422195000,2446795000,1623753000,5513965000,4053076000
Kentucky,Administrative and Support and Waste Management and Remediation Services,2008,17006,9705,2505,1580,13790,1550,566,15906,1100,20195,9720,2510,1585,13815,1610,730,16155,4040,483547,13091,15137,18521,50870,55921,61603,180815,290322,10440902000,482740000,419367000,577808000,1531420000,1440472000,1156064000,4364482000,5801015000
Kentucky,"Agriculture, Forestry, Fishing and Hunting",2008,1375,930,240,90,1260,55,45,1360,15,1390,930,240,90,1260,55,60,1375,15,9139,1408,1438,392,4019,922,2669,9041,0,291822000,35720000,35558000,21152000,101222000,24316000,124799000,287069000,0
Kentucky,"Arts, Entertainment, and Recreation",2008,6457,3355,1170,820,5345,874,118,6337,120,6690,3360,1170,845,5375,940,160,6475,215,86465,4097,7043,9985,22524,32111,12687,72514,11735,1731197000,170431000,128174000,173029000,490404000,641545000,242339000,1469723000,170232000
Kentucky,Construction,2008,43394,26905,7725,4485,39115,3426,540,43081,313,43810,26905,7725,4500,39130,3525,585,43240,570,394390,44866,50642,58176,156753,130241,64787,361100,25513,15956830000,1383690000,1473794000,2040057000,4906328000,5804751000,3330985000,14317930000,1317995000
Kentucky,Educational Services,2008,3786,1735,515,591,2841,523,243,3607,179,4405,1735,515,600,2850,605,430,3885,520,125495,2371,3103,7523,13814,17728,41045,75388,47273,2888358000,65658000,48460000,119191000,251353000,385947000,985714000,1687186000,1091490000
Kentucky,Finance and Insurance,2008,16358,9740,2570,955,13265,1276,517,15058,1300,33190,9785,2655,1185,13625,3380,3270,20275,12915,329392,16965,14848,11965,43815,42936,37987,133213,191989,16232402000,610269000,542183000,505197000,1706362000,1754437000,1457018000,5247138000,10517040000
Kentucky,Health Care and Social Assistance,2008,41130,17610,10245,5945,33800,4512,1517,39829,1301,53400,17630,10320,6180,34130,6215,4180,44525,8875,1195287,32662,67686,78349,180738,161756,189434,545962,636189,44470475000,1563575000,2424742000,2936608000,6954180000,6741438000,5401061000,19442809000,24653977000
Kentucky,Information,2008,4152,1795,565,405,2765,516,263,3544,608,7790,1795,565,425,2785,670,450,3905,3885,125524,2117,3002,4591,12028,17792,8998,43676,84260,6181116000,103693000,90058000,142518000,363752000,637847000,403358000,1584901000,3611740000
Kentucky,Management of Companies and Enterprises,2008,2314,160,30,60,250,436,610,1296,1018,3400,160,30,60,250,440,690,1380,2020,134100,0,0,312,650,4852,14580,20290,113777,10695885000,16667000,162000,18068000,53780000,238961000,682465000,980730000,9712456000
Kentucky,Manufacturing,2008,18860,5470,2910,2590,10970,3643,1646,16259,2601,20535,5470,2910,2600,10980,3945,2005,16930,3605,1119236,7217,15429,29321,59582,127860,157338,397803,652632,47304098000,290601000,481911000,948447000,1910577000,4583455000,5839740000,14293395000,30422009000
Kentucky,"Mining, Quarrying, and Oil and Gas Extraction",2008,2888,1095,445,370,1910,557,198,2665,223,3405,1095,455,370,1920,600,265,2785,620,111459,1486,2599,4817,9178,19971,20650,54624,56488,6939485000,134217000,112690000,221743000,471119000,1043532000,1218164000,2969120000,3949872000
Kentucky,Other,2008,105,99,4,2,105,0,0,105,0,105,99,4,2,105,0,0,105,0,0,0,0,0,0,0,0,0,0,2086000,1722000,0,0,2086000,0,0,2086000,0
Kentucky,Other Services (except Public Administration),2008,44244,27645,8944,4057,40646,2588,476,43710,534,48085,27685,9025,4270,40980,3580,1055,45615,2470,336892,51489,56702,52498,163356,83369,29393,282009,31811,7598857000,1032443000,1148512000,1098940000,3325218000,1942727000,605265000,6024193000,1052638000
Kentucky,"Professional, Scientific, and Technical Services",2008,38287,25880,5775,2915,34570,2154,592,37316,971,40920,25895,5780,2960,34635,2585,935,38155,2765,324517,38754,36913,36832,115745,68742,39295,230221,83620,14401344000,1486588000,1285594000,1467386000,4259314000,3307272000,2110385000,9863234000,4307023000
Kentucky,Real Estate and Rental and Leasing,2008,14945,10850,1820,793,13463,596,322,14381,564,19075,10850,1870,855,13575,1065,835,15475,3600,90902,16966,10920,9226,37960,16248,5584,65888,22073,2858912000,442686000,306407000,312592000,1065951000,512035000,188455000,1968616000,777429000
Kentucky,Retail Trade,2008,52481,26340,11462,6750,44552,4877,1017,50446,2035,80120,26380,11630,7450,45460,7175,3420,56055,24065,1062270,44319,74765,85588,212781,154320,60522,441121,485293,24091621000,999245000,1487918000,1933756000,4440454000,4138795000,1594122000,10360659000,11724959000
Kentucky,Total,2008,71510,38758,13202,8144,60104,7169,1902,69175,2335,92587,38825,13319,8531,60675,9513,5149,75337,17250,1570800,69279,87091,108551,264921,262711,228483,756115,814685,54120319000,2046796000,2304350000,3042017000,7393163000,8284738000,7295964000,22973865000,31146454000
Kentucky,Transportation and Warehousing,2008,13215,7255,1870,1090,10215,1079,546,11840,1375,15370,7255,1875,1105,10235,1185,630,12050,3320,283328,9963,11380,13272,37678,28771,21588,96435,172588,11220831000,349097000,325658000,404379000,1113955000,983097000,803337000,3234775000,7506218000
Kentucky,Utilities,2008,475,130,75,45,250,80,55,385,90,1660,130,75,45,250,150,240,640,1020,39362,243,381,528,1106,4781,5864,12725,16315,2871300000,8948000,12880000,16311000,40446000,266973000,328476000,668739000,1718109000
Kentucky,Wholesale Trade,2008,18611,7820,2685,2179,12684,2665,1190,16539,2072,22140,7855,2710,2290,12855,3110,1965,17930,4210,356738,11880,14983,24100,56008,68985,57467,201667,140466,17270085000,544774000,610885000,981389000,2242291000,2990616000,2644707000,8554331000,7580535000
Louisiana,Accommodation and Food Services,2008,30547,10640,5815,5730,22185,6705,875,29765,782,41080,10640,5820,5880,22340,7500,3295,33135,7945,928833,17005,38693,78423,134846,250621,136495,523262,398548,13948485000,392237000,445450000,886694000,1727732000,3174251000,2003291000,6924567000,6895868000
Louisiana,Administrative and Support and Waste Management and Remediation Services,2008,19824,10605,2970,2130,15705,2293,768,18766,1058,22455,10620,2995,2135,15750,2550,1060,19360,3095,554180,15992,19301,27458,65854,89242,107525,266327,271208,15918495000,605834000,540660000,845503000,2020976000,2938396000,2758163000,7843717000,7668153000
Louisiana,"Agriculture, Forestry, Fishing and Hunting",2008,3184,1551,965,435,2951,170,20,3141,43,3255,1555,965,445,2965,170,55,3190,65,20757,2584,6379,5137,14237,4354,156,19695,138,737598000,86445000,201640000,169925000,466181000,169801000,7372000,688501000,19238000
Louisiana,"Arts, Entertainment, and Recreation",2008,6391,3475,1050,772,5297,842,130,6269,122,6825,3480,1050,780,5310,1055,205,6570,255,107697,3718,6513,8775,21045,32253,8805,68711,32213,2682529000,149868000,122153000,138741000,429866000,613963000,154967000,1480875000,931638000
Louisiana,Construction,2008,45268,25620,8930,5155,39705,4235,801,44741,527,45695,25620,8935,5155,39710,4250,920,44880,815,675755,44702,58408,68792,173940,161297,108110,449210,198787,31265295000,1451364000,1794605000,2494108000,5770360000,7083415000,5612860000,18710010000,11152974000
Louisiana,Educational Services,2008,4801,1895,690,595,3180,1180,295,4655,146,5255,1900,690,605,3195,1305,410,4910,345,160179,2686,4148,7926,15785,56013,33669,107873,43835,5038558000,79224000,87648000,155377000,344757000,1358643000,939849000,2723338000,2050646000
Louisiana,Finance and Insurance,2008,20764,12965,3530,1220,17715,1347,560,19622,1142,39165,13020,3620,1600,18240,4535,3695,26470,12695,318799,22110,19562,13850,59937,48406,55187,173547,127289,16016738000,1103616000,815529000,753844000,2708513000,2231722000,2370590000,7741012000,8205073000
Louisiana,Health Care and Social Assistance,2008,49200,21657,11820,6903,40380,5834,1899,48113,1087,58165,21700,11865,7090,40655,7385,4260,52300,5865,1336804,38908,78066,89631,209545,240053,283742,742370,550825,47565544000,2264507000,2854590000,3128505000,8264663000,6895239000,7624090000,23058644000,22750174000
Louisiana,Information,2008,3331,1415,410,425,2250,433,175,2858,473,7470,1415,420,435,2270,535,385,3190,4280,141264,1813,2070,3638,9862,11185,5206,33996,103530,6526670000,105198000,72856000,186813000,409719000,441552000,333124000,1386149000,5069963000
Louisiana,Management of Companies and Enterprises,2008,2213,140,45,105,290,485,635,1410,803,2915,140,45,105,290,490,665,1445,1470,86420,0,156,814,1247,5669,21276,28440,57633,7610310000,13623000,6464000,48955000,69890000,324750000,1267017000,1670875000,5939435000
Louisiana,Manufacturing,2008,16114,5575,2940,2241,10756,2906,932,14594,1520,17425,5575,2940,2245,10760,3025,1320,15105,2320,601000,7572,15520,25113,54649,99608,63221,254327,302030,30716818000,331728000,528562000,956270000,1995085000,4250348000,3309456000,10880186000,18023312000
Louisiana,"Mining, Quarrying, and Oil and Gas Extraction",2008,6283,3085,765,655,4505,841,356,5702,581,7820,3100,765,670,4535,985,530,6050,1770,258531,4698,5019,8693,18759,31126,43258,93404,164099,18947271000,458523000,275340000,537304000,1271294000,2116201000,3314913000,6720274000,12216585000
Louisiana,Other,2008,113,103,10,0,113,0,0,113,0,113,103,10,0,113,0,0,113,0,164,100,64,0,164,0,0,164,0,3304000,2105000,1199000,0,3304000,0,0,3304000,0
Louisiana,Other Services (except Public Administration),2008,45045,26355,9622,4945,40922,3048,520,44490,555,48600,26360,9645,5225,41230,3780,945,45955,2645,373845,49992,61971,62777,177415,111520,40267,335906,26834,8988483000,1125913000,1321292000,1475563000,3951076000,2570498000,1125279000,7823564000,900579000
Louisiana,"Professional, Scientific, and Technical Services",2008,53715,36590,7880,4473,48943,3098,730,52771,944,56770,36600,7895,4555,49050,3685,1110,53845,2925,440730,53872,49872,58024,167489,104427,59774,342317,90694,23279098000,2687067000,2058964000,2807277000,7582132000,5920592000,3663670000,17619520000,5355911000
Louisiana,Real Estate and Rental and Leasing,2008,18085,12936,2125,1115,16176,962,359,17497,588,22810,12940,2170,1195,16305,1535,1125,18965,3845,152658,19010,12999,13536,47860,28288,20484,99825,47864,6304769000,638735000,405626000,530766000,1597325000,1075580000,762332000,3542065000,2652081000
Louisiana,Retail Trade,2008,56488,29154,12021,7247,48422,5147,1011,54580,1908,84330,29215,12215,7905,49335,7345,3075,59755,24575,972760,48314,76551,91377,220202,182597,84822,505587,395511,22187940000,1200045000,1645117000,2135811000,5064933000,4941905000,2699647000,12901413000,8866198000
Louisiana,Total,2008,82301,44309,15552,9719,69580,8592,2016,80188,2113,104007,44368,15669,10193,70230,11239,5220,86689,17318,1655151,78972,102452,129527,310951,330989,261514,903454,751697,62392576000,2836266000,3016176000,4057127000,9909569000,10916179000,9955126000,30780874000,31611702000
Louisiana,Transportation and Warehousing,2008,15055,7720,2265,1515,11500,1633,601,13734,1321,18855,7725,2270,1560,11555,1795,745,14095,4760,331994,9942,14035,16925,47010,54242,46249,157305,143826,16531611000,516079000,531573000,800303000,1900579000,2455351000,3526196000,8162833000,6820995000
Louisiana,Utilities,2008,1171,675,220,50,945,65,48,1058,113,2685,675,220,50,945,100,185,1230,1455,4842,1461,1356,493,3451,1640,6023,12594,0,341412000,27880000,31902000,22253000,85770000,67957000,320164000,537251000,130500000
Louisiana,Wholesale Trade,2008,22321,9012,3730,3131,15873,3319,1202,20394,1927,27895,9045,3770,3330,16145,4170,2115,22430,5465,375049,14296,22724,37527,78890,98617,48724,241764,121088,18292230000,730106000,1045743000,1744348000,3601657000,4488624000,2321192000,11004391000,6908140000
Maine,Accommodation and Food Services,2008,17563,8748,3095,2865,14708,2306,275,17289,274,19670,8755,3100,2885,14740,2725,1020,18485,1185,232067,8792,21124,38295,69388,80960,38515,190475,42530,3980784000,517813000,416756000,562747000,1508870000,1279789000,542600000,3364055000,595254000
Maine,Administrative and Support and Waste Management and Remediation Services,2008,9191,5910,1325,715,7950,640,207,8797,394,9745,5910,1330,735,7975,720,250,8945,800,112398,7052,8042,8160,24760,22066,19283,72444,33342,3180447000,291091000,209914000,239343000,790396000,682832000,454731000,2057053000,910339000
Maine,"Agriculture, Forestry, Fishing and Hunting",2008,3788,2955,350,265,3570,185,20,3775,13,3815,2955,350,265,3570,205,20,3795,20,17623,3679,2144,3247,9388,5860,403,17434,0,618368000,113049000,64594000,108135000,286560000,205021000,22994000,606044000,0
Maine,"Arts, Entertainment, and Recreation",2008,4377,2960,660,330,3950,290,72,4312,65,4470,2960,660,330,3950,310,130,4390,80,32165,3198,4019,3701,12256,8976,7362,30057,1945,724842000,162134000,92956000,88306000,370371000,173771000,69606000,640635000,42186000
Maine,Construction,2008,26794,20155,3790,1575,25520,1060,121,26701,93,26875,20155,3790,1580,25525,1085,140,26750,125,136743,29168,24083,19678,75878,36088,9020,127112,3211,5619085000,1041559000,830043000,818456000,2704559000,1656089000,411217000,5088720000,192499000
Maine,Educational Services,2008,2370,1280,320,280,1880,275,120,2275,95,2495,1280,320,280,1880,305,155,2340,155,71542,1490,1944,3291,7181,10245,15990,35781,33993,1873642000,57409000,35286000,75111000,180324000,268750000,436835000,955965000,884474000
Maine,Finance and Insurance,2008,5131,2785,630,330,3745,504,225,4474,657,10190,2785,650,420,3855,1255,1540,6650,3540,130435,4094,3795,3634,12316,16767,21488,52042,59642,7086882000,183080000,158462000,178916000,531613000,792920000,946485000,2338875000,3770791000
Maine,Health Care and Social Assistance,2008,16980,8065,3520,1875,13460,1725,1083,16268,712,24155,8095,3555,1970,13620,2585,4100,20305,3850,526966,13193,22563,25035,60474,68557,131644,265970,246856,19600630000,538173000,890593000,1007222000,2477982000,2079638000,4113993000,8755373000,10445423000
Maine,Information,2008,2518,1155,405,240,1800,294,152,2246,272,4020,1155,405,240,1800,350,275,2425,1595,60445,522,2147,2259,6466,8259,7731,26688,24146,2668780000,51265000,59738000,65123000,225925000,339256000,273856000,1051562000,1237751000
Maine,Management of Companies and Enterprises,2008,857,45,5,35,85,140,311,536,321,1065,45,5,35,85,140,330,555,510,39710,0,0,100,22,1442,7218,8860,30810,2702187000,1176000,0,5260000,6795000,58042000,353673000,420312000,2281875000
Maine,Manufacturing,2008,8518,3700,1420,1165,6285,1339,395,8019,499,8865,3700,1425,1190,6315,1395,485,8195,670,232827,3488,6649,10697,26010,40106,27156,111779,70707,10280959000,170355000,215834000,397427000,908562000,1634846000,1097940000,4272705000,3640996000
Maine,"Mining, Quarrying, and Oil and Gas Extraction",2008,136,90,20,0,110,10,0,120,16,145,90,20,0,110,10,0,120,25,64,0,0,0,22,0,0,31,0,24341000,6202000,0,0,9793000,0,0,17835000,0
Maine,Other,2008,57,53,4,0,57,0,0,57,0,57,53,4,0,57,0,0,57,0,60,0,20,0,60,0,0,60,0,876000,676000,200000,0,876000,0,0,876000,0
Maine,Other Services (except Public Administration),2008,17621,11980,3430,1240,16650,612,147,17409,212,18405,11990,3490,1270,16750,895,315,17960,445,91519,21473,20010,14848,59959,17479,4418,85651,4079,2215319000,503572000,477113000,374552000,1382959000,422462000,115654000,1991192000,150578000
Maine,"Professional, Scientific, and Technical Services",2008,16798,11535,2443,1265,15243,851,205,16299,499,17485,11535,2470,1295,15300,1035,260,16595,890,114120,15251,15042,15436,48438,26191,7326,85875,21512,5852803000,692108000,664764000,728537000,2135964000,1488133000,510390000,4364324000,1157927000
Maine,Real Estate and Rental and Leasing,2008,7486,5870,745,315,6930,228,110,7268,218,8570,5870,765,370,7005,335,160,7500,1070,35302,7070,4245,3581,16540,5495,3560,26894,2764,1061845000,251175000,143094000,100749000,515358000,167181000,110460000,829138000,141004000
Maine,Retail Trade,2008,25138,12806,5233,3347,21386,2000,522,23908,1230,33875,12840,5315,3575,21730,2845,1730,26305,7570,377697,16680,30284,37418,90853,56788,33898,191943,99792,8823113000,521635000,637667000,906251000,2077124000,1605862000,1117669000,5108590000,2245826000
Maine,Total,2008,34942,21513,5794,3383,30690,2591,681,33962,980,41755,21535,5860,3549,30944,3502,2370,36816,4939,509093,34062,38178,44855,117095,94427,87469,298991,210102,17684908000,1128843000,1095772000,1318002000,3542617000,3028110000,2921882000,9492609000,8192299000
Maine,Transportation and Warehousing,2008,5665,3555,700,479,4734,399,173,5306,359,6190,3555,705,500,4760,455,215,5430,760,62117,3449,3596,5263,15070,10948,8759,40659,12108,2190737000,144301000,113616000,175831000,457460000,380474000,359874000,1417818000,471899000
Maine,Utilities,2008,243,105,20,10,135,30,25,190,53,425,105,20,20,145,40,60,245,180,1276,52,44,0,253,816,1828,3497,183,74701000,12382000,2420000,0,22528000,43238000,92204000,173987000,12099000
Maine,Wholesale Trade,2008,7195,3620,900,751,5271,732,433,6436,759,8030,3630,905,785,5320,820,665,6805,1225,82532,4241,4280,7016,18237,15179,13574,52661,14181,3785969000,211346000,182179000,277676000,756992000,651251000,634850000,2297080000,1050734000
Maryland,Accommodation and Food Services,2008,42368,17405,8230,6668,32303,8132,998,41433,935,54395,17410,8250,6740,32400,8820,2785,44005,10390,1008355,30232,54124,90243,175003,309213,128680,615977,388654,15952420000,744979000,739902000,1221607000,2711784000,4637839000,1873952000,9287462000,6600076000
Maryland,Administrative and Support and Waste Management and Remediation Services,2008,36340,19880,5540,3858,29278,4166,1275,34719,1621,40755,19880,5550,3885,29315,4275,1600,35190,5565,967986,28256,35081,49774,118124,158172,153927,435514,510785,32501531000,1195914000,1154768000,1807324000,4198260000,5620767000,4476037000,14461706000,17581677000
Maryland,"Agriculture, Forestry, Fishing and Hunting",2008,958,715,130,55,900,35,0,935,23,970,715,130,55,900,35,0,935,35,4615,659,294,274,2182,392,0,3611,541,147605000,26315000,12044000,10353000,59890000,9490000,0,94312000,21153000
Maryland,"Arts, Entertainment, and Recreation",2008,9652,5203,1557,1080,7840,1325,262,9427,225,10345,5210,1560,1120,7890,1420,350,9660,685,181161,6464,9504,13571,31772,51882,38450,123908,28361,4443240000,319712000,211150000,284174000,821766000,966404000,1046011000,2898733000,393974000
Maryland,Construction,2008,80567,49390,13295,8480,71165,7443,1350,79958,609,81165,49390,13305,8480,71175,7495,1500,80170,995,910695,83234,86840,113407,285550,280448,197330,776820,121464,44677211000,3052085000,3254155000,4924984000,11232480000,13913005000,10570246000,36094755000,7967953000
Maryland,Educational Services,2008,9329,4335,1360,1190,6885,1525,613,9023,306,10025,4335,1365,1225,6925,1710,705,9340,685,374048,5873,8744,16093,32267,62336,82921,181827,186520,14573332000,233102000,212861000,344933000,800753000,1778494000,3018753000,5769482000,8387834000
Maryland,Finance and Insurance,2008,23349,13885,3575,1669,19129,1558,902,21589,1760,42150,13915,3640,1815,19370,3210,2490,25070,17080,558877,23811,22195,20890,68306,52786,62088,188982,336404,41619866000,1150039000,1181560000,1479754000,3835955000,3592086000,3924129000,11942685000,27891419000
Maryland,Health Care and Social Assistance,2008,61364,30115,13850,7664,51629,6046,2122,59797,1567,76355,30190,14045,8230,52465,8940,6630,68035,8320,1601477,57118,90380,98074,248065,218821,279984,759624,810148,68775430000,2908013000,3880618000,4490651000,11283487000,9773063000,9047467000,30684105000,37072457000
Maryland,Information,2008,7039,3395,820,693,4908,875,452,6235,804,12665,3400,820,700,4920,945,570,6435,6230,288384,1948,3916,7331,16526,28468,33957,85752,182291,20328426000,299095000,252960000,423870000,1030104000,1553883000,2445566000,5238948000,12372316000
Maryland,Management of Companies and Enterprises,2008,3016,190,50,95,335,611,820,1766,1250,5210,190,50,95,335,620,880,1835,3375,241690,269,0,530,1020,8036,27004,36060,205630,20560505000,30698000,19151000,41440000,93080000,539397000,1425935000,2058412000,18497028000
Maryland,Manufacturing,2008,16824,6195,3009,2411,11615,2867,951,15433,1391,17635,6195,3015,2440,11650,2955,1125,15730,1905,531729,6571,16099,25579,56156,95829,67014,251359,238745,29217095000,405643000,612381000,1128351000,2361935000,4303593000,3252674000,11420404000,15826870000
Maryland,"Mining, Quarrying, and Oil and Gas Extraction",2008,346,105,65,35,205,70,15,290,56,420,105,65,35,205,70,40,315,105,6776,62,230,176,746,2491,0,3193,1793,344621000,6854000,10470000,9355000,28676000,124299000,0,173437000,139062000
Maryland,Other,2008,203,189,10,4,203,0,0,203,0,203,189,10,4,203,0,0,203,0,276,178,0,46,276,0,0,276,0,5157000,3866000,976000,315000,5157000,0,0,5157000,0
Maryland,Other Services (except Public Administration),2008,63359,36570,13134,7457,57161,4808,739,62708,651,68075,36610,13190,7650,57450,5605,1330,64385,3690,564782,67569,84495,98143,253823,168990,60585,491661,60230,17571895000,1890760000,2240245000,2723287000,6885796000,5122219000,2442980000,14666852000,2446570000
Maryland,"Professional, Scientific, and Technical Services",2008,90076,61143,11315,7006,79464,6704,1890,88058,2018,96585,61160,11335,7125,79620,7300,2510,89430,7155,1180530,81896,72769,90849,255614,236932,171018,670684,478507,87193169000,5263053000,4192037000,5698520000,15186248000,17324016000,12531990000,45347169000,40310232000
Maryland,Real Estate and Rental and Leasing,2008,23770,16805,2705,1449,20959,1434,585,22978,792,31710,16815,2765,1585,21165,2100,1925,25190,6520,231780,21113,17061,17616,59971,42370,41048,147344,79426,11157631000,928327000,633845000,839532000,2421602000,2223471000,2197549000,6949820000,3993274000
Maryland,Retail Trade,2008,62012,32682,12940,7433,53055,4902,1549,59506,2506,95440,32750,13180,8010,53940,7130,4260,65330,30110,1419744,49610,77403,90680,219979,159853,122892,534737,811600,33968555000,1503163000,1946996000,2347569000,5832516000,4972477000,4660862000,15924238000,17490482000
Maryland,Total,2008,112392,64012,19489,12213,95714,11176,2803,109693,2699,138607,64078,19660,12678,96416,13660,6326,116402,22205,2232490,109135,127650,162377,399162,417794,342539,1159495,1072995,99649640000,4340005000,4507199000,6169170000,15016374000,17232922000,14793527000,47042823000,52606817000
Maryland,Transportation and Warehousing,2008,16219,9140,2300,1344,12784,1556,610,14950,1269,17990,9140,2300,1350,12790,1655,760,15205,2785,321290,12984,13688,14009,43178,47258,28411,128974,130781,12327655000,436256000,425855000,482133000,1424534000,1612254000,1141425000,4445491000,5457193000
Maryland,Utilities,2008,281,95,15,25,135,20,15,170,111,605,95,15,25,135,20,65,220,385,51173,125,0,96,466,224,0,214,33318,6018846000,9253000,5152000,12320000,40530000,18840000,0,243965000,3964462000
Maryland,Wholesale Trade,2008,25526,11935,3642,2762,18339,3541,1360,23240,2286,29525,11940,3670,2805,18415,3995,2105,24515,5010,473916,16364,21423,34280,77843,113229,68119,279944,180674,27510939000,1066002000,1216605000,2011407000,4378628000,6089469000,3737551000,15020960000,11683744000
Massachusetts,Accommodation and Food Services,2008,63546,28070,12543,10445,51058,10465,1163,62686,860,80310,28140,12575,10545,51260,12040,3880,67180,13130,1320185,48146,82334,143737,274871,371372,165412,812655,506812,23317785000,1460398000,1214474000,2180157000,4863395000,6194849000,2767198000,13838695000,9470411000
Massachusetts,Administrative and Support and Waste Management and Remediation Services,2008,44061,27980,5815,3559,37354,3709,1400,42463,1598,49225,27985,5825,3605,37415,3870,1850,43135,6090,1018732,35856,36843,45886,122173,138029,203412,477606,521828,38291487000,2159172000,1604810000,1873970000,5706880000,5424058000,6352884000,18040058000,19816005000
Massachusetts,"Agriculture, Forestry, Fishing and Hunting",2008,1915,1600,205,65,1870,30,10,1910,5,1920,1600,205,65,1870,30,10,1910,10,5241,1346,1119,624,3798,183,0,5173,0,152012000,66277000,21512000,20914000,118780000,7853000,0,145428000,0
Massachusetts,"Arts, Entertainment, and Recreation",2008,14529,7990,2360,1633,11983,1896,414,14293,236,15620,7990,2370,1655,12015,2120,700,14835,785,258341,11055,15089,20723,48843,69349,56895,185879,51974,8359002000,618082000,473068000,631177000,1766721000,1620373000,1692821000,5535126000,1165335000
Massachusetts,Construction,2008,93007,65465,14180,7100,86745,5162,686,92593,414,93325,65465,14180,7105,86750,5220,715,92685,640,654665,101969,91289,94957,289821,189656,93643,582590,52295,39449870000,4722472000,4376520000,5296560000,14396650000,12680454000,6975908000,34576545000,3947280000
Massachusetts,Educational Services,2008,11951,5245,1880,1435,8560,2041,873,11474,477,12905,5245,1900,1465,8610,2190,1150,11950,955,923421,7731,12452,19196,40517,81590,127720,256890,663652,35475150000,322326000,331291000,536781000,1195942000,2745613000,4763929000,9006755000,26410236000
Massachusetts,Finance and Insurance,2008,28839,15635,4563,2537,22735,2683,1338,26756,2083,50090,15740,4710,2985,23435,4590,5385,33410,16680,1084719,27575,28406,30592,90929,87227,124018,306754,759386,111546956000,1878129000,2191226000,3225155000,7314778000,9305171000,9226408000,26105154000,84127329000
Massachusetts,Health Care and Social Assistance,2008,65585,28455,14675,9317,52447,7441,3457,63345,2240,89055,28485,14775,9770,53030,10140,11260,74430,14625,2680416,54859,95360,123201,277516,277651,495461,1057435,1573834,122516243000,2709624000,4415359000,5943354000,13103591000,12320554000,16793314000,42324049000,79427132000
Massachusetts,Information,2008,11575,5053,1585,1305,7943,1683,648,10274,1301,19155,5060,1585,1330,7975,1720,750,10445,8710,522746,7152,9662,14972,35290,63547,58910,166802,353083,43535666000,546040000,599285000,1044694000,2237068000,5184803000,5478501000,13229559000,30008428000
Massachusetts,Management of Companies and Enterprises,2008,4156,350,90,155,595,636,1110,2341,1815,6060,350,90,155,595,645,1140,2380,3680,437260,440,392,1090,2052,8809,38731,49592,387655,44636900000,69612000,34540000,123145000,228312000,665835000,2835614000,3731485000,40905415000
Massachusetts,Manufacturing,2008,36602,12560,6528,5734,24822,7438,2106,34366,2236,37800,12570,6535,5765,24870,7660,2350,34880,2920,1244050,17798,37064,69956,138649,272898,211936,680229,467745,73461042000,1034200000,1682784000,3219672000,6271870000,13483044000,11712305000,33998368000,32950228000
Massachusetts,"Mining, Quarrying, and Oil and Gas Extraction",2008,423,170,75,65,310,69,17,396,27,480,170,75,65,310,85,45,440,40,4759,127,186,744,1515,1340,0,4287,316,305941000,17538000,22681000,34058000,83218000,72107000,0,254808000,19686000
Massachusetts,Other,2008,410,380,20,6,406,4,0,410,0,410,380,20,6,406,4,0,410,0,691,0,132,80,586,105,0,691,0,17610000,10985000,3073000,1930000,15988000,1622000,0,17610000,0
Massachusetts,Other Services (except Public Administration),2008,76587,46330,16630,8056,71016,4206,712,75934,653,82750,46445,16750,8545,71740,5070,1900,78710,4040,604014,89924,107471,104435,303316,138574,73454,522610,71459,17421350000,2546808000,2815638000,2773528000,8177184000,4097911000,2204168000,14666297000,2507982000
Massachusetts,"Professional, Scientific, and Technical Services",2008,103484,70165,14201,7892,92258,6358,2231,100847,2637,108605,70185,14230,8020,92435,6780,2780,101995,6610,1292717,90101,92672,101964,304784,218408,212514,749586,529298,114152215000,6663950000,5430544000,7184654000,19295441000,19828483000,20006285000,59680270000,53798030000
Massachusetts,Real Estate and Rental and Leasing,2008,26186,18510,3404,1742,23656,1283,556,25495,691,33700,18585,3610,1895,24090,1860,1585,27535,6165,229288,28464,21053,21789,72043,40256,43061,161259,58045,11657358000,1323693000,884896000,1024819000,3271427000,2128429000,2376635000,8056190000,3367463000
Massachusetts,Retail Trade,2008,85060,48250,16994,9118,74362,6532,1655,82549,2511,125605,48465,17440,9860,75765,9625,5700,91090,34515,1756547,79609,102080,105579,292222,208027,106422,646902,744762,44831808000,2530728000,2744506000,3141489000,8460386000,7662256000,4111315000,21325048000,16734670000
Massachusetts,Total,2008,141843,81971,24873,15149,121993,13291,3562,138846,2997,174290,82129,25144,15792,123065,16268,8974,148307,25983,3074569,140724,163249,202568,506541,496186,469363,1472090,1602479,161821239000,6289046000,6446297000,8660862000,21396205000,23941756000,23024491000,68362452000,93458787000
Massachusetts,Transportation and Warehousing,2008,16001,8213,2360,1739,12312,1659,823,14794,1207,18255,8220,2365,1750,12335,1750,1010,15095,3160,393190,9848,14761,22573,50814,60182,55500,174817,203650,15311495000,473621000,508466000,780058000,1842478000,2090028000,1815485000,6064033000,8519596000
Massachusetts,Utilities,2008,468,165,40,35,240,35,47,322,146,1305,165,40,35,240,35,75,350,955,53888,147,88,0,660,1202,3618,7432,45762,6067152000,15088000,5012000,0,56450000,259983000,393048000,1019518000,5010767000
Massachusetts,Wholesale Trade,2008,38502,17855,6313,4228,28396,5232,1981,35609,2893,43235,17880,6360,4315,28555,5890,2585,37030,6205,707992,27435,38825,53435,125984,174392,107904,426783,241967,50977301000,1888798000,2430319000,3411223000,7833622000,11329879000,7888580000,27954804000,21235831000
Michigan,Accommodation and Food Services,2008,75805,29505,15265,14300,59070,14319,1323,74712,1093,98115,29520,15300,14530,59350,16710,5535,81595,16520,1700860,46736,102251,195971,345890,519940,192405,1061744,636394,22267115000,1023015000,1084353000,2070691000,4181420000,6338737000,2244130000,12812462000,9411567000
Michigan,Administrative and Support and Waste Management and Remediation Services,2008,53696,32215,6927,4532,43674,5864,2399,51937,1759,61385,32225,6955,4630,43810,6300,2865,52975,8410,1531158,39887,44813,59731,148139,250511,381998,792887,715493,44981147000,2202690000,1497875000,1854382000,5579639000,9340597000,10530563000,25863202000,17650054000
Michigan,"Agriculture, Forestry, Fishing and Hunting",2008,2799,1965,475,190,2630,104,30,2764,35,2805,1965,475,190,2630,105,30,2765,40,14831,3035,2606,2005,8753,2149,998,14266,206,508960000,86846000,82631000,80298000,271391000,79538000,38322000,452715000,20861000
Michigan,"Arts, Entertainment, and Recreation",2008,17249,10170,2475,2080,14725,1968,323,17016,233,18040,10180,2495,2105,14780,2125,440,17345,695,236032,11070,15585,27143,54670,75824,44479,183151,28661,7059640000,663850000,341357000,493127000,1523513000,1514485000,2521085000,5736800000,644485000
Michigan,Construction,2008,107787,78059,15360,7790,101209,5471,705,107385,402,108540,78065,15360,7805,101230,5545,965,107740,800,729800,110091,100450,103160,317975,195875,92301,611810,79835,36066965000,4798290000,4001255000,4828165000,13679765000,11071096000,5973939000,30953615000,4462244000
Michigan,Educational Services,2008,10045,4980,1657,1250,7887,1431,430,9748,297,11115,4985,1660,1280,7925,1605,780,10310,805,338205,7238,10610,16907,35477,57314,64261,160529,163720,8523195000,228966000,210927000,313736000,777316000,1439074000,1781792000,4088840000,4022834000
Michigan,Finance and Insurance,2008,37608,24398,5520,2497,32415,2509,997,35921,1687,76290,24500,5650,3015,33165,5575,5175,43915,32375,833448,41687,34228,30272,109490,94224,100242,310806,482816,45053640000,1660275000,1521354000,1665562000,4921531000,4537318000,4737112000,14639571000,30417116000
Michigan,Health Care and Social Assistance,2008,104540,47783,26218,15273,89274,10165,3246,102685,1855,129740,47855,26415,15870,90140,14895,11770,116805,12935,2788908,88206,174115,200613,466734,380805,491543,1343752,1435501,114462544000,4193682000,7085076000,8892644000,20177892000,15980253000,15587125000,51950137000,62049931000
Michigan,Information,2008,8864,4180,1332,948,6460,991,364,7815,1049,18580,4180,1340,955,6475,1325,585,8385,10195,372696,4665,6837,11599,25926,31710,16367,87848,279387,22356196000,259146000,315526000,490527000,1089552000,1399241000,772513000,3827409000,18126943000
Michigan,Management of Companies and Enterprises,2008,5468,450,95,200,745,1116,1599,3460,2008,7800,450,105,200,755,1140,1710,3605,4195,572640,0,376,1093,2020,14830,55167,72150,500051,54432750000,1966000,81064000,67601000,276440000,723125000,2864241000,3871165000,50530679000
Michigan,Manufacturing,2008,62571,20955,11009,9729,41693,12785,4365,58843,3728,66710,20970,11015,9755,41740,13405,5490,60635,6075,2702182,34515,69261,125000,239878,482095,518240,1293403,1311970,134301421000,1476650000,2488234000,5298800000,9550337000,21440846000,22997300000,56281938000,73341921000
Michigan,"Mining, Quarrying, and Oil and Gas Extraction",2008,1824,980,255,170,1405,210,91,1706,118,1995,980,255,185,1420,230,110,1760,235,23981,1046,1539,1839,5229,5349,3213,14566,9197,1563104000,92983000,97208000,122099000,318567000,433859000,203847000,970433000,588943000
Michigan,Other,2008,561,531,21,6,558,3,0,561,0,561,531,21,6,558,3,0,561,0,710,408,140,0,622,88,0,710,0,10852000,7679000,1479000,0,9859000,993000,0,10852000,0
Michigan,Other Services (except Public Administration),2008,110576,66367,25063,11201,102631,6382,842,109855,721,118510,66410,25310,11685,103405,8725,1750,113880,4630,809171,129074,162194,144342,438582,211257,71444,733556,60096,19613455000,2827597000,3361684000,3175075000,9372880000,5294998000,2009048000,17015490000,2288428000
Michigan,"Professional, Scientific, and Technical Services",2008,103749,70520,14340,8254,93114,6204,2045,101363,2386,111705,70550,14410,8485,93445,7400,3235,104080,7625,1263861,93369,93230,106249,306341,221916,204704,740354,507062,80637839000,5287570000,4431253000,5757428000,15519490000,13263876000,11403905000,40416007000,39567510000
Michigan,Real Estate and Rental and Leasing,2008,32036,22930,4349,1864,29143,1574,626,31343,693,41180,22995,4540,2055,29590,2620,1975,34185,6995,259902,34245,26805,22960,84360,48346,45740,181447,69215,8582778000,1111631000,787265000,739882000,2660761000,1645901000,1418823000,5802270000,2367607000
Michigan,Retail Trade,2008,121507,70816,24690,12436,107942,9134,1790,118866,2641,181905,70980,25225,13760,109965,14775,7130,131870,50035,2291592,115308,156835,140937,430589,322115,162369,953336,1246655,51795310000,2841718000,3258128000,3680477000,9898946000,9303354000,4119840000,23727465000,25675164000
Michigan,Total,2008,182606,105618,33110,19900,158628,16976,3921,179525,3081,229310,105766,33501,20886,160153,22505,11060,193718,35592,3636241,177655,218159,266054,661868,645428,560573,1867869,1768372,147812891000,6402047000,6779766000,8975099000,22156912000,23649105000,20984305000,66790322000,81022569000
Michigan,Transportation and Warehousing,2008,24019,14530,2925,1923,19378,2280,859,22517,1502,28315,14530,2970,1985,19485,2520,1250,23255,5060,478208,17799,18634,24186,63627,71786,54748,200248,254295,18681922000,678606000,610975000,892416000,2206455000,2637478000,2135977000,7282678000,10392588000
Michigan,Utilities,2008,491,165,45,35,245,56,30,331,160,1985,165,45,65,275,85,100,460,1525,7595,116,172,0,700,2401,2972,7590,6999,606552000,11939000,5943000,9616000,45070000,148206000,322113000,673598000,468029000
Michigan,Wholesale Trade,2008,49754,24637,7769,5533,37939,5995,2466,46400,3354,59030,24670,7875,5845,38390,7425,4405,50220,8810,851885,30195,49388,69934,163072,183743,144010,507181,314121,48535156000,2106716000,2392788000,3640090000,8189490000,9984967000,7313947000,26133802000,20769184000
Minnesota,Accommodation and Food Services,2008,42304,14449,7440,8798,30687,9654,1041,41382,922,55915,14475,7455,8875,30805,10980,3165,44950,10965,1108945,21531,50696,122784,195783,357944,132148,688156,416236,15669300000,573252000,505910000,1193172000,2273077000,4376228000,1770107000,8459636000,7131670000
Minnesota,Administrative and Support and Waste Management and Remediation Services,2008,32457,20675,4355,2695,27725,2598,912,31235,1222,35995,20680,4370,2780,27830,2850,1155,31835,4160,699501,24551,26634,33672,89683,99405,115784,319869,364364,21890144000,1275770000,903748000,1095960000,3291469000,3339284000,3052857000,10072982000,11203009000
Minnesota,"Agriculture, Forestry, Fishing and Hunting",2008,2205,1485,455,110,2050,80,40,2170,35,2250,1485,455,110,2050,90,45,2185,65,10225,1756,2920,1290,6458,2136,917,9768,330,346877000,74448000,82783000,35685000,199283000,77802000,31713000,322669000,17070000
Minnesota,"Arts, Entertainment, and Recreation",2008,13193,8230,1910,1352,11492,1216,263,12971,222,13825,8230,1915,1385,11530,1270,290,13090,735,222115,9856,10746,14134,36846,40822,41419,128862,47258,5820135000,381122000,228491000,226577000,867887000,703743000,2251663000,3936088000,833861000
Minnesota,Construction,2008,85442,63363,11570,5435,80368,4034,569,84971,471,85985,63375,11570,5440,80385,4140,655,85180,805,589290,86635,74510,70343,234810,150327,77178,469855,83341,33935610000,3995731000,3213453000,3690043000,10917993000,8903539000,4943414000,25262214000,5574070000
Minnesota,Educational Services,2008,8590,4045,1140,1163,6348,1695,285,8328,262,9350,4045,1145,1170,6360,1855,395,8610,740,322715,5758,7754,15829,28711,67181,43512,146034,165081,8012955000,192413000,151590000,324614000,670384000,1629426000,1332741000,3752426000,4015582000
Minnesota,Finance and Insurance,2008,32322,21910,3721,1895,27526,2194,878,30598,1724,49450,22000,3885,2295,28180,4690,3645,36515,12935,728456,31036,22009,23222,79354,75364,68175,234802,321203,53421287000,1469950000,1140654000,1392743000,4121857000,4266310000,4154610000,13227083000,32343767000
Minnesota,Health Care and Social Assistance,2008,49084,22305,9575,6166,38046,6332,3175,47553,1531,71345,22340,9645,6545,38530,9490,11340,59360,11985,1979597,33248,63828,83653,186319,258429,490730,942657,983532,75258284000,1512546000,2373559000,3060439000,7010505000,8925043000,13858435000,29952622000,42638830000
Minnesota,Information,2008,8551,4050,1143,955,6148,1069,396,7613,938,13655,4050,1160,980,6190,1415,890,8495,5160,319343,3677,6715,10914,23596,39380,38665,113963,163586,19442948000,279179000,287149000,481570000,1060144000,1992706000,2131797000,5881544000,13777194000
Minnesota,Management of Companies and Enterprises,2008,4046,275,95,75,445,755,1205,2405,1641,5625,275,100,75,450,770,1245,2465,3160,456520,0,447,412,1084,9985,38665,49895,404733,51886940000,31301000,15458000,16816000,66885000,595730000,2498365000,3160980000,48704685000
Minnesota,Manufacturing,2008,36990,13555,6295,5107,24957,6945,2461,34363,2627,39390,13560,6305,5120,24985,7250,2940,35175,4215,1522137,19546,36712,62200,128051,265477,281679,726730,706964,75447122000,910878000,1337131000,2501185000,4969591000,11954849000,13490836000,32596117000,38465383000
Minnesota,"Mining, Quarrying, and Oil and Gas Extraction",2008,647,345,95,70,510,50,21,581,66,765,345,95,70,510,55,25,590,175,25432,362,387,608,1770,1542,453,4517,19288,2033953000,35637000,31789000,49363000,126744000,111908000,14325000,284782000,1613431000
Minnesota,Other,2008,169,161,5,3,169,0,0,169,0,169,161,5,3,169,0,0,169,0,0,0,0,39,0,0,0,0,0,3514000,2944000,304000,266000,3514000,0,0,3514000,0
Minnesota,Other Services (except Public Administration),2008,71012,41315,14949,8279,64543,5144,719,70406,606,76690,41370,15120,8630,65120,6525,1875,73520,3170,698030,75477,96887,108481,283620,168008,66372,525714,71110,20114350000,1687588000,1958671000,2246424000,5926783000,3714318000,1742560000,11547460000,3113294000
Minnesota,"Professional, Scientific, and Technical Services",2008,78973,57630,9130,5354,72114,4002,1198,77314,1659,82770,57650,9165,5555,72370,4685,1600,78655,4115,723201,60027,58334,69455,199003,134332,93167,440815,252634,42504793000,3831680000,2792564000,3715033000,10408930000,9086345000,7147141000,26873609000,15078261000
Minnesota,Real Estate and Rental and Leasing,2008,26490,20325,2655,1178,24158,1149,548,25855,635,32235,20440,2710,1310,24460,1910,1400,27770,4465,206248,19543,16348,14555,57838,36956,39500,137164,44348,7011317000,937355000,502075000,477269000,1928864000,1200111000,1117235000,4258550000,1978648000
Minnesota,Retail Trade,2008,68530,33250,15150,9207,57607,6840,1725,66172,2358,101030,33310,15325,10045,58680,10385,6075,75140,25890,1454889,55234,97315,115881,272831,229638,132905,662083,625215,32583179000,1409150000,1915000000,2605700000,5962131000,5746124000,3827489000,15931071000,14791869000
Minnesota,Total,2008,120950,71792,19410,12680,103882,11622,2887,118391,2559,148845,71897,19606,13309,104812,15228,8155,128195,20650,2517356,111691,128229,170123,410043,442206,397712,1249961,1267395,109378505000,4206754000,4004816000,5463541000,13675111000,15787730000,15602088000,45064929000,64313576000
Minnesota,Transportation and Warehousing,2008,20986,12985,2365,1816,17166,1901,691,19758,1228,23445,12985,2375,1840,17200,2080,885,20165,3280,343449,9035,14027,20915,52049,64721,54260,181514,140928,12540387000,616971000,472120000,720348000,1842004000,2008985000,1847960000,5862739000,6352370000
Minnesota,Utilities,2008,535,100,30,75,205,155,60,420,115,1350,100,30,75,205,210,115,530,820,1108,38,86,1019,1264,5522,5532,12188,98,2251566000,6634000,7793000,60652000,78596000,339000000,383948000,798238000,6753000
Minnesota,Wholesale Trade,2008,36544,17924,5107,4072,27103,4661,1933,33697,2847,42310,17965,5180,4230,27375,5490,3035,35900,6410,687983,25187,30164,49134,111642,149994,101960,378986,273770,43559147000,1538395000,1770345000,2784973000,6194239000,8392871000,5492301000,20590451000,21071694000
Mississippi,Accommodation and Food Services,2008,17582,6325,3378,3410,13113,3285,481,16879,703,24320,6335,3380,3465,13180,3710,1695,18585,5735,615894,10365,22900,46394,80302,117492,58302,261334,352556,9497307000,231382000,244105000,475889000,957079000,1243236000,667562000,2909167000,6566401000
Mississippi,Administrative and Support and Waste Management and Remediation Services,2008,9931,5490,1580,1015,8085,838,333,9256,675,11185,5490,1585,1020,8095,895,430,9420,1765,252422,8993,9577,12832,32935,33774,40480,113927,132749,5581842000,252371000,218003000,293711000,789958000,765821000,847011000,2480658000,2970096000
Mississippi,"Agriculture, Forestry, Fishing and Hunting",2008,3517,1900,965,435,3300,145,20,3465,52,3585,1900,965,435,3300,150,35,3485,100,21140,3386,6195,5236,15162,3625,0,19703,546,695409000,112872000,177480000,153393000,453316000,138594000,0,613539000,34456000
Mississippi,"Arts, Entertainment, and Recreation",2008,3300,1895,575,395,2865,345,45,3255,45,3370,1895,580,395,2870,365,70,3305,65,35450,2638,3373,4909,11622,11967,5149,31080,100,628215000,91737000,51702000,69368000,227218000,187046000,74155000,532602000,2509000
Mississippi,Construction,2008,24543,14360,4675,2770,21805,2240,288,24333,210,24755,14360,4675,2770,21805,2260,330,24395,360,266875,24104,30285,37117,93310,84750,42113,225160,22011,9921720000,720710000,777485000,1151817000,2657375000,3123052000,1851524000,7834320000,1128957000
Mississippi,Educational Services,2008,2496,1035,385,260,1680,576,125,2381,115,3020,1035,385,260,1680,595,265,2540,480,89157,1343,2157,3272,7078,24651,16455,48608,40098,1845151000,54096000,31115000,63205000,172491000,476554000,416508000,1082703000,745217000
Mississippi,Finance and Insurance,2008,12385,8285,1510,640,10435,702,380,11517,868,24680,8300,1625,1010,10935,2470,2705,16110,8570,175286,15363,9322,7272,32535,23833,29318,88019,55665,7807701000,484524000,321575000,313561000,1145571000,960229000,1158767000,3336971000,4382278000
Mississippi,Health Care and Social Assistance,2008,24337,10585,6025,3605,20215,2415,961,23591,746,29635,10590,6040,3715,20345,3335,2490,26170,3465,734445,19503,38608,46335,106837,87061,123632,323506,390966,28331902000,987638000,1443051000,1780362000,4244590000,3079387000,3843904000,11311089000,16567988000
Mississippi,Information,2008,2061,750,365,260,1375,220,146,1741,320,5125,750,370,275,1395,325,260,1980,3145,63806,926,1521,2765,6300,6671,3742,20789,34768,2588310000,39930000,49884000,69768000,173008000,216186000,172929000,654349000,1837027000
Mississippi,Management of Companies and Enterprises,2008,1180,65,25,25,115,241,395,751,429,1560,65,25,25,115,245,430,790,770,36923,12,0,0,0,2409,8101,10652,26219,2387569000,2054000,1770000,1655000,18335000,84176000,479730000,583345000,1804224000
Mississippi,Manufacturing,2008,11636,3560,1765,1507,6832,2196,1023,10051,1585,12825,3560,1765,1515,6840,2260,1245,10345,2480,640253,4159,8718,16541,33814,71143,90373,218360,373271,22168753000,170730000,246862000,495257000,1003821000,2306468000,2763898000,6812498000,13773729000
Mississippi,"Mining, Quarrying, and Oil and Gas Extraction",2008,1712,940,190,130,1260,209,70,1539,173,1830,940,190,135,1265,215,85,1565,265,26013,116,748,1288,3284,6205,2931,13995,7532,1681707000,70174000,49513000,70816000,196060000,344854000,178879000,765897000,676167000
Mississippi,Other,2008,72,71,1,0,72,0,0,72,0,72,71,1,0,72,0,0,72,0,0,0,0,0,0,0,0,0,0,1221000,1157000,0,0,1221000,0,0,1221000,0
Mississippi,Other Services (except Public Administration),2008,31390,19585,6820,2900,29305,1515,247,31067,323,32985,19610,6845,3035,29490,1915,480,31885,1100,198816,36423,43616,36109,119617,48089,11175,187257,7039,4008061000,738385000,799722000,733906000,2320994000,878386000,242546000,3656513000,276511000
Mississippi,"Professional, Scientific, and Technical Services",2008,21945,14675,3365,1860,19900,1112,418,21430,515,23805,14680,3390,1885,19955,1495,690,22140,1665,157976,24035,20975,23136,70335,33898,20525,128333,23754,7089190000,849319000,741129000,944679000,2566879000,1701090000,1181913000,5595783000,1272428000
Mississippi,Real Estate and Rental and Leasing,2008,10020,7682,1095,413,9190,346,175,9711,309,12425,7690,1130,445,9265,475,635,10375,2050,53208,11189,5651,4631,24267,7681,5414,40378,8019,1547595000,309400000,154592000,140651000,624152000,235146000,208678000,1182492000,289651000
Mississippi,Retail Trade,2008,40612,21792,8495,4699,34986,3378,654,39018,1594,60740,21850,8640,5000,35490,4790,3255,43535,17205,630657,38447,54098,58575,156097,109636,50614,326323,254100,12938701000,764916000,1070089000,1400499000,3250111000,2840725000,988531000,7336202000,4715819000
Mississippi,Total,2008,47489,26138,8954,5313,40405,4313,1157,45875,1614,60918,26174,9049,5588,40811,5730,3374,49915,11003,944747,47847,58578,70732,177157,158511,131317,466985,477762,29276870000,1339385000,1445701000,1913830000,4698916000,4576549000,3988044000,13263509000,16013361000
Mississippi,Transportation and Warehousing,2008,9700,5335,1465,960,7760,722,311,8793,907,11125,5340,1465,970,7775,790,425,8990,2135,160060,7742,8568,10825,28688,23691,12271,69815,73488,5973427000,269957000,254313000,337748000,900543000,788263000,395610000,2240005000,2938128000
Mississippi,Utilities,2008,1773,1145,330,70,1545,90,65,1700,73,2810,1150,330,100,1580,165,215,1960,850,41800,2756,1992,796,5660,5075,9345,20311,0,3139346000,55985000,47697000,27213000,137320000,247827000,516816000,909238000,138292000
Mississippi,Wholesale Trade,2008,12042,4965,1835,1379,8179,1733,799,10711,1331,14450,4975,1855,1485,8315,2195,1130,11640,2810,178765,7179,10039,15212,36754,41208,27161,120892,48164,7367685000,313322000,376548000,614207000,1379374000,1685866000,1112828000,4658373000,2304408000
Missouri,Accommodation and Food Services,2008,44830,16744,7510,8256,32510,9767,1342,43619,1211,61075,16795,7535,8340,32670,11185,4595,48450,12625,1235818,26371,50722,113057,191328,358428,182445,733538,498611,16597235000,577919000,550719000,1205283000,2333846000,4234617000,2261371000,8862669000,7712017000
Missouri,Administrative and Support and Waste Management and Remediation Services,2008,33142,20267,5070,2705,28042,2630,934,31606,1536,37485,20275,5075,2720,28070,2800,1200,32070,5415,807188,29071,32024,35783,100899,93547,112375,319964,455856,21431153000,885523000,876517000,1068778000,2861139000,2795320000,2774229000,8703048000,12065643000
Missouri,"Agriculture, Forestry, Fishing and Hunting",2008,1215,885,180,45,1110,60,20,1190,25,1235,885,180,45,1110,65,20,1195,40,6692,1173,693,312,3066,1751,488,6244,0,187982000,32247000,28865000,6929000,76414000,55838000,12214000,170414000,0
Missouri,"Arts, Entertainment, and Recreation",2008,10038,5662,1510,1195,8367,1199,214,9780,258,10695,5670,1510,1195,8375,1325,305,10005,690,199932,7507,9285,15101,33754,42059,22155,104876,80978,6525376000,268362000,150616000,263637000,697367000,822299000,2233486000,3853448000,1639544000
Missouri,Construction,2008,78597,49991,14164,7457,71612,5654,811,78077,520,79270,50000,14170,7470,71640,5780,975,78395,875,716837,84302,93107,98858,277085,203026,107792,594230,96798,33537058000,2568420000,2973866000,3909490000,9452590000,10044964000,6080142000,25850225000,6319242000
Missouri,Educational Services,2008,7042,3085,990,990,5065,1360,373,6798,244,7720,3085,990,995,5070,1475,470,7015,705,341720,3906,5530,12254,24571,59547,62532,153013,184384,11487872000,125555000,111614000,222332000,471347000,1365302000,1741674000,3698304000,7677857000
Missouri,Finance and Insurance,2008,30795,20890,3320,1544,25754,2306,897,28957,1838,55985,20945,3460,1780,26185,5725,4640,36550,19435,673430,34615,20734,17893,74430,77967,81283,236547,402143,36645797000,1218873000,797881000,885130000,2973176000,3544842000,3846690000,10581450000,25233680000
Missouri,Health Care and Social Assistance,2008,62858,31583,12395,7795,51773,6934,2431,61138,1720,80410,31620,12490,8135,52245,9045,7475,68765,11645,1841724,48570,80532,101733,237970,290340,324269,860932,969065,68383955000,2151304000,3089396000,4284786000,9549270000,9405028000,8929696000,28072239000,39852992000
Missouri,Information,2008,6671,2950,976,735,4661,851,340,5852,819,12965,2955,980,765,4700,1045,665,6410,6555,344372,3800,5810,9253,20660,26698,26536,76589,249099,19463985000,194057000,208464000,406201000,823200000,1038687000,996798000,3023240000,15935508000
Missouri,Management of Companies and Enterprises,2008,4166,300,50,150,500,827,1191,2518,1648,7295,300,50,150,500,845,1270,2615,4680,367435,410,4,849,1451,8875,31665,42005,325430,34298300000,38410000,13335000,68740000,120490000,603660000,1913815000,2637965000,31660335000
Missouri,Manufacturing,2008,31528,11460,5370,4573,21403,5573,1948,28924,2604,33720,11460,5385,4595,21440,6015,2375,29830,3890,1298034,18147,31112,53172,112357,189045,177433,531959,672006,55762358000,629044000,955238000,1874877000,3659367000,7216080000,7048070000,19847279000,31558281000
Missouri,"Mining, Quarrying, and Oil and Gas Extraction",2008,851,315,145,105,565,134,79,778,73,1310,315,145,105,565,310,185,1060,250,16925,376,813,1438,2984,4320,4269,11885,4908,860778000,22731000,31189000,46734000,106154000,190951000,235436000,550000000,303824000
Missouri,Other,2008,2294,2281,9,4,2294,0,0,2294,0,2294,2281,9,4,2294,0,0,2294,0,0,0,49,0,0,0,0,0,0,14804000,14008000,357000,439000,14804000,0,0,14804000,0
Missouri,Other Services (except Public Administration),2008,73774,46185,14540,7025,67750,4623,726,73099,675,79635,46200,14655,7410,68265,5645,2110,76020,3615,577482,86783,94113,90871,273555,158245,49445,493026,69019,13791304000,1867279000,1949546000,1992008000,5827228000,3669005000,1376812000,11205667000,2177774000
Missouri,"Professional, Scientific, and Technical Services",2008,63081,41850,9360,5170,56380,3885,1194,61459,1622,67580,41860,9390,5310,56560,4605,1695,62860,4720,718488,63961,58827,65541,192425,121899,84629,411304,274450,41522318000,2688390000,2407217000,3179695000,8325956000,7179385000,5264282000,21227184000,18648287000
Missouri,Real Estate and Rental and Leasing,2008,26487,19960,2775,1267,24002,1177,582,25761,726,33335,19980,2875,1415,24270,1690,1600,27560,5775,197774,28822,17234,14965,63945,33288,29396,132746,59169,6761585000,814732000,549189000,498538000,1902375000,1191079000,897099000,4234612000,2241924000
Missouri,Retail Trade,2008,72222,37447,14822,8834,61103,6867,1611,69581,2641,112885,37590,15125,9635,62350,10970,6275,79595,33290,1456584,62088,94343,110883,269556,231376,113776,635139,765768,32580621000,1501722000,1956473000,2612639000,6098844000,6752116000,3030996000,16210655000,15714962000
Missouri,Total,2008,120145,69960,20244,12670,102874,11577,2835,117286,2859,152440,70067,20461,13225,103753,15305,8111,127169,25271,2472902,119010,133112,168579,420701,432594,346829,1200124,1272778,93709772000,3523518000,3785608000,5223261000,12532387000,14141317000,12242686000,38916390000,54793382000
Missouri,Transportation and Warehousing,2008,21704,13060,2925,1820,17805,1694,724,20223,1481,24850,13060,2940,1825,17825,1825,930,20580,4270,416316,18107,18237,22971,63172,54777,52033,179377,230669,15317191000,596971000,586087000,741925000,1972442000,1730431000,1841873000,5753375000,9352577000
Missouri,Utilities,2008,571,140,45,40,225,180,54,459,112,1940,140,45,40,225,275,260,760,1180,82323,243,112,172,875,8882,5288,14907,63399,6539000000,7785000,5859000,15691000,33841000,524174000,327381000,897256000,5365071000
Missouri,Wholesale Trade,2008,34789,15748,5185,4016,24949,4865,2078,31892,2897,41340,15795,5260,4175,25230,5900,3510,34640,6700,645654,24914,31154,50138,112047,140510,105674,372794,253999,30293345000,1188925000,1480165000,2253611000,4986996000,6749108000,4968126000,17249328000,12218492000
Montana,Accommodation and Food Services,2008,15098,5685,3054,3055,11794,2795,296,14885,213,16745,5685,3060,3120,11865,3160,815,15840,905,234526,8737,20280,41146,70533,96409,35187,203695,20390,3047860000,207337000,215142000,464450000,888508000,1200800000,457215000,2574040000,376764000
Montana,Administrative and Support and Waste Management and Remediation Services,2008,8014,5435,1180,580,7195,407,98,7700,314,8495,5435,1185,590,7210,470,170,7850,645,74694,6891,7373,5999,22215,13972,7087,46258,6724,1774962000,211975000,172329000,160023000,577849000,298345000,116104000,1073722000,162634000
Montana,"Agriculture, Forestry, Fishing and Hunting",2008,2079,1690,250,45,1985,40,26,2051,28,2120,1690,250,45,1985,40,45,2070,50,6422,1833,1382,164,4153,1005,342,5922,66,272130000,76553000,44918000,17028000,143766000,44682000,13378000,227680000,2105000
Montana,"Arts, Entertainment, and Recreation",2008,5090,2950,945,635,4530,455,60,5045,45,5620,2950,955,650,4555,525,70,5150,470,49136,2214,5894,7998,18352,15168,7766,43134,0,738111000,118630000,107098000,104390000,339046000,208987000,66818000,636826000,0
Montana,Construction,2008,29649,22130,4425,1920,28475,915,139,29529,120,29760,22130,4425,1920,28475,925,165,29565,195,144582,31986,27532,23890,85858,28495,11707,133412,4049,5728332000,1064988000,883179000,901411000,2890055000,1353782000,708593000,5225072000,248478000
Montana,Educational Services,2008,1605,890,240,200,1330,190,50,1570,35,1670,890,240,200,1330,210,75,1615,55,25744,1053,1273,2442,5375,6688,5570,18576,4942,522270000,31331000,22346000,37118000,96411000,143895000,134672000,388346000,87424000
Montana,Finance and Insurance,2008,6739,4445,745,378,5568,455,182,6205,534,10525,4465,750,490,5705,1205,650,7560,2965,84448,6875,4083,4026,15928,13874,9393,42714,35338,3785944000,240674000,149477000,164086000,571104000,512018000,411369000,1639304000,1971675000
Montana,Health Care and Social Assistance,2008,14298,7545,3010,1580,12135,1140,621,13896,402,16440,7545,3020,1630,12195,1395,1530,15120,1320,302512,12471,19502,19954,53651,43245,75267,175470,111315,10555125000,459167000,738465000,734364000,1940882000,1336658000,2161588000,5505584000,4409533000
Montana,Information,2008,2064,1050,320,215,1585,149,113,1847,217,3140,1050,320,220,1590,190,410,2190,950,42866,936,1612,2496,6190,2870,7970,20235,20691,1637073000,40530000,46763000,74845000,173219000,118033000,356866000,758658000,819974000
Montana,Management of Companies and Enterprises,2008,560,45,10,25,80,150,125,355,205,625,45,10,25,80,155,130,365,260,11998,0,0,0,156,0,3106,3887,8111,749394000,288000,0,3934000,14670000,27117000,195776000,240091000,511352000
Montana,Manufacturing,2008,6433,3275,1165,805,5245,755,179,6179,254,6600,3275,1165,805,5245,795,215,6255,345,79068,3831,5130,7816,20122,18496,8115,58011,12084,3063712000,128161000,150509000,238175000,591912000,619224000,284406000,1835942000,787927000
Montana,"Mining, Quarrying, and Oil and Gas Extraction",2008,1578,815,205,155,1175,164,80,1419,159,1675,815,205,155,1175,165,90,1430,245,21025,1073,291,1590,3411,2767,4789,13299,6778,1479717000,59209000,23371000,71564000,200409000,215866000,373958000,916670000,492106000
Montana,Other,2008,42,41,1,0,42,0,0,42,0,42,41,1,0,42,0,0,42,0,0,0,0,0,0,0,0,0,0,708000,653000,0,0,708000,0,0,708000,0
Montana,Other Services (except Public Administration),2008,14718,9545,3065,1299,13909,594,75,14578,140,15370,9555,3070,1330,13955,805,120,14880,490,74837,15770,19366,15707,51795,16394,418,71673,1508,1632932000,361883000,404438000,340997000,1120850000,343197000,21854000,1553400000,39936000
Montana,"Professional, Scientific, and Technical Services",2008,16876,12150,2420,1062,15632,690,153,16475,401,17725,12150,2435,1080,15665,950,400,17015,710,89179,13378,14562,12797,46172,16443,7740,78438,7817,3742085000,609811000,524621000,532452000,1700426000,871635000,350935000,3216351000,444774000
Montana,Real Estate and Rental and Leasing,2008,8403,6895,757,333,7985,188,72,8245,158,9240,6900,800,370,8070,435,155,8660,580,29593,8280,4013,3622,17427,4175,489,24850,3382,774740000,235127000,93775000,99078000,456247000,94517000,17426000,634552000,98286000
Montana,Retail Trade,2008,20036,10035,4476,2575,17086,1767,351,19204,832,25685,10055,4545,2830,17430,2535,1110,21075,4610,281940,16271,27386,31049,80604,52382,18984,164912,99229,6480392000,390154000,583850000,771669000,1767930000,1389765000,491877000,3925777000,2259575000
Montana,Total,2008,32570,20316,5566,3146,29028,2275,486,31789,781,37318,20334,5608,3305,29247,3081,1399,33727,3591,359812,32552,36654,41658,110864,79937,55703,246504,113308,11077819000,929283000,935647000,1083624000,2948554000,2190011000,1767071000,6905636000,4172183000
Montana,Transportation and Warehousing,2008,5753,3830,745,374,4949,315,147,5411,342,6715,3830,750,385,4965,325,220,5510,1205,58726,3405,4119,3954,13424,8967,8528,36118,11725,1886963000,151991000,119702000,131302000,415336000,328086000,190554000,1100538000,498132000
Montana,Utilities,2008,398,175,40,35,250,90,20,360,38,975,175,40,35,250,130,40,420,555,13152,237,100,342,825,2423,0,4648,3750,938770000,8407000,4692000,20346000,39261000,143207000,0,285280000,296986000
Montana,Wholesale Trade,2008,5984,2825,795,595,4215,740,305,5260,724,7255,2825,810,645,4280,990,585,5855,1400,68075,3381,3937,5818,15528,19233,6956,47530,17541,2951771000,150948000,164028000,235793000,614514000,717585000,291870000,1832939000,925490000
Nebraska,Accommodation and Food Services,2008,16767,6220,3154,3201,12575,3203,477,16255,512,21285,6220,3170,3250,12640,3800,1765,18205,3080,350824,10612,21038,41996,74276,112558,57124,244634,105879,3972507000,179637000,182221000,369930000,741822000,1199737000,655508000,2602252000,1365829000
Nebraska,Administrative and Support and Waste Management and Remediation Services,2008,11630,7265,1715,875,9855,753,340,10948,682,13055,7265,1715,875,9855,850,470,11175,1880,294874,9169,10186,10864,32117,23540,39763,100585,183327,8674121000,305061000,259903000,287925000,886879000,618466000,931751000,2582658000,5730321000
Nebraska,"Agriculture, Forestry, Fishing and Hunting",2008,860,650,90,50,790,30,20,840,20,900,650,90,50,790,30,55,875,25,4066,769,452,602,1875,458,162,3111,0,201183000,36217000,18186000,14744000,69988000,19768000,15794000,121423000,0
Nebraska,"Arts, Entertainment, and Recreation",2008,4049,2395,560,450,3405,455,85,3945,104,4200,2395,560,450,3405,485,105,3995,205,53937,2605,3292,5571,11955,17045,9214,41665,8802,814526000,81173000,46672000,87177000,226799000,265240000,98719000,653184000,106975000
Nebraska,Construction,2008,29399,20030,4600,2545,27175,1697,294,29166,233,29630,20030,4600,2550,27180,1725,380,29285,345,220025,29921,29340,32500,95666,63703,28433,195400,19095,9040710000,1041359000,908349000,1222081000,3182557000,2872254000,1475386000,7853780000,957505000
Nebraska,Educational Services,2008,2393,1075,330,345,1750,475,95,2320,73,2620,1075,330,345,1750,535,235,2520,100,85135,1142,1934,4077,7936,19476,16315,45164,0,2246865000,36596000,26232000,55535000,125244000,394793000,487705000,1043366000,0
Nebraska,Finance and Insurance,2008,13158,8520,1633,834,10987,847,351,12185,973,21125,8540,1700,1070,11310,2315,1420,15045,6080,276973,12818,9791,9011,33747,27172,22727,87464,151346,15207237000,418106000,383268000,406642000,1290413000,1170407000,1077706000,3837316000,10252339000
Nebraska,Health Care and Social Assistance,2008,20314,9600,4070,2548,16218,2529,933,19680,634,24995,9610,4110,2640,16360,3585,2395,22340,2655,568563,12449,26587,32857,77188,100110,112145,294879,252392,22253160000,790063000,1003131000,1354078000,3189848000,3796115000,3437285000,10546022000,11313672000
Nebraska,Information,2008,2958,1143,410,355,1908,403,173,2484,474,4855,1150,410,360,1920,500,235,2655,2200,68574,983,2550,3590,6562,9210,5196,28139,34541,3883986000,50653000,70518000,144502000,276278000,500945000,214515000,1301057000,1510275000
Nebraska,Management of Companies and Enterprises,2008,1435,85,65,50,200,335,330,865,570,1800,85,65,50,200,340,335,875,925,73785,80,336,0,620,3009,8835,12635,61068,5065080000,9476000,13942000,5510000,31350000,155745000,492840000,679935000,4385145000
Nebraska,Manufacturing,2008,9048,3325,1460,1155,5940,1492,731,8163,885,9730,3325,1460,1160,5945,1605,855,8405,1325,420109,3960,6819,10519,25059,43830,60621,154517,228370,16032593000,144822000,201660000,375903000,815577000,1689402000,2215599000,5586587000,8712950000
Nebraska,"Mining, Quarrying, and Oil and Gas Extraction",2008,562,310,75,65,450,42,15,507,55,615,310,75,65,450,45,15,510,105,3779,202,385,588,1381,672,0,2503,414,204716000,13844000,15666000,26270000,63766000,31575000,0,130070000,25729000
Nebraska,Other,2008,74,70,2,2,74,0,0,74,0,74,70,2,2,74,0,0,74,0,0,0,0,0,0,0,0,0,0,1243000,1052000,0,0,1243000,0,0,1243000,0
Nebraska,Other Services (except Public Administration),2008,26629,17325,4845,2377,24547,1491,309,26347,282,28630,17375,4895,2500,24770,1905,1020,27695,935,180040,30013,29572,30535,92995,48056,14551,164537,9510,3936505000,653367000,609476000,585926000,1875730000,1022120000,447996000,3532101000,297955000
Nebraska,"Professional, Scientific, and Technical Services",2008,19908,13095,3065,1625,17785,1058,360,19203,705,21225,13095,3065,1670,17830,1315,590,19735,1490,231302,16970,17877,19043,56000,32534,24777,120772,69266,11146013000,713338000,737064000,812269000,2248068000,1860721000,1340017000,5804423000,3408828000
Nebraska,Real Estate and Rental and Leasing,2008,8676,6610,795,410,7815,321,186,8322,354,10070,6620,840,460,7920,405,385,8710,1360,49832,1761,4226,4103,14992,7073,10600,39883,7217,1603813000,241159000,136154000,114722000,522495000,212872000,363543000,1274472000,216444000
Nebraska,Retail Trade,2008,26652,12708,5633,3605,21946,2477,796,25219,1433,38115,12760,5725,3930,22415,3850,2720,28985,9130,487957,21424,35552,43690,106100,79132,42815,239513,214799,10386976000,479697000,677677000,885015000,2081727000,2068992000,1273981000,5716112000,4202000000
Nebraska,Total,2008,42302,24558,7052,4458,36068,3803,1014,40885,1417,52152,24599,7135,4723,36457,5300,3071,44828,7324,805791,41385,46211,58760,146356,140977,120246,407579,398212,28239392000,1189055000,1219804000,1626233000,4035092000,4437917000,3986835000,12459844000,15779548000
Nebraska,Transportation and Warehousing,2008,10834,7450,1130,709,9289,652,213,10154,680,11860,7450,1130,710,9290,675,305,10270,1590,151620,10040,6279,8092,26028,20294,14117,66562,65129,5773235000,295306000,204349000,244044000,749492000,736262000,576774000,2214295000,2903793000
Nebraska,Utilities,2008,158,55,10,5,70,25,5,100,58,610,55,10,5,70,50,5,125,485,6436,0,0,0,174,504,0,690,5731,632915000,752000,0,0,5790000,24488000,0,32873000,598581000
Nebraska,Wholesale Trade,2008,11588,4625,1700,1335,7660,1838,852,10350,1238,15070,4635,1715,1465,7815,2485,2065,12365,2705,197822,6610,9631,13032,33911,49198,31482,127533,59489,9514257000,283912000,394861000,586865000,1383174000,2043028000,1364089000,5272941000,3881237000
Nevada,Accommodation and Food Services,2008,20187,6817,4335,3656,14808,3672,741,19221,966,28880,6885,4385,3730,15000,4395,2610,22005,6875,1560148,10434,26888,44408,80805,134613,120582,342429,1207339,42327642000,429202000,343033000,625207000,1410231000,2185499000,2390102000,6087637000,36110989000
Nevada,Administrative and Support and Waste Management and Remediation Services,2008,19360,10853,2680,1870,15403,2095,701,18199,1161,21105,10855,2685,1895,15435,2170,835,18440,2665,518909,15536,16579,23499,57712,65906,60817,193314,281120,13973950000,644916000,474700000,687707000,1880565000,1890497000,1588105000,5571135000,7511143000
Nevada,"Agriculture, Forestry, Fishing and Hunting",2008,245,220,15,10,245,0,0,245,0,245,220,15,10,245,0,0,245,0,375,238,0,0,375,0,0,375,0,16984000,13373000,0,0,16984000,0,0,16984000,0
Nevada,"Arts, Entertainment, and Recreation",2008,5408,3090,620,453,4163,737,287,5187,221,6295,3100,625,455,4180,850,600,5630,665,151990,2461,3608,5665,13526,31989,43275,93348,49383,4081828000,358874000,141412000,152887000,684338000,872174000,916773000,2609745000,1034827000
Nevada,Construction,2008,29560,14445,5265,4040,23750,4258,933,28941,619,29905,14445,5270,4040,23755,4295,970,29020,885,560622,23057,34708,54596,113508,166474,128454,415305,132578,28743964000,1102621000,1268392000,2187951000,4582806000,7193656000,6256032000,18422676000,9639796000
Nevada,Educational Services,2008,2897,1540,405,325,2270,390,85,2745,152,3115,1540,405,330,2275,410,100,2785,330,47166,1517,2454,3796,8503,13582,6095,29909,12164,1393246000,72322000,57598000,83188000,229019000,409376000,238657000,946697000,288833000
Nevada,Finance and Insurance,2008,14362,9535,1437,519,11491,815,618,12924,1438,22910,9655,1495,555,11705,1320,1740,14765,8145,188077,12038,8243,5590,28896,17240,18366,65835,114736,9872335000,672884000,374311000,293600000,1388089000,968767000,889593000,3289206000,6374313000
Nevada,Health Care and Social Assistance,2008,26437,14323,5430,3125,22878,2228,504,25610,827,30290,14350,5450,3250,23050,2960,1275,27285,3005,470238,21349,35405,39158,98011,76121,61928,244933,209229,22156532000,1795027000,1542797000,1652390000,5020969000,3264488000,2415636000,10993589000,10454995000
Nevada,Information,2008,3913,2265,410,270,2945,325,160,3430,483,5685,2265,415,280,2960,330,235,3525,2160,79345,2300,1618,2259,8472,8566,4785,26125,51587,4323637000,189171000,113702000,143858000,493358000,450563000,277737000,1494067000,2924915000
Nevada,Management of Companies and Enterprises,2008,2681,850,80,85,1015,340,462,1817,864,3120,855,90,85,1030,350,505,1885,1235,76795,829,380,424,1734,2633,9365,13920,62837,8475140000,57685000,36393000,38104000,135212000,191382000,627063000,966120000,7504442000
Nevada,Manufacturing,2008,9367,3720,1705,1175,6600,1449,593,8642,725,9690,3720,1705,1175,6600,1490,675,8765,925,212814,4397,8770,11187,28127,40166,29104,115534,65742,9908035000,232429000,323668000,415059000,1081070000,1680925000,1177995000,4737078000,4161953000
Nevada,"Mining, Quarrying, and Oil and Gas Extraction",2008,1058,470,145,125,740,135,85,960,98,1140,470,145,125,740,135,85,960,180,55393,176,802,1001,2138,1781,8998,16519,36088,4761528000,83624000,65573000,73735000,266641000,88687000,852685000,1422121000,3122574000
Nevada,Other,2008,105,97,6,1,104,1,0,105,0,105,97,6,1,104,1,0,105,0,181,82,0,0,134,0,0,181,0,3845000,2453000,0,0,3757000,0,0,3845000,0
Nevada,Other Services (except Public Administration),2008,18707,11535,3480,1770,16785,1168,344,18297,410,20815,11550,3530,1815,16895,1590,590,19075,1740,170140,18483,22029,17899,64721,37695,16649,132604,27375,4472513000,569567000,576391000,584887000,1763133000,1008214000,490120000,3481236000,793292000
Nevada,"Professional, Scientific, and Technical Services",2008,37630,26525,4480,2615,33620,2152,794,36566,1064,39910,26535,4500,2645,33680,2360,1010,37050,2860,290799,28071,27945,32849,96726,61473,37599,203355,70504,16774524000,2158638000,1391848000,1772746000,5385862000,3655261000,2378238000,11671802000,4038994000
Nevada,Real Estate and Rental and Leasing,2008,16910,12467,1825,917,15209,784,343,16336,574,20440,12490,1865,1000,15355,985,745,17085,3355,153816,17281,11319,10700,40733,20714,13708,79981,60858,5408539000,655527000,365478000,356449000,1395394000,826076000,463055000,2884879000,2181456000
Nevada,Retail Trade,2008,26195,12570,4704,3134,20408,2260,1068,23736,2459,41935,12595,4795,3390,20780,3090,2540,26410,15525,661531,15968,28409,36436,86443,63656,47517,211590,407479,17339093000,543113000,730002000,905361000,2255012000,1937511000,1804130000,6360339000,10460836000
Nevada,Total,2008,49956,28234,7878,5153,41265,4893,1614,47772,2184,61826,28302,7963,5331,41596,5867,3244,50707,11119,1156080,43752,51878,67955,163585,173060,153479,490124,665956,43761567000,2126769000,1737504000,2300184000,6164457000,6238906000,5687066000,18090429000,25671138000
Nevada,Transportation and Warehousing,2008,6459,3210,685,537,4432,599,437,5468,991,7500,3215,695,560,4470,615,495,5580,1920,207282,3166,3012,5216,12371,13262,20720,57817,120428,7172946000,188675000,109793000,191760000,522920000,517246000,714598000,2074609000,3829916000
Nevada,Utilities,2008,268,120,15,5,140,50,25,215,53,580,120,15,5,140,80,60,280,300,1977,0,0,0,291,0,1232,2457,1184,193442000,9516000,0,0,12976000,0,139294000,218576000,125154000
Nevada,Wholesale Trade,2008,13509,6160,1694,1268,9122,1698,958,11778,1731,15045,6160,1700,1305,9165,1905,1150,12220,2825,193577,6562,8035,12888,32259,36968,24661,104639,66328,10020803000,489029000,411629000,683888000,1697534000,1842485000,1162298000,5050298000,3662026000
New Hampshire,Accommodation and Food Services,2008,14539,5620,2875,2735,11230,2618,337,14185,354,17540,5630,2885,2790,11305,2980,1045,15330,2210,273791,7437,19164,36729,64215,89536,34767,188232,89849,4238172000,270773000,269939000,504026000,1046177000,1346953000,533545000,2945093000,1281894000
New Hampshire,Administrative and Support and Waste Management and Remediation Services,2008,10510,6733,1505,840,9078,727,230,10035,475,11260,6735,1510,850,9095,800,285,10180,1080,181275,8485,8660,10111,29596,24656,23201,80691,76421,6453603000,412924000,335229000,351307000,1138189000,930347000,699926000,2938626000,2928938000
New Hampshire,"Agriculture, Forestry, Fishing and Hunting",2008,720,550,120,35,705,10,0,715,5,720,550,120,35,705,10,0,715,5,2491,177,679,0,2139,0,0,2469,0,82772000,29117000,19013000,17695000,68969000,0,0,82454000,0
New Hampshire,"Arts, Entertainment, and Recreation",2008,3678,1995,610,420,3025,477,90,3592,86,3825,1995,610,420,3025,550,135,3710,115,62911,2289,3251,4986,12134,15019,10826,42348,17273,1237404000,323716000,90229000,131858000,565709000,337209000,103373000,1093919000,118894000
New Hampshire,Construction,2008,22343,16040,3240,1655,20935,1188,145,22268,75,22395,16040,3240,1655,20935,1210,155,22300,95,132970,23944,20457,21142,69066,42830,13939,130311,1638,6838560000,1051541000,917510000,1054000000,3056060000,2606255000,812502000,6695510000,89649000
New Hampshire,Educational Services,2008,2750,1295,435,325,2055,451,128,2634,116,2990,1295,440,330,2065,530,180,2775,215,137023,1441,2452,4254,9193,14972,19476,44261,86607,3773296000,57740000,53443000,78823000,210560000,389539000,708979000,1324316000,2255662000
New Hampshire,Finance and Insurance,2008,5808,3085,742,350,4177,502,298,4977,831,10520,3110,760,415,4285,860,1220,6365,4155,124713,4145,4307,3612,13493,13971,18364,49765,62610,8527216000,277398000,229658000,231723000,758422000,865823000,1105701000,3233715000,4660780000
New Hampshire,Health Care and Social Assistance,2008,13990,5715,3365,2063,11143,1604,690,13437,553,17605,5715,3370,2115,11200,2135,1670,15005,2600,400887,10733,22090,26568,60975,56637,89667,211317,183464,16950213000,451536000,906365000,1204880000,2596152000,2243141000,2945662000,7902542000,8658449000
New Hampshire,Information,2008,2516,1015,365,314,1694,274,160,2128,388,4085,1015,365,315,1695,350,210,2255,1830,79341,823,1595,3215,7827,7137,11061,30992,44735,5410064000,64882000,143259000,216548000,487415000,445845000,629657000,1738076000,3555199000
New Hampshire,Management of Companies and Enterprises,2008,851,65,20,35,120,125,185,430,421,1110,65,25,35,125,125,190,440,670,59444,0,104,0,352,1325,5385,7099,52345,5632598000,0,12416000,4740000,25878000,83395000,343425000,452698000,5179900000
New Hampshire,Manufacturing,2008,9934,3625,1575,1395,6595,2000,553,9148,786,10265,3625,1575,1395,6595,2040,620,9255,1010,319201,4468,7533,14356,29946,66319,37253,163581,136122,17440154000,215839000,323535000,678425000,1404067000,3163917000,1818225000,7569206000,8878640000
New Hampshire,"Mining, Quarrying, and Oil and Gas Extraction",2008,202,125,25,20,170,10,10,190,12,225,125,25,20,170,10,20,200,25,1082,198,0,0,473,0,0,1203,0,82154000,10544000,0,2729000,28126000,0,0,74545000,0
New Hampshire,Other,2008,44,42,2,0,44,0,0,44,0,44,42,2,0,44,0,0,44,0,40,0,0,0,40,0,0,40,0,1263000,1091000,0,0,1263000,0,0,1263000,0
New Hampshire,Other Services (except Public Administration),2008,16950,10615,3740,1430,15785,752,151,16688,262,17995,10625,3760,1450,15835,985,360,17180,815,105202,19251,23392,17639,61880,20678,3897,95318,5131,2862462000,512931000,590007000,429378000,1555324000,606005000,176820000,2525393000,228713000
New Hampshire,"Professional, Scientific, and Technical Services",2008,19019,12765,2780,1470,17015,1128,300,18443,576,19960,12765,2795,1515,17075,1285,410,18770,1190,146258,17500,17230,18196,56256,32350,18218,110038,33583,8464651000,1107836000,993106000,1210261000,3344128000,2118018000,1448833000,7091718000,1323178000
New Hampshire,Real Estate and Rental and Leasing,2008,6147,4435,765,320,5520,259,110,5889,258,7315,4435,855,365,5655,455,140,6250,1065,37125,6323,3664,3321,15349,6875,1442,25912,6927,1196636000,264341000,147631000,101678000,533542000,273549000,60658000,922800000,246319000
New Hampshire,Retail Trade,2008,22254,10570,4674,2822,18066,2151,584,20801,1453,32365,10585,4730,3100,18415,2885,1635,22935,9430,467832,13966,25399,28375,71852,55766,37102,184809,164931,11351969000,505528000,712170000,890032000,2189609000,1983811000,1368945000,5833351000,3774894000
New Hampshire,Total,2008,32334,18117,5718,3474,27309,3048,789,31146,1188,38906,18133,5776,3611,27520,3757,1843,33120,5786,595384,31160,37529,46233,114922,108254,86795,309971,285413,24970440000,1258048000,1313260000,1728780000,4300088000,4232416000,3602279000,12134783000,12835657000
New Hampshire,Transportation and Warehousing,2008,3866,2255,540,329,3124,305,115,3544,322,4280,2255,545,330,3130,335,140,3605,675,62452,1799,2628,3349,10100,7320,3655,27288,15092,2126462000,116097000,100663000,124750000,381211000,234747000,106757000,950667000,593685000
New Hampshire,Utilities,2008,229,75,18,20,113,15,28,156,73,555,75,20,20,115,15,105,235,320,10997,115,40,0,351,460,936,2663,7471,1097268000,8397000,2482000,0,76354000,20636000,61662000,283462000,682537000
New Hampshire,Wholesale Trade,2008,8554,3815,1235,893,5943,1130,533,7606,948,9300,3815,1240,900,5955,1225,695,7875,1425,124630,5396,5854,9418,23896,29398,18800,81382,35121,8110251000,406495000,384909000,570614000,1469475000,1718183000,1192626000,4635949000,3058963000
New Jersey,Accommodation and Food Services,2008,83464,44247,15698,11375,71320,10244,1034,82598,866,97105,44265,15715,11520,71500,10825,2305,84630,12475,1377466,75814,102602,153258,331565,368456,129436,832837,539865,24707328000,1854208000,1492607000,2286316000,5642185000,5960451000,2018585000,13652140000,10981425000
New Jersey,Administrative and Support and Waste Management and Remediation Services,2008,62074,39520,8605,5209,53334,5174,1588,60096,1978,68655,39530,8630,5240,53400,5340,2030,60770,7885,1451638,53645,54724,69164,181285,204467,216796,613051,826627,48083091000,2574315000,2138255000,2715758000,7442296000,7546225000,5814006000,21130637000,26042386000
New Jersey,"Agriculture, Forestry, Fishing and Hunting",2008,1150,865,155,75,1095,40,5,1140,10,1150,865,155,75,1095,40,5,1140,10,7226,46,784,861,2619,953,0,4424,0,192788000,33734000,19823000,24914000,86719000,29346000,0,134771000,0
New Jersey,"Arts, Entertainment, and Recreation",2008,16646,9890,2345,1642,13877,2080,490,16447,199,17615,9905,2345,1675,13925,2095,660,16680,935,263610,9637,14862,21464,50562,82397,75903,214958,38168,7856530000,841506000,371808000,482512000,1789570000,1933415000,3272117000,7152911000,557636000
New Jersey,Construction,2008,119838,83755,18070,9774,111599,6822,889,119310,528,120365,83755,18070,9780,111605,6865,950,119420,945,860020,136310,117448,127863,381192,252436,122491,768645,81663,48970445000,5674265000,5235680000,6787283000,17703460000,15864646000,7983031000,42104120000,5956384000
New Jersey,Educational Services,2008,15485,7015,2640,2000,11655,2802,673,15130,355,16725,7025,2640,2025,11690,2935,935,15560,1165,470010,10673,17411,26577,55477,115093,92710,269740,183970,16088665000,310260000,399755000,632890000,1345645000,3407515000,3497459000,8447115000,6872279000
New Jersey,Finance and Insurance,2008,34166,21065,4715,2531,28311,2651,1143,32105,2061,66405,21150,4800,2770,28720,4260,3885,36865,29540,1028651,33946,28540,31154,95997,82249,89029,273312,755815,93101484000,2102716000,1995539000,2809226000,6974364000,7296630000,6266139000,20850154000,72596365000
New Jersey,Health Care and Social Assistance,2008,109258,53020,25606,14593,93219,11173,3102,107494,1764,128575,53085,25800,15365,94250,14345,9100,117695,10880,2556420,108868,165294,191990,468637,410651,448754,1336034,1184790,112879268000,5025624000,7129463000,9600795000,21770415000,18349418000,15102817000,55449555000,56194537000
New Jersey,Information,2008,11404,6010,1375,1134,8519,1332,515,10366,1038,20195,6010,1375,1135,8520,1430,670,10620,9575,555848,8468,7463,13900,32229,45409,42237,127355,387906,45632065000,596033000,470280000,932648000,2052524000,3097454000,3169477000,8891360000,33434015000
New Jersey,Management of Companies and Enterprises,2008,4912,375,110,110,595,795,1087,2477,2435,6860,375,110,110,595,800,1195,2590,4270,683044,0,536,820,1918,13320,43110,58270,614641,73776426000,94723000,46930000,51800000,193760000,898685000,3962535000,5054980000,68726489000
New Jersey,Manufacturing,2008,43495,15785,7888,6209,29882,8452,2673,41007,2488,44785,15785,7900,6260,29945,8620,2965,41530,3255,1352847,25150,46697,74683,158826,313258,295778,826023,434384,75395557000,1212939000,1956405000,3501114000,7134001000,14955687000,14437936000,39055598000,30980094000
New Jersey,"Mining, Quarrying, and Oil and Gas Extraction",2008,414,165,75,30,270,45,38,353,61,500,165,75,30,270,55,55,380,120,5965,190,379,62,886,1010,131,3477,1729,473794000,12685000,39208000,2948000,74317000,43428000,4032000,269636000,120346000
New Jersey,Other,2008,280,266,11,3,280,0,0,280,0,280,266,11,3,280,0,0,280,0,335,0,69,48,335,0,0,335,0,8469000,5703000,973000,1793000,8469000,0,0,8469000,0
New Jersey,Other Services (except Public Administration),2008,112678,75235,20095,9640,104970,6146,822,111938,740,117030,75295,20180,9855,105330,6765,1480,113575,3455,758894,138744,130174,126323,399208,207699,61251,686212,58636,21029556000,3326770000,3258930000,3379332000,9999005000,5685371000,2018877000,18126753000,2369113000
New Jersey,"Professional, Scientific, and Technical Services",2008,147175,104536,18570,10526,133632,8253,2576,144461,2714,154055,104570,18635,10720,133925,8945,3315,146185,7870,1638503,160367,121287,137048,422843,281833,243435,956480,671437,123033237000,9017691000,6628199000,9005929000,24671944000,20438802000,18489924000,64000420000,58598861000
New Jersey,Real Estate and Rental and Leasing,2008,38327,26938,5802,2515,35255,1798,478,37531,796,46680,26995,5970,2850,35815,2335,950,39100,7580,299184,42400,37044,31964,114778,57309,31072,204094,75425,14828670000,1670054000,1403544000,1284246000,4387600000,3036479000,1618482000,9122789000,5305740000
New Jersey,Retail Trade,2008,122170,78442,20648,10885,109975,7721,1799,119495,2675,167820,78600,20980,11600,111180,9900,4985,126065,41755,2194868,120089,119936,117453,370605,253794,111415,753556,1165157,60163901000,3553543000,3255483000,3634519000,10673886000,9536609000,5198129000,25847678000,30721635000
New Jersey,Total,2008,202600,124884,33589,19746,178219,17109,4054,199382,3218,238440,125027,33837,20405,179269,19693,8349,207311,31129,3640654,215666,219635,262114,697415,633907,517460,1848782,1791872,185393520000,8688890000,8287339000,11162223000,28138452000,28484271000,24123175000,80745898000,104647622000
New Jersey,Transportation and Warehousing,2008,32151,17950,4417,2959,25326,3440,1552,30318,1833,35840,17960,4430,2995,25385,3655,2065,31105,4735,807608,27074,28353,37474,95691,121622,139194,362495,405677,33091499000,1092216000,1110403000,1467398000,3715705000,4472066000,5092822000,13474528000,17837374000
New Jersey,Utilities,2008,419,155,40,15,210,50,12,272,147,1820,160,40,15,215,60,35,310,1510,70898,0,0,0,497,1512,0,3135,51863,6994434000,22360000,721000,0,53216000,113572000,0,276763000,6299178000
New Jersey,Wholesale Trade,2008,72704,38290,11214,7868,57372,8622,3062,69056,3648,78620,38310,11280,7990,57580,9195,4160,70935,7685,1351855,62723,72867,97490,233592,291473,239265,791422,529460,98858324000,3824046000,4108727000,6196360000,14260262000,17491403000,14666407000,47382782000,49336009000
New Mexico,Accommodation and Food Services,2008,15030,5035,2565,2995,10595,3315,498,14408,622,20300,5045,2575,3035,10655,3945,1530,16130,4170,403929,6821,16892,42035,67534,121362,56847,254585,145881,5735234000,177293000,192654000,519869000,905033000,1661748000,947652000,3527531000,2126807000
New Mexico,Administrative and Support and Waste Management and Remediation Services,2008,8936,4940,1490,760,7190,785,251,8226,710,9960,4945,1490,775,7210,880,370,8460,1500,198860,6809,8977,9023,26818,25424,28713,84480,100819,5189409000,219429000,230695000,242990000,707159000,693009000,739012000,2267788000,2664908000
New Mexico,"Agriculture, Forestry, Fishing and Hunting",2008,516,355,75,50,480,11,10,501,15,530,355,80,50,485,20,10,515,15,2690,205,239,108,1547,0,0,2425,0,81325000,14989000,6094000,10317000,42921000,0,0,73772000,0
New Mexico,"Arts, Entertainment, and Recreation",2008,3273,1985,390,332,2707,385,75,3167,106,3425,1985,390,350,2725,440,105,3270,155,70595,2561,1928,3912,9198,14553,805,32571,14046,1519417000,83339000,46977000,62923000,206435000,234847000,89131000,645312000,300730000
New Mexico,Construction,2008,28052,16785,5265,2834,24884,2532,384,27800,252,28220,16785,5265,2835,24885,2565,415,27865,355,274504,26855,34225,36750,98748,91773,47370,248014,20677,10545812000,879436000,931495000,1209945000,3058477000,3705198000,2158592000,9218152000,1035035000
New Mexico,Educational Services,2008,2931,1480,415,375,2270,405,135,2810,121,3040,1480,415,375,2270,405,155,2830,210,51053,2047,2536,4756,9774,14411,12114,40436,7926,1477188000,70852000,53849000,103535000,236065000,376752000,446269000,1202893000,197540000
New Mexico,Finance and Insurance,2008,8436,5265,1100,435,6800,485,330,7615,821,14720,5280,1195,555,7030,1250,1500,9780,4940,117788,8898,6598,4333,20739,15237,24022,62341,51990,5666859000,314867000,223160000,185109000,747033000,655388000,1146054000,2743045000,2888037000
New Mexico,Health Care and Social Assistance,2008,19247,9020,3865,2522,15407,2348,714,18469,778,23265,9035,3890,2565,15490,2955,1770,20215,3050,518530,13240,24956,32303,74257,88111,89615,258749,245728,20154450000,683362000,970370000,1339846000,3029430000,2883116000,2627649000,8741934000,10675456000
New Mexico,Information,2008,2570,1245,385,215,1845,223,130,2198,372,4275,1245,390,215,1850,285,295,2430,1845,65235,1326,1997,2141,7052,5139,4498,17105,37851,2742042000,76046000,63095000,78102000,246700000,221974000,158867000,712548000,1926666000
New Mexico,Management of Companies and Enterprises,2008,851,35,46,25,106,160,215,481,370,1045,35,50,25,110,165,225,500,545,54800,0,0,0,0,2106,4668,7180,0,3589835000,0,0,0,1502000,91662000,276974000,401940000,0
New Mexico,Manufacturing,2008,7535,3445,1385,979,5809,958,315,7082,453,7780,3445,1385,985,5815,1005,350,7170,610,131315,3692,6581,8785,23965,24069,11475,71443,50414,5826624000,168438000,196546000,304965000,790790000,838959000,403025000,2599516000,2947669000
New Mexico,"Mining, Quarrying, and Oil and Gas Extraction",2008,3135,1345,380,329,2054,560,145,2759,376,3520,1345,380,335,2060,570,195,2825,695,82227,2112,2341,4041,8776,17081,12750,38994,43587,5346972000,128742000,101689000,217629000,450576000,1062693000,903074000,2430590000,2926525000
New Mexico,Other,2008,44,43,1,0,44,0,0,44,0,44,43,1,0,44,0,0,44,0,50,44,0,0,50,0,0,50,0,1261000,1252000,0,0,1261000,0,0,1261000,0
New Mexico,Other Services (except Public Administration),2008,19454,11450,4175,2090,17715,1191,207,19113,341,20635,11450,4190,2110,17750,1420,575,19745,890,136595,19807,27258,26542,75909,38092,5033,124909,6857,3246233000,490059000,591080000,605814000,1717345000,907745000,104290000,2884257000,240689000
New Mexico,"Professional, Scientific, and Technical Services",2008,22696,15315,3170,1811,20296,1183,405,21884,812,24060,15320,3185,1850,20355,1340,505,22200,1860,180008,21655,20244,22787,67575,35059,18267,129066,52789,10359401000,1011831000,916325000,1131330000,3099404000,1967622000,1317268000,6649394000,3920936000
New Mexico,Real Estate and Rental and Leasing,2008,10055,7545,1205,462,9212,331,184,9727,328,12160,7560,1240,500,9300,435,780,10515,1645,51672,10246,7592,5542,24502,7146,908,38847,10713,1773410000,321437000,187508000,175544000,698110000,284245000,86827000,1139317000,579602000
New Mexico,Retail Trade,2008,23571,11647,4664,2894,19205,2142,670,22017,1554,35535,11680,4765,3130,19575,3040,1995,24610,10925,414154,18564,27598,33812,83801,62843,31253,195136,153002,9797483000,482729000,669809000,877533000,2058106000,1771992000,1195179000,5286231000,3823207000
New Mexico,Total,2008,37549,20915,6528,4094,31537,3600,893,36030,1519,46200,20940,6604,4253,31797,4531,2342,38670,7530,640894,35732,43228,54520,133480,127353,93969,354802,286092,22260582000,1141453000,1212829000,1616989000,3971271000,4012282000,3203124000,11186677000,11073905000
New Mexico,Transportation and Warehousing,2008,5935,3540,690,460,4690,470,190,5350,585,7055,3540,690,470,4700,515,240,5455,1600,80639,4169,3975,4798,14062,13186,4506,37532,20423,2813619000,142958000,105011000,138621000,413077000,462190000,182331000,1169027000,1067270000
New Mexico,Utilities,2008,716,450,60,45,555,70,30,655,61,1115,450,60,45,555,130,45,730,385,22051,942,348,468,1882,2805,1964,6594,54,1432908000,19245000,10644000,18867000,53611000,146802000,98650000,296825000,242881000
New Mexico,Wholesale Trade,2008,8766,3505,1375,1015,5895,1141,459,7495,1271,10140,3505,1380,1060,5945,1290,650,7885,2255,107548,4251,7560,9121,24615,21115,9077,62447,37481,4816957000,227086000,316195000,406930000,1036184000,892061000,381173000,2565092000,2089896000
New York,Accommodation and Food Services,2008,194076,101200,38063,27046,166309,23078,3297,192684,1392,222460,101355,38090,27235,166680,25110,7755,199545,22915,3130975,173175,250996,365146,790120,851975,509567,2152930,972541,61169725000,3938550000,3892340000,5931730000,13765590000,16156357000,9849136000,39784395000,21264149000
New York,Administrative and Support and Waste Management and Remediation Services,2008,115324,76075,14560,9120,99755,9312,3504,112571,2753,126255,76095,14585,9235,99915,9805,4460,114180,12075,2593255,105713,94546,118196,319249,363109,527756,1219925,1356055,104671260000,5412500000,3965165000,5185032000,14539875000,14681028000,16418390000,46079290000,58122450000
New York,"Agriculture, Forestry, Fishing and Hunting",2008,2970,2270,405,155,2830,100,20,2950,20,2985,2270,405,155,2830,105,25,2960,25,15839,3318,1690,1551,7824,3335,0,14759,433,499702000,94188000,70875000,50969000,224396000,121576000,0,458306000,17135000
New York,"Arts, Entertainment, and Recreation",2008,53125,36025,6465,4318,46808,4648,1129,52585,540,56260,36040,6475,4375,46890,4860,1780,53530,2730,793254,37022,42106,58205,145488,187133,166448,510506,267112,33341707000,4995480000,2046916000,2364993000,9417620000,6086946000,5014067000,20934033000,11949107000
New York,Construction,2008,237582,166835,33980,19485,220300,14677,2047,237024,558,238595,166835,33990,19505,220330,14790,2220,237340,1255,1754670,253055,222990,261084,739250,547395,320576,1614600,119148,101661660000,10400814000,9488690000,13270178000,33192720000,33535950000,22737536000,89941185000,9756014000
New York,Educational Services,2008,31341,14780,4200,3597,22577,6120,1675,30372,969,34315,14780,4205,3695,22680,6515,2525,31720,2595,1807145,22045,28083,49808,100640,245295,275031,621500,1179003,66076880000,813920000,756120000,1216407000,2786770000,7788746000,9795354000,20391170000,45480551000
New York,Finance and Insurance,2008,84714,52362,12988,6542,71892,6831,2837,81560,3154,145785,52535,13335,7365,73235,9820,8975,92030,53755,2935002,85985,80782,82471,252878,229871,313008,814043,2094503,564238794000,7277579000,8603292000,11664258000,27596147000,43878278000,53927661000,128979961000,433446403000
New York,Health Care and Social Assistance,2008,221783,120931,44195,24272,189398,18928,8399,216725,5058,272295,121115,44575,25325,191015,25525,25250,241790,30505,6726755,220625,288381,321956,836989,722894,1339934,2903679,3806256,288789917000,11092278000,12242823000,14659848000,38004374000,30380787000,44167599000,112596286000,175674563000
New York,Information,2008,37857,21858,4780,3641,30279,4247,1310,35836,2021,56700,21885,4795,3720,30400,4745,1745,36890,19810,1448725,28279,27639,44016,105286,149160,125702,397703,1010451,119014140000,2381881000,1577909000,2472523000,6550511000,9382104000,9754664000,27215121000,91093523000
New York,Management of Companies and Enterprises,2008,9309,1156,260,291,1707,1488,2405,5600,3709,13905,1160,265,320,1745,1545,2640,5930,7975,877250,25,1169,1971,4502,22564,89584,116650,760305,108309780000,201660000,260435000,294655000,756107000,2281926000,8108382000,11146415000,96979465000
New York,Manufacturing,2008,88596,37820,15161,12587,65568,15627,4125,85320,3276,91255,37830,15175,12660,65665,16015,4760,86440,4815,2456999,63169,94278,161613,333217,592503,494760,1491181,863265,115968997000,2707268000,3303410000,6091909000,12428666000,24348801000,21505680000,61274078000,49474045000
New York,"Mining, Quarrying, and Oil and Gas Extraction",2008,1464,745,230,125,1100,142,101,1343,121,1840,745,230,125,1100,165,180,1445,395,20803,832,1384,1347,4115,3257,5547,15582,5653,1218386000,76255000,70240000,87539000,249645000,194442000,278733000,892641000,339649000
New York,Other,2008,708,676,22,7,705,3,0,708,0,708,676,22,7,705,3,0,708,0,0,0,147,94,0,0,0,0,0,21992000,17728000,2520000,1229000,21477000,0,0,21992000,0
New York,Other Services (except Public Administration),2008,247661,169910,42187,20405,232502,12203,1852,246557,1104,261810,170060,42445,20905,233410,14435,3955,251800,10010,1774605,296464,275301,267959,852668,428086,236361,1526510,190271,55855915000,7543887000,7435633000,7914451000,22908740000,14226395000,9655610000,47083025000,7081908000
New York,"Professional, Scientific, and Technical Services",2008,278782,200270,35635,19556,255461,15760,4074,275295,3487,292590,200345,35730,19905,255980,17500,5820,279300,13290,2914601,273677,228958,254978,780775,546346,420599,1754865,1128230,227620724000,18210672000,13037787000,16449628000,48233989000,39977794000,32893752000,121224619000,105780466000
New York,Real Estate and Rental and Leasing,2008,144509,111701,16711,8134,136546,5680,1199,143425,1084,159620,111815,17055,8675,137545,8130,3510,149185,10435,839645,168261,106604,105894,384080,191511,105671,684229,145459,43767442000,6327542000,4418607000,4970270000,15737030000,9656518000,6485230000,32046206000,11111102000
New York,Retail Trade,2008,286684,192133,47306,23235,262674,17446,3189,283309,3375,379265,192360,47890,24790,265040,22860,11155,299055,80210,4284191,297654,293683,277434,907511,581703,289012,1830042,2087653,112870718000,8793754000,7955007000,8387188000,24991124000,19799779000,9784106000,55196970000,54336730000
New York,Total,2008,443992,287840,69461,40235,397536,34343,7781,439660,4332,518632,288149,70009,41607,399765,40965,19299,460029,58603,7617164,474787,453783,536167,1464737,1288267,1189017,3942021,3675143,440631852000,20228061000,17819013000,23000362000,61047436000,62550525000,60040051000,183638012000,256993840000
New York,Transportation and Warehousing,2008,53121,32812,6630,4597,44039,5294,1853,51186,1935,60170,32840,6650,4695,44185,5720,2900,52805,7365,1197276,37944,41319,58020,149343,183331,178711,519542,654803,46907409000,1710106000,1485842000,2184633000,5466526000,7092984000,6466814000,19472289000,26618234000
New York,Utilities,2008,964,365,100,83,548,120,63,731,233,2955,365,100,85,550,165,215,930,2025,194410,57,400,689,1878,4468,4445,13006,180861,18359362000,28605000,41489000,54572000,144565000,356927000,431943000,1135023000,17224339000
New York,Wholesale Trade,2008,158578,96819,23751,14879,135449,15188,4241,154878,3700,170560,96935,23940,15230,136105,17000,6625,159730,10830,1969238,159781,153031,191101,506646,508865,364276,1393102,511202,118479534000,7954310000,7723217000,10664375000,26400000000,29527349000,22531464000,79079745000,36313024000
North Carolina,Accommodation and Food Services,2008,66610,23858,12647,13591,50096,13602,1547,65245,1365,92470,23875,12690,13765,50330,15620,5675,71625,20845,1811572,37320,85068,185497,308773,478411,237220,1025879,783874,23609857000,944305000,1003719000,2170951000,4123060000,5857289000,2906016000,12900260000,10683365000
North Carolina,Administrative and Support and Waste Management and Remediation Services,2008,50876,29995,8505,4812,43312,4202,1433,48947,1929,58335,30025,8515,4910,43450,4600,2095,50145,8190,1401640,46610,54948,63409,168312,158990,197493,533547,810370,37949736000,1513729000,1452650000,1762086000,4770146000,4264155000,4692954000,13976343000,22001767000
North Carolina,"Agriculture, Forestry, Fishing and Hunting",2008,3988,2445,905,410,3760,145,35,3940,48,4010,2445,905,410,3760,145,50,3955,55,22417,4120,5235,4877,15353,3928,838,21116,602,721599000,127944000,161327000,169685000,464460000,114865000,31536000,651524000,27377000
North Carolina,"Arts, Entertainment, and Recreation",2008,16006,8825,2540,1719,13084,2196,436,15716,290,16915,8825,2545,1725,13095,2355,610,16060,855,287122,9218,15272,22047,51696,85948,63004,205572,68875,7723355000,461947000,369450000,453225000,1305565000,1658082000,1865357000,4933347000,2513852000
North Carolina,Construction,2008,134943,84845,24395,13885,123125,9775,1258,134158,785,136625,84845,24395,13895,123135,9910,1575,134620,2005,1197775,147973,159528,185955,493790,364070,162210,1033895,154049,45200180000,4408525000,4671075000,6089630000,15169230000,13791760000,7253897000,36432220000,8448021000
North Carolina,Educational Services,2008,10981,5715,1640,1210,8565,1660,428,10653,328,11685,5715,1640,1215,8570,1740,625,10935,750,411781,7117,10567,15554,33912,68231,70246,176071,221449,14404497000,237136000,197598000,315382000,754118000,1631627000,2059740000,4479437000,9458890000
North Carolina,Finance and Insurance,2008,33606,22455,4548,1901,28904,1819,950,31673,1933,69515,22570,4720,2380,29670,4330,5350,39350,30165,857440,34806,27001,22828,88812,53600,67962,215456,584176,56442067000,1512437000,1124887000,1310659000,4061133000,3023799000,3855383000,11223657000,44573346000
North Carolina,Health Care and Social Assistance,2008,86720,35710,20263,13496,69469,12356,2964,84789,1931,110450,35750,20350,13815,69915,16220,9275,95410,15040,2654479,61530,135048,180415,379562,468982,438123,1300090,1313230,100848053000,2979430000,5606615000,6836061000,15423406000,15666953000,13936130000,45163621000,54915789000
North Carolina,Information,2008,9086,4705,1185,840,6730,975,424,8129,957,17940,4705,1190,845,6740,1315,880,8935,9005,388321,5547,6457,10694,25809,30013,27059,87190,248920,22028439000,307799000,249376000,413793000,1000499000,1669606000,1641088000,4514788000,17306766000
North Carolina,Management of Companies and Enterprises,2008,5090,360,120,175,655,920,1398,2973,2117,7845,360,120,175,655,925,1555,3135,4710,375067,0,564,935,1875,11200,40046,53545,321522,32339545000,62552000,52275000,46995000,161822000,603538000,2265720000,3031080000,29308465000
North Carolina,Manufacturing,2008,44795,15125,7435,5823,28383,8646,3309,40338,4457,49160,15135,7435,5830,28400,8880,3945,41225,7935,2328007,23894,45122,69969,148964,315465,337291,869580,1350204,92116432000,881780000,1355644000,2324898000,4821652000,11022591000,12011753000,30283043000,57800385000
North Carolina,"Mining, Quarrying, and Oil and Gas Extraction",2008,550,210,80,75,365,60,33,458,92,975,210,80,75,365,80,65,510,465,16499,231,354,878,1573,1962,1387,5776,8929,748810000,11624000,13219000,27281000,67670000,64826000,79880000,248732000,414735000
North Carolina,Other,2008,305,281,13,9,303,2,0,305,0,305,281,13,9,303,2,0,305,0,488,0,83,110,0,0,0,488,0,8922000,5623000,1487000,1303000,8413000,0,0,8922000,0
North Carolina,Other Services (except Public Administration),2008,103641,65625,21364,9306,96295,5932,715,102942,699,111760,65655,21475,9700,96830,7810,2325,106965,4795,746511,123321,137803,121410,386084,203028,68692,666331,63519,17094457000,2688139000,2900561000,2739645000,8338265000,4509562000,1626743000,14727230000,2008942000
North Carolina,"Professional, Scientific, and Technical Services",2008,104226,72620,14275,7919,94814,5450,1726,101990,2236,112210,72640,14345,8175,95160,6720,2950,104830,7380,947324,105850,92230,103008,306816,165578,109746,587272,340565,57685075000,4770594000,3955312000,4854434000,13641175000,9451511000,6898836000,30169275000,26856112000
North Carolina,Real Estate and Rental and Leasing,2008,41569,32879,4042,1562,38483,1664,632,40779,790,54270,32955,4145,1840,38940,2745,3900,45585,8685,255357,44360,24807,19231,88983,47777,36218,179465,75830,9170927000,1458290000,817218000,647272000,2931644000,1754727000,1454775000,6353199000,2787413000
North Carolina,Retail Trade,2008,110260,61936,22818,12007,96761,8790,1990,107541,2719,178380,62095,23380,13775,99250,15170,8360,122780,55600,2043864,106165,146019,139970,406187,297528,149518,886131,1115611,45979613000,2503268000,3230992000,3731862000,9498272000,8609950000,4472700000,23010574000,22429157000
North Carolina,Total,2008,176196,101735,31431,19130,152296,16627,3809,172732,3464,225158,101863,31759,20086,153708,21622,11070,186400,38758,3585123,174244,206597,254692,635533,611363,475662,1722558,1862565,132400692000,5542493000,6006682000,7646713000,19195888000,19222236000,16441286000,54859410000,77541282000
North Carolina,Transportation and Warehousing,2008,24718,14740,3128,2042,19910,2040,968,22918,1800,29195,14755,3140,2120,20015,2260,1310,23585,5610,545510,20683,19259,25228,66983,60897,54714,193316,282204,20058697000,669910000,528036000,770877000,2018019000,2001681000,2103323000,6360738000,11262559000
North Carolina,Utilities,2008,750,270,105,60,435,125,75,635,115,2175,270,105,60,435,210,195,840,1335,91633,53,622,735,1860,5930,8634,16932,73926,7886157000,17128000,16564000,23620000,59100000,377183000,561089000,998276000,6852521000
North Carolina,Wholesale Trade,2008,49800,25051,7409,5358,37818,5848,2747,46413,3387,60350,25080,7555,5675,38310,7065,4610,49985,10365,902423,38782,45595,66194,156869,175112,140707,491469,372369,49596083000,1931753000,2085276000,3045000000,7123815000,8220386000,7289647000,23262779000,25508691000
North Dakota,Accommodation and Food Services,2008,7964,2990,1545,1370,5905,1568,314,7787,177,9190,2990,1550,1380,5920,1805,730,8455,735,160825,4250,10189,18500,33567,56550,38028,128979,23030,1898149000,88420000,78330000,176954000,345964000,631350000,477216000,1460056000,285009000
North Dakota,Administrative and Support and Waste Management and Remediation Services,2008,4072,2455,630,340,3425,254,105,3784,288,4490,2455,630,345,3430,295,195,3920,570,60988,3217,3721,3614,11633,6163,10685,32969,24668,1389388000,95211000,97696000,87387000,303678000,116473000,235049000,736915000,550325000
North Dakota,"Agriculture, Forestry, Fishing and Hunting",2008,560,465,35,40,540,10,0,550,10,570,465,35,40,540,10,0,550,20,1951,633,225,0,1223,0,0,812,0,71536000,28396000,7505000,0,48076000,0,0,58221000,0
North Dakota,"Arts, Entertainment, and Recreation",2008,1906,1195,250,205,1650,175,61,1886,20,2055,1195,250,205,1650,245,140,2035,20,21175,1203,1352,2143,5216,5131,1586,20941,0,296624000,40413000,14665000,26205000,97346000,66280000,54493000,292390000,1672000
North Dakota,Construction,2008,12258,8250,1870,1144,11264,815,89,12168,90,12375,8250,1870,1150,11270,840,125,12235,140,89044,11832,11979,14176,39894,28006,8291,79934,4130,4338355000,503743000,468603000,625231000,1617142000,1379886000,495885000,3643755000,327530000
North Dakota,Educational Services,2008,740,325,75,80,480,165,35,680,60,775,325,75,90,490,170,35,695,80,21615,325,348,953,1902,7058,4974,14105,2278,409586000,13915000,4619000,11409000,31561000,130627000,104092000,268779000,48790000
North Dakota,Finance and Insurance,2008,5295,3545,445,390,4380,363,142,4885,410,8430,3545,475,580,4600,1115,985,6700,1730,93565,5344,2534,4593,13189,11462,11419,38375,39239,4080644000,196050000,91763000,183281000,489527000,445011000,582093000,1676547000,1826658000
North Dakota,Health Care and Social Assistance,2008,7397,3335,1430,1028,5793,819,512,7124,273,8785,3345,1430,1090,5865,1045,1090,8000,785,256733,4960,8758,12065,26558,31410,59031,124792,103596,9191205000,168810000,324382000,362961000,856140000,802970000,1488705000,3348746000,4315194000
North Dakota,Information,2008,1180,350,205,203,758,180,72,1010,170,1870,350,205,230,785,280,80,1145,725,36466,387,1141,2218,4171,6095,3792,17534,11642,1690739000,13478000,25866000,62360000,112380000,291638000,149951000,636756000,678149000
North Dakota,Management of Companies and Enterprises,2008,461,25,20,10,55,125,125,305,156,500,25,20,10,55,125,135,315,185,54438,0,0,0,0,1021,2069,3330,51224,1458867000,0,4928000,0,10544000,80352000,114195000,222830000,1253104000
North Dakota,Manufacturing,2008,3549,1270,645,420,2335,646,255,3236,313,3795,1270,645,420,2335,695,310,3340,455,99078,1079,2665,2435,9286,15996,10021,50170,27917,3982392000,47122000,88660000,104859000,310755000,537795000,372155000,1722417000,1299053000
North Dakota,"Mining, Quarrying, and Oil and Gas Extraction",2008,1111,445,150,100,695,170,40,905,206,1210,445,150,105,700,175,50,925,285,27743,95,808,1220,2834,6218,440,10628,15774,2209286000,44269000,50174000,79305000,182290000,560740000,64222000,860903000,1250374000
North Dakota,Other,2008,29,28,1,0,29,0,0,29,0,29,28,1,0,29,0,0,29,0,22,0,0,0,22,0,0,22,0,527000,492000,0,0,527000,0,0,527000,0
North Dakota,Other Services (except Public Administration),2008,11532,7512,2175,1041,10728,558,68,11354,178,12010,7540,2190,1085,10815,760,90,11665,345,65052,12125,12943,12485,40067,17346,400,61089,2172,1269992000,259853000,276051000,230608000,787875000,288150000,11774000,1136813000,80078000
North Dakota,"Professional, Scientific, and Technical Services",2008,7086,4750,1015,590,6355,402,135,6892,194,7540,4750,1015,600,6365,595,205,7165,375,52031,6479,5645,6649,19878,10397,3422,36599,11058,2251522000,252182000,213630000,309239000,799785000,582463000,249031000,1751651000,422991000
North Dakota,Real Estate and Rental and Leasing,2008,3536,2645,335,180,3160,158,81,3399,137,3920,2645,335,195,3175,210,245,3630,290,18478,3273,1860,1691,7135,2979,429,15386,862,544901000,107656000,42056000,42202000,230541000,96551000,21030000,431267000,56122000
North Dakota,Retail Trade,2008,12587,5430,2756,1734,9920,1409,389,11718,869,16470,5435,2835,1880,10150,1970,1015,13135,3335,214651,8143,16132,20082,48856,39088,23305,117102,66430,4643862000,216924000,348123000,510609000,1121344000,1051889000,578766000,2884236000,1310867000
North Dakota,Total,2008,17922,10053,3008,1972,15033,1726,456,17215,707,21558,10064,3046,2111,15221,2454,1283,18958,2600,304906,16663,19819,26226,62708,62390,53896,178994,125912,10054513000,494959000,529170000,737252000,1761381000,1904876000,1604197000,5270454000,4784059000
North Dakota,Transportation and Warehousing,2008,4909,3180,594,340,4114,305,143,4562,347,5520,3185,595,340,4120,345,235,4700,820,48891,3143,3368,3868,11850,9469,6842,31564,16595,1944661000,157988000,115547000,123546000,417346000,328579000,283938000,1181296000,724784000
North Dakota,Utilities,2008,184,30,10,10,50,90,10,150,34,575,30,10,10,50,135,40,225,350,2272,39,0,0,106,3065,0,4674,0,147628000,1197000,0,0,3078000,186435000,0,315628000,0
North Dakota,Wholesale Trade,2008,5612,1935,885,693,3513,999,408,4920,692,7565,1935,910,800,3645,1455,710,5810,1755,89008,1957,4837,7280,16000,23327,10091,55882,25494,4053810000,112829000,205494000,328270000,707957000,1097758000,451162000,2522962000,1278835000
Ohio,Accommodation and Food Services,2008,84643,33079,16460,15776,65315,15747,2138,83200,1443,117625,33180,16470,16125,65775,18890,9500,94165,23460,2175335,52035,110091,214058,376983,574166,318276,1272445,897110,26504090000,1082416000,1086977000,2198956000,4376575000,6724376000,3607228000,14730215000,11750167000
Ohio,Administrative and Support and Waste Management and Remediation Services,2008,59722,34910,8805,6117,49832,5574,2098,57504,2218,70415,34955,8820,6185,49960,5990,2885,58835,11580,1725585,46441,57228,81343,188176,215895,295828,706472,990868,45820175000,1903008000,1694305000,2374139000,6000870000,6113466000,6875929000,19120165000,25920236000
Ohio,"Agriculture, Forestry, Fishing and Hunting",2008,1215,855,200,60,1115,50,20,1185,30,1235,855,200,60,1115,50,20,1185,50,4792,1201,1110,541,2923,894,0,4471,247,161870000,32100000,28561000,16652000,85555000,26774000,0,140273000,23450000
Ohio,"Arts, Entertainment, and Recreation",2008,18508,10275,3015,2225,15515,2191,491,18197,311,19770,10275,3015,2265,15555,2370,775,18700,1070,308537,13815,18962,28777,64359,87286,70368,226364,62470,9182296000,599037000,407534000,448990000,1504168000,1650242000,4165159000,7399943000,981244000
Ohio,Construction,2008,115231,74955,19315,11023,105293,8112,1129,114534,697,116630,74955,19315,11040,105310,8350,1425,115085,1545,1037600,118738,126969,146175,394550,298443,154017,852625,175418,50088770000,4582690000,4674545000,6358515000,15615750000,14898782000,8499237000,39271595000,10384758000
Ohio,Educational Services,2008,13145,5330,2145,1807,9282,2792,601,12675,470,14540,5345,2180,1830,9355,3125,785,13265,1275,548418,8344,13859,24644,47861,115614,89720,257168,284087,14099440000,255571000,250342000,481592000,993875000,2830410000,2585024000,6539285000,7325197000
Ohio,Finance and Insurance,2008,46692,30635,6900,2979,40514,2995,989,44498,2194,93745,30775,7195,3720,41690,6915,4515,53120,40625,1275012,53206,43156,36782,135673,102798,89499,336440,939135,76532581000,2004945000,1798099000,1942762000,5812100000,5141593000,3893639000,15172336000,59542673000
Ohio,Health Care and Social Assistance,2008,104889,42075,25749,15658,83482,13641,5104,102227,2662,138785,42185,26100,16655,84940,19505,15065,119510,19275,3826762,85074,170701,207427,465137,536848,749011,1755626,2036636,146165843000,3632957000,6629470000,8589172000,18890362000,20059386000,21150377000,60273692000,85634263000
Ohio,Information,2008,9559,4076,1410,1113,6599,1400,455,8454,1105,21060,4080,1415,1135,6630,1570,850,9050,12010,481213,5846,7806,12866,29197,46886,39167,119561,336786,26421332000,271815000,334785000,557507000,1187670000,2243827000,1998469000,5563538000,19830347000
Ohio,Management of Companies and Enterprises,2008,6889,415,115,295,825,1310,1901,4036,2853,10995,420,120,295,835,1315,1955,4105,6890,736685,0,448,1855,2511,15335,52055,70255,666365,59787200000,91720000,37185000,106005000,255189000,862400000,3492375000,4610110000,55177090000
Ohio,Manufacturing,2008,73997,22015,13139,11054,46208,16141,5764,68113,5884,79705,22015,13145,11145,46305,16870,7150,70325,9380,3593809,36706,82885,141662,272368,622928,675586,1643354,1753822,169460517000,1556576000,2778474000,5238733000,9951669000,25700269000,29349007000,68146955000,91119326000
Ohio,"Mining, Quarrying, and Oil and Gas Extraction",2008,3253,1610,580,450,2640,308,130,3078,175,3945,1610,580,465,2655,350,265,3270,675,47872,2937,3643,4759,12415,7357,9302,30659,15098,2609754000,113573000,166304000,256826000,548237000,400811000,531944000,1510441000,1005957000
Ohio,Other,2008,271,243,21,7,271,0,0,271,0,271,243,21,7,271,0,0,271,0,457,0,125,86,457,0,0,457,0,6777000,4665000,1298000,814000,6777000,0,0,6777000,0
Ohio,Other Services (except Public Administration),2008,128913,73796,30154,14322,118272,8477,1094,127843,1070,143845,73975,30455,14955,119385,10990,3310,133685,10160,1082573,148718,196561,185647,533319,281650,95155,920662,132179,25315603000,3066017000,3809696000,3919802000,10816398000,6434851000,2786899000,20324498000,4208584000
Ohio,"Professional, Scientific, and Technical Services",2008,113840,74473,17560,9864,101897,7422,2171,111490,2350,123950,74520,17595,10210,102325,8730,3425,114480,9470,1172782,119362,114673,128738,366241,250187,182974,803376,350584,66722092000,4861014000,4745615000,6176156000,15829520000,14346421000,11392588000,41747334000,24526900000
Ohio,Real Estate and Rental and Leasing,2008,36897,25727,5099,2395,33221,2003,822,36046,851,52445,25770,5255,2910,33935,3210,3665,40810,11635,333469,40389,31733,30397,104052,59926,46209,217551,89262,11914183000,1166982000,923624000,1022161000,3120899000,2130520000,1790479000,7278267000,3762218000
Ohio,Retail Trade,2008,114412,59670,24521,13854,98045,10916,2396,111357,3055,193250,59945,25080,15355,100380,16910,9835,127125,66125,2880240,95698,152824,168675,428126,385838,214296,1063753,1743649,64260290000,2353259000,3187570000,4061738000,9698129000,10738457000,6268125000,26937742000,36465367000
Ohio,Total,2008,199647,107847,37927,23751,169525,21252,5053,195830,3817,263761,108091,38369,25123,171583,27998,14736,214317,49444,4728416,190509,251048,317375,758932,808701,707146,2274779,2453637,182093270000,6275579000,7343731000,10045579000,23664889000,27887280000,25602868000,77155037000,104938233000
Ohio,Transportation and Warehousing,2008,30602,16350,4455,3213,24018,3118,1200,28336,2266,37215,16365,4475,3285,24125,3605,1715,29445,7770,836863,23105,28282,40775,94856,105799,75027,284959,532724,32638126000,853542000,875702000,1358865000,3113150000,3717178000,2790537000,9841397000,22397541000
Ohio,Utilities,2008,834,275,95,73,443,215,50,708,126,3165,275,95,75,445,295,105,845,2320,109512,382,509,595,1847,7471,1930,12801,95765,10353222000,20106000,24383000,52218000,101282000,425547000,118712000,844986000,8987597000
Ohio,Wholesale Trade,2008,61232,27667,10086,7455,45208,8616,3459,57283,3949,75130,27740,10230,7870,45840,10950,6435,63225,11905,1150425,34666,64369,93574,207038,278574,217776,719370,415527,59799601000,2308447000,2972725000,4471897000,9818870000,13460788000,10754037000,34364291000,24644872000
Oklahoma,Accommodation and Food Services,2008,24936,9695,4410,4184,18289,5173,721,24183,753,34940,9705,4415,4235,18355,6120,2700,27175,7765,670520,16095,29399,57211,103723,191861,105815,404149,264222,7880969000,293858000,300497000,572720000,1171961000,2149590000,1141897000,4497212000,3340222000
Oklahoma,Administrative and Support and Waste Management and Remediation Services,2008,19764,11930,3075,1610,16615,1492,576,18683,1081,21940,11930,3085,1640,16655,1625,870,19150,2790,499165,17735,19205,20116,58592,51869,61284,195156,284707,13273552000,516892000,484112000,560019000,1598198000,1621979000,1663438000,5069044000,7764573000
Oklahoma,"Agriculture, Forestry, Fishing and Hunting",2008,781,520,120,90,730,15,11,756,25,790,520,120,90,730,15,20,765,25,4315,579,500,820,2517,150,0,3115,0,130021000,21931000,15782000,25867000,73222000,4262000,0,114749000,0
Oklahoma,"Arts, Entertainment, and Recreation",2008,5081,2840,805,500,4145,603,222,4970,111,5420,2845,805,505,4155,655,315,5125,295,129429,3440,4771,6581,16258,20763,38282,79447,1280,2818450000,104271000,91138000,92380000,301385000,356008000,882503000,1679172000,26163000
Oklahoma,Construction,2008,42813,26730,7580,4710,39020,3055,428,42503,310,43045,26730,7580,4710,39020,3080,450,42550,495,383335,42527,49710,62810,157830,111859,52622,328840,46833,15494700000,1401154000,1462470000,2143242000,5020410000,4514461000,2228397000,11983120000,3221190000
Oklahoma,Educational Services,2008,3293,1545,550,405,2500,465,168,3133,160,3535,1545,550,410,2505,485,245,3235,300,90675,1215,3575,4829,10563,15691,17777,47566,41698,2314495000,51848000,70250000,82689000,213941000,401040000,450155000,1186875000,1048780000
Oklahoma,Finance and Insurance,2008,20709,14280,2395,1110,17785,1338,479,19602,1107,34300,14325,2485,1425,18235,3345,2815,24395,9905,308583,23212,14175,13885,52237,49007,49182,155750,142958,14494731000,819195000,510670000,619599000,2004462000,2134950000,2009542000,6342607000,7956496000
Oklahoma,Health Care and Social Assistance,2008,41189,20130,9425,4785,34340,4433,1483,40256,933,51915,20165,9430,4885,34480,6010,5740,46230,5685,1019064,34470,60569,62553,161281,190173,202715,563369,429502,36324908000,1936625000,2316886000,2201918000,6476966000,5753961000,5909320000,18302636000,17142969000
Oklahoma,Information,2008,4148,1835,630,554,3019,444,177,3640,508,8070,1835,630,575,3040,545,455,4040,4030,149097,1785,3423,5798,13140,13020,4615,40238,94189,6854588000,105109000,126362000,251831000,505478000,578662000,238292000,1779016000,4536181000
Oklahoma,Management of Companies and Enterprises,2008,2192,180,40,75,295,455,580,1330,862,2860,185,40,75,300,460,620,1380,1480,136856,7,0,397,759,4920,13210,19094,116882,13421628000,26091000,258000,24776000,59955000,242120000,888000000,1193772000,12183659000
Oklahoma,Manufacturing,2008,18395,6745,3045,2780,12570,3159,1010,16739,1656,19620,6745,3045,2785,12575,3310,1195,17080,2540,662464,8792,16366,30835,62184,106020,93336,296123,321888,28949989000,399020000,525746000,1104727000,2239011000,4201838000,4041747000,11751097000,15526075000
Oklahoma,"Mining, Quarrying, and Oil and Gas Extraction",2008,12708,7965,1809,1024,10798,1070,349,12217,491,14135,7965,1815,1030,10810,1115,520,12445,1690,236639,4926,11735,9251,37789,35935,34981,109229,127371,18184515000,732631000,607611000,774067000,2118061000,2191695000,2130244000,6468625000,11713653000
Oklahoma,Other,2008,109,103,5,1,109,0,0,109,0,109,103,5,1,109,0,0,109,0,0,0,0,0,0,0,0,0,0,1883000,1387000,0,0,1883000,0,0,1883000,0
Oklahoma,Other Services (except Public Administration),2008,42108,26311,8370,3986,38667,2622,373,41662,446,44725,26360,8435,4095,38890,3275,660,42825,1900,315081,46726,54663,51135,156119,91184,31299,288294,13861,6563179000,967839000,1064431000,1092554000,3148248000,1819469000,684153000,5877534000,475243000
Oklahoma,"Professional, Scientific, and Technical Services",2008,43512,30745,6240,3063,40048,2021,571,42640,872,46050,30755,6260,3150,40165,2360,850,43375,2675,343084,43478,39908,39209,128416,64939,45281,247939,89127,16635856000,1844869000,1446095000,1723869000,5071989000,3574052000,2556507000,11539668000,4972630000
Oklahoma,Real Estate and Rental and Leasing,2008,16448,12416,1770,807,14993,727,226,15946,502,20370,12425,1850,920,15195,1255,455,16905,3465,112913,16983,10389,9727,37669,21269,10106,74026,32185,3846722000,524081000,322972000,269034000,1150373000,676435000,344964000,2359137000,1365677000
Oklahoma,Retail Trade,2008,44541,23131,9918,5153,38202,3735,811,42748,1793,66090,23180,10160,5590,38930,5450,2845,47225,18865,772608,35192,62475,63576,170662,116594,58060,363431,337565,16906363000,909296000,1278045000,1470070000,3688770000,3313262000,1665494000,8965347000,6624508000
Oklahoma,Total,2008,73310,42567,12929,7575,63071,6619,1623,71313,1997,91382,42626,13054,7926,63606,8715,4662,76983,14399,1335622,73580,84802,100902,259284,247811,207602,714697,620925,47993796000,2353621000,2403654000,3024115000,7781390000,7888790000,6990255000,22660435000,25333361000
Oklahoma,Transportation and Warehousing,2008,11991,7120,1485,930,9535,943,426,10904,1087,13875,7120,1490,930,9540,1045,555,11140,2735,205838,7335,9225,9589,30662,27987,24930,87638,88703,8195826000,294527000,306525000,359556000,1001952000,1046523000,974530000,3109810000,3883413000
Oklahoma,Utilities,2008,669,240,100,20,360,135,70,565,104,1675,240,100,20,360,180,185,725,950,25705,441,561,295,1390,6692,1298,14000,266,2225221000,14505000,20466000,6940000,46030000,355936000,68064000,816556000,13048000
Oklahoma,Wholesale Trade,2008,18879,8015,2916,2377,13308,2597,1139,17044,1835,23010,8040,2950,2555,13545,3245,1815,18605,4405,300579,12041,16685,27970,61579,68241,45863,192204,89516,14668664000,588211000,790326000,1275356000,2748178000,3034912000,2113272000,8530764000,5066929000
Oregon,Accommodation and Food Services,2008,41507,14290,9575,9406,33271,6720,824,40815,692,51765,14290,9620,9575,33485,8590,3345,45420,6345,779950,22187,62606,126393,211832,227747,110059,558197,215835,11611475000,495335000,744609000,1610597000,2866085000,3286295000,1566885000,7754257000,3769441000
Oregon,Administrative and Support and Waste Management and Remediation Services,2008,24340,14545,3900,2164,20609,2201,594,23404,936,27175,14555,3905,2195,20655,2415,960,24030,3145,459845,22067,24435,27588,76938,80101,69486,235121,214554,12244053000,640363000,592961000,746295000,1995890000,2368361000,1539856000,6053000000,5920018000
Oregon,"Agriculture, Forestry, Fishing and Hunting",2008,6689,4410,820,640,5870,665,105,6640,49,6835,4410,820,640,5870,710,155,6735,100,62384,4617,5160,8545,19832,24389,9731,59718,2578,2301200000,254514000,196288000,301493000,765640000,823528000,367834000,2125899000,168429000
Oregon,"Arts, Entertainment, and Recreation",2008,7710,4310,1270,840,6420,976,172,7568,142,8130,4310,1280,840,6430,1105,235,7770,360,116499,5548,7888,11189,25002,35014,18127,87901,21491,2355164000,197306000,143062000,193792000,555531000,578442000,372463000,1684220000,460100000
Oregon,Construction,2008,69984,48225,11260,5593,65078,3984,492,69554,430,70500,48225,11260,5595,65080,4135,565,69780,720,485001,75140,72975,73481,225100,147417,45552,431245,38702,21484022000,2315287000,2244815000,2769795000,7330055000,7019962000,2636025000,17442650000,2966134000
Oregon,Educational Services,2008,6201,3085,955,905,4945,845,245,6035,166,6775,3085,955,925,4965,960,585,6510,265,200393,4080,5994,11756,22274,32424,39471,95988,101974,4951283000,131173000,117739000,208420000,471756000,716533000,915054000,2128328000,2778210000
Oregon,Finance and Insurance,2008,18770,12635,2357,829,15821,963,631,17415,1355,32490,12665,2495,970,16130,1885,2395,20410,12080,320802,20227,14242,9133,45503,30558,36915,116847,196717,17703671000,726746000,588683000,587966000,1967482000,1814832000,1890688000,5894804000,11753769000
Oregon,Health Care and Social Assistance,2008,46414,24625,10020,5332,39977,3987,1471,45435,979,57175,24635,10075,5515,40225,5845,5255,51325,5850,999544,41620,64679,68921,177914,157434,171037,517137,457444,42298198000,1869124000,2455329000,2680750000,7025534000,5742006000,5626990000,18721892000,22797506000
Oregon,Information,2008,6599,3450,981,676,5107,586,296,5989,610,10250,3455,995,715,5165,630,660,6455,3795,191522,3320,6253,8025,18532,19843,16195,66432,110118,10567045000,214725000,251109000,356990000,837139000,1135656000,981080000,3480379000,6694796000
Oregon,Management of Companies and Enterprises,2008,2447,130,55,65,250,570,730,1550,897,3145,130,55,65,250,570,775,1595,1550,194695,29,220,305,760,5913,20722,27411,167026,16736910000,18084000,7685000,11702000,40150000,291151000,1172969000,1505526000,15213120000
Oregon,Manufacturing,2008,26844,10885,4790,3685,19360,4344,1485,25189,1655,28240,10885,4800,3685,19370,4610,1755,25735,2505,836625,15361,26754,43867,94876,151292,135071,440397,320976,37683349000,588805000,892569000,1504684000,3184670000,5993552000,5500947000,16998420000,17344910000
Oregon,"Mining, Quarrying, and Oil and Gas Extraction",2008,610,250,130,75,455,95,15,565,45,750,250,130,75,455,100,15,570,180,8651,359,782,889,2060,2036,60,4964,1129,449855000,16296000,28128000,35645000,81415000,83971000,3977000,204243000,71396000
Oregon,Other,2008,170,159,9,2,170,0,0,170,0,170,159,9,2,170,0,0,170,0,0,0,56,0,0,0,0,0,0,2639000,2256000,272000,0,2639000,0,0,2639000,0
Oregon,Other Services (except Public Administration),2008,43401,26605,9272,4217,40094,2484,398,42976,425,47540,26625,9305,4465,40395,3360,1915,45670,1870,315438,48559,59651,53958,164577,81798,27058,281613,22008,7726819000,1134070000,1313651000,1235288000,3711353000,1914635000,770549000,6697339000,836218000
Oregon,"Professional, Scientific, and Technical Services",2008,55441,39380,7180,3936,50496,2814,869,54179,1262,58170,39390,7200,4020,50610,3130,1160,54900,3270,445460,48597,46105,49999,154234,83771,44627,291001,101188,26505873000,2499043000,1852691000,2330968000,6718446000,5036964000,2725003000,14866009000,8036275000
Oregon,Real Estate and Rental and Leasing,2008,24972,19473,2517,1150,23140,924,386,24450,522,29705,19515,2585,1340,23440,1405,1400,26245,3460,145562,27767,15395,13410,58904,26698,22174,108568,32525,4582068000,773033000,423605000,374231000,1616502000,849284000,643366000,3212932000,1200629000
Oregon,Retail Trade,2008,50105,25364,10820,6017,42201,4667,1270,48138,1967,72430,25420,11045,6680,43145,7490,4825,55460,16970,1016854,37739,65401,72894,183435,153106,88614,449599,500916,24558053000,1002249000,1389073000,1669960000,4105011000,4212138000,2560782000,11302470000,12396096000
Oregon,Total,2008,92335,54487,16187,9811,80485,7867,1887,90239,2096,111550,54536,16343,10252,81131,10390,5848,97369,14181,1482968,91235,106760,130382,328377,287567,222467,838411,644557,56824167000,2849935000,2958947000,3835188000,9644070000,9885292000,7970250000,27499612000,29324555000
Oregon,Transportation and Warehousing,2008,13854,8032,1730,1235,10997,1254,542,12793,1061,15835,8040,1735,1290,11065,1375,705,13145,2690,264456,9268,10648,13946,38915,36581,27617,110622,139405,10183999000,376402000,339292000,490192000,1232379000,1425450000,1188432000,3988253000,5906893000
Oregon,Utilities,2008,583,320,40,35,395,85,25,505,78,1340,320,40,40,400,140,30,570,770,33080,121,0,403,219,3886,305,5549,27560,2825843000,10404000,0,24739000,44285000,284962000,12884000,344930000,2464320000
Oregon,Wholesale Trade,2008,24197,11675,3327,2496,17498,2916,1575,21989,2208,28650,11680,3370,2620,17670,3495,2505,23670,4980,383422,15330,19027,27835,69492,82184,66990,235594,126395,20491433000,841429000,912821000,1498442000,3361145000,4040002000,3337459000,11383692000,8369255000
Pennsylvania,Accommodation and Food Services,2008,108698,50515,21470,16931,88916,16393,2147,107456,1242,136320,50570,21535,17115,89220,18320,6310,113850,22470,2159675,87744,142957,228446,460305,596224,288295,1344333,812136,30120721000,1647965000,1624260000,2521264000,5794080000,7518260000,3882334000,17209955000,12865781000
Pennsylvania,Administrative and Support and Waste Management and Remediation Services,2008,65418,39020,9780,6309,55109,5800,2217,63126,2292,75130,39030,9790,6400,55220,6305,3410,64935,10195,1532564,53122,63734,84645,207582,225090,302693,740615,768053,43164609000,2285072000,2064029000,2659044000,7018906000,7345841000,7176348000,21656172000,20944175000
Pennsylvania,"Agriculture, Forestry, Fishing and Hunting",2008,2530,1955,350,90,2395,90,30,2515,15,2535,1955,350,90,2395,90,30,2515,20,14134,3149,1987,1005,6464,2450,3254,13809,325,375750000,77153000,55828000,25355000,166241000,75166000,69140000,359485000,16265000
Pennsylvania,"Arts, Entertainment, and Recreation",2008,22095,11985,3667,2423,18075,3030,622,21727,368,23240,11990,3675,2445,18110,3295,850,22255,985,415929,14543,24293,30575,71969,122368,80251,277878,118480,11584972000,604942000,474807000,607035000,1770274000,2242355000,1912891000,6058914000,4480342000
Pennsylvania,Construction,2008,142872,93940,23465,13265,130670,10024,1448,142142,730,144100,93945,23465,13290,130700,10190,1720,142610,1490,1286145,155378,154025,178095,487670,371220,219072,1085310,183334,65306210000,5599715000,5731695000,8035160000,19366570000,20358930000,12999724000,53217225000,11289722000
Pennsylvania,Educational Services,2008,15399,6075,2320,2015,10410,3411,862,14683,716,17335,6075,2320,2100,10495,3685,1430,15610,1725,1179540,8397,15317,27345,52990,148423,128507,333605,844634,41209675000,309943000,304860000,609848000,1231541000,4186526000,4146613000,9660970000,31514894000
Pennsylvania,Finance and Insurance,2008,49687,30839,8147,3644,42630,3121,1450,47201,2486,96115,30930,8405,4320,43655,6275,6950,56880,39235,1374008,52038,50055,45945,153374,101628,131333,397079,965762,95394250000,2498451000,2541040000,2868599000,7939595000,7046580000,7838997000,23849795000,71193103000
Pennsylvania,Health Care and Social Assistance,2008,129670,58209,28811,18303,105323,15220,5485,126028,3642,178025,58405,29085,19430,106920,22595,18800,148315,29710,4524896,114315,189373,243674,548677,571952,828343,1955075,2564062,179006989000,4506777000,7115697000,9967075000,21619474000,21933346000,25674538000,69466103000,109430838000
Pennsylvania,Information,2008,13331,5990,2060,1640,9690,1772,643,12105,1226,26600,6000,2075,1705,9780,2135,1070,12985,13615,616063,8824,13370,20274,43162,61389,52034,162871,382270,39437685000,430089000,489649000,733885000,1731401000,3133632000,2849882000,7932155000,26500231000
Pennsylvania,Management of Companies and Enterprises,2008,6950,335,135,245,715,1181,2024,3920,3030,11120,335,135,255,725,1215,2300,4240,6880,733850,0,0,1643,3074,16781,73541,94020,639830,68962830000,833000,0,111717000,569796000,920636000,4502668000,6027785000,62935045000
Pennsylvania,Manufacturing,2008,71114,22155,12380,11001,45536,15328,5031,65895,5219,75870,22165,12385,11045,45595,15980,6215,67790,8080,3071135,37630,76620,138680,267576,587606,578916,1496152,1400151,143431771000,1535738000,2506407000,5368256000,9773421000,24480409000,24953735000,61622788000,71517581000
Pennsylvania,"Mining, Quarrying, and Oil and Gas Extraction",2008,4097,1915,655,540,3110,544,203,3857,240,5030,1915,655,540,3110,625,335,4070,960,104687,2900,3749,6603,14088,19424,14023,48582,55507,6488327000,181643000,181908000,320600000,695100000,1014137000,739978000,2484954000,3965010000
Pennsylvania,Other,2008,218,204,10,4,218,0,0,218,0,218,204,10,4,218,0,0,218,0,257,0,57,41,257,0,0,257,0,5873000,4127000,1212000,534000,5873000,0,0,5873000,0
Pennsylvania,Other Services (except Public Administration),2008,165000,101987,35695,15623,153305,9441,1253,163999,1001,176880,102065,35915,16185,154165,11425,3020,168610,8270,1228336,200073,229903,202924,635106,324584,123878,1093036,104403,28797910000,4237003000,4577845000,4418451000,13240150000,7669920000,3792866000,24911735000,3353392000
Pennsylvania,"Professional, Scientific, and Technical Services",2008,138102,91838,19329,11800,122967,9643,2507,135117,2985,148615,91865,19435,12095,123395,11595,3765,138755,9860,1566896,138629,125695,153447,426196,327459,225854,989325,554333,105653830000,7014240000,6398492000,8785542000,22266290000,21319914000,16157809000,59998895000,45177728000
Pennsylvania,Real Estate and Rental and Leasing,2008,36087,24020,5573,2567,32160,2131,809,35100,987,47800,24095,5765,2995,32855,3240,2335,38430,9370,331486,38667,35324,32453,108882,67384,48181,229465,91752,13201511000,1400500000,1160940000,1295299000,3866490000,2974253000,2156627000,9152505000,3757397000
Pennsylvania,Retail Trade,2008,141736,75379,29621,16457,121457,13776,3193,138426,3310,227915,75580,30185,18190,123955,19895,10870,154720,73195,3212340,118404,179846,194265,499411,483683,310369,1330109,1615928,72705947000,3121058000,3946731000,4938579000,12022841000,14142125000,8212937000,34964489000,35993277000
Pennsylvania,Total,2008,237055,133107,43818,26729,203654,23848,5570,233072,3983,303115,133311,44251,28071,205633,30366,15421,251420,51695,5231026,237205,288476,356999,882680,901676,783058,2567414,2663612,215783820000,7924733000,8909025000,12233563000,29067321000,33359139000,29986729000,92413189000,123370631000
Pennsylvania,Transportation and Warehousing,2008,33913,17789,4890,3656,26335,3899,1397,31631,2282,40285,17810,4895,3715,26420,4310,1840,32570,7715,968243,26326,30340,47211,106023,136149,117486,368209,552967,33373324000,892139000,887761000,1411671000,3224979000,4089123000,3674847000,11250418000,21694855000
Pennsylvania,Utilities,2008,946,310,150,72,532,137,40,709,237,3775,310,155,75,540,200,110,850,2925,148749,566,758,653,2213,5162,0,10233,136233,15028829000,17266000,37479000,35976000,99472000,345455000,0,632466000,14393350000
Pennsylvania,Wholesale Trade,2008,65578,30440,10898,7993,49331,8745,3501,61577,4001,77795,30495,10980,8345,49820,10455,5745,66020,11775,1236985,49843,69180,102069,227729,284093,224703,755882,459897,70099515000,2760010000,3582611000,5312782000,11751905000,14596187000,11341155000,38475433000,31063345000
Rhode Island,Accommodation and Food Services,2008,12753,5425,2345,2290,10060,2121,217,12398,355,14805,5430,2355,2330,10115,2375,555,13045,1760,218132,8416,15366,32399,56302,74398,27726,159437,58634,3323020000,225230000,202624000,423919000,855682000,1110147000,418553000,2402515000,919658000
Rhode Island,Administrative and Support and Waste Management and Remediation Services,2008,8375,5650,955,535,7140,560,243,7943,432,8735,5650,960,535,7145,570,280,7995,740,121454,4871,5371,6042,19277,18009,25364,66946,47452,3283041000,359790000,173529000,220186000,789573000,524542000,505242000,1962851000,1130555000
Rhode Island,"Agriculture, Forestry, Fishing and Hunting",2008,230,200,15,10,225,5,0,230,0,230,200,15,10,225,5,0,230,0,475,0,0,0,137,0,0,475,0,23454000,7987000,603000,0,16154000,0,0,23454000,0
Rhode Island,"Arts, Entertainment, and Recreation",2008,2564,1375,490,267,2132,317,50,2499,65,2685,1375,490,275,2140,330,115,2585,100,35450,1265,2873,3230,7805,10402,2040,25232,5304,942171000,84866000,91604000,106106000,295414000,247273000,36801000,666197000,100252000
Rhode Island,Construction,2008,17264,12840,2375,1120,16335,750,115,17200,64,17280,12840,2375,1125,16340,750,115,17205,75,99066,18225,15143,14213,48850,22218,12921,93584,635,5459084000,745600000,622784000,713413000,2118155000,1304597000,904843000,4944040000,53862000
Rhode Island,Educational Services,2008,1956,1005,235,150,1390,325,121,1836,120,2055,1005,240,155,1400,345,150,1895,160,123523,1278,1268,1660,4708,12029,12914,30825,86501,4046359000,39130000,25372000,34110000,107459000,347386000,443042000,937234000,2892754000
Rhode Island,Finance and Insurance,2008,5086,2840,650,355,3845,293,257,4395,691,7885,2865,650,380,3895,370,795,5060,2825,110015,4157,3974,4146,13497,5417,14464,39493,50272,7554148000,248032000,180065000,217010000,675599000,698541000,819445000,2460756000,3917369000
Rhode Island,Health Care and Social Assistance,2008,12839,5215,2985,1875,10075,1454,808,12337,502,16415,5265,3005,1960,10230,2010,2700,14940,1475,408312,9644,19305,24291,54766,59726,108202,226179,169469,15825576000,448846000,798578000,949200000,2216316000,2244725000,3495529000,8047735000,7416761000
Rhode Island,Information,2008,1301,525,235,135,895,115,75,1085,216,2040,525,235,135,895,120,85,1100,940,36435,196,918,737,2441,2706,4565,15028,15535,2039200000,31575000,59384000,52605000,163539000,119840000,191652000,752800000,1061672000
Rhode Island,Management of Companies and Enterprises,2008,627,50,10,25,85,70,176,331,296,865,50,10,25,85,70,190,345,520,44160,0,0,105,28,917,6296,7545,36615,5366145000,4029000,0,4845000,10855000,50582000,401815000,466515000,4899630000
Rhode Island,Manufacturing,2008,8573,3280,1515,1306,6101,1671,398,8170,403,8745,3280,1515,1315,6110,1710,485,8305,440,202014,4331,7378,12433,29230,54652,31879,142374,35624,8745144000,202068000,285258000,481753000,1062019000,2239610000,1276524000,5628584000,2044089000
Rhode Island,"Mining, Quarrying, and Oil and Gas Extraction",2008,120,60,20,25,105,5,0,110,10,125,60,20,25,105,5,0,110,15,787,0,0,304,524,0,0,664,0,49367000,5331000,0,15183000,30170000,0,0,36394000,0
Rhode Island,Other,2008,26,26,0,0,26,0,0,26,0,26,26,0,0,26,0,0,26,0,0,0,0,0,0,0,0,0,0,529000,529000,0,0,529000,0,0,529000,0
Rhode Island,Other Services (except Public Administration),2008,13967,8900,2775,1325,13000,687,85,13772,195,14580,8905,2795,1350,13050,855,100,14005,575,93199,16238,16995,16062,51972,20792,70,81752,4810,2396886000,427582000,398669000,428472000,1281303000,620588000,2212000,2126102000,142050000
Rhode Island,"Professional, Scientific, and Technical Services",2008,14752,10105,2125,1088,13318,715,270,14303,449,15280,10105,2130,1090,13325,765,295,14385,895,116259,14461,13072,12347,41816,20338,11160,79622,30839,7507580000,676478000,642080000,714574000,2063654000,1292776000,703668000,4358755000,2950463000
Rhode Island,Real Estate and Rental and Leasing,2008,4957,3510,550,293,4353,260,136,4749,208,5940,3510,575,400,4485,325,255,5065,875,30886,1308,2981,2720,10285,6289,3064,21579,3129,1177835000,182516000,113804000,126148000,430514000,255322000,96823000,848899000,178467000
Rhode Island,Retail Trade,2008,15544,8740,2691,1579,13010,978,291,14279,1265,20085,8760,2750,1695,13205,1085,685,14975,5110,240037,11410,14229,16259,45456,22083,10431,91024,85195,5914982000,379994000,376801000,456081000,1283717000,822737000,402295000,2707004000,2206089000
Rhode Island,Total,2008,25818,15006,4282,2654,21942,2255,627,24824,994,29759,15031,4314,2751,22096,2601,1444,26141,3618,433562,25300,28083,35568,88951,82476,71459,242886,190676,17468919000,914842000,920722000,1190958000,3026522000,3061052000,2649909000,8737483000,8731436000
Rhode Island,Transportation and Warehousing,2008,3182,1950,365,220,2535,297,84,2916,266,3430,1950,365,225,2540,305,90,2935,495,42653,1997,1589,1978,6493,7429,1214,19234,16885,1670675000,96409000,69280000,72219000,274345000,262766000,42880000,688796000,687570000
Rhode Island,Utilities,2008,57,15,5,5,25,5,0,30,27,165,15,5,5,25,5,0,30,135,0,0,0,0,62,0,0,134,0,0,0,0,0,3300000,0,0,7093000,0
Rhode Island,Wholesale Trade,2008,6996,3225,1080,720,5025,910,315,6250,746,7320,3235,1080,720,5035,1005,325,6365,955,101711,3565,5485,7303,19542,23029,7826,60712,26986,5246158000,255898000,287808000,386121000,1049669000,1251030000,361861000,3178030000,1381834000
South Carolina,Accommodation and Food Services,2008,35068,12405,6505,6670,25580,7323,1275,34178,890,46860,12420,6530,6765,25715,8255,4000,37970,8890,962432,19059,44168,90973,154965,280542,172620,609382,352418,12475460000,424026000,495379000,1021343000,1943251000,3530650000,2138230000,7632415000,4835441000
South Carolina,Administrative and Support and Waste Management and Remediation Services,2008,25109,14310,4080,2645,21035,2226,707,23968,1141,28210,14350,4090,2665,21105,2485,865,24455,3755,660813,21220,26215,32544,84027,76985,96238,270023,373286,16545663000,627814000,722548000,904577000,2277601000,2064584000,2146159000,6803077000,9559232000
South Carolina,"Agriculture, Forestry, Fishing and Hunting",2008,2835,1500,640,455,2595,160,40,2795,40,2860,1500,640,455,2595,170,45,2810,50,21363,2037,3909,5412,12473,4137,1100,19973,328,664214000,76446000,125559000,166550000,391123000,141518000,23636000,595399000,16718000
South Carolina,"Arts, Entertainment, and Recreation",2008,7157,3770,980,825,5575,1178,228,6981,176,7720,3770,980,830,5580,1365,355,7300,420,137199,4710,5934,10608,23028,46631,24012,98262,27969,2157674000,152467000,101020000,165897000,441411000,799871000,371055000,1693964000,309293000
South Carolina,Construction,2008,60090,37065,10850,6625,54540,4536,555,59631,459,60700,37065,10850,6645,54560,4585,670,59815,885,538039,61741,71655,88315,217801,162438,56951,452075,62404,19807243000,2180147000,1995875000,2771799000,6714130000,6033712000,2135259000,15982010000,2751700000
South Carolina,Educational Services,2008,4843,2440,675,563,3678,815,160,4653,190,5170,2440,675,565,3680,865,245,4790,380,147465,3594,4116,7128,15248,30468,27474,75773,69318,3163811000,108532000,76007000,118067000,306284000,656205000,700481000,1723169000,1392271000
South Carolina,Finance and Insurance,2008,17172,10710,2595,1025,14330,1061,537,15928,1244,38655,10745,2860,1420,15025,3205,3790,22020,16635,334312,18090,15622,12545,47618,31988,40126,126447,193527,16154329000,671508000,568698000,532382000,1781381000,1343515000,1807306000,5103235000,10956591000
South Carolina,Health Care and Social Assistance,2008,38100,16390,9325,5765,31480,4419,1068,36967,1133,46995,16420,9390,6000,31810,5575,3345,40730,6265,1013908,27900,61744,75514,168251,163617,145030,483906,515806,40874287000,1443432000,2336769000,3029659000,6831075000,6470865000,4433694000,17899949000,22776354000
South Carolina,Information,2008,3570,1665,435,290,2390,400,222,3012,558,7230,1670,435,295,2400,485,405,3290,3940,153227,1876,2121,2833,7843,10425,15757,38626,110987,7361656000,95402000,76888000,101362000,301977000,462105000,877396000,1798025000,5546039000
South Carolina,Management of Companies and Enterprises,2008,2145,130,45,85,260,355,541,1156,989,2975,130,45,90,265,355,575,1195,1780,129390,0,0,468,901,3425,15591,20016,109225,9472260000,14474000,13055000,26273000,56169000,167775000,684420000,908365000,8563895000
South Carolina,Manufacturing,2008,20192,6690,3095,2715,12500,3330,1612,17442,2750,21865,6695,3095,2715,12505,3450,1840,17795,4070,1074751,8694,16382,30635,63065,112650,144771,357426,633450,45157207000,359709000,521162000,1037061000,2098495000,4089817000,5593541000,13103649000,28676181000
South Carolina,"Mining, Quarrying, and Oil and Gas Extraction",2008,354,160,50,40,250,50,10,310,44,460,160,50,40,250,50,10,310,150,5754,0,0,124,214,794,0,2188,2701,257153000,7146000,6900000,12444000,34183000,33022000,0,87645000,153697000
South Carolina,Other,2008,115,106,7,2,115,0,0,115,0,115,106,7,2,115,0,0,115,0,0,0,47,0,0,0,0,0,0,2884000,2048000,627000,0,2884000,0,0,2884000,0
South Carolina,Other Services (except Public Administration),2008,52591,31565,11736,4865,48166,3454,465,52085,506,56040,31575,11775,5015,48365,4295,935,53595,2445,400170,59717,75095,62602,199982,119198,35452,361681,31575,8611520000,1261458000,1492903000,1364786000,4138278000,2383023000,711160000,7357591000,1148133000
South Carolina,"Professional, Scientific, and Technical Services",2008,45522,31055,6945,3450,41450,2233,765,44448,1074,48660,31060,6950,3530,41540,2790,1320,45650,3010,399626,40003,43551,44027,136330,67591,52099,266047,120562,20822985000,1916808000,1673965000,1941916000,5637121000,4115351000,3042161000,13001418000,7491041000
South Carolina,Real Estate and Rental and Leasing,2008,20514,15670,1988,992,18650,748,483,19881,633,26115,15715,2080,1150,18945,1235,1445,21625,4490,146647,15786,12000,11577,47564,23158,23222,97226,39044,4670420000,760244000,386367000,371492000,1542757000,720128000,742523000,3129647000,1393194000
South Carolina,Retail Trade,2008,57561,32541,11818,5880,50239,4091,1006,55336,2225,92305,32615,12130,6620,51365,6530,3645,61540,30765,1066736,56638,72858,65572,202738,132222,59993,413891,580522,22693056000,1290332000,1537924000,1792884000,4677650000,3787049000,1703859000,10596513000,10945879000
South Carolina,Total,2008,83427,46865,15267,9176,71308,7765,1990,81063,2364,106678,46935,15470,9638,72043,9992,5290,87325,19353,1654414,82479,100570,121987,305036,282831,221975,809842,844572,55089431000,2655768000,2721946000,3500571000,8878285000,8439232000,6855845000,24173362000,30916069000
South Carolina,Transportation and Warehousing,2008,11300,6013,1549,887,8449,994,603,10046,1254,13270,6015,1560,920,8495,1065,760,10320,2950,280373,8653,9111,10371,29573,23030,28658,84853,156974,10356215000,288502000,263392000,341449000,932655000,736933000,932528000,2734921000,5994955000
South Carolina,Utilities,2008,505,165,75,45,285,100,65,450,55,1560,165,75,45,285,130,190,605,955,56985,153,477,597,1388,4177,8096,13911,29101,3960631000,8925000,15750000,21831000,47534000,203841000,434167000,695557000,2240696000
South Carolina,Wholesale Trade,2008,20703,9601,3088,2311,15000,2537,1254,18791,1912,25165,9635,3105,2415,15155,3070,2010,20235,4930,333158,13850,18329,26007,63410,67224,44238,191652,103213,16249590000,729503000,845348000,1166828000,2872555000,3119356000,2049618000,8549472000,6406252000
South Dakota,Accommodation and Food Services,2008,10445,4135,1880,2005,8020,1879,329,10228,217,11925,4135,1895,2050,8080,2185,865,11130,795,186510,5642,12587,27981,46475,66856,40664,154720,26069,2312943000,151654000,121049000,276109000,555446000,768689000,589085000,1924703000,353812000
South Dakota,Administrative and Support and Waste Management and Remediation Services,2008,4824,3055,755,330,4140,308,120,4568,256,5120,3055,755,345,4155,350,150,4655,465,59063,3666,4516,3413,12066,9221,9342,33095,11763,1360528000,131385000,109268000,61221000,330020000,225748000,199867000,819428000,360394000
South Dakota,"Agriculture, Forestry, Fishing and Hunting",2008,590,465,60,40,565,5,15,585,5,590,465,60,40,565,5,15,585,5,673,224,196,202,372,0,0,510,0,73579000,19545000,9716000,13516000,46186000,0,0,72704000,0
South Dakota,"Arts, Entertainment, and Recreation",2008,3177,1845,585,380,2810,265,67,3142,35,3305,1845,585,385,2815,310,125,3250,55,30716,1969,3310,4369,10575,7992,3079,27833,788,496198000,78347000,52414000,64365000,211900000,148203000,40598000,476758000,5906000
South Dakota,Construction,2008,16321,11230,2760,1315,15305,785,151,16241,80,16400,11230,2760,1315,15305,790,200,16295,105,99652,15883,17593,15548,52178,26624,13602,97197,1147,3956671000,604126000,574736000,620119000,1816396000,1235316000,553751000,3806696000,71778000
South Dakota,Educational Services,2008,1000,455,140,95,690,180,90,960,40,1040,455,140,95,690,180,95,965,75,36820,308,776,969,2499,6556,18304,27831,8974,803859000,21228000,12380000,10940000,53009000,151228000,404137000,622361000,179248000
South Dakota,Finance and Insurance,2008,5960,3810,712,398,4920,351,182,5453,507,9625,3815,750,580,5145,800,1105,7050,2575,112281,6063,3787,4116,14968,10518,13339,41411,37711,5164847000,199875000,161294000,200244000,583522000,418977000,578002000,1674987000,2380750000
South Dakota,Health Care and Social Assistance,2008,9103,4149,1833,1170,7152,1115,574,8841,262,11260,4160,1840,1215,7215,1795,1555,10565,695,286752,6456,11651,13934,33715,43724,67898,151479,116955,10718514000,286956000,352272000,565604000,1241341000,1399148000,2358787000,5113396000,5200311000
South Dakota,Information,2008,1422,560,235,145,940,196,77,1213,209,2245,560,240,155,955,320,300,1575,670,37884,673,1286,1043,3448,7048,2090,17762,9390,1453894000,27798000,35162000,28402000,116261000,206430000,77362000,604183000,343543000
South Dakota,Management of Companies and Enterprises,2008,643,25,15,26,66,145,220,431,212,740,25,15,30,70,145,230,445,295,23382,0,80,104,196,1297,4491,6165,17336,1656651000,0,2064000,3628000,10132000,71093000,312528000,404180000,1251852000
South Dakota,Manufacturing,2008,4940,1895,865,575,3335,799,367,4501,439,5240,1895,865,580,3340,825,485,4650,590,153359,1657,4112,4525,12341,21430,17840,72903,60097,5731740000,79164000,114500000,162846000,414891000,837358000,659625000,2554223000,2291781000
South Dakota,"Mining, Quarrying, and Oil and Gas Extraction",2008,305,150,40,25,215,32,24,271,34,360,150,40,25,215,35,50,300,60,4443,57,0,148,556,0,780,2746,770,264672000,8929000,1029000,5782000,26340000,0,53212000,162063000,48671000
South Dakota,Other,2008,26,25,1,0,26,0,0,26,0,26,25,1,0,26,0,0,26,0,0,0,0,0,0,0,0,0,0,0,0,0,0,0,0,0,0,0
South Dakota,Other Services (except Public Administration),2008,12921,8425,2745,1025,12195,510,101,12806,115,13405,8435,2755,1055,12245,670,165,13080,325,70801,13738,16337,12148,45266,15547,62,62395,583,1368950000,300511000,324379000,243525000,898605000,316377000,1923000,1270726000,36313000
South Dakota,"Professional, Scientific, and Technical Services",2008,8556,5760,1295,760,7815,405,83,8303,253,8910,5760,1315,795,7870,525,100,8495,415,53195,8619,8071,9119,26686,10823,2061,41993,7899,2029683000,281681000,268767000,340460000,913323000,502612000,84988000,1586109000,313772000
South Dakota,Real Estate and Rental and Leasing,2008,4074,3040,438,180,3658,178,80,3916,158,4395,3040,450,205,3695,235,100,4030,365,17575,2656,2220,1774,8623,2785,1167,15283,1795,497205000,104706000,58644000,42797000,227202000,85979000,28944000,415773000,71982000
South Dakota,Retail Trade,2008,15947,7454,3329,2405,13188,1360,520,15068,879,20345,7480,3370,2540,13390,1905,1620,16915,3430,214345,11133,19680,28884,63999,40240,25505,139234,64592,4611099000,286134000,399411000,598428000,1329967000,1019268000,601204000,3137761000,1284082000
South Dakota,Total,2008,21797,12428,3838,2369,18635,1880,542,21057,740,25689,12442,3879,2518,18839,2570,1641,23050,2639,337816,20560,25353,31184,77097,68754,62228,208079,129737,10608240000,591742000,613944000,805697000,2011383000,1974354000,1942450000,5928187000,4680053000
South Dakota,Transportation and Warehousing,2008,5148,3405,690,379,4474,310,115,4899,249,5635,3405,690,385,4480,345,175,5000,635,43584,3464,3783,3913,12382,8546,2178,29682,12140,1499996000,146288000,121747000,122106000,404100000,272725000,81173000,904502000,489191000
South Dakota,Utilities,2008,341,60,55,65,180,100,10,290,51,760,60,55,70,185,165,50,400,360,9911,0,369,890,1413,2943,0,5573,0,600546000,3557000,14355000,41580000,60773000,159521000,0,294718000,0
South Dakota,Wholesale Trade,2008,5617,2110,803,663,3576,954,409,4939,678,7015,2115,810,725,3650,1265,820,5735,1280,79558,2232,3669,6286,15393,25353,12546,57903,15494,3349006000,115648000,152164000,244754000,573205000,982510000,577633000,2322040000,822992000
Tennessee,Accommodation and Food Services,2008,39870,13865,7417,7729,29011,8557,1091,38659,1211,58535,14105,7445,7925,29475,9945,4295,43715,14820,1233228,22292,49796,105109,178958,309718,149391,639493,591818,15974885000,508525000,561387000,1223518000,2294545000,3837931000,1775013000,7920065000,8026796000
Tennessee,Administrative and Support and Waste Management and Remediation Services,2008,27612,14640,4415,2880,21935,2925,998,25858,1754,33555,14690,4425,2900,22015,3060,1335,26410,7145,1006106,23434,27842,36882,90496,108366,129787,342799,661389,26852499000,838425000,885568000,1147480000,2916933000,3339697000,3141273000,9911609000,16455145000
Tennessee,"Agriculture, Forestry, Fishing and Hunting",2008,1290,910,245,65,1220,35,25,1280,10,1305,910,250,65,1225,35,25,1285,20,6401,1408,1485,739,4102,237,0,6304,0,202467000,43999000,41689000,20752000,113557000,7559000,0,192272000,0
Tennessee,"Arts, Entertainment, and Recreation",2008,11138,6190,1945,1360,9495,1120,284,10899,239,11730,6190,1950,1365,9505,1260,370,11135,595,166713,7662,12488,16716,40921,40667,29874,117909,27654,5348512000,493718000,363106000,674245000,1535964000,1068393000,985208000,4092529000,650432000
Tennessee,Construction,2008,56873,32690,10550,6879,50119,5350,947,56416,457,57605,32690,10550,6880,50120,5400,1105,56625,980,625690,57517,69470,91850,219323,202227,136252,563015,44338,26353012000,1822680000,2087007000,3268318000,7195700000,8886406000,6439092000,22697892000,2768909000
Tennessee,Educational Services,2008,5530,2420,835,730,3985,795,458,5238,292,5905,2420,840,765,4025,805,540,5370,535,264650,3497,5399,9533,19309,33394,75207,130161,130174,7713919000,136842000,98490000,193227000,435944000,827621000,2250007000,3575859000,4032943000
Tennessee,Finance and Insurance,2008,24811,15618,3279,1417,20314,1795,915,23024,1787,52020,15690,3520,1915,21125,4755,5110,30990,21030,552990,26040,20104,17203,66621,64216,73707,210712,338367,33297783000,1161542000,883411000,1006962000,3116573000,4025813000,3650029000,11800975000,21142646000
Tennessee,Health Care and Social Assistance,2008,55650,24608,13760,7780,46148,5736,2097,53981,1669,72950,24640,13835,8150,46625,7645,6470,60740,12210,1792501,47781,90146,101678,242923,216660,315254,786119,995311,73074493000,2300774000,3557792000,4281309000,10162767000,9479545000,11434730000,31284980000,41420308000
Tennessee,Information,2008,7259,3505,1125,736,5366,778,338,6482,777,12655,3505,1140,770,5415,905,630,6950,5705,222519,4350,5525,9106,20078,19236,17708,66773,136518,11684118000,243675000,239445000,338967000,906146000,882222000,874700000,3007298000,7644838000
Tennessee,Management of Companies and Enterprises,2008,3691,180,45,90,315,611,1056,1982,1709,7090,180,45,90,315,615,1100,2030,5060,367945,6,0,462,788,6040,30219,37165,330780,31770395000,39385000,8780000,48293000,98480000,462135000,2109680000,2670295000,29099725000
Tennessee,Manufacturing,2008,30682,9900,5275,4180,19355,5470,2370,27195,3487,33000,9900,5280,4200,19380,5695,2780,27855,5145,1623878,14175,30727,50094,102150,197514,207863,561888,967198,66228534000,580395000,947011000,1773279000,3515937000,7230286000,8302306000,20864305000,41644003000
Tennessee,"Mining, Quarrying, and Oil and Gas Extraction",2008,742,235,85,155,475,111,63,649,93,1150,235,85,155,475,120,110,705,445,14308,191,441,1580,2715,2837,5336,12629,69,881600000,24240000,13828000,59449000,107773000,156923000,303354000,655254000,70062000
Tennessee,Other,2008,155,139,12,3,154,1,0,155,0,155,139,12,3,154,1,0,155,0,279,0,0,0,254,0,0,279,0,3705000,2376000,822000,0,3510000,0,0,3705000,0
Tennessee,Other Services (except Public Administration),2008,66031,40295,13532,6433,60260,4480,651,65391,640,72025,40330,13575,6720,60625,5950,1335,67910,4115,558470,76338,87733,83479,250858,161228,60889,483877,60740,12922232000,1624025000,1830710000,1877348000,5343443000,3597179000,1248609000,10472807000,2032839000
Tennessee,"Professional, Scientific, and Technical Services",2008,51772,33712,7850,4425,45987,3335,1088,50410,1362,56365,33730,7870,4535,46135,3885,1645,51665,4700,543750,53034,50917,57374,164858,102442,69709,345529,181906,27500361000,2470142000,2122192000,2639948000,7309342000,5699015000,3732593000,17032877000,9755087000
Tennessee,Real Estate and Rental and Leasing,2008,21289,14837,2882,1338,19057,960,548,20565,724,29395,14865,2985,1530,19380,1705,1635,22720,6675,176163,23416,17841,15602,58065,27397,21472,115207,59542,5933389000,686703000,551698000,588368000,1893463000,885834000,828353000,3800671000,2059391000
Tennessee,Retail Trade,2008,73592,40467,14940,8124,63531,6104,1402,71037,2555,117840,40550,15235,8995,64780,8840,5380,79000,38840,1466900,69686,95565,103199,273060,206930,100549,596187,813176,33045990000,1670010000,2085505000,2575509000,6343029000,6321048000,2969106000,15885276000,16737933000
Tennessee,Total,2008,102398,55082,19049,11866,85997,10476,2866,99339,3059,136585,55218,19262,12511,86991,13526,7616,108133,28452,2492746,101018,125932,158175,385125,386663,346415,1118203,1374543,90853613000,3313912000,3687511000,5016074000,12017497000,13494933000,12734536000,38246966000,52606647000
Tennessee,Transportation and Warehousing,2008,16894,8310,2467,1744,12521,1645,840,15006,1888,21830,8315,2480,1770,12565,1775,1135,15475,6355,560208,10851,15307,20878,53068,53683,58284,173337,332790,21190415000,446931000,461059000,721639000,1689605000,1972556000,2288471000,6254661000,13210482000
Tennessee,Utilities,2008,302,50,30,10,90,90,45,225,77,740,50,30,10,90,195,220,505,235,14830,0,142,0,349,5051,5895,11466,2809,850370000,2360000,2559000,0,11555000,262971000,357877000,638481000,179036000
Tennessee,Wholesale Trade,2008,29743,12390,4646,3660,20696,4236,1868,26800,2943,36455,12400,4710,3800,20910,5035,2860,28805,7650,618506,18597,28113,43143,96126,125776,87176,328799,271365,30864630000,1087639000,1384998000,2001838000,4565536000,6343319000,4448026000,16127461000,14139853000
Texas,Accommodation and Food Services,2008,149736,56280,28883,27233,112396,31508,3822,147726,2010,219535,56335,28995,27695,113025,37355,15990,166370,53165,4546750,89943,191319,363818,640820,1183797,627604,2465429,2072992,63831390000,2099820000,2203658000,4392237000,8703475000,15308786000,8419007000,32537055000,31236190000
Texas,Administrative and Support and Waste Management and Remediation Services,2008,108413,60762,16735,11202,88699,11524,4386,104609,3804,129270,60940,16755,11425,89120,12365,5830,107315,21955,4690926,95481,106731,147604,347496,437680,669714,1473490,3173398,137978558000,4382149000,3631418000,4973321000,13007306000,15184054000,18993607000,47489631000,89297411000
Texas,"Agriculture, Forestry, Fishing and Hunting",2008,5265,3355,1005,490,4850,300,65,5215,50,5625,3355,1005,490,4850,320,385,5555,70,39653,4916,6245,6109,17896,8630,6573,35338,3904,1278951000,168214000,200141000,196555000,577811000,237525000,230785000,1112991000,158779000
Texas,"Arts, Entertainment, and Recreation",2008,28161,15240,4682,3679,23601,3416,702,27719,442,31045,15245,4720,3710,23675,3705,910,28290,2755,560942,22101,29586,48950,103797,130848,100544,341922,198861,15304899000,1010915000,613687000,878836000,2507480000,2265440000,4827056000,9752310000,5245671000
Texas,Construction,2008,206081,117894,37545,23194,178633,21821,3946,204400,1681,210315,117910,37565,23205,178680,22225,5150,206055,4260,3165030,200976,246552,310980,761240,858962,660414,2282660,867297,147789990000,8497965000,8432330000,11884165000,28814460000,36498091000,30584740000,95988810000,50735450000
Texas,Educational Services,2008,24787,12180,3805,3213,19198,4131,921,24250,537,27445,12195,3805,3245,19245,4575,1635,25455,1990,710885,18370,25150,41785,85637,169064,127675,391172,307589,22457325000,613605000,485543000,802243000,1959855000,4282121000,4225553000,10502786000,11418965000
Texas,Finance and Insurance,2008,98052,67199,12885,5869,85953,6132,2614,94699,3353,193055,67580,13385,7140,88105,13455,13120,114680,78375,2340481,111330,80079,74781,271424,224667,264970,768864,1558827,151464214000,5457647000,3843564000,4332169000,13632776000,14362394000,17515737000,45922122000,105271116000
Texas,Health Care and Social Assistance,2008,231855,113716,53873,31267,198856,23548,6233,228637,3218,279405,113910,54130,32275,200315,30485,16435,247235,32170,5934766,203875,353452,411764,973930,914589,990492,2888606,2973535,231575583000,13899808000,14725759000,16446106000,45087605000,31992734000,30469137000,107674702000,122227096000
Texas,Information,2008,22710,11080,3518,2409,17007,2689,1169,20865,1845,47025,11100,3540,2470,17110,3295,2220,22625,24400,1261561,16946,18683,31032,68840,92897,97469,272728,985864,82249413000,943750000,895811000,1538502000,3433855000,5167557000,6263623000,15337169000,66829131000
Texas,Management of Companies and Enterprises,2008,12459,1090,376,431,1897,2363,3207,7467,4992,21105,1090,380,440,1910,2450,3450,7810,13295,1267850,1483,102,2763,5953,31025,106260,143280,1124570,139129615000,242900000,129195000,220800000,592895000,2120370000,8400825000,11114090000,128015525000
Texas,Manufacturing,2008,95548,35056,16240,14129,65425,17670,5861,88956,6592,104100,35080,16260,14190,65530,18355,7085,90970,13130,4173341,58987,101755,180717,355051,685698,669037,1778671,2204016,213613586000,2828944000,3451174000,6856665000,13464750000,28581475000,28459230000,73030132000,129387013000
Texas,"Mining, Quarrying, and Oil and Gas Extraction",2008,32236,18679,4508,3365,26552,3759,992,31303,933,37690,18685,4530,3390,26605,3965,1550,32120,5570,906326,29418,29681,44916,104285,140019,131370,378150,527861,79022347000,2488322000,1977916000,2854287000,7332485000,10098675000,11811896000,29364321000,49645214000
Texas,Other,2008,921,877,32,9,918,3,0,921,0,921,877,32,9,918,3,0,921,0,1063,0,209,107,0,0,0,1063,0,23148000,15730000,2688000,1877000,20295000,0,0,23148000,0
Texas,Other Services (except Public Administration),2008,215635,126370,44595,24148,195113,16586,2365,214064,1571,239975,126535,44855,25195,196585,21545,5855,223985,15990,2084764,238079,290684,319711,853041,601974,253561,1716721,311515,51856220000,5581455000,6257075000,7074294000,18914229000,13347158000,7038506000,39527000000,11255370000
Texas,"Professional, Scientific, and Technical Services",2008,269882,188190,37393,20866,246449,15083,4166,265698,4184,290880,188250,37555,21410,247215,17680,6710,271605,19275,3007585,286353,244146,276861,810434,519708,390430,1726910,1235611,206797970000,16421010000,12434265000,15415696000,44323845000,34327213000,27967782000,106757645000,98915208000
Texas,Real Estate and Rental and Leasing,2008,95595,70177,12141,5643,87961,4338,1669,93968,1627,132630,70340,12370,6240,88950,7305,6760,103015,29615,862731,110772,77992,71006,261337,137724,118246,527110,324983,37041497000,4056212000,2592944000,2804990000,9449392000,5731814000,4912209000,20577545000,16249437000
Texas,Retail Trade,2008,228417,133723,45409,24391,203523,17071,4043,224637,3780,388345,134120,46745,27610,208475,27870,16815,253160,135185,5284183,229470,272009,302923,794053,597786,425051,1900244,3271023,124692046000,5928420000,6479060000,7895756000,20399626000,18178279000,15009892000,53884405000,69943308000
Texas,Total,2008,396412,226937,71004,44558,342499,39337,9174,391010,5402,522336,227392,71837,46816,346045,50833,25393,422271,100065,9231955,393884,466629,594816,1455329,1499596,1290296,4245221,4986734,394696044000,16672843000,15565770000,20595958000,52834571000,54740216000,52821447000,160396234000,234299810000
Texas,Transportation and Warehousing,2008,63497,33965,10088,6750,50803,6305,2557,59665,3832,81410,34015,10150,6885,51050,7055,4645,62750,18660,1648537,53444,64194,86640,208729,210117,196956,627152,1005445,69710618000,2202426000,2241210000,3116868000,7665561000,8346283000,8532074000,24753946000,43731033000
Texas,Utilities,2008,4724,2540,815,367,3722,423,233,4378,346,9145,2540,820,395,3755,625,550,4930,4215,232437,5361,4734,4284,14985,17342,28565,62191,145086,20533609000,237567000,157366000,259051000,685074000,1177360000,1998467000,4060799000,16228365000
Texas,Wholesale Trade,2008,126955,63116,21055,15554,99725,15078,5989,120792,6163,159075,63350,21460,16625,101435,19520,11870,132825,26250,2438224,103481,134039,196528,445991,468934,418983,1354883,1028994,143309161000,5885622000,6752219000,10212978000,22988445000,24641079000,22941384000,71164704000,69152165000
United States,Accommodation and Food Services,2008,2389715,992181,471733,432912,1896826,433107,48373,2378306,11409,3182930,994205,473340,439535,1907080,503235,195415,2605730,577200,59631645,1654167,3152073,5887529,10693769,16011510,8321590,35027015,24599003,916142440000,37803350000,38476224000,72369359000,148667135000,220779275000,120319580000,489765990000,426321852000
United States,Administrative and Support and Waste Management and Remediation Services,2008,1665090,1050212,249979,154435,1454626,145893,43793,1644312,20778,1967690,1051485,250970,157440,1459895,163550,74445,1697890,269800,51122785,1592812,1639956,2075665,5327055,5853825,7641674,18822645,32183871,1569664350000,62315015000,51047557000,67186990000,180556235000,190850925000,206583273000,577996895000,990980102000
United States,"Agriculture, Forestry, Fishing and Hunting",2008,109637,75024,18475,8960,102459,5533,1110,109102,535,113255,75035,18490,9000,102525,6080,2360,110965,2290,835195,109251,120301,117509,353123,196565,152332,703750,126032,28026220000,4008595000,3746740000,3921577000,11677920000,6847940000,4596597000,23207575000,4648806000
United States,"Arts, Entertainment, and Recreation",2008,578117,357358,81451,58060,496869,63135,13815,573819,4298,621395,357550,81820,58995,498365,69215,21040,588620,32775,10346730,422667,536422,783738,1801150,2554565,2294622,6652265,3668023,311716355000,38792275000,14390980000,18090558000,71429350000,53462860000,83684685000,208576895000,102302892000
United States,Construction,2008,3811088,2506835,622934,358591,3488360,278468,36767,3803595,7493,3868070,2506960,623125,359125,3489210,284945,49035,3823190,44880,35218155,4049615,4090345,4794940,12934900,10578625,6093070,29606595,5594600,1665411340000,148199860000,144868525000,198050800000,491119185000,510380785000,324241430000,1325741400000,338505303000
United States,Educational Services,2008,393931,193030,60674,50021,303725,67211,16448,387384,6547,442890,193170,60960,51330,305460,74935,27780,408175,34715,15706485,298285,405550,683920,1390260,2807765,2842050,7040075,8657542,508832730000,9684475000,8582550000,14612465000,32879490000,75943270000,91432855000,200255615000,308415011000
United States,Finance and Insurance,2008,1278100,905775,178668,79266,1163709,76962,23919,1264590,13510,2509535,911220,186190,97650,1195060,181935,182670,1559665,949870,32519364,1531620,1134061,1043193,3751767,3023166,3685507,10470735,21864299,2608331903000,70707320000,59581049000,72684768000,203000930000,222960106000,269022612000,695842975000,1909839242000
United States,Health Care and Social Assistance,2008,3149416,1576735,715135,406116,2697986,310668,101944,3110598,38818,3955035,1579435,720710,425200,2725345,432765,331360,3489470,465565,86086280,2893083,4731645,5390945,13059344,12111760,15877614,41052875,44881297,3533637315000,149318025000,190503801000,225346100000,565171085000,463342865000,508071043000,1536606935000,1996819346000
United States,Information,2008,366990,212366,54469,39758,306593,41897,10998,359488,7502,707770,212815,54995,41470,309280,54065,31965,395310,312460,17171170,316211,358384,534654,1214129,1617010,1748697,4582620,12566089,1168203790000,21687090000,16078827000,25900390000,63672865000,93201650000,108711611000,265625935000,900668595000
United States,Management of Companies and Enterprises,2008,139046,16964,3899,5627,26490,30535,43985,101010,38036,258805,17040,3985,5780,26805,31550,49570,107925,150880,14437035,21825,18563,35362,76140,375680,1392650,1844470,12592565,1366332910000,2519105000,1922800000,2998915000,7494445000,23946290000,94565670000,126006405000,1240326505000
United States,Manufacturing,2008,1443103,559856,263920,219926,1043702,278443,78661,1400806,42297,1631080,560035,264265,221145,1045445,295045,115225,1455715,175365,65423879,1050695,1764838,2991573,5821574,11275730,12108510,29243183,35980964,3109758794000,41372565000,57877653000,110415497000,209846942000,460931080000,519682713000,1191893344000,1908992286000
United States,"Mining, Quarrying, and Oil and Gas Extraction",2008,107409,60374,16153,12341,88868,12844,3431,105143,2266,137200,60465,16345,12740,89550,15210,7635,112395,24805,3143418,96403,107219,165175,369494,475214,489866,1337486,1800836,237442642000,6889335000,5841915000,9441078000,22202883000,30796419000,35885229000,88992954000,148099900000
United States,Other,2008,12924,12353,422,121,12896,28,0,12924,0,12924,12353,422,121,12896,28,0,12924,0,15378,0,2657,1529,0,785,0,15378,0,285814000,218225000,37589000,20053000,275867000,9947000,0,285814000,0
United States,Other Services (except Public Administration),2008,3337414,2098662,677323,328014,3103999,202758,22912,3329669,7745,3653470,2100795,682315,341575,3124685,262905,77340,3464930,188540,27226709,3957888,4409850,4311215,12675755,7227124,3166929,23075880,3839601,715657355000,91545295000,99406925000,104172710000,295124930000,185294465000,99044403000,579480890000,135240985000
United States,"Professional, Scientific, and Technical Services",2008,3866384,2798900,522625,288112,3609637,201013,36606,3847256,19128,4241545,2800685,525655,298495,3624835,257335,99490,3981660,259885,40164235,4217942,3417530,3831215,11500090,7460655,5586758,24552455,15349294,2695336365000,221602010000,166900970000,213200715000,601703695000,493123170000,395223093000,1490384450000,1202745667000
United States,Real Estate and Rental and Leasing,2008,1423739,1106358,164605,75516,1346479,55628,13991,1416098,7641,1828310,1108800,170265,86210,1365275,96125,79860,1541260,287050,10664970,1651935,1055085,977810,3684745,1937530,1588150,7225335,3342821,440264969000,56690445000,35417115000,37218590000,129326150000,79650440000,66911500000,275888090000,157308984000
United States,Retail Trade,2008,3486646,2036429,719466,391594,3147489,275346,48310,3471145,15501,5504715,2042640,735405,434875,3212920,435145,251395,3899460,1605255,76124016,3659188,4670166,5096670,13388738,9995814,6305350,29852772,45369303,1803053643000,88760968000,104340911000,125509913000,318599984000,294702620000,193679133000,807223174000,988799741000
United States,Total,2008,5930132,3617764,1044065,633141,5294970,526307,90386,5911663,18469,7601169,3624614,1056947,667463,5349024,705430,359902,6414356,1186813,120903551,6086291,6878051,8497391,21461733,20684691,17547567,59693991,61209560,5130509178000,232062907000,222504912000,293534352000,748102171000,774589335000,706476693000,2229168199000,2901340979000
United States,Transportation and Warehousing,2008,857420,540547,122935,81707,745189,75975,20777,841941,15479,1085415,541140,124045,84515,749700,92220,49670,891590,193825,22143947,826262,807333,1089196,2726130,2801557,2564310,8098610,13927984,879097227000,28120652000,25974620000,37124686000,91294645000,101391229000,97633399000,290728640000,584897284000
United States,Utilities,2008,29278,14935,4558,2411,21904,4366,1634,27904,1374,84800,14960,4645,2705,22310,7170,6120,35600,49200,3197015,29559,29173,31522,90627,193780,258124,542634,2654365,274729420000,1059701000,1118136000,1880110000,4063320000,12025700000,17835404000,33928530000,240800890000
United States,Wholesale Trade,2008,1661479,929557,278754,194444,1402755,190176,46296,1639227,22252,2147315,932870,285100,208925,1426895,263580,147135,1837610,309705,30826020,1594570,1835150,2580690,6014380,6910450,5547439,18473515,12177921,1765304120000,77968290000,86169660000,127036675000,291174625000,352512960000,292019596000,935797885000,821430469000
Utah,Accommodation and Food Services,2008,17471,5845,2665,3788,12298,4048,573,16919,552,23460,5845,2685,3820,12350,4710,1905,18965,4495,482983,7027,18035,51229,77930,146672,80823,307503,174685,6325544000,232632000,190589000,517277000,945595000,1704409000,1088435000,3764194000,2551788000
Utah,Administrative and Support and Waste Management and Remediation Services,2008,18125,11453,2435,1455,15343,1333,505,17181,944,19820,11470,2440,1465,15375,1410,590,17375,2445,591684,12514,15212,17700,47905,48978,52817,156552,418760,15915663000,550888000,410305000,526725000,1519150000,1437156000,1463097000,4665144000,10639160000
Utah,"Agriculture, Forestry, Fishing and Hunting",2008,350,250,50,30,330,5,10,345,5,365,250,50,30,330,5,10,345,20,1454,145,178,306,942,0,0,1134,0,58975000,8825000,4128000,14238000,31973000,0,0,55959000,0
Utah,"Arts, Entertainment, and Recreation",2008,4190,2465,590,450,3505,475,105,4085,105,4300,2465,590,450,3505,485,140,4130,170,82800,2345,2919,4554,10963,17376,13914,44086,28398,1745080000,117227000,68209000,76492000,284111000,335306000,183235000,836730000,504238000
Utah,Construction,2008,53989,35105,9490,4983,49578,3611,445,53634,355,54155,35105,9490,4990,49585,3640,460,53685,470,436335,56028,61394,65756,186283,135434,52249,386573,39550,16425180000,1766300000,1724685000,2121883000,5630658000,5211872000,2509256000,13800160000,2112908000
Utah,Educational Services,2008,4024,2135,525,551,3211,565,110,3886,138,4360,2135,545,600,3280,585,140,4005,355,109359,2101,3365,6902,12763,22599,11336,51080,0,2658188000,109165000,58417000,127971000,306643000,525873000,354789000,1317235000,0
Utah,Finance and Insurance,2008,17326,12390,1730,720,14840,914,343,16097,1229,26380,12415,1765,805,14985,1885,1340,18210,8170,245686,14714,9288,7567,33879,29751,21568,96264,132425,13761729000,645609000,396475000,370548000,1454243000,1378077000,1227098000,4388607000,7624475000
Utah,Health Care and Social Assistance,2008,28112,14840,6265,3535,24640,2278,635,27553,559,32515,14845,6275,3655,24775,2960,1945,29680,2835,566179,16475,41245,44585,110436,88445,78763,289382,158489,21284991000,1384660000,1285629000,1366096000,4077675000,2899287000,2215589000,9544936000,7003326000
Utah,Information,2008,4926,2435,625,401,3461,625,226,4312,614,6890,2435,630,420,3485,645,360,4490,2400,153040,1526,3298,4714,11425,20718,18230,54428,89582,9536002000,138141000,128027000,195798000,483902000,1067892000,1074468000,2733788000,5454538000
Utah,Management of Companies and Enterprises,2008,1632,165,35,50,250,310,350,910,722,2115,165,35,60,260,310,360,930,1185,87484,0,190,390,754,4081,10034,14869,71855,6421480000,53150000,6978000,20875000,81765000,205923000,577809000,866700000,5477934000
Utah,Manufacturing,2008,16333,6085,2715,2645,11445,2770,830,15045,1288,16870,6085,2720,2645,11450,2835,890,15175,1695,517783,6786,14132,29403,56506,91388,57042,246497,219747,22747121000,324793000,436701000,936226000,1837336000,3270797000,2454590000,9099311000,11443111000
Utah,"Mining, Quarrying, and Oil and Gas Extraction",2008,2098,995,225,269,1489,250,75,1814,284,2205,995,225,270,1490,255,75,1820,385,41810,1306,1208,2950,5143,6880,2639,17585,23003,2939602000,91120000,58320000,192081000,365591000,423630000,179900000,1099494000,1784837000
Utah,Other,2008,88,84,1,2,87,1,0,88,0,88,84,1,2,87,1,0,88,0,101,40,0,0,70,0,0,101,0,2743000,2063000,0,0,2626000,0,0,2743000,0
Utah,Other Services (except Public Administration),2008,20525,12660,4090,2051,18801,1091,239,20131,394,23015,12675,4130,2145,18950,1890,695,21535,1480,241179,18980,26182,24018,69504,33646,12041,123628,32091,7021590000,516777000,593999000,623198000,1756920000,865919000,291703000,3173998000,1207128000
Utah,"Professional, Scientific, and Technical Services",2008,40248,29070,4500,2560,36130,2306,737,39173,1075,42175,29070,4510,2605,36185,2600,960,39745,2430,357743,33739,27948,31176,96138,79077,53216,236194,111784,17026562000,1612697000,1181958000,1468512000,4316498000,4343185000,2745171000,11656275000,5083385000
Utah,Real Estate and Rental and Leasing,2008,20874,17675,1331,595,19601,609,248,20458,416,23135,17685,1345,670,19700,845,465,21010,2125,108370,9469,7794,6745,28124,18361,13214,71673,17827,3369807000,626930000,211606000,180694000,1056391000,590973000,458210000,2197689000,750342000
Utah,Retail Trade,2008,30298,14467,5941,4355,24763,2972,849,28584,1714,44775,14505,6055,4720,25280,4355,2465,32100,12675,725109,18742,36804,52704,111374,96488,68081,296531,396650,17037875000,628301000,781283000,1239941000,2690583000,2476633000,2049354000,7501032000,9039539000
Utah,Total,2008,60271,36451,9314,6142,51907,5211,1294,58412,1859,71433,36483,9382,6379,52244,6503,2892,61639,9794,1114716,54933,61654,81621,198208,195033,147290,540531,574185,39438430000,1948545000,1710804000,2351602000,6010951000,6353639000,5248480000,17613070000,21825360000
Utah,Transportation and Warehousing,2008,9993,6215,1100,755,8070,784,261,9115,878,10955,6215,1100,755,8070,840,295,9205,1750,227059,7404,6636,8503,23599,25041,13831,70788,138410,8519843000,274514000,227000000,298564000,824232000,978845000,543864000,2592104000,5507599000
Utah,Utilities,2008,380,210,50,25,285,31,15,331,49,1080,210,50,25,285,90,25,400,680,15089,0,365,255,35,730,0,3837,6790,1212212000,5522000,12365000,11235000,31246000,43817000,0,261936000,562546000
Utah,Wholesale Trade,2008,16102,7400,2250,1695,11345,1961,972,14278,1824,18155,7425,2265,1755,11445,2165,1340,14950,3205,276398,9405,13244,19282,44526,48483,35948,147755,85762,13353781000,468373000,539627000,893871000,1964232000,2250073000,1775338000,6590354000,5468968000
Vermont,Accommodation and Food Services,2008,8692,3580,1578,1730,6888,1433,158,8479,213,9715,3580,1595,1760,6935,1630,385,8950,765,149914,5492,10399,22462,39553,46610,17612,105689,39207,2350154000,127016000,124757000,305490000,568033000,708710000,311589000,1594974000,606090000
Vermont,Administrative and Support and Waste Management and Remediation Services,2008,5168,3530,685,325,4540,310,70,4920,248,5405,3530,685,325,4540,355,85,4980,425,40608,3681,3627,3354,12122,7786,3091,25086,13143,1060878000,179899000,111012000,92791000,408264000,223404000,49760000,744360000,241300000
Vermont,"Agriculture, Forestry, Fishing and Hunting",2008,650,555,60,25,640,0,10,650,0,650,555,60,25,640,0,10,650,0,1529,664,241,0,1389,0,0,1529,0,51393000,19019000,7758000,0,39879000,0,0,51393000,0
Vermont,"Arts, Entertainment, and Recreation",2008,2294,1560,300,175,2035,195,34,2264,30,2340,1560,300,175,2035,210,60,2305,35,32361,1764,1591,1572,5854,4719,0,18081,5024,547023000,103548000,42976000,38510000,202840000,106785000,0,393531000,55076000
Vermont,Construction,2008,15128,11445,2070,970,14485,530,78,15093,35,15140,11445,2070,975,14490,535,80,15105,35,69334,14380,12705,12192,42471,16940,4539,68371,43,3134389000,690219000,498067000,528720000,1781164000,867253000,232605000,3061678000,2074000
Vermont,Educational Services,2008,1728,845,280,198,1323,240,95,1658,70,1815,845,280,215,1340,255,140,1735,80,66104,1115,1656,2138,5792,9230,18121,34302,31075,1823490000,43434000,39839000,52187000,149647000,253265000,565407000,1008764000,799241000
Vermont,Finance and Insurance,2008,2871,1535,405,185,2125,199,110,2434,437,5115,1540,420,250,2210,570,665,3445,1670,43461,1796,2358,1854,6274,6140,6438,22634,16878,2577566000,101673000,124421000,90002000,363988000,340252000,344831000,1275975000,1258074000
Vermont,Health Care and Social Assistance,2008,9024,4200,2050,1110,7360,1015,393,8768,256,10860,4200,2050,1135,7385,1380,1255,10020,840,241121,6904,12451,13638,35217,35013,42965,116378,108503,8064641000,327520000,421929000,456389000,1240632000,1169568000,1491689000,3931293000,3544996000
Vermont,Information,2008,1891,920,320,200,1440,220,72,1732,159,2580,920,320,210,1450,290,135,1875,705,27190,1312,1178,1830,5440,5483,2346,17162,7328,1191137000,53840000,41085000,58728000,192568000,303821000,78632000,654424000,447441000
Vermont,Management of Companies and Enterprises,2008,375,20,10,15,45,100,85,230,145,415,20,10,15,45,100,85,230,185,16542,0,0,40,10,1490,2104,3750,0,1223417000,0,0,2760000,11585000,80985000,104485000,200105000,6688000
Vermont,Manufacturing,2008,5152,2220,960,595,3775,825,288,4888,264,5365,2220,960,600,3780,865,375,5020,345,108912,2449,3376,4842,14076,26155,12550,70180,20534,4762260000,102360000,133720000,174958000,494103000,1101210000,545060000,3064771000,987253000
Vermont,"Mining, Quarrying, and Oil and Gas Extraction",2008,231,150,20,10,180,20,10,210,21,255,150,20,10,180,40,10,230,25,137,128,0,0,324,622,0,1090,0,6159000,10332000,3420000,0,23130000,28370000,0,52515000,0
Vermont,Other,2008,30,27,2,1,30,0,0,30,0,30,27,2,1,30,0,0,30,0,53,0,0,0,53,0,0,53,0,1157000,547000,0,0,1157000,0,0,1157000,0
Vermont,Other Services (except Public Administration),2008,9894,6710,2025,605,9340,356,78,9774,120,10295,6715,2045,655,9415,520,150,10085,210,44469,11808,12586,7124,32317,7382,0,43250,287,1108995000,292524000,292475000,173051000,772098000,223844000,24766000,1066687000,19079000
Vermont,"Professional, Scientific, and Technical Services",2008,10504,7295,1600,815,9710,395,115,10220,284,10745,7295,1610,820,9725,500,135,10360,385,93930,10683,10126,9203,30154,11559,4983,51579,28783,4820318000,500238000,462794000,508239000,1519824000,701358000,326821000,2766059000,1660873000
Vermont,Real Estate and Rental and Leasing,2008,3486,2630,350,195,3175,140,15,3330,156,3925,2635,350,200,3185,315,25,3525,400,15505,3774,1964,2177,8502,2929,0,12667,1690,465050000,130080000,64997000,53705000,261147000,98558000,0,386467000,55010000
Vermont,Retail Trade,2008,14484,6560,3178,2104,11842,1366,310,13518,966,18670,6570,3195,2290,12055,1825,1120,15000,3670,196932,9972,19077,22940,54561,32278,15541,106115,38289,4703063000,288063000,422543000,608576000,1365890000,1034402000,471230000,3048042000,787769000
Vermont,Total,2008,19282,11407,3343,1954,16704,1550,362,18616,666,22121,11413,3364,2052,16829,2059,1052,19940,2181,272488,18885,21862,25816,66563,54183,43781,164527,107961,9467118000,655702000,638837000,780617000,2075156000,1840199000,1581870000,5497225000,3969893000
Vermont,Transportation and Warehousing,2008,2349,1405,275,155,1835,258,70,2163,186,2650,1405,275,155,1835,275,115,2225,425,28013,1715,1280,1177,5214,5671,700,14656,4061,922282000,67613000,39251000,49609000,182063000,239969000,21223000,534248000,152860000
Vermont,Utilities,2008,118,35,10,15,60,5,28,93,25,260,35,10,15,60,10,85,155,105,8694,18,0,0,100,0,2607,3756,0,804597000,1203000,0,0,16651000,0,204439000,293550000,0
Vermont,Wholesale Trade,2008,3910,1710,553,420,2683,505,263,3451,459,4255,1710,555,425,2690,620,345,3655,600,50148,1727,2258,3722,9958,10637,8312,36221,8574,2364793000,108526000,90892000,169685000,449034000,494473000,381021000,1705260000,496882000
Virginia,Accommodation and Food Services,2008,58007,22155,11300,11247,44702,10527,1435,56664,1343,79910,22195,11320,11360,44875,11710,5490,62075,17835,1560093,36334,74845,151824,263561,372259,208612,845668,712748,22660890000,865995000,1014992000,1946923000,3832365000,5266243000,2678204000,11793875000,10846328000
Virginia,Administrative and Support and Waste Management and Remediation Services,2008,46328,26425,7162,4540,38127,4480,1665,44272,2056,53145,26460,7180,4580,38220,4935,2430,45585,7560,1266873,40566,46327,59649,150069,160695,213537,532678,723455,45412938000,1434603000,1347270000,1960050000,4773212000,5328563000,5941108000,16295963000,28709974000
Virginia,"Agriculture, Forestry, Fishing and Hunting",2008,3343,2310,715,190,3215,70,25,3310,33,3360,2310,715,190,3215,70,40,3325,35,19808,3438,4529,2193,10579,1089,0,15523,829,780310000,111780000,133770000,62607000,318653000,54987000,0,491376000,56624000
Virginia,"Arts, Entertainment, and Recreation",2008,12868,7393,1665,1460,10518,1703,369,12590,278,13845,7395,1665,1470,10530,1775,525,12830,1015,231553,7861,9847,18829,39060,67623,41638,155488,65911,5093822000,365883000,207492000,372339000,970466000,1161167000,1057739000,3551842000,1163142000
Virginia,Construction,2008,117883,74700,20505,11540,106745,9136,1344,117225,658,119120,74700,20510,11545,106755,9295,1670,117720,1400,1097760,129001,133990,155172,420590,342740,196547,967530,123630,46697725000,4184195000,4334585000,6005200000,14529270000,14826790000,9382069000,39012030000,7471921000
Virginia,Educational Services,2008,11489,5702,1735,1370,8807,1810,513,11130,359,12550,5705,1740,1410,8855,1945,650,11450,1100,329380,8710,10999,17569,38300,74038,79104,194256,127059,9917868000,301947000,236817000,358876000,907997000,2036880000,2746958000,5724320000,3926330000
Virginia,Finance and Insurance,2008,31214,20718,4100,1780,26598,1679,1027,29304,1910,61445,20795,4295,2130,27220,3550,5105,35875,25570,783577,34009,24274,21908,80687,50444,75939,221873,533945,50814417000,1463619000,1166050000,1512134000,4177360000,2887373000,4715120000,12309423000,36681828000
Virginia,Health Care and Social Assistance,2008,70123,31103,16890,10132,58125,8349,1994,68468,1655,88090,31165,17025,10835,59025,11570,6260,76855,11235,1897505,57896,112115,135018,307486,306130,302711,922221,945509,81311055000,2950496000,4754449000,6139090000,13840256000,12672304000,10396862000,37517656000,42841819000
Virginia,Information,2008,10133,4620,1375,1060,7055,1358,628,9041,1092,19855,4635,1390,1080,7105,1545,935,9585,10270,481115,5027,7654,13054,27360,46526,49671,131758,354351,35576959000,423697000,466639000,747630000,1685613000,3096780000,3101139000,8313113000,27448154000
Virginia,Management of Companies and Enterprises,2008,4078,260,90,125,475,690,1202,2367,1711,5960,260,90,125,475,700,1290,2465,3495,285438,360,328,895,1593,7769,31139,40655,245147,24451710000,39405000,27302000,71260000,137967000,476766000,2182247000,2804755000,21684008000
Virginia,Manufacturing,2008,26571,9610,4560,3560,17730,4547,1828,24105,2466,28495,9610,4560,3565,17735,4840,2160,24735,3760,1138026,15250,26090,41884,90778,156185,156907,457462,577256,50594391000,616791000,868383000,1504361000,3224563000,6260227000,6472119000,17825915000,27189113000
Virginia,"Mining, Quarrying, and Oil and Gas Extraction",2008,1071,305,135,140,580,213,115,908,163,1575,305,135,140,580,240,215,1035,540,51446,235,728,1714,2915,7345,9705,23211,25324,2985212000,43638000,50054000,101837000,207886000,363730000,491828000,1168975000,1654310000
Virginia,Other,2008,259,240,14,4,258,1,0,259,0,259,240,14,4,258,1,0,259,0,0,0,89,0,0,0,0,0,0,6575000,4764000,1283000,0,6557000,0,0,6575000,0
Virginia,Other Services (except Public Administration),2008,98179,58910,20577,10383,89870,6637,902,97409,770,106585,58930,20690,10755,90375,8090,2440,100905,5680,828299,111295,133853,135063,382422,232133,85890,707625,99174,26010475000,2773880000,3236526000,3866213000,9885385000,7583497000,3914106000,21604730000,3578452000
Virginia,"Professional, Scientific, and Technical Services",2008,123015,83735,15005,9297,108037,8691,3286,120014,3001,137695,83740,15030,9515,108285,10150,5060,123495,14200,1961204,103012,98597,122389,339560,305936,345305,1005965,913731,153199459000,7348837000,5687419000,7955718000,21040135000,22206871000,26693614000,70398174000,80009087000
Virginia,Real Estate and Rental and Leasing,2008,34084,25405,3618,1836,30859,1572,733,33164,920,45695,25495,3725,2095,31315,2975,2770,37060,8635,277125,36129,22757,22420,83182,44931,48519,184641,87632,11824083000,1339228000,808942000,869784000,3042835000,1995266000,2307679000,7597770000,4015730000
Virginia,Retail Trade,2008,86855,46261,18303,10119,74683,7097,2070,83850,3005,144360,46385,18655,11235,76275,10740,6685,93700,50660,2022034,75054,116297,128030,324712,232553,144448,734199,1205906,48005794000,1944379000,2537361000,3062046000,7571309000,6898207000,4924703000,20122693000,27222580000
Virginia,Total,2008,154808,89745,26994,16736,133475,14385,3645,151505,3303,197716,89854,27259,17499,134612,18172,9654,162438,35278,3184234,153742,177798,223062,554602,526659,463935,1545196,1639038,138926921000,5762146000,5809512000,7973845000,19545503000,20561834000,20239389000,60346726000,78580195000
Virginia,Transportation and Warehousing,2008,22040,13065,2877,1845,17787,1848,813,20448,1592,25585,13065,2890,1885,17840,2030,1135,21005,4580,474345,18037,17613,22464,61367,56535,51937,176487,290519,18631321000,594257000,562489000,789105000,1969022000,2105645000,1951490000,6176880000,12121382000
Virginia,Utilities,2008,530,180,35,15,230,62,65,357,173,1720,180,35,15,230,65,200,495,1225,74406,134,0,0,310,1830,6998,9371,32565,6964890000,11420000,5985000,0,22974000,105359000,444106000,577984000,6350091000
Virginia,Wholesale Trade,2008,30861,14740,4459,3438,22637,3805,1812,28254,2607,38295,14740,4575,3545,22860,4630,3210,30700,7595,560379,22010,27210,40272,95777,116032,94180,321942,221070,30600014000,1319425000,1335875000,2018284000,4840535000,5643439000,5049741000,16062077000,14102519000
Washington,Accommodation and Food Services,2008,64281,25780,14085,12679,52544,9614,1240,63398,883,80400,25885,14145,12985,53015,11575,4205,68795,11605,1220340,41190,90917,168558,300987,332758,154825,788576,409465,19712475000,888210000,1125806000,2322847000,4307360000,5260775000,2593367000,12248360000,7446284000
Washington,Administrative and Support and Waste Management and Remediation Services,2008,41157,25450,6540,3780,35770,3132,868,39770,1387,45645,25455,6550,3865,35870,3340,1160,40370,5275,784806,38136,42242,47313,131385,109150,99677,354064,406599,28282570000,1284226000,1177153000,1531512000,4042475000,3472272000,2855793000,10786838000,16670717000
Washington,"Agriculture, Forestry, Fishing and Hunting",2008,7395,5385,800,560,6745,429,145,7319,76,7530,5385,800,560,6745,445,190,7380,150,70731,5268,4902,7100,18397,13401,16661,51814,12215,2850521000,399644000,186589000,299697000,892402000,588434000,581595000,2180495000,393697000
Washington,"Arts, Entertainment, and Recreation",2008,12714,7010,1930,1320,10260,1616,594,12470,244,13560,7010,1940,1325,10275,1670,810,12755,805,298376,7094,11341,17000,37339,64416,89382,202229,73005,7794961000,425844000,276805000,343349000,1070644000,1133657000,1851833000,4327288000,2363705000
Washington,Construction,2008,124239,84125,19683,10829,114637,7988,1012,123637,602,124995,84125,19690,10830,114645,8165,1165,123975,1020,992795,135195,128535,144150,410045,297760,140324,856215,116030,50043715000,4764605000,4558122000,5972925000,15297740000,15383423000,8795699000,39939215000,9347877000
Washington,Educational Services,2008,10923,5565,1785,1398,8748,1543,360,10651,272,11620,5575,1785,1435,8795,1725,480,11000,620,248745,7575,11442,18458,38537,58820,35881,139488,106021,6244879000,257685000,236458000,397988000,902280000,1521871000,1037355000,3635356000,2497923000
Washington,Finance and Insurance,2008,28607,19278,3540,1458,24276,1583,976,26835,1772,54830,19425,3660,1685,24770,2815,5175,32760,22070,526364,31776,21623,16539,71053,51151,76053,207094,315004,35753752000,1350083000,1109560000,1146946000,3676130000,3276410000,4342294000,11449376000,23683331000
Washington,Health Care and Social Assistance,2008,78408,40350,18207,9470,68027,6635,2265,76927,1481,92635,40375,18310,9830,68515,9280,6215,84010,8625,1758549,70654,119760,121261,315192,247918,321410,888644,845968,75803008000,2801038000,4516676000,4882347000,12182739000,8879068000,11919682000,33540302000,41577709000
Washington,Information,2008,10179,4980,1237,1135,7352,1213,574,9139,1040,16500,4980,1250,1145,7375,1350,765,9490,7010,587293,5238,6065,15132,27714,40468,43350,121542,259251,59202825000,395709000,328058000,737436000,1479543000,2655569000,3667183000,8266177000,21743041000
Washington,Management of Companies and Enterprises,2008,3736,380,96,175,651,665,1061,2377,1359,4890,380,100,175,655,675,1120,2450,2440,307193,360,0,173,1693,7464,30994,40807,267299,29085752000,57373000,32927000,14755000,323219000,487912000,1942735000,2753866000,26415488000
Washington,Manufacturing,2008,36332,15084,6240,5040,26364,5944,1854,34162,2170,37805,15085,6245,5055,26385,6100,2145,34630,3175,1068722,22180,37119,59433,126729,217419,195145,583823,347064,53377753000,1001851000,1283523000,2416256000,5004801000,9303870000,9483611000,25753090000,20067599000
Washington,"Mining, Quarrying, and Oil and Gas Extraction",2008,806,310,135,125,570,87,66,723,83,960,310,135,135,580,105,95,780,180,14075,393,667,1369,2590,2087,2041,8214,3657,931868000,35147000,31526000,49275000,137371000,115935000,142009000,450644000,313598000
Washington,Other,2008,339,320,18,0,338,1,0,339,0,339,320,18,0,338,1,0,339,0,0,0,107,0,0,0,0,0,0,7942000,5689000,1910000,0,7599000,0,0,7942000,0
Washington,Other Services (except Public Administration),2008,74337,46055,15048,7531,68634,4393,697,73724,613,81900,46090,15140,7795,69025,6345,1910,77280,4620,556794,83068,96769,95014,277452,143359,51263,484380,42151,14809313000,2072080000,2257260000,2401689000,6746791000,3850220000,1515860000,12411376000,1424690000
Washington,"Professional, Scientific, and Technical Services",2008,93885,66110,11948,7025,85083,5129,1614,91826,2059,98295,66115,11985,7175,85275,5750,2415,93440,4855,817192,86446,77225,91423,265149,163705,114141,550887,248019,55378796000,4917510000,3884546000,5208302000,14061570000,11612502000,8145133000,34158562000,20458386000
Washington,Real Estate and Rental and Leasing,2008,40125,30983,4458,1921,37362,1502,590,39454,671,49965,31035,4560,2330,37925,2525,2330,42780,7185,252562,45732,28065,23237,98757,42779,33296,183470,57214,9334247000,1421318000,874732000,867653000,3184517000,1601015000,1274170000,6388059000,2490148000
Washington,Retail Trade,2008,76949,40100,16099,9314,65513,7477,1695,74685,2264,112405,40155,16325,10225,66705,11490,6025,84220,28185,1618354,62156,99200,115638,275748,261771,132675,700020,825310,42521253000,1676229000,2278754000,3014127000,6927269000,8130285000,4783048000,20308926000,21597708000
Washington,Total,2008,150991,90291,26182,15902,132375,12691,3112,148178,2813,182207,90403,26407,16636,133446,16393,8321,158160,24047,2536645,149792,172440,210926,533158,463798,373444,1370400,1166245,115284564000,5301084000,5418725000,7245845000,17965654000,17821733000,15978631000,51766018000,63518546000
Washington,Transportation and Warehousing,2008,21816,12310,2880,2027,17217,1939,1005,20161,1655,25370,12310,2920,2090,17320,2260,1610,21190,4180,432454,15568,18543,24391,60143,58206,51356,176827,237299,19055152000,700083000,663317000,926683000,2337075000,2203617000,2318549000,7104088000,11042481000
Washington,Utilities,2008,975,585,150,70,805,55,34,894,81,1450,585,155,70,810,100,80,990,460,17956,1052,866,763,2750,1089,0,4097,192,1791863000,18615000,28678000,35535000,98372000,133242000,0,196313000,18360000
Washington,Wholesale Trade,2008,40601,20097,6176,4191,30464,4978,2189,37631,2970,48585,20135,6250,4470,30855,6245,3710,40810,7775,682238,29017,37996,49427,121640,146314,126952,408510,241404,38374608000,1761745000,1836883000,2558745000,6248844000,7669975000,6170348000,20588054000,16645653000
West Virginia,Accommodation and Food Services,2008,13536,5330,2570,2458,10358,2171,577,13106,430,18245,5345,2575,2575,10495,2775,2070,15340,2905,310953,9018,17173,32777,59793,76292,62632,200009,110636,3711556000,149937000,174675000,343391000,669712000,888834000,693789000,2260952000,1447570000
West Virginia,Administrative and Support and Waste Management and Remediation Services,2008,6490,3350,1106,750,5206,560,180,5946,544,7255,3350,1110,755,5215,615,210,6040,1215,146330,4508,6332,8034,20628,20530,20465,66077,68886,3670653000,140735000,167777000,251433000,589710000,578311000,495823000,1761442000,1576731000
West Virginia,"Agriculture, Forestry, Fishing and Hunting",2008,1415,1085,230,65,1380,10,10,1400,15,1425,1085,230,65,1380,10,15,1405,20,4814,2154,1341,753,4441,0,0,4751,21,104714000,42218000,23558000,23458000,93798000,0,0,100353000,1687000
West Virginia,"Arts, Entertainment, and Recreation",2008,3224,1670,665,445,2780,316,59,3155,69,3405,1670,670,475,2815,435,70,3320,85,56907,2410,3143,5564,12629,9341,5366,29945,26098,1064437000,65298000,60489000,113031000,244805000,145201000,43891000,464146000,590384000
West Virginia,Construction,2008,20390,13100,3760,1880,18740,1244,255,20239,151,20490,13100,3760,1880,18740,1260,295,20295,195,157045,19264,23100,23466,69595,44223,23094,142105,9506,6377313000,602901000,583016000,838187000,2061755000,2069227000,1309698000,5671801000,444425000
West Virginia,Educational Services,2008,1333,590,265,125,980,223,75,1278,55,1385,590,265,125,980,235,90,1305,80,35783,743,1833,1334,4535,5898,11120,24204,12988,753858000,18908000,25312000,27313000,78102000,107362000,231900000,454924000,221014000
West Virginia,Finance and Insurance,2008,5942,3498,875,399,4772,422,161,5355,587,10925,3510,895,550,4955,1150,720,6825,4100,100069,6663,5277,4660,17022,15531,10109,44893,25607,3879145000,200676000,170517000,195212000,578339000,531992000,337252000,1539234000,2146410000
West Virginia,Health Care and Social Assistance,2008,18196,7035,4780,2626,14441,2144,971,17556,640,24455,7035,4795,2725,14555,3085,2780,20420,4035,576938,14555,30565,33655,79891,80947,122910,289826,282244,20661685000,518244000,961610000,1184558000,2687088000,2636697000,3192339000,8569319000,11797802000
West Virginia,Information,2008,1505,525,230,220,975,169,104,1248,257,3450,525,230,220,975,245,195,1415,2035,53151,493,1129,2106,4513,4029,4688,18252,34606,2067229000,25660000,30286000,48477000,113843000,142707000,157551000,531399000,1523455000
West Virginia,Management of Companies and Enterprises,2008,811,60,10,20,90,175,260,525,286,1020,60,10,20,90,175,270,535,485,20296,11,0,0,244,2106,4606,6956,13337,1370310000,2593000,0,0,11722000,90670000,316236000,419055000,950532000
West Virginia,Manufacturing,2008,6493,1940,1095,1040,4075,1241,456,5772,721,6945,1940,1095,1040,4075,1345,575,5995,950,227630,1973,5230,9966,21345,36239,19093,94189,112486,10136861000,77927000,157370000,284001000,605654000,1285999000,933767000,3484007000,5698383000
West Virginia,"Mining, Quarrying, and Oil and Gas Extraction",2008,2651,1065,365,350,1780,441,220,2441,210,3470,1065,375,350,1790,465,275,2530,940,142431,1823,2298,3031,8746,16981,27929,53659,88989,9990589000,88925000,83234000,208093000,394549000,938227000,1844938000,3179916000,6809854000
West Virginia,Other,2008,28,26,1,1,28,0,0,28,0,28,26,1,1,28,0,0,28,0,0,0,0,0,0,0,0,0,0,606000,479000,0,0,606000,0,0,606000,0
West Virginia,Other Services (except Public Administration),2008,21939,13985,4676,1885,20546,939,189,21674,265,23425,13985,4730,1955,20670,1310,275,22255,1170,131390,25376,28647,24120,79787,27904,7437,121480,4962,2737220000,443684000,508882000,471602000,1440357000,610894000,242448000,2432965000,202361000
West Virginia,"Professional, Scientific, and Technical Services",2008,13515,8280,2395,1115,11790,889,332,13011,504,14600,8280,2405,1165,11850,1135,595,13580,1020,129759,14119,14793,14046,43474,26968,14070,90231,30723,4759950000,473510000,510825000,573219000,1577968000,1225598000,650570000,3586973000,1067320000
West Virginia,Real Estate and Rental and Leasing,2008,6203,4475,825,310,5610,227,73,5910,293,7510,4495,865,355,5715,330,290,6335,1175,32306,7766,4632,3481,16465,5240,637,24461,5930,856645000,191640000,115769000,93280000,415913000,122113000,13371000,599515000,217491000
West Virginia,Retail Trade,2008,21624,10239,4566,2846,17651,2265,456,20372,1252,34230,10380,4670,3085,18135,3395,1695,23225,11005,383082,16711,27245,31966,79487,71984,27518,181561,162751,7671994000,360741000,536984000,783095000,1736543000,1695668000,600247000,4164245000,2941315000
West Virginia,Total,2008,30873,16410,6037,3601,26048,2863,786,29697,1176,39641,16455,6111,3796,26362,3968,2235,32565,7076,592022,30858,39435,47501,117794,104424,89888,312106,279916,19168311000,762070000,925803000,1262387000,2950260000,3153727000,2826932000,8930919000,10237392000
West Virginia,Transportation and Warehousing,2008,6003,3420,759,655,4834,559,134,5527,476,6785,3420,760,660,4840,575,175,5590,1195,72014,5324,4329,7549,18277,16021,2136,40794,14909,2657302000,169509000,128588000,229910000,540085000,575717000,67655000,1318700000,615734000
West Virginia,Utilities,2008,335,110,55,45,210,30,15,255,80,1165,110,55,45,210,80,15,305,860,27371,0,132,0,0,617,0,172,21036,1986455000,1970000,4495000,11404000,21455000,21257000,0,8046000,1641194000
West Virginia,Wholesale Trade,2008,6483,2195,1034,865,4094,981,399,5474,1009,7880,2200,1055,930,4185,1220,565,5970,1910,95923,3498,5332,9019,19326,21473,10680,60780,25815,4360697000,147254000,187005000,290746000,700165000,912704000,488116000,2431396000,1473822000
Wisconsin,Accommodation and Food Services,2008,59582,24508,11328,11000,46836,10803,1099,58738,844,71255,24590,11350,11130,47070,12465,3555,63090,8165,1136195,39725,74552,149659,265360,387896,147460,802590,250266,13321530000,775733000,740374000,1423820000,2944215000,4254940000,1784214000,8996840000,4289979000
Wisconsin,Administrative and Support and Waste Management and Remediation Services,2008,29543,17630,4350,2915,24895,2469,884,28248,1295,34800,17635,4380,2935,24950,2795,1480,29225,5575,695123,24511,27272,37571,91761,85615,121438,310612,348744,17570886000,931878000,805748000,1129263000,2912268000,2348302000,2619203000,8191831000,8163801000
Wisconsin,"Agriculture, Forestry, Fishing and Hunting",2008,2513,1955,325,100,2380,65,35,2480,33,2545,1955,325,100,2380,65,50,2495,50,15995,2814,2102,543,6189,1175,0,11486,1773,642867000,77072000,55515000,25121000,172172000,33360000,12693000,429152000,85181000
Wisconsin,"Arts, Entertainment, and Recreation",2008,13258,7720,1962,1530,11212,1588,284,13084,174,13710,7720,1970,1550,11240,1730,335,13305,405,202852,8763,12299,19770,44363,57633,43322,151515,36546,5150510000,389555000,253733000,304424000,968056000,974666000,2133332000,4209609000,530477000
Wisconsin,Construction,2008,78701,54710,12545,6160,73415,4395,486,78296,405,79530,54715,12545,6180,73440,4580,700,78720,810,560855,85294,81300,80416,248908,156857,59214,477940,78352,29968165000,3465623000,3244689000,3791856000,10505066000,8889296000,4041618000,24434925000,5198550000
Wisconsin,Educational Services,2008,6958,2805,1185,1000,4990,1455,220,6665,293,7420,2805,1185,1015,5005,1575,280,6860,560,259057,3557,7507,12624,25501,56074,25438,108158,146943,7490740000,112283000,141271000,223407000,482070000,1223009000,679273000,2480988000,5003300000
Wisconsin,Finance and Insurance,2008,25753,16540,3224,1440,21204,2184,907,24295,1458,48470,16585,3325,1710,21620,5365,4845,31830,16640,731038,25920,19203,18101,65818,75554,97539,246177,469438,42680446000,1078892000,834008000,872525000,2801325000,3459173000,4872295000,11855314000,30679551000
Wisconsin,Health Care and Social Assistance,2008,51685,22147,11490,7563,41200,6354,2426,49980,1705,72285,22185,11685,8010,41880,9520,7315,58715,13570,1871925,38944,75696,99971,218015,239291,350525,812892,1036732,73395812000,2185990000,2838056000,3862176000,8905851000,9174745000,9705770000,27939392000,44448199000
Wisconsin,Information,2008,5756,2295,850,690,3835,877,324,5036,720,11425,2295,850,715,3860,1225,590,5675,5750,267530,3249,4532,8983,17945,29551,22305,76492,185516,13484399000,149246000,176668000,354681000,706735000,1146759000,1084607000,3174922000,10299163000
Wisconsin,Management of Companies and Enterprises,2008,3471,255,75,130,460,660,1053,2173,1298,5375,255,75,130,460,670,1125,2255,3120,323625,396,405,612,1510,7700,31415,40680,282811,26466310000,34184000,21030000,37174000,95555000,391936000,1773710000,2263395000,24193733000
Wisconsin,Manufacturing,2008,44167,13362,7194,6699,27255,9585,3812,40652,3515,47915,13370,7200,6740,27310,10025,4870,42205,5710,2310538,19939,43814,83094,157609,378814,482912,1079648,1122782,106576444000,857850000,1458718000,3187171000,5757342000,15689349000,20982722000,44838754000,56798237000
Wisconsin,"Mining, Quarrying, and Oil and Gas Extraction",2008,674,290,110,85,485,95,42,622,52,780,290,110,85,485,110,105,700,80,12007,278,663,925,1986,1767,2188,7209,1552,823071000,22921000,35465000,61330000,132890000,134541000,119703000,440283000,132526000
Wisconsin,Other,2008,259,253,5,1,259,0,0,259,0,259,253,5,1,259,0,0,259,0,0,0,36,0,0,0,0,0,0,3552000,2999000,473000,0,3552000,0,0,3552000,0
Wisconsin,Other Services (except Public Administration),2008,69700,40175,15565,8209,63949,4562,590,69101,599,75115,40210,15705,8490,64405,6130,1410,71945,3170,551677,74292,101091,103862,284064,150949,43954,488910,57714,12522024000,1702388000,1997791000,2079667000,5826134000,3378425000,1124866000,10614006000,1760872000
Wisconsin,"Professional, Scientific, and Technical Services",2008,53369,34500,8280,4817,47597,3633,880,52110,1259,56610,34515,8345,4975,47835,4325,1495,53655,2955,513094,44593,53303,62390,165763,121216,65437,364623,125930,26949527000,2182511000,2254452000,2950646000,7465427000,6545641000,4384707000,18689908000,7870892000
Wisconsin,Real Estate and Rental and Leasing,2008,19667,14210,2585,1245,18040,860,380,19280,387,24270,14230,2630,1325,18185,1335,1825,21345,2925,131021,16608,15868,14595,52490,24788,13460,99025,26148,3955362000,604926000,423378000,461227000,1530878000,762311000,594343000,3068161000,750949000
Wisconsin,Retail Trade,2008,69561,33575,14914,9357,57846,7571,1807,67224,2337,102710,33705,15280,10390,59375,10890,6565,76830,25880,1515691,57466,95706,120891,278652,256321,158443,714925,754123,33304262000,1343336000,1978293000,2692908000,6069532000,6698845000,3985013000,16984564000,15694602000
Wisconsin,Total,2008,115003,63062,20709,13744,97515,12251,2792,112558,2445,144081,63162,20948,14406,98516,16213,8206,122935,21146,2496850,106472,136595,184151,427218,463166,403976,1294360,1202490,95115917000,3592385000,3890308000,5462001000,12944694000,15318982000,14934812000,43198488000,51917429000
Wisconsin,Transportation and Warehousing,2008,24380,14120,3210,2422,19752,2455,840,23047,1333,27495,14125,3210,2470,19805,2735,1220,23760,3735,515072,13242,20396,30327,72701,82714,70459,230550,275884,18419911000,712591000,648894000,980502000,2385111000,2806461000,2312457000,7598509000,10611183000
Wisconsin,Utilities,2008,362,70,25,25,120,125,15,260,102,1430,70,25,30,125,180,25,330,1100,70867,42,127,0,490,4313,0,5874,64531,5814753000,1792000,4835000,20546000,28688000,226196000,0,304725000,5502352000
Wisconsin,Wholesale Trade,2008,30071,13255,4455,3856,21566,4388,1860,27814,2257,35970,13290,4520,4045,21855,5345,3240,30440,5530,570869,19223,26426,45863,97199,138399,122909,375913,165060,28866412000,1087940000,1225461000,2277761000,4692072000,6598359000,5742001000,17573091000,9505138000
Wyoming,Accommodation and Food Services,2008,7612,2685,1565,1460,5710,1438,271,7419,193,8660,2685,1570,1475,5730,1690,680,8100,560,143958,2729,10245,19141,33334,50582,35554,119862,12296,2344260000,124700000,128218000,249004000,505215000,718541000,589062000,1818170000,409234000
Wyoming,Administrative and Support and Waste Management and Remediation Services,2008,4409,2855,745,328,3928,185,55,4168,241,4670,2855,760,340,3955,215,55,4225,445,30226,2753,3538,3183,12067,3827,0,17196,7220,931506000,148796000,127800000,87316000,398866000,96476000,0,535433000,331770000
Wyoming,"Agriculture, Forestry, Fishing and Hunting",2008,400,320,45,20,385,5,0,390,10,400,320,45,20,385,5,0,390,10,333,125,96,0,333,0,0,333,0,32148000,11347000,6651000,2057000,28096000,0,0,30104000,0
Wyoming,"Arts, Entertainment, and Recreation",2008,2110,1480,230,175,1885,185,25,2095,15,2160,1480,230,175,1885,215,35,2135,25,17929,1701,961,1412,5339,6045,0,13794,0,361910000,78226000,21397000,21701000,140053000,120281000,0,315181000,0
Wyoming,Construction,2008,15371,9975,2880,1390,14245,907,129,15281,90,15405,9975,2880,1390,14245,915,145,15305,100,116614,14266,18409,17353,53064,28953,12235,98904,1001,5353719000,640204000,650090000,767152000,2093420000,1592770000,790801000,4629699000,333528000
Wyoming,Educational Services,2008,807,475,100,102,677,70,25,772,35,850,475,100,105,680,70,60,810,40,8495,76,555,1007,2043,2472,814,7194,0,225297000,19789000,5153000,20665000,53409000,54620000,27836000,184006000,0
Wyoming,Finance and Insurance,2008,3131,2030,295,160,2485,258,74,2817,314,5115,2040,310,190,2540,745,200,3485,1630,37707,3033,1650,1723,6794,8482,2854,19487,17060,1702065000,119844000,63807000,54612000,252690000,375092000,110257000,805979000,840110000
Wyoming,Health Care and Social Assistance,2008,7950,3972,1683,1082,6737,707,276,7720,230,8675,3985,1685,1095,6765,965,515,8245,430,144826,6183,10133,12881,31344,22496,37701,99311,39883,5780762000,367994000,392335000,529527000,1319564000,836298000,1605130000,3929841000,1709418000
Wyoming,Information,2008,1091,395,155,140,690,202,80,972,119,1620,395,160,150,705,280,150,1135,485,18881,320,479,1115,2562,5628,1170,13542,4479,672463000,18550000,18336000,30070000,94528000,150257000,50766000,410882000,240120000
Wyoming,Management of Companies and Enterprises,2008,357,45,15,20,80,75,85,240,117,425,45,15,20,80,75,90,245,180,5478,0,0,0,275,596,1694,2587,2887,410175000,3631000,0,0,17920000,35685000,128367000,186061000,221075000
Wyoming,Manufacturing,2008,2879,1395,455,335,2185,365,127,2677,202,2955,1395,455,340,2190,380,155,2725,230,40107,1243,1618,1983,6339,7943,2060,24161,12461,2216903000,59026000,44596000,91889000,241163000,353691000,101285000,1099039000,909926000
Wyoming,"Mining, Quarrying, and Oil and Gas Extraction",2008,3824,1770,665,451,2886,421,123,3430,394,4360,1770,665,460,2895,430,175,3500,860,125168,2511,4429,5264,12077,12251,7340,34396,89536,9598565000,172884000,234985000,369561000,788011000,830521000,536278000,2394394000,7157533000
Wyoming,Other,2008,47,45,1,1,47,0,0,47,0,47,45,1,1,47,0,0,47,0,59,37,0,0,59,0,0,59,0,1524000,1193000,0,0,1524000,0,0,1524000,0
Wyoming,Other Services (except Public Administration),2008,8851,5760,1810,755,8325,290,100,8715,136,9150,5760,1810,825,8395,345,115,8855,295,42932,10087,11027,8744,31365,5607,764,39905,1290,1191318000,289413000,258637000,241705000,814374000,131753000,41769000,1075765000,66700000
Wyoming,"Professional, Scientific, and Technical Services",2008,9449,6760,1340,645,8745,370,125,9240,209,9740,6760,1345,665,8770,445,180,9395,345,44493,7839,8255,8056,26644,8606,2560,41739,2590,2105200000,422561000,348176000,376539000,1179235000,456211000,149203000,1978147000,103358000
Wyoming,Real Estate and Rental and Leasing,2008,5005,3890,505,195,4590,155,76,4821,184,5610,3890,505,195,4590,235,245,5070,540,22047,1461,2675,2115,10975,2548,636,16059,4983,845444000,168660000,81562000,75713000,340538000,81104000,31570000,498473000,318117000
Wyoming,Retail Trade,2008,11173,5257,2395,1429,9081,1059,376,10516,657,14310,5260,2410,1565,9235,1465,865,11565,2745,136610,7214,13936,15577,41833,27946,10563,87531,39059,3438122000,209377000,313745000,431281000,993938000,805093000,384469000,2266657000,957235000
Wyoming,Total,2008,18104,10636,3170,1860,15666,1408,387,17461,643,20785,10647,3192,1949,15788,1866,868,18522,2263,221971,17782,20716,24505,63003,46619,34410,144032,77939,8869219000,639052000,615548000,806284000,2060884000,1687164000,1320140000,5068188000,3801031000
Wyoming,Transportation and Warehousing,2008,4127,2625,555,295,3475,235,87,3797,330,4860,2625,560,300,3485,250,200,3935,925,42370,3270,3251,2304,10708,6553,3942,24337,12530,1909906000,146284000,127995000,100625000,429955000,311283000,141818000,1013049000,646410000
Wyoming,Utilities,2008,216,70,15,15,100,40,20,160,56,575,70,15,25,110,65,55,230,345,11307,0,0,0,58,1473,0,3098,6454,847998000,1557000,1406000,0,1158000,84732000,28784000,177179000,522164000
Wyoming,Wholesale Trade,2008,3251,1205,420,392,2017,443,230,2690,561,4150,1225,435,405,2065,540,420,3025,1125,39579,293,1924,3752,8174,8127,3243,22291,15365,2192011000,85905000,91157000,174708000,402434000,420090000,172745000,1126924000,996491000
