state_name,industry_name,YEAR,firms_01: Total,firms_02: <5,firms_03: 5-9,firms_04: 10-19,firms_05: <20,firms_06: 20-99,firms_07: 100-499,firms_08: <500,firms_09: 500+,establishments_01: Total,establishments_02: <5,establishments_03: 5-9,establishments_04: 10-19,establishments_05: <20,establishments_06: 20-99,establishments_07: 100-499,establishments_08: <500,establishments_09: 500+,employment_01: Total,employment_02: <5,employment_03: 5-9,employment_04: 10-19,employment_05: <20,employment_06: 20-99,employment_07: 100-499,employment_08: <500,employment_09: 500+,annual_payroll_01: Total,annual_payroll_02: <5,annual_payroll_03: 5-9,annual_payroll_04: 10-19,annual_payroll_05: <20,annual_payroll_06: 20-99,annual_payroll_07: 100-499,annual_payroll_08: <500,annual_payroll_09: 500+
Alabama,Accommodation and Food Services,2016,29975,10215,5895,5508,21618,6471,942,29031,944,44095,10235,5925,5580,21740,7505,3820,33065,11030,889174,16821,39664,76301,132971,236093,135582,505211,383336,13269342000,458660000,539022000,1077307000,2077628000,3471944000,1868175000,7427828000,5832799000
Alabama,Administrative and Support and Waste Management and Remediation Services,2016,18756,10140,2843,1825,14808,1876,743,17427,1329,22120,10140,2855,1845,14840,2000,985,17825,4295,754185,17168,18638,23966,60220,70727,93525,229877,518608,21004149000,645266000,578364000,808135000,2053870000,2274174000,2654498000,7192230000,13561978000
Alabama,"Agriculture, Forestry, Fishing and Hunting",2016,3987,2075,1090,475,3640,245,43,3928,59,4070,2075,1090,475,3640,260,60,3960,110,32727,4013,7276,6289,17739,7881,1801,28652,2329,1286122000,168118000,261805000,256807000,692105000,322867000,64779000,1112362000,100857000
Alabama,"Arts, Entertainment, and Recreation",2016,5401,3090,840,600,4530,629,134,5293,108,5730,3090,840,640,4570,645,190,5405,325,89460,4680,5362,7322,17855,23347,15766,61353,19651,1733665000,151604000,111435000,128507000,411693000,429265000,333451000,1279688000,289215000
Alabama,Construction,2016,36510,21015,6590,4302,31907,3564,564,36035,475,37120,21015,6590,4305,31910,3665,635,36210,910,411635,36435,43430,57958,137855,127359,64814,335255,75570,20264250000,1390100000,1583400000,2419773000,5393665000,6314677000,4167321000,16183310000,4024768000
Alabama,Educational Services,2016,4091,1800,630,590,3020,710,175,3905,186,4330,1805,630,605,3040,770,175,3985,345,130862,2882,4192,7907,15157,28648,29045,73205,51781,3763492000,71738000,78177000,132637000,289302000,703594000,874194000,1896655000,1702136000
Alabama,Finance and Insurance,2016,15994,9787,2340,785,12912,1030,626,14568,1426,36535,9790,2400,1020,13210,3115,3575,19900,16635,349965,18664,14540,9988,43520,38149,42416,126256,219293,24517623000,766307000,653756000,540223000,1981882000,2041452000,2644600000,6840544000,17245715000
Alabama,Health Care and Social Assistance,2016,40279,15983,10170,6445,32598,5119,1363,39080,1199,53195,16035,10275,6715,33025,6430,4455,43910,9285,1227730,31845,67332,84971,184393,192148,199984,580499,646501,56167559000,1803035000,2949733000,3865236000,8626208000,8972755000,7452518000,25218837000,30924278000
Alabama,Information,2016,3817,1675,615,366,2656,370,232,3258,559,8290,1725,620,385,2730,475,330,3535,4755,163642,2713,3963,4431,11552,11201,18994,44399,118617,9275224000,118523000,166424000,190873000,495838000,645523000,1042558000,2336372000,6902892000
Alabama,Management of Companies and Enterprises,2016,2294,155,60,35,250,470,620,1340,954,3260,155,60,35,250,475,680,1405,1855,88985,155,305,115,585,4685,13905,19175,69793,8217815000,16710000,18500000,8347000,44015000,270575000,974780000,1289370000,6927401000
Alabama,Manufacturing,2016,18986,6025,3025,2399,11449,3455,1572,16476,2510,20545,6025,3025,2420,11470,3525,1750,16745,3800,1187948,11177,18901,29385,63451,129151,172488,395936,708606,59185327000,422087000,625447000,1124201000,2332384000,5412091000,7481943000,16681187000,38421568000
Alabama,"Mining, Quarrying, and Oil and Gas Extraction",2016,814,225,70,105,400,160,65,625,189,1070,225,70,105,400,180,80,660,410,25832,304,375,985,1979,4146,2726,10521,14745,1755881000,32262000,14888000,48751000,125830000,202441000,169761000,592676000,1125086000
Alabama,Other,2016,184,174,9,0,183,1,0,184,0,184,174,9,0,183,1,0,184,0,306,210,68,0,278,0,0,306,0,5150000,4118000,788000,0,4906000,0,0,5150000,0
Alabama,Other Services (except Public Administration),2016,51151,31490,10736,4609,46835,3321,435,50591,560,55115,31545,10780,4815,47140,4240,910,52290,2825,407593,61136,69186,60234,190819,117085,35575,346643,52022,10583521000,1426756000,1578733000,1452130000,4465923000,2730487000,898789000,8197236000,2054386000
Alabama,"Professional, Scientific, and Technical Services",2016,41812,27375,6020,3573,36968,2557,987,40512,1300,47020,27385,6045,3660,37090,3095,1305,41490,5530,502378,45055,39090,47661,132323,86397,84015,305613,192716,34479032000,2186959000,1934997000,2659576000,6805352000,5914591000,7014767000,19882307000,14493346000
Alabama,Real Estate and Rental and Leasing,2016,15512,11335,1667,806,13808,728,397,14933,579,21080,11360,1770,960,14090,1805,1525,17420,3660,116062,17696,10721,9732,38475,21568,18007,78880,35299,4887551000,666061000,398805000,367600000,1448264000,1030670000,709636000,3230449000,1600639000
Alabama,Retail Trade,2016,55075,30830,11234,5654,47718,4360,949,53027,2048,90485,30915,11430,6325,48670,7680,3175,59525,30960,1113260,60066,73116,73574,207154,151765,76134,439010,664078,28115343000,1444837000,1822093000,2099394000,5373481000,5101412000,2670656000,13247143000,14515624000
Alabama,Total,2016,73976,39880,13721,8281,61882,7539,2017,71438,2538,99584,39961,13871,8709,62541,10200,5402,78143,21441,1673249,71782,90193,110654,272629,278558,238238,789425,883824,68970623000,2600979000,2951991000,3921442000,9474412000,10530784000,10013379000,30018575000,38952048000
Alabama,Transportation and Warehousing,2016,12455,6595,1759,1157,9511,1229,588,11328,1127,14800,6595,1760,1170,9525,1350,805,11680,3120,294076,10715,11107,14957,37422,38957,37373,118057,155512,13098923000,398420000,370509000,553642000,1344628000,1514012000,1576410000,4630473000,7540070000
Alabama,Utilities,2016,561,155,130,25,310,105,37,452,109,1765,155,130,25,310,205,115,630,1135,67174,342,807,325,1512,5311,3040,10492,30558,6172043000,10837000,33287000,12244000,57828000,387814000,232601000,708132000,2906394000
Alabama,Wholesale Trade,2016,20392,8638,2968,2389,13995,2678,1331,18004,2388,26375,8665,3015,2460,14140,3575,2440,20155,6220,362945,15072,19162,29112,64400,75550,73898,219930,136379,20213049000,695839000,908212000,1540056000,3190845000,3930647000,3912342000,11333967000,8511788000
Alaska,Accommodation and Food Services,2016,9230,4385,1893,1349,7627,1200,177,9004,226,10780,4400,1910,1360,7670,1485,770,9925,855,143030,5638,12740,18020,36591,42593,24785,105110,37443,3880105000,320080000,290234000,375894000,990948000,1024892000,599492000,2666780000,1200604000
Alaska,Administrative and Support and Waste Management and Remediation Services,2016,4830,2840,755,455,4050,309,83,4442,388,5640,2840,755,470,4065,380,175,4620,1020,84636,3697,4748,5544,14399,9843,5311,32452,47880,4273716000,188539000,192703000,260723000,658591000,460417000,234698000,1544246000,2503377000
Alaska,"Agriculture, Forestry, Fishing and Hunting",2016,2265,2135,60,20,2215,25,10,2250,15,2375,2135,60,20,2215,30,110,2355,20,3049,1248,307,55,1860,641,0,3014,7,219523000,102980000,14932000,2207000,130591000,47926000,0,217688000,367000
Alaska,"Arts, Entertainment, and Recreation",2016,2695,1890,360,205,2455,200,10,2665,30,2845,1895,365,245,2505,215,25,2745,100,22463,2102,2132,2592,7231,6076,0,15558,1381,538536000,133938000,50149000,65119000,266224000,120326000,0,432601000,21187000
Alaska,Construction,2016,12312,8415,2015,981,11411,579,99,12089,223,12605,8415,2015,990,11420,600,145,12165,440,85110,11775,12784,12308,37460,18284,5256,63935,19889,7484685000,843740000,844798000,1056092000,2796645000,1586180000,552195000,5224310000,2127430000
Alaska,Educational Services,2016,1190,565,225,165,955,140,40,1135,55,1350,565,225,180,970,145,155,1270,80,15245,706,1498,2203,4432,4125,2788,13637,1423,421232000,26589000,28540000,56341000,112654000,95730000,67826000,355976000,52254000
Alaska,Finance and Insurance,2016,2224,1140,365,120,1625,130,108,1863,361,3960,1140,370,125,1635,265,410,2310,1650,37824,1960,2078,1081,5519,3649,6406,18363,16471,2568870000,103957000,104305000,79659000,321924000,210815000,382321000,1140755000,1211849000
Alaska,Health Care and Social Assistance,2016,10696,4955,2380,1600,8935,975,413,10323,373,13165,4970,2380,1635,8985,1330,895,11210,1955,247362,9047,15955,20498,46113,34122,54842,137809,100130,14520623000,640332000,828305000,1366997000,2863663000,1866777000,2704103000,7537445000,6652528000
Alaska,Information,2016,1072,455,170,100,725,120,73,918,154,2040,455,170,100,725,215,220,1160,880,33532,743,874,825,3001,2899,2925,11982,19122,2111464000,31970000,31798000,30225000,117389000,159149000,172760000,541632000,1442140000
Alaska,Management of Companies and Enterprises,2016,685,40,25,20,85,130,186,401,284,965,40,25,20,85,130,215,430,535,37368,35,99,39,180,1475,6058,7713,29655,3852500000,4490000,5177000,4276000,14395000,98000000,400275000,512670000,3339830000
Alaska,Manufacturing,2016,2257,1155,420,240,1815,235,40,2090,167,2660,1155,430,245,1830,255,80,2165,495,60645,1495,1938,2443,7108,4798,4320,18719,39180,2700786000,89494000,75709000,149311000,364919000,238180000,253310000,983820000,1581654000
Alaska,"Mining, Quarrying, and Oil and Gas Extraction",2016,699,300,80,65,445,60,49,554,145,875,300,80,65,445,60,55,560,315,56827,304,433,569,1702,1877,3062,8103,46836,6911926000,35312000,67992000,67727000,222955000,271628000,354282000,1082091000,5644214000
Alaska,Other,2016,40,38,2,0,40,0,0,40,0,40,38,2,0,40,0,0,40,0,51,41,0,0,51,0,0,51,0,1012000,916000,0,0,1012000,0,0,1012000,0
Alaska,Other Services (except Public Administration),2016,8409,5115,1803,825,7743,360,95,8198,211,9115,5125,1820,890,7835,525,370,8730,385,48645,9212,11126,10549,31255,10250,2163,45335,2575,1704777000,299681000,360641000,390946000,1070003000,345945000,91006000,1571313000,108520000
Alaska,"Professional, Scientific, and Technical Services",2016,8754,5710,930,695,7335,507,270,8112,642,9800,5710,940,710,7360,615,365,8340,1460,96889,8798,5773,8611,23742,13367,18507,57271,36994,6885122000,512044000,379584000,608290000,1533490000,1025700000,1143809000,3792048000,2924847000
Alaska,Real Estate and Rental and Leasing,2016,4171,3140,385,215,3740,183,68,3991,180,4665,3145,405,265,3815,280,230,4325,340,22305,4458,2356,2270,9496,4257,1448,18125,3196,1080700000,189739000,102820000,88535000,400947000,201281000,75950000,817801000,206649000
Alaska,Retail Trade,2016,9471,4714,1884,1224,7822,855,176,8853,618,12390,4755,1920,1345,8020,1315,510,9845,2545,174930,7874,11978,14754,35653,22503,10685,72679,75959,5648780000,310946000,345490000,452616000,1139978000,839089000,404147000,2509601000,2278436000
Alaska,Total,2016,17059,10175,2908,1753,14836,1233,339,16408,651,21077,10211,2947,1872,15030,1759,1154,17943,3134,266072,14954,19052,23195,57201,43028,40918,141147,124925,15239195000,845550000,831772000,1158376000,2835698000,2113534000,2175468000,7124700000,8114495000
Alaska,Transportation and Warehousing,2016,4535,2788,475,325,3588,318,217,4123,412,5725,2795,475,330,3600,465,515,4580,1145,79840,3160,2685,3232,10082,8016,12492,35698,37600,5093863000,265556000,127112000,173460000,631442000,481989000,662764000,2086239000,2694139000
Alaska,Utilities,2016,307,85,50,50,185,62,40,287,20,535,85,50,60,195,110,155,460,75,9287,148,228,568,1103,1778,3940,8455,624,868629000,4064000,14601000,19437000,45802000,164504000,398085000,775130000,70732000
Alaska,Wholesale Trade,2016,2685,915,330,272,1517,291,223,2031,654,3695,940,330,305,1575,375,370,2320,1375,44262,1270,1588,2368,6569,5182,5999,21917,19120,2753067000,74853000,88307000,133769000,374685000,299453000,366084000,1284980000,1277401000
Arizona,Accommodation and Food Services,2016,43509,13564,8150,8566,30280,10608,1310,42198,1311,62730,13570,8185,8650,30405,11890,5255,47550,15180,1452480,21607,55344,117780,194770,402101,208621,806010,644899,26795550000,936962000,831523000,1781115000,3550361000,6685637000,3558958000,13816735000,12956857000
Arizona,Administrative and Support and Waste Management and Remediation Services,2016,36297,21100,5220,3428,29748,3312,1155,34215,2082,41850,21105,5255,3450,29810,3485,1340,34635,7215,1353641,32878,34252,44882,112278,125343,152077,391558,939602,46863617000,1288354000,1078960000,1425349000,3805985000,4113634000,4855115000,12847710000,32025191000
Arizona,"Agriculture, Forestry, Fishing and Hunting",2016,1040,705,130,90,925,85,10,1020,20,1060,705,130,90,925,95,10,1030,30,7406,978,748,861,2829,2659,0,6636,608,284232000,42040000,27769000,33758000,114118000,108804000,0,261822000,17314000
Arizona,"Arts, Entertainment, and Recreation",2016,8413,4660,1015,845,6520,1175,414,8109,304,9625,4665,1015,850,6530,1275,675,8480,1145,238268,5982,6435,11254,24247,45850,66596,139667,95177,7994786000,266583000,171702000,252875000,712651000,817894000,2851817000,4456711000,3459008000
Arizona,Construction,2016,58907,34935,10050,6340,51325,5698,1100,58123,784,59605,34935,10050,6350,51335,5720,1280,58335,1270,705964,55430,66385,84845,206785,226735,142793,577321,123955,35186155000,2357585000,2501877000,3605310000,8471565000,10687995000,7537746000,26748846000,8173975000
Arizona,Educational Services,2016,9410,4410,1260,1305,6975,1686,401,9062,348,10725,4415,1260,1330,7005,1835,575,9415,1310,304410,6450,8197,17089,31960,70368,46374,149328,153411,11499699000,259833000,211776000,434897000,912358000,2047764000,1547164000,4538703000,6897677000
Arizona,Finance and Insurance,2016,26235,18804,2685,829,22318,878,790,23986,2249,48030,18820,2695,880,22395,1445,2180,26020,22010,738118,29795,17463,10283,57814,26434,53287,140029,592641,51620533000,1470660000,927825000,750703000,3164792000,2026678000,3850341000,9218429000,42013486000
Arizona,Health Care and Social Assistance,2016,69365,37775,13375,8110,59260,6301,1913,67474,1891,90390,37840,13485,8420,59745,8320,5910,73975,16415,1795679,58913,89337,108060,256551,246316,308368,813864,977105,84783061000,3918395000,3860973000,4592669000,12378317000,10238022000,13041393000,35791596000,48771218000
Arizona,Information,2016,6784,3545,785,525,4855,651,330,5836,948,11360,3550,785,530,4865,785,470,6120,5240,240569,4905,4930,6605,16776,20376,23141,64644,172755,15854494000,349373000,221658000,342561000,932713000,1176465000,1473499000,3844827000,11840964000
Arizona,Management of Companies and Enterprises,2016,3317,365,55,80,500,476,852,1828,1489,4950,365,55,80,500,485,1040,2025,2925,274395,419,290,730,1470,5875,32575,39920,234475,22224720000,147245000,21055000,53010000,223130000,359545000,2063515000,2646190000,19578530000
Arizona,Manufacturing,2016,20430,7930,3545,2885,14360,3393,1159,18912,1518,21455,7930,3555,2890,14375,3510,1345,19230,2225,685391,13863,21745,35589,76075,121952,87049,318620,322327,40696419000,562871000,802664000,1362069000,2922075000,5498664000,3976643000,13854325000,24129634000
Arizona,"Mining, Quarrying, and Oil and Gas Extraction",2016,848,320,135,99,554,133,37,724,124,1115,320,135,100,555,145,45,745,370,54414,491,686,1141,2629,3664,542,8573,45494,3884289000,30462000,33436000,58451000,144532000,211189000,43981000,535990000,3313238000
Arizona,Other,2016,289,273,12,3,288,1,0,289,0,289,273,12,3,288,1,0,289,0,397,264,71,37,372,0,0,397,0,12496000,10388000,1241000,783000,12412000,0,0,12496000,0
Arizona,Other Services (except Public Administration),2016,50579,30850,9775,5194,45819,3296,751,49866,713,56280,30875,9830,5390,46095,4270,2335,52700,3580,446154,54337,63869,69661,188122,115157,68219,374839,60798,13421884000,1597411000,1788628000,1923760000,5317332000,3118817000,2086686000,10648169000,2315777000
Arizona,"Professional, Scientific, and Technical Services",2016,81067,60295,8567,4648,73510,3996,1370,78876,2191,88070,60295,8600,4715,73610,4555,2045,80210,7860,741335,80720,55614,60023,196955,127939,84003,411930,322213,52667710000,4797495000,3018430000,3543934000,11394015000,8448918000,5628401000,25711570000,26415449000
Arizona,Real Estate and Rental and Leasing,2016,37256,30310,2973,1318,34601,1127,574,36302,954,46400,30340,3040,1450,34830,1785,1860,38475,7925,233045,35245,18833,16693,70950,34061,37726,144620,88356,11650475000,1777220000,758031000,756515000,3299480000,1561454000,2104436000,7065400000,4579173000
Arizona,Retail Trade,2016,49856,27029,9913,5345,42287,3976,1126,47389,2467,90135,27100,10115,6045,43260,6255,4000,53515,36620,1602805,47913,65481,69639,183400,136646,92409,417465,1145247,44788365000,1417927000,1634777000,1950179000,5011595000,4654800000,4081512000,13902020000,29930613000
Arizona,Total,2016,106963,63733,16648,10651,91032,9986,2662,103680,3283,139134,63803,16794,11043,91640,12184,6743,110567,28567,2379409,96811,110022,142411,349244,373662,316322,1039228,1340181,106431260000,4570554000,3937783000,5093149000,13601486000,13857999000,13549367000,41008852000,65422408000
Arizona,Transportation and Warehousing,2016,14202,7600,1850,1329,10779,1425,669,12873,1329,16835,7605,1855,1355,10815,1555,905,13275,3560,444618,10878,11913,17052,40521,46225,37802,130622,305848,22054026000,447003000,411443000,602989000,1489018000,1724127000,1531952000,4949833000,16520163000
Arizona,Utilities,2016,796,385,110,50,545,64,57,666,130,1275,385,115,50,550,110,190,850,425,52664,797,639,480,1955,2737,7131,11892,20110,5344234000,25089000,28166000,23203000,78847000,161416000,610031000,853734000,2170586000
Arizona,Wholesale Trade,2016,26296,12815,3672,2474,18961,2991,1471,23423,2873,32335,12830,3750,2575,19155,3395,2255,24805,7530,468950,20408,23932,31217,76396,86788,66747,234330,227331,29992400000,1062400000,1190918000,1634433000,3924539000,4710284000,3766216000,12618625000,17024018000
Arkansas,Accommodation and Food Services,2016,21927,7205,3895,4340,15440,5196,609,21245,682,28750,7215,3930,4365,15510,6055,2435,24000,4750,528975,11320,26868,58664,96985,187351,78728,363815,164887,7708050000,296850000,359598000,805727000,1463605000,2651557000,1119996000,5257465000,2448115000
Arkansas,Administrative and Support and Waste Management and Remediation Services,2016,11783,6645,1735,1120,9500,1070,332,10902,881,13520,6650,1735,1140,9525,1175,495,11195,2325,317782,10995,11264,14892,37589,37469,45152,127572,184522,7732824000,369643000,354350000,455227000,1199363000,1131361000,987441000,3490654000,4065206000
Arkansas,"Agriculture, Forestry, Fishing and Hunting",2016,3106,1740,785,300,2825,175,40,3040,66,3225,1740,785,310,2835,175,45,3055,170,24012,3027,4946,3513,11686,5372,2824,20832,1589,1011825000,145031000,230119000,159395000,542492000,192950000,78866000,832255000,92565000
Arkansas,"Arts, Entertainment, and Recreation",2016,3934,2330,655,345,3330,437,87,3854,80,4050,2330,655,345,3330,490,125,3945,105,47588,3661,4140,4300,12634,14073,7784,39785,3619,956718000,99305000,74262000,72439000,262005000,280965000,146161000,787812000,77030000
Arkansas,Construction,2016,26251,16335,4460,2850,23645,2058,260,25963,288,26465,16335,4465,2850,23650,2085,310,26045,420,228045,26250,29333,38290,94025,72744,28968,201460,22026,10408870000,976830000,1017500000,1584861000,3583895000,3375311000,1421341000,8671105000,1396823000
Arkansas,Educational Services,2016,2855,1380,480,260,2120,490,140,2750,105,3080,1380,480,270,2130,545,225,2900,180,79876,2198,3183,3391,8958,18316,25376,55341,23667,1877136000,94777000,54845000,77338000,233864000,428481000,648398000,1381966000,463880000
Arkansas,Finance and Insurance,2016,12578,8463,1695,489,10647,633,395,11675,903,22050,8480,1735,640,10855,1790,2370,15015,7035,181874,14266,10335,6116,31223,20545,27388,81704,99078,10820466000,534541000,486742000,306261000,1366843000,1084292000,1533513000,4157061000,6573129000
Arkansas,Health Care and Social Assistance,2016,29800,14370,6090,3699,24159,3311,1311,28781,1019,38265,14405,6120,3800,24325,4920,3435,32680,5585,853526,23251,40145,48421,111974,137814,172734,425528,425683,36149394000,1620813000,1632530000,1948006000,5210560000,4868138000,5423308000,15643822000,20417734000
Arkansas,Information,2016,2598,1010,390,320,1720,309,108,2137,461,5425,1015,390,345,1750,390,335,2475,2950,121801,1700,2391,3808,8283,9125,2959,25552,91194,6801895000,129520000,77597000,141620000,369071000,443303000,169930000,1316950000,5396272000
Arkansas,Management of Companies and Enterprises,2016,1543,65,20,45,130,300,452,882,661,5670,65,20,50,135,305,495,935,4735,195930,88,96,255,465,3605,11525,15595,180326,20504735000,5942000,6088000,7755000,21500000,188165000,642480000,852145000,19649481000
Arkansas,Manufacturing,2016,11633,3785,1940,1522,7247,2015,738,10000,1633,12805,3785,1940,1545,7270,2170,875,10315,2490,721791,6757,11330,17910,38806,71626,51224,187423,464381,31978386000,261620000,358447000,627167000,1374990000,2756189000,2230653000,7472679000,20909653000
Arkansas,"Mining, Quarrying, and Oil and Gas Extraction",2016,1522,755,205,165,1125,155,46,1326,196,1750,755,205,165,1125,160,50,1335,415,25802,1185,1449,1978,4737,4139,2289,12056,13385,1511389000,56715000,62574000,95056000,218454000,191854000,137511000,608682000,877754000
Arkansas,Other,2016,116,108,7,1,116,0,0,116,0,116,108,7,1,116,0,0,116,0,188,133,43,0,188,0,0,188,0,3142000,2542000,332000,0,3142000,0,0,3142000,0
Arkansas,Other Services (except Public Administration),2016,31555,20515,6235,2538,29288,1689,262,31239,316,33235,20545,6260,2720,29525,2220,580,32325,910,204140,38540,39998,32774,111779,56869,19880,192456,9086,5064775000,905721000,969343000,838307000,2726584000,1221144000,523626000,4598908000,377239000
Arkansas,"Professional, Scientific, and Technical Services",2016,27115,19211,3770,1820,24801,1102,383,26286,829,29235,19215,3785,1885,24885,1465,930,27280,1955,189055,28145,23833,23650,75990,33776,20754,132840,52944,10703980000,1382970000,1006725000,1092618000,3498965000,1938019000,1283420000,6816720000,3639257000
Arkansas,Real Estate and Rental and Leasing,2016,11849,9353,1090,417,10860,435,228,11523,326,15015,9365,1120,475,10960,795,770,12525,2490,62367,13657,6650,4605,25295,12782,5943,46358,14669,2288653000,412370000,201879000,174145000,807525000,479111000,280206000,1684215000,537374000
Arkansas,Retail Trade,2016,34082,17582,7743,3984,29309,2591,612,32512,1570,54255,17620,7810,4350,29780,4185,2810,36775,17480,683314,33361,51000,50195,135153,87154,46895,273091,394049,17387317000,818074000,1217198000,1412081000,3461875000,2917932000,1428819000,7918677000,9084283000
Arkansas,Total,2016,50511,28515,8913,5291,42719,4766,1195,48680,1831,65611,28555,8971,5575,43101,6470,3697,53268,12343,1023854,47733,58461,69998,176192,176319,137986,490497,533357,40969051000,1792602000,1814997000,2259793000,5867392000,5826362000,4937756000,16631510000,24337541000
Arkansas,Transportation and Warehousing,2016,10095,5694,1480,970,8144,803,320,9267,828,11930,5705,1480,1000,8185,855,430,9470,2460,266776,8933,9608,11927,30840,28266,17361,80146,172812,11611704000,328445000,319788000,412235000,1068201000,1049407000,741641000,3002472000,8014061000
Arkansas,Utilities,2016,698,400,75,35,510,60,43,613,85,1770,400,75,35,510,135,160,805,965,34332,920,450,392,1782,2747,6880,11805,20668,3044429000,26440000,14070000,14619000,56051000,186573000,502554000,764504000,2051117000
Arkansas,Wholesale Trade,2016,13302,5230,1814,1477,8521,1934,913,11368,1934,16980,5230,1830,1580,8640,2435,1610,12685,4295,236533,8851,11588,17824,39449,55363,35295,137272,93894,12600244000,403236000,486838000,785563000,1734278000,2791886000,2037091000,6949057000,5367343000
California,Accommodation and Food Services,2016,328403,114970,67269,68772,251011,67840,7041,325892,2511,430285,115230,67580,70045,252855,79345,27135,359335,70950,8355900,185078,450530,934235,1569843,2537615,1172223,5280510,3074301,183033115000,6263062000,7766575000,16989910000,31019547000,52796968000,25606066000,109449615000,73549629000
California,Administrative and Support and Waste Management and Remediation Services,2016,187909,114310,28382,17969,160661,17883,5409,183953,3956,221055,114425,28495,18315,161235,19470,7595,188300,32755,7289216,181972,186381,242663,611085,707081,817594,2137973,5148126,343241941000,8855823000,6990241000,9564100000,25413630000,32017902000,32915560000,90547386000,252546876000
California,"Agriculture, Forestry, Fishing and Hunting",2016,9328,5975,1305,860,8140,814,264,9218,110,9560,5975,1305,870,8150,865,355,9370,190,137405,8620,8696,11237,28780,34848,34825,99460,32860,5421785000,580105000,414731000,536567000,1536950000,1608249000,1171658000,4359440000,909350000
California,"Arts, Entertainment, and Recreation",2016,117444,90490,10016,6828,107334,7509,1781,116624,820,124535,90560,10065,6930,107555,8140,2640,118335,6200,1693525,83393,64857,91016,239400,306220,300052,847170,834939,84987145000,24514114000,3076776000,3384973000,30989935000,8296015000,12648806000,51989585000,32516505000
California,Construction,2016,354936,226175,58872,35835,320882,28306,4214,353402,1534,359905,226180,58900,35890,320970,28880,5515,355365,4540,3617870,355110,386960,480665,1222735,1086645,670394,2980470,634424,227713470000,17349930000,17508050000,25337330000,60195310000,68083605000,45882401000,174198340000,53337799000
California,Educational Services,2016,62977,30243,9768,8575,48586,10499,2818,61903,1074,71070,30330,9840,8835,49005,11775,4880,65660,5410,2113745,46985,65301,117190,229500,420590,454428,1104730,1007463,84120060000,1903715000,1655755000,2994145000,6553895000,14503010000,18928206000,39992780000,44080713000
California,Finance and Insurance,2016,146675,106327,18565,7623,132515,7177,2946,142638,4037,256375,106445,18845,8395,133685,10760,13085,157530,98845,3050170,176484,118578,100024,395264,255404,338202,989635,2060363,340505944000,10900245000,8132735000,9806877000,28855355000,28855640000,37504306000,95277052000,245164626000
California,Health Care and Social Assistance,2016,462029,266025,97946,49139,413110,34821,9663,457594,4435,553640,266565,98625,51025,416215,47660,29840,493715,59925,9642340,462385,642751,645495,1750819,1331150,1451274,4533430,5107128,551783600000,29025174000,27475410000,27858564000,84369830000,55867718000,61263190000,201517655000,350178765000
California,Information,2016,84171,56418,9213,5889,71520,6887,2898,81305,2866,119150,56490,9340,6060,71890,7680,4550,84120,35030,3558400,66450,60359,77450,204275,263125,381533,850875,2705771,444200800000,9580305000,4529837000,6160265000,20270820000,24528415000,42762831000,87741110000,356319258000
California,Management of Companies and Enterprises,2016,16161,1311,370,585,2266,3111,4891,10268,5893,26685,1315,370,590,2275,3215,5260,10750,15935,1695765,1522,1578,3465,6575,44030,178225,228830,1466935,230262680000,245676000,136240000,295095000,677440000,3489205000,16493725000,20660370000,209602310000
California,Manufacturing,2016,180917,74591,33510,26216,134317,31364,8214,173895,7022,190515,74635,33550,26315,134500,32305,9875,176680,13835,5729455,135905,223159,353112,714737,1226487,1082126,3051539,2611448,377053657000,7242064000,8961046000,15388694000,31710422000,62245183000,61989885000,157559215000,214495488000
California,"Mining, Quarrying, and Oil and Gas Extraction",2016,2822,1265,395,344,2004,350,140,2494,328,3825,1265,395,355,2015,370,185,2570,1255,103544,2199,2504,4289,9178,12443,13560,36694,65833,8742647000,149135000,139876000,303859000,602198000,896807000,994121000,2598422000,6071504000
California,Other,2016,2946,2839,87,16,2942,4,0,2946,0,2946,2839,87,16,2942,4,0,2946,0,3984,3156,514,217,3887,97,0,3984,0,113738000,97205000,10523000,3986000,111714000,2024000,0,113738000,0
California,Other Services (except Public Administration),2016,339993,218505,62859,31745,313109,21995,3294,338398,1595,372700,218745,63335,32965,315045,27285,9065,351395,21305,2930765,388680,407295,419196,1215210,771025,393472,2382050,539734,98564425000,12122020000,12015980000,13088623000,37227535000,26110705000,14752131000,78206055000,19761594000
California,"Professional, Scientific, and Technical Services",2016,579456,423111,72231,38662,534004,30885,8020,572909,6547,624030,423335,72585,39700,535620,35685,13640,584945,39085,5953585,601190,473015,510085,1584290,1090720,896721,3571905,2379516,568062330000,43109220000,31309560000,37688215000,112106995000,97682845000,94450044000,304255095000,263666108000
California,Real Estate and Rental and Leasing,2016,215613,169176,23151,10888,203215,8336,2309,213860,1753,271555,169460,23660,12350,205470,14080,14150,233700,37855,1463740,236305,147753,140005,524070,288405,221578,1036730,424709,88441030000,13412800000,6899456000,7143165000,27455795000,16298270000,13828734000,57750530000,30249395000
California,Retail Trade,2016,352671,205904,71505,38609,316018,26617,6037,348672,3999,541655,206610,73300,42805,322715,38650,22515,383880,157775,8378079,373313,473099,507220,1353687,964179,723336,3042979,5184419,258615243000,11747153000,13273744000,15979700000,41001611000,36045546000,33479299000,110578262000,143657980000
California,Total,2016,751982,465078,124595,76973,666646,65829,13316,745791,6191,922477,465846,125830,80213,671889,81348,38031,791268,131209,14600349,731400,819252,1028048,2578700,2509428,2041076,7129204,7471145,886643923000,43110073000,33834977000,43740209000,120685259000,120108727000,117356679000,358150665000,528493258000
California,Transportation and Warehousing,2016,99473,59812,14400,9862,84074,8578,3113,95765,3708,119260,59930,14510,10115,84555,9925,5445,99925,19335,2522592,87388,93973,128417,310106,287170,278017,879261,1635802,133218558000,3929085000,3602898000,5315711000,12859828000,13199081000,13620916000,39876979000,93082116000
California,Utilities,2016,2705,1470,520,205,2195,181,84,2460,245,6300,1470,530,225,2225,230,255,2710,3590,265608,2843,3221,2462,8705,5955,6141,21625,243432,32728903000,122692000,188162000,160751000,484618000,508967000,582052000,1655132000,31006082000
California,Wholesale Trade,2016,257859,145776,43135,28257,217168,26154,7942,251264,6595,295555,146070,43485,29200,218755,30400,14170,263325,32230,4216425,245100,282290,367799,895215,906369,745979,2548275,1660516,353930485000,13978035000,14980935000,20537922000,49497680000,57128757000,55173471000,161832560000,191723139000
Colorado,Accommodation and Food Services,2016,51291,16055,9500,10756,36311,12481,1153,49945,1346,67845,16070,9550,10885,36505,13880,4115,54500,13345,1412415,24320,63855,146135,234310,450073,186496,871155,540911,27842620000,973030000,1096385000,2493115000,4562530000,8335180000,3730101000,16636240000,11197516000
Colorado,Administrative and Support and Waste Management and Remediation Services,2016,39577,24285,5700,3430,33415,3290,989,37694,1883,44940,24305,5700,3455,33460,3505,1285,38250,6690,1281680,34227,37288,46098,117987,125189,110106,358875,920217,60006931000,1611954000,1359403000,1744512000,4729793000,4665231000,4611256000,14285699000,45575593000
Colorado,"Agriculture, Forestry, Fishing and Hunting",2016,1610,1275,155,80,1510,50,25,1585,25,1610,1275,155,80,1510,50,25,1585,25,9484,1767,907,750,3632,2286,2420,9167,135,316672000,64159000,34956000,29204000,139147000,82587000,55196000,298567000,8190000
Colorado,"Arts, Entertainment, and Recreation",2016,13596,8920,1595,1267,11782,1198,307,13287,309,14335,8920,1600,1285,11805,1255,420,13480,855,290376,10957,10470,17132,38978,43961,52709,138788,144446,9287179000,574610000,262685000,347510000,1198105000,1020748000,1637986000,3964477000,4155731000
Colorado,Construction,2016,87886,61075,12180,6890,80145,6013,975,87133,753,88650,61075,12180,6900,80155,6065,1190,87410,1240,761625,85950,79240,91470,256660,220500,125708,607785,150925,44446430000,4138400000,3564330000,4485340000,12188070000,12392400000,8119204000,33031740000,11195257000
Colorado,Educational Services,2016,12363,6745,1765,1490,10000,1600,420,12020,343,13135,6750,1770,1500,10020,1700,685,12405,730,255741,9687,11516,19932,41225,65865,44337,154431,96499,8215489000,385452000,337254000,488609000,1213774000,1834026000,1668698000,4831524000,3130179000
Colorado,Finance and Insurance,2016,31886,23155,3482,929,27566,1247,752,29565,2321,52495,23180,3515,1020,27715,2185,1915,31815,20680,529704,37375,21781,11746,71327,38249,43820,156129,370178,46375060000,2053348000,1318663000,1058361000,4473261000,3322266000,3788117000,11816861000,34256674000
Colorado,Health Care and Social Assistance,2016,66192,36540,12160,7815,56515,6384,1769,64668,1524,81140,36575,12220,8075,56870,8090,5020,69980,11160,1535185,59195,81577,105105,245952,243350,266653,759127,773180,74642476000,3228334000,3678474000,4470316000,11378597000,9856103000,10505929000,31926782000,42576269000
Colorado,Information,2016,10341,5675,1265,780,7720,839,558,9117,1224,16735,5675,1300,795,7770,895,730,9395,7340,434438,7994,8077,10187,26586,27261,41917,99266,331149,36183268000,653824000,426286000,599031000,1694881000,1782847000,3779345000,7475691000,28198713000
Colorado,Management of Companies and Enterprises,2016,3528,310,85,100,495,486,897,1878,1650,5285,310,85,100,495,495,930,1920,3365,300365,307,475,735,1520,5970,30530,38020,262345,32301310000,42075000,27480000,71560000,142250000,491440000,2862455000,3496145000,28805165000
Colorado,Manufacturing,2016,24310,11105,4259,3135,18499,3329,1043,22871,1439,25135,11105,4265,3165,18535,3450,1195,23180,1955,570442,18799,26655,38588,88257,109260,76838,304456,232528,33119454000,819855000,983942000,1658452000,3661601000,5111394000,4348715000,14834388000,16249276000
Colorado,"Mining, Quarrying, and Oil and Gas Extraction",2016,5489,2980,690,555,4225,591,188,5004,485,6175,3000,690,560,4250,615,260,5125,1050,111247,4533,4645,6988,16320,19014,17191,53050,56254,10545561000,394069000,435284000,637186000,1496930000,1526718000,1689239000,4757178000,5604260000
Colorado,Other,2016,280,267,10,2,279,1,0,280,0,280,267,10,2,279,1,0,280,0,371,265,55,0,348,0,0,371,0,8893000,7275000,664000,0,8710000,0,0,8893000,0
Colorado,Other Services (except Public Administration),2016,65639,42067,11872,6218,60157,3932,772,64861,778,71325,42115,11985,6395,60495,4740,1840,67075,4250,536480,71386,78242,81814,231731,137230,61500,434415,91799,18126850000,2307133000,2386174000,2569269000,7278680000,4364320000,2306183000,14123275000,3706144000
Colorado,"Professional, Scientific, and Technical Services",2016,120924,92255,12081,6395,110731,5321,2024,118076,2848,129160,92270,12100,6495,110865,5930,2560,119355,9805,972330,120385,78206,81803,280730,169998,105729,558605,406831,81704545000,7215970000,4865980000,5577845000,17676215000,12860615000,10228378000,40929535000,40302917000
Colorado,Real Estate and Rental and Leasing,2016,48387,40382,3491,1573,45446,1427,525,47398,989,55830,40425,3550,1665,45640,2020,1160,48820,7010,227139,47049,22087,19973,89280,45288,18560,156190,70298,11154443000,2610001000,896879000,835773000,4351660000,2016248000,945367000,7474835000,3657193000
Colorado,Retail Trade,2016,62484,33526,12962,7485,53973,4844,1199,60016,2468,93950,33630,13125,8055,54810,6985,4095,65890,28060,1407175,60801,85848,97943,244845,164034,84436,497145,874728,41302330000,1846119000,2277172000,2785145000,6914990000,5977402000,3667480000,16706165000,23692950000
Colorado,Total,2016,136351,86746,19815,12532,119093,11133,2778,133004,3347,165264,86834,19958,12918,119710,13318,6222,139250,26014,2318190,127021,130501,166640,424162,402236,290804,1117202,1200988,120398734000,6211257000,5210325000,6545951000,17967533000,16768961000,15049217000,49785711000,70613023000
Colorado,Transportation and Warehousing,2016,16295,10090,1935,1169,13194,1087,641,14922,1373,18710,10095,1935,1185,13215,1160,870,15245,3465,336839,13911,12538,14843,41975,34104,27806,108437,194562,17847817000,577358000,476017000,558578000,1662620000,1522361000,1203981000,4574220000,11804769000
Colorado,Utilities,2016,1019,525,135,45,705,145,83,933,86,1950,525,135,45,705,245,155,1105,845,54230,889,712,436,2129,6329,6457,15501,28276,4617907000,41151000,27103000,20745000,110235000,512932000,604875000,1291080000,2517605000
Colorado,Wholesale Trade,2016,29857,15504,3840,2794,22138,2828,1789,26755,3102,36515,15535,3880,2920,22335,3320,2660,28315,8200,514930,23579,24844,34280,83403,82132,78717,249450,260286,39183825000,1380139000,1435644000,1898876000,4760505000,5106123000,4755717000,14955645000,23866264000
Connecticut,Accommodation and Food Services,2016,36030,13960,7457,6600,28017,6781,556,35354,676,42900,13985,7480,6680,28145,7460,1790,37395,5505,706634,24678,49923,90523,165218,240162,72334,478703,227462,14735826000,686851000,812989000,1650300000,3153091000,4888035000,1325780000,9382806000,5344933000
Connecticut,Administrative and Support and Waste Management and Remediation Services,2016,23887,15145,3130,2075,20350,1752,607,22709,1178,26600,15145,3150,2090,20385,1845,725,22955,3645,427162,21525,20384,27662,69864,65063,73065,213619,209080,18104056000,1245657000,877676000,1381431000,3529120000,2970546000,2432422000,9297220000,8103434000
Connecticut,"Agriculture, Forestry, Fishing and Hunting",2016,390,295,55,25,375,15,0,390,0,390,295,55,25,375,15,0,390,0,1490,444,320,194,1027,113,0,1490,0,64925000,19969000,6950000,5645000,35027000,7455000,0,64925000,0
Connecticut,"Arts, Entertainment, and Recreation",2016,7790,3980,1160,1010,6150,1230,234,7614,176,8595,3985,1170,1025,6180,1285,415,7880,715,141525,5548,7654,13461,27017,48387,35369,114562,24458,3786007000,374644000,287817000,377324000,1055928000,1332751000,658564000,3182257000,481795000
Connecticut,Construction,2016,39641,27045,6230,3310,36585,2420,339,39344,297,39810,27050,6230,3310,36590,2440,360,39390,420,291245,41783,40857,44830,127585,86647,30756,249910,34319,20108065000,2296735000,2271111000,2953498000,7529290000,6326549000,2362891000,16598145000,2980334000
Connecticut,Educational Services,2016,6804,3190,1178,885,5253,940,370,6563,241,7215,3190,1190,885,5265,975,440,6680,535,381933,5177,8005,11678,24912,37990,53720,121214,256328,17599253000,224691000,182675000,274103000,682722000,1452313000,2898057000,5277560000,12201220000
Connecticut,Finance and Insurance,2016,17398,10261,2412,1080,13753,1151,747,15651,1747,30040,10285,2440,1150,13875,1845,2485,18205,11835,597648,18147,15269,13427,47221,38197,60963,148175,432245,88723036000,1530407000,1369925000,2072120000,5042168000,6606010000,9642951000,21642279000,63895280000
Connecticut,Health Care and Social Assistance,2016,37894,15086,8338,5501,28925,5093,2549,36567,1327,54965,15145,8515,5970,29630,7075,6950,43655,11310,1424676,29774,56011,73650,159791,194003,362707,719338,698473,68404666000,1607914000,2550499000,3607138000,7801889000,8695598000,13038046000,29737629000,38073131000
Connecticut,Information,2016,5117,2325,630,570,3525,580,256,4361,756,8745,2335,630,575,3540,625,335,4500,4245,188344,3665,3899,7087,15089,17930,17646,52951,123600,17420331000,245965000,245585000,411010000,936277000,1193830000,1230776000,3480021000,12162341000
Connecticut,Management of Companies and Enterprises,2016,2480,195,45,110,350,270,613,1233,1247,3585,195,45,110,350,275,690,1315,2270,170946,260,223,795,1285,3440,17496,22221,148725,22748670000,56425000,27182000,82605000,167410000,274265000,1557670000,1999345000,20749325000
Connecticut,Manufacturing,2016,19697,6885,3710,2760,13355,3974,1162,18491,1206,20350,6885,3710,2765,13360,4065,1315,18740,1610,722528,12811,22906,34217,74111,145272,113425,366792,300283,51977298000,662733000,1050254000,1756310000,3718625000,8383918000,7161178000,21382372000,26099013000
Connecticut,"Mining, Quarrying, and Oil and Gas Extraction",2016,253,105,35,40,180,25,5,210,43,365,105,35,40,180,35,5,220,145,4605,184,222,450,908,687,0,1753,1896,310395000,7658000,13813000,29472000,54008000,56263000,0,132041000,125430000
Connecticut,Other,2016,156,151,4,1,156,0,0,156,0,156,151,4,1,156,0,0,156,0,208,166,29,0,208,0,0,208,0,6304000,5398000,828000,0,6304000,0,0,6304000,0
Connecticut,Other Services (except Public Administration),2016,44729,27180,9940,4432,41552,2410,322,44284,445,47520,27205,10010,4565,41780,2805,560,45145,2375,304906,52298,65061,57675,175355,78015,12497,270248,26707,10019047000,1549033000,1887789000,1780332000,5230781000,2538562000,693401000,8703390000,977308000
Connecticut,"Professional, Scientific, and Technical Services",2016,42526,27525,6380,3430,37335,2606,839,40780,1746,45930,27535,6410,3465,37410,2910,1090,41410,4520,531035,44085,41765,43676,130270,83790,61723,281615,247228,49289555000,2826730000,2797939000,3306658000,8982950000,7513749000,5380448000,22370495000,26563561000
Connecticut,Real Estate and Rental and Leasing,2016,12205,8645,1570,675,10890,603,268,11761,444,16190,8665,1605,745,11015,770,1175,12960,3230,100415,13910,9881,7886,31999,17188,14141,65779,30840,5676537000,701893000,515176000,407767000,1639860000,1165244000,712826000,3718135000,1676441000
Connecticut,Retail Trade,2016,42615,23520,8569,4150,36239,3345,905,40489,2126,62950,23585,8725,4410,36720,4155,2410,43285,19665,934881,44177,55524,53245,153346,120560,70829,348931,564706,27754235000,1316502000,1657088000,1814468000,4798895000,5150568000,3095383000,13172890000,14026038000
Connecticut,Total,2016,71526,39493,12898,7846,60237,7114,1900,69251,2275,89416,39563,13030,8127,60720,8415,4533,73668,15748,1533879,67899,84913,104726,257538,260368,232551,750457,783422,94658647000,3380010000,3662390000,4950750000,11993150000,13475174000,12678999000,38147323000,56511324000
Connecticut,Transportation and Warehousing,2016,6763,3120,985,765,4870,807,340,6017,746,8390,3120,990,770,4880,870,510,6260,2130,211451,4675,6229,9574,21014,26041,21533,75063,109766,9419947000,295981000,359118000,421115000,1106677000,1541832000,740648000,3725558000,4375901000
Connecticut,Utilities,2016,311,55,35,50,140,25,40,205,106,665,60,35,55,150,30,60,240,425,33180,87,119,624,969,486,1638,5005,20099,3893833000,5098000,9685000,67978000,112407000,44795000,215112000,591762000,2340959000
Connecticut,Wholesale Trade,2016,18260,8275,2705,1944,12924,2398,1038,16360,1900,21095,8290,2705,1995,12990,2595,1350,16935,4160,366774,14586,16863,24514,57128,74912,56808,199619,157766,30356605000,1049306000,1177885000,1804679000,4121664000,5689336000,4197104000,15156885000,14321414000
Delaware,Accommodation and Food Services,2016,8905,3310,1335,1455,6100,2174,226,8500,405,10600,3310,1340,1460,6110,2280,735,9125,1475,204387,5291,8828,19316,33586,80535,27327,143273,61110,3731343000,241564000,150167000,315481000,711257000,1416292000,415186000,2603252000,1128070000
Delaware,Administrative and Support and Waste Management and Remediation Services,2016,6768,3610,1085,635,5330,590,175,6095,673,7590,3610,1085,635,5330,600,195,6125,1465,145435,5529,6745,8057,21032,19550,20644,63177,81021,5304575000,254653000,232001000,322924000,840143000,760813000,718189000,2404907000,2845264000
Delaware,"Agriculture, Forestry, Fishing and Hunting",2016,165,110,35,15,160,0,0,160,5,165,110,35,15,160,0,0,160,5,574,118,184,66,499,0,0,499,0,21003000,3607000,6084000,3670000,18878000,0,0,18878000,0
Delaware,"Arts, Entertainment, and Recreation",2016,2052,1210,240,210,1660,265,50,1975,77,2180,1210,240,210,1660,280,65,2005,175,39287,1464,1416,2493,6017,9073,4465,24135,11442,1327802000,81293000,33539000,54629000,198393000,212609000,188440000,953857000,301387000
Delaware,Construction,2016,11079,7130,1610,1120,9860,925,178,10963,116,11140,7130,1610,1120,9860,935,185,10980,160,100348,11470,10303,14492,36663,38117,15033,92040,6717,5533415000,478470000,425763000,758527000,1680543000,2186917000,1015191000,5009203000,415022000
Delaware,Educational Services,2016,1555,715,225,210,1150,235,85,1470,85,1610,715,225,210,1150,245,95,1490,120,35104,999,1368,2464,5136,9474,9007,24449,9969,1291321000,32128000,37747000,44878000,129739000,258991000,356443000,781123000,487094000
Delaware,Finance and Insurance,2016,6178,3425,648,305,4378,356,266,5000,1178,10160,3460,680,330,4470,540,510,5520,4640,210607,4964,3753,3195,12433,8135,4948,28966,180094,19469963000,330050000,209663000,243685000,822769000,646925000,332558000,2061703000,17280818000
Delaware,Health Care and Social Assistance,2016,9699,3510,2045,1639,7194,1400,434,9028,671,13470,3525,2050,1710,7285,1785,1345,10415,3055,335168,6440,13690,21549,42043,45959,53567,146305,186434,17624119000,340497000,655131000,1066702000,2076151000,2210832000,2048014000,6510904000,11002796000
Delaware,Information,2016,1826,985,155,163,1303,150,65,1518,308,2855,985,155,165,1305,160,95,1560,1295,33681,1410,875,1692,4379,4170,3671,13851,18588,2166271000,101139000,50093000,105234000,271882000,275562000,321960000,967514000,1142369000
Delaware,Management of Companies and Enterprises,2016,2948,1176,30,56,1262,240,362,1864,1084,3680,1205,30,60,1295,265,400,1960,1720,41225,1405,73,259,1737,1455,3123,6335,34885,4191710000,76050000,2327000,6709000,85086000,87035000,318393000,491110000,3700369000
Delaware,Manufacturing,2016,2724,1010,455,355,1820,380,207,2407,317,2820,1010,455,365,1830,380,235,2445,375,115720,1426,2104,3122,8352,7909,11176,36168,68701,6670028000,66268000,91735000,153587000,390923000,410516000,520314000,1771634000,4102357000
Delaware,"Mining, Quarrying, and Oil and Gas Extraction",2016,67,35,0,10,45,5,5,55,12,85,35,0,10,45,5,5,55,30,602,6,0,0,116,0,0,469,0,39597000,3060000,0,0,19830000,0,0,32569000,0
Delaware,Other,2016,52,50,0,2,52,0,0,52,0,52,50,0,2,52,0,0,52,0,74,43,0,0,74,0,0,74,0,1429000,1233000,0,0,1429000,0,0,1429000,0
Delaware,Other Services (except Public Administration),2016,10506,6310,2055,1032,9397,804,80,10281,225,11055,6310,2065,1105,9480,945,80,10505,550,74395,11696,13252,12894,38179,26040,1258,68836,3773,2216742000,347478000,342212000,357427000,1062878000,749750000,53368000,2028311000,127561000
Delaware,"Professional, Scientific, and Technical Services",2016,13907,8995,1660,1117,11772,983,335,13090,817,14755,9000,1670,1180,11850,1120,415,13385,1370,147772,12467,10765,14519,38408,28740,16445,86864,51461,13886214000,912970000,754665000,1053821000,2773358000,2289122000,2086878000,7339633000,5712150000
Delaware,Real Estate and Rental and Leasing,2016,5157,3590,450,265,4305,321,128,4754,403,6185,3595,455,290,4340,465,355,5160,1025,32542,4770,2665,3161,11036,7457,5875,26836,4672,1603324000,196306000,124466000,147616000,501642000,389027000,252321000,1295728000,260374000
Delaware,Retail Trade,2016,12555,6585,2140,1099,9824,856,324,11004,1551,18580,6605,2180,1200,9985,1185,690,11860,6720,274089,11199,13617,13668,39480,27776,19471,91165,180397,7316077000,337952000,352915000,403150000,1121187000,1086970000,979389000,3332530000,3907759000
Delaware,Total,2016,20390,11281,3002,2052,16335,2069,596,19000,1390,25366,11310,3037,2149,16496,2443,1186,20125,5241,400069,17696,19768,27137,64601,71987,50968,187556,212513,21196371000,852281000,785324000,1140818000,2778423000,3067269000,2559753000,8405445000,12790926000
Delaware,Transportation and Warehousing,2016,3224,1785,368,255,2408,386,115,2909,315,3535,1785,370,255,2410,415,130,2955,580,70899,2617,2163,2791,8198,10740,3923,28183,35279,3069668000,104108000,59712000,84608000,271310000,430194000,196215000,1138624000,1575730000
Delaware,Utilities,2016,122,40,10,0,50,5,22,77,45,240,40,20,0,60,5,30,95,145,7298,27,0,0,92,0,896,1939,4975,756560000,1347000,0,0,6547000,0,76512000,162699000,565987000
Delaware,Wholesale Trade,2016,5217,2655,515,400,3570,534,300,4404,813,5865,2660,520,415,3595,605,365,4565,1300,64844,3979,2726,4140,12371,12568,4504,35767,27686,4692642000,263537000,173255000,223479000,745995000,726766000,250305000,2075350000,2528599000
District of Columbia,Accommodation and Food Services,2016,10035,3200,1575,1605,6380,2733,411,9524,511,13195,3220,1580,1630,6430,2830,745,10005,3190,360930,5375,10578,22064,38175,107532,49561,196130,164494,10170505000,271470000,227595000,530450000,1034735000,2585846000,1317147000,4967475000,5196544000
District of Columbia,Administrative and Support and Waste Management and Remediation Services,2016,4028,1495,485,360,2340,618,414,3372,656,5740,1500,490,360,2350,650,480,3480,2260,166341,2453,2960,4509,10677,22388,39561,75423,90372,7410514000,200760000,198732000,255492000,695938000,953556000,1543989000,3331696000,4034969000
District of Columbia,"Agriculture, Forestry, Fishing and Hunting",2016,5,5,0,0,5,0,0,5,0,5,5,0,0,5,0,0,5,0,0,0,0,0,0,0,0,0,0,0,0,0,0,0,0,0,0,0
District of Columbia,"Arts, Entertainment, and Recreation",2016,1527,833,185,145,1163,190,75,1428,99,1795,835,185,145,1165,195,120,1480,315,44671,1191,1033,1768,4373,6761,9652,21657,10852,3225604000,97243000,50048000,63809000,228571000,208409000,284627000,790979000,667460000
District of Columbia,Construction,2016,2233,970,420,250,1640,395,105,2140,93,2245,970,420,250,1640,395,110,2145,100,49247,1515,2476,3134,7605,14540,11201,37688,7528,3352371000,90253000,131214000,215764000,469610000,961237000,824310000,2530672000,538917000
District of Columbia,Educational Services,2016,2780,1048,350,260,1658,590,325,2573,207,3055,1050,350,265,1665,595,490,2750,305,249231,1685,2270,3465,7556,26241,41309,76241,172449,13187157000,99011000,118670000,158074000,380807000,1306744000,2182188000,3910527000,9255569000
District of Columbia,Finance and Insurance,2016,2856,890,320,180,1390,335,216,1941,915,5065,895,320,195,1410,415,415,2240,2825,83310,1452,1873,2251,5864,7411,4696,19508,52126,14872688000,146478000,214373000,332329000,725945000,959757000,509680000,2423262000,10445647000
District of Columbia,Health Care and Social Assistance,2016,8847,4055,1675,1000,6730,1049,567,8346,501,10470,4055,1675,1085,6815,1245,1100,9160,1310,341033,7343,10588,12601,31311,34846,72721,140137,191710,20615206000,482846000,589003000,737136000,1849066000,1524131000,2905510000,6352150000,13755301000
District of Columbia,Information,2016,2807,980,330,220,1530,325,214,2069,738,3875,980,330,220,1530,330,230,2090,1785,113364,1543,2001,2573,6436,10245,13731,32427,78701,12717439000,138215000,166946000,206908000,541393000,976907000,1273237000,2992693000,9503249000
District of Columbia,Management of Companies and Enterprises,2016,822,40,25,20,85,35,155,275,547,1060,45,25,20,90,35,160,285,775,92260,55,145,100,325,258,4575,5170,87090,5246305000,6292000,28875000,8272000,45700000,39578000,295120000,382295000,4864010000
District of Columbia,Manufacturing,2016,555,275,95,65,435,65,5,505,50,565,275,95,65,435,65,5,505,60,5232,435,326,553,1565,1401,0,3734,644,208117000,21490000,20265000,15882000,66510000,34519000,0,141128000,24393000
District of Columbia,"Mining, Quarrying, and Oil and Gas Extraction",2016,10,5,0,0,5,0,0,5,5,10,5,0,0,5,0,0,5,5,0,0,0,0,0,0,0,0,0,0,0,0,0,0,0,0,0,0
District of Columbia,Other,2016,84,84,0,0,84,0,0,84,0,84,84,0,0,84,0,0,84,0,78,78,0,0,78,0,0,78,0,2258000,2258000,0,0,2258000,0,0,2258000,0
District of Columbia,Other Services (except Public Administration),2016,18714,8123,3600,2475,14198,2965,1171,18334,380,20930,8130,3625,2525,14280,3085,1460,18825,2105,375539,15675,23584,31568,71035,102213,125446,299552,74761,30908703000,1059338000,1537258000,2370287000,4973685000,8473573000,11815271000,25297131000,5551470000
District of Columbia,"Professional, Scientific, and Technical Services",2016,23481,12255,3147,2153,17555,2500,1345,21400,2081,28420,12255,3150,2155,17560,2540,1425,21525,6895,513724,18666,20297,26835,66113,77500,89157,234561,277687,63328620000,2319976000,2286129000,3092410000,7720243000,8937817000,9951260000,26750393000,36478104000
District of Columbia,Real Estate and Rental and Leasing,2016,4011,2320,445,293,3058,372,230,3660,351,6420,2335,460,300,3095,510,560,4165,2255,61378,3474,2923,3183,9680,10507,9943,30865,30309,4117760000,240702000,165389000,238645000,651099000,756190000,832655000,2288135000,1810209000
District of Columbia,Retail Trade,2016,7121,3735,1205,568,5508,502,240,6250,871,9005,3745,1215,580,5540,590,340,6470,2535,105873,7291,7601,6242,22360,11275,2346,38802,64386,3079973000,243108000,228849000,190590000,704636000,365363000,56832000,1203369000,1748717000
District of Columbia,Total,2016,18095,8335,2832,1951,13118,2523,1044,16685,1410,23177,8352,2847,2003,13202,2733,1559,17494,5683,526879,14186,18573,25513,58272,89578,99611,247461,279418,39833690000,1117334000,1237391000,1767703000,4122428000,5806959000,7107082000,17036469000,22797221000
District of Columbia,Transportation and Warehousing,2016,760,345,55,65,465,70,45,580,180,825,345,55,65,465,70,45,580,245,13906,522,110,331,1357,1407,900,5146,5068,908331000,35321000,3579000,19753000,80607000,60092000,68668000,285231000,324824000
District of Columbia,Utilities,2016,163,25,0,10,35,0,5,40,123,260,25,0,10,35,0,5,40,220,8380,13,0,0,71,0,0,83,8292,1420080000,789000,0,0,2958000,0,0,4803000,1414559000
District of Columbia,Wholesale Trade,2016,1695,670,255,135,1060,102,100,1262,433,2525,670,260,145,1075,115,105,1295,1230,23026,1095,1187,958,4189,1493,1661,9085,10819,1976850000,68479000,63762000,50438000,242717000,78829000,219377000,703790000,1008323000
Florida,Accommodation and Food Services,2016,152670,60025,27586,27426,115037,31827,3576,150440,2230,201750,60115,27650,27645,115410,34325,10550,160285,41465,4664272,98892,185277,376123,660340,1222095,590815,2473815,2189662,91789197000,3124544000,2972636000,6054496000,12153100000,21597089000,11577065000,45337975000,46441269000
Florida,Administrative and Support and Waste Management and Remediation Services,2016,158944,112790,18730,10712,142232,9987,3042,155261,3683,178895,112800,18770,10810,142380,10830,4415,157625,21270,8538900,170243,121713,143634,435656,382146,457131,1277679,7258061,379668280000,5892833000,3959782000,4966058000,14821805000,13056620000,14721477000,42700829000,336841622000
Florida,"Agriculture, Forestry, Fishing and Hunting",2016,5207,3610,725,460,4795,290,81,5166,41,5305,3610,725,460,4795,330,120,5245,60,45236,5360,4728,5881,16101,9264,7991,34246,10394,1491464000,189190000,180926000,218686000,593884000,322058000,181935000,1145504000,299945000
Florida,"Arts, Entertainment, and Recreation",2016,39915,26315,4245,3365,33925,4009,1300,39234,681,42800,26330,4255,3405,33990,4195,1900,40085,2715,993432,35478,27182,44934,107717,170395,216464,496897,487200,31319983000,1866406000,700462000,984156000,3555463000,4446516000,8238794000,16291878000,14683698000
Florida,Construction,2016,251261,175415,35056,20718,231189,16612,2374,250175,1086,254100,175415,35060,20760,231235,16845,3245,251325,2775,1986215,255390,230510,277195,763115,619085,356388,1740680,242876,93032250000,9105480000,8257420000,11507795000,28871735000,29271150000,19029335000,77273430000,15605899000
Florida,Educational Services,2016,31730,18150,3870,3525,25545,4442,1072,31059,671,34445,18165,3925,3585,25675,4990,1510,32175,2270,870605,25490,26063,47833,99485,182435,144707,428815,439020,31522545000,907755000,620955000,1127146000,2660340000,5422515000,5377902000,13598180000,17754039000
Florida,Finance and Insurance,2016,90923,65504,11831,4606,81941,3652,1979,87572,3351,163575,65555,12030,5045,82630,6165,7400,96195,67380,1775867,101889,76573,58777,237426,125380,176253,542140,1224935,138496370000,5178231000,3984682000,3817614000,12995214000,9446932000,13380262000,36053208000,101882029000
Florida,Health Care and Social Assistance,2016,240045,136448,49878,27377,213703,18003,5148,236854,3191,302080,136635,50220,28270,215125,23770,16235,255130,46950,5432795,223539,329793,361928,915284,675765,791159,2383279,3047168,263864995000,12583648000,14523895000,15771233000,42879783000,31266466000,32187741000,106393793000,157371728000
Florida,Information,2016,25769,17482,2510,1760,21752,1615,864,24231,1538,44175,17625,2525,1785,21935,1940,1540,25415,18760,837450,23855,15959,22573,62835,56238,71154,192345,643394,62874145000,1309315000,749002000,1192816000,3271335000,3271184000,5765707000,12431210000,50254536000
Florida,Management of Companies and Enterprises,2016,8236,1261,245,210,1716,1265,2031,5012,3224,14440,1265,245,220,1730,1280,2115,5125,9315,768250,1562,1290,1370,4222,17167,74720,96135,672115,66347780000,292246000,79140000,127570000,498956000,1138009000,5720865000,7360430000,58987350000
Florida,Manufacturing,2016,63360,32870,10015,7440,50325,7633,2665,60623,2737,66615,32870,10015,7450,50335,7910,3195,61440,5175,1518676,56080,64929,97018,222985,283398,270077,823465,635640,81928739000,2214827000,2334639000,3810848000,8546616000,12406047000,12896173000,36072589000,42603936000
Florida,"Mining, Quarrying, and Oil and Gas Extraction",2016,997,490,145,80,715,141,30,886,111,1180,490,145,80,715,180,50,945,235,17317,765,935,1067,2826,4077,540,8288,7880,1187132000,33089000,39208000,81186000,157298000,237094000,33201000,493088000,595671000
Florida,Other,2016,736,701,31,4,736,0,0,736,0,736,701,31,4,736,0,0,736,0,901,674,178,49,901,0,0,901,0,26301000,21218000,4950000,133000,26301000,0,0,26301000,0
Florida,Other Services (except Public Administration),2016,220378,155415,33962,16606,205983,11518,1632,219133,1245,237915,155480,34095,16965,206540,13560,4485,224585,13330,1630150,255030,220531,220367,696035,409722,180363,1288545,336886,46668190000,7048959000,5876604000,6116612000,19046645000,11315583000,5259402000,35702070000,10818466000
Florida,"Professional, Scientific, and Technical Services",2016,366844,289203,37935,18461,345599,13831,3713,363143,3701,391240,289350,38075,18915,346340,16460,6355,369155,22085,2497590,395660,244395,239543,879650,464940,323191,1670250,823314,169460550000,22588510000,13397635000,14351712000,50340925000,30807853000,23737413000,105032200000,64166278000
Florida,Real Estate and Rental and Leasing,2016,148774,126568,11174,4687,142429,3283,1548,147260,1514,178765,126715,11455,5050,143220,4570,6465,154255,24510,824180,157465,71285,60827,289605,104680,110022,504890,318908,37360960000,6544710000,2841890000,2519755000,11906775000,5038337000,5052227000,22035735000,15279303000
Florida,Retail Trade,2016,240986,161070,39813,20747,221630,12556,3219,237405,3581,375905,161550,40595,22280,224425,18935,9265,252625,123280,5442820,281464,260223,271938,813720,457889,361053,1634340,3692824,148355905000,7996861000,6887959000,7401201000,22287740000,16108390000,16475131000,54926085000,90530632000
Florida,Total,2016,445126,304447,62593,36441,403481,30077,6807,440365,4761,546218,304788,63114,37577,405479,36397,17566,459442,86776,8169642,459040,409783,485077,1353900,1127172,916859,3397931,4771711,363336322000,19199742000,15034431000,17902943000,52137116000,43640620000,40836985000,136614721000,226721601000
Florida,Transportation and Warehousing,2016,65671,46960,6658,3991,57609,3875,1567,63051,2620,74710,46965,6700,4065,57730,4230,2200,64160,10550,1242733,64366,43017,51442,159357,127152,111253,403453,831867,61738549000,2349575000,1594467000,2050073000,6017157000,5291504000,4867217000,16400526000,45079299000
Florida,Utilities,2016,1592,780,345,112,1237,116,107,1460,132,3780,780,345,125,1250,190,335,1775,2005,132209,1273,2187,1429,5076,5324,17744,31503,100458,13473300000,51386000,82006000,68526000,208824000,348492000,1420879000,2198554000,11258833000
Florida,Wholesale Trade,2016,135241,88621,18439,10575,117635,9578,3650,130863,4378,155735,88720,18585,10950,118255,11280,6450,135985,19750,1593445,137615,118982,135745,392640,304039,247635,948350,637145,94103640000,6587140000,5965606000,7116603000,19680485000,16708513000,14483846000,51140450000,42408190000
Georgia,Accommodation and Food Services,2016,73643,25695,13140,14161,52996,17372,1792,72160,1483,101455,25760,13165,14315,53240,19005,7295,79540,21915,2106115,41530,88870,195166,325605,640467,287148,1254110,851634,34604940000,1276420000,1337405000,2861042000,5475155000,9938338000,4304395000,19739155000,14857158000
Georgia,Administrative and Support and Waste Management and Remediation Services,2016,52428,32150,6895,4370,43415,4490,1872,49777,2651,62680,32160,6910,4415,43485,4675,2380,50540,12140,1897636,48921,45792,58422,153247,172874,225048,553886,1336821,67554237000,2045019000,1658900000,2153313000,5863374000,6459977000,7633512000,20062347000,46728303000
Georgia,"Agriculture, Forestry, Fishing and Hunting",2016,4748,2490,1110,595,4195,426,60,4681,67,4860,2490,1110,595,4195,435,100,4730,130,38642,4396,7340,7550,19612,12324,3078,36032,2469,1559188000,172221000,284912000,297765000,762678000,527878000,85819000,1406553000,145268000
Georgia,"Arts, Entertainment, and Recreation",2016,14736,9255,1920,1420,12595,1506,342,14443,293,15940,9265,1925,1430,12620,1605,535,14760,1180,241281,12075,12292,18913,43580,57766,45293,149466,81696,8110241000,622848000,295652000,370863000,1298893000,1197754000,1238707000,3902986000,3949401000
Georgia,Construction,2016,86173,56095,13170,8119,77384,6714,1199,85297,876,87145,56095,13170,8125,77390,6770,1400,85560,1585,859170,85510,87370,109540,282420,252020,141525,678825,177396,46971185000,3801420000,3640860000,5100300000,12542580000,13704840000,8286847000,34702770000,12029566000
Georgia,Educational Services,2016,14066,7600,2005,1405,11010,2005,661,13676,390,15455,7605,2005,1410,11020,2395,805,14220,1235,429935,10412,13371,18656,42585,78988,100885,222710,206305,17443965000,367071000,298268000,366042000,1033520000,2284883000,3534243000,6860165000,10535030000
Georgia,Finance and Insurance,2016,40084,26506,5640,2017,34163,2144,1188,37495,2589,74550,26530,5800,2345,34675,4840,4440,43955,30595,882003,45756,34742,25264,106028,72914,86468,266898,612630,73527341000,2182736000,1809899000,1748945000,5766774000,5139147000,6515579000,17566506000,55662600000
Georgia,Health Care and Social Assistance,2016,94176,46528,20057,12850,79435,10312,2254,92001,2175,123465,46575,20230,13240,80045,13170,7515,100730,22735,2483043,76496,133980,171021,381551,385566,329804,1098756,1380467,118703273000,4526322000,5645070000,7170950000,17343420000,15872663000,13166381000,46491491000,72025542000
Georgia,Information,2016,12306,6783,1525,835,9143,1180,570,10893,1413,21925,6855,1535,860,9250,1315,930,11495,10430,603467,9119,9802,10510,29830,40701,52691,126340,460934,53572648000,585551000,525991000,672100000,1813055000,2934806000,4302940000,9316732000,42604187000
Georgia,Management of Companies and Enterprises,2016,5333,410,135,130,675,710,1318,2703,2630,8985,410,135,130,675,715,1385,2775,6210,655030,450,569,803,1817,8725,41070,51625,603384,69170875000,45085000,76521000,46128000,167515000,623285000,3402495000,4199640000,64967264000
Georgia,Manufacturing,2016,33929,12535,5000,4672,22207,5397,2603,30207,3722,37390,12550,5000,4705,22255,5660,3075,30990,6400,1793792,22381,31179,58466,117335,204651,252668,621020,1102453,89471999000,1079731000,1130391000,2350424000,4847076000,9076638000,11887894000,28042385000,57548129000
Georgia,"Mining, Quarrying, and Oil and Gas Extraction",2016,601,165,115,75,355,100,55,510,91,925,165,115,75,355,105,100,560,365,21737,283,695,821,1951,3049,6790,12978,7702,1338029000,11179000,26476000,35975000,79790000,212114000,437653000,777426000,485242000
Georgia,Other,2016,397,380,12,3,395,2,0,397,0,397,380,12,3,395,2,0,397,0,568,401,71,47,519,0,0,568,0,13246000,9332000,1525000,1326000,12183000,0,0,13246000,0
Georgia,Other Services (except Public Administration),2016,99072,63938,18350,8503,90791,6287,1090,98168,904,106450,64045,18485,8765,91295,7450,2180,100925,5525,796435,114102,118695,112250,345257,227246,98438,672455,118267,23032080000,3105013000,3106089000,3214994000,9434398000,6085757000,3390145000,18959500000,3903666000
Georgia,"Professional, Scientific, and Technical Services",2016,137045,102099,14565,8158,124822,6684,2411,133917,3128,146990,102125,14610,8285,125020,7485,3150,135655,11335,1317770,138515,94838,107912,341445,224363,187574,755870,559352,98623450000,8187045000,5191673000,6671794000,20060840000,15984919000,14334672000,50543435000,47815173000
Georgia,Real Estate and Rental and Leasing,2016,45372,36278,3763,1585,41626,1662,863,44151,1221,58610,36400,3835,1725,41960,2425,3155,47540,11070,313138,45158,24200,20404,89848,50326,45949,189068,112473,18256737000,2152344000,971760000,1018197000,4145169000,2538088000,2573929000,9442894000,6696763000
Georgia,Retail Trade,2016,106613,67242,19546,8875,95663,6415,1575,103653,2960,170545,67435,19905,9645,96985,9065,4655,110705,59840,2312646,122845,126765,115275,364941,225086,130584,723021,1530914,59608021000,3139686000,3099037000,3180276000,9420253000,8365512000,5585432000,23439138000,34781151000
Georgia,Total,2016,177410,108426,27528,17013,152967,15948,4248,173163,4247,228330,108604,27792,17583,153979,19277,9858,183114,45216,3804433,170082,180873,227000,577955,586286,473651,1637892,2166541,182911144000,7381587000,6531658000,8491496000,22404741000,23148343000,21940666000,67493750000,115417394000
Georgia,Transportation and Warehousing,2016,27671,16580,3010,1915,21505,2342,1336,25183,2488,33915,16590,3025,1950,21565,2550,1710,25825,8090,912643,23679,19530,24725,68669,70794,74168,216264,690239,44448580000,917432000,774324000,933143000,2656016000,2919898000,3204130000,8906402000,35193899000
Georgia,Utilities,2016,703,215,80,20,315,150,132,597,106,3130,215,80,20,315,225,420,960,2170,114446,391,504,114,1224,7096,22344,31270,585,10766754000,20149000,15417000,6876000,55788000,474127000,1823426000,2420011000,29403000
Georgia,Wholesale Trade,2016,54415,27790,7789,5688,41267,5782,3025,50074,4341,65250,27850,7860,5865,41575,6485,4060,52120,13130,1059790,45745,50798,71802,168725,177564,161115,512750,541960,69060515000,2475255000,2640223000,3927117000,9062715000,10497722000,9926554000,29805485000,39012918000
Hawaii,Accommodation and Food Services,2016,14908,5005,3143,2600,10748,3314,428,14490,418,18885,5005,3145,2605,10755,3815,1280,15850,3035,539700,8531,21055,35290,64950,131250,73281,270555,266997,15828804000,297526000,381062000,643832000,1324162000,2819028000,1947217000,6103049000,9685150000
Hawaii,Administrative and Support and Waste Management and Remediation Services,2016,8065,4225,1230,770,6225,947,320,7492,573,9230,4230,1230,775,6235,1150,425,7810,1420,275482,7181,7468,9481,24918,34190,43573,108527,139433,9764965000,316672000,213278000,307199000,921374000,1176638000,1113940000,3559401000,5067691000
Hawaii,"Agriculture, Forestry, Fishing and Hunting",2016,165,145,0,5,150,15,0,165,0,165,145,0,5,150,15,0,165,0,598,192,0,0,224,94,0,598,0,18287000,6191000,0,0,6961000,3093000,0,18287000,0
Hawaii,"Arts, Entertainment, and Recreation",2016,2419,1205,310,275,1790,395,164,2349,70,2610,1210,320,275,1805,415,255,2475,135,56538,1697,1887,3292,7408,15075,19995,45745,6273,1433376000,79562000,37517000,81034000,213705000,344024000,568879000,1190607000,143724000
Hawaii,Construction,2016,14155,8035,2515,1659,12209,1454,285,13948,207,14345,8035,2515,1660,12210,1510,340,14060,285,167440,12960,16487,21109,50996,50322,32788,139444,24440,11634115000,656590000,812631000,1175529000,2668876000,3477022000,2634016000,9219759000,2135482000
Hawaii,Educational Services,2016,2473,1095,410,325,1830,405,115,2350,123,2680,1095,410,330,1835,460,200,2495,185,90947,1493,2782,4240,8916,16222,15182,43497,46762,3148314000,46348000,50388000,90176000,203638000,479840000,576507000,1390789000,1743488000
Hawaii,Finance and Insurance,2016,3995,2141,465,205,2811,240,201,3252,743,7275,2145,490,225,2860,520,730,4110,3165,95164,3966,2741,2570,9696,7866,14597,34383,56988,6436443000,202244000,146067000,158642000,540341000,416360000,1083435000,2211557000,3950059000
Hawaii,Health Care and Social Assistance,2016,14618,7715,3567,1429,12711,1059,486,14256,362,18180,7715,3620,1515,12850,1605,1530,15985,2195,347067,14916,22812,18602,57002,40165,67846,168256,160959,18376332000,932315000,1087342000,901789000,2939468000,1673713000,2608901000,7364435000,10286730000
Hawaii,Information,2016,1561,735,185,140,1060,130,70,1260,301,2580,735,185,140,1060,235,75,1370,1210,39598,1067,1061,1306,4157,3607,440,10044,25437,2482056000,64565000,47022000,56319000,199989000,184224000,26403000,520101000,1872441000
Hawaii,Management of Companies and Enterprises,2016,974,45,30,45,120,200,266,586,388,1330,45,30,45,120,205,295,620,710,31975,35,68,185,305,2165,6885,9355,22564,2421580000,2270000,4969000,10266000,18445000,103930000,446150000,568525000,1839190000
Hawaii,Manufacturing,2016,3780,1745,805,445,2995,499,163,3657,123,3895,1745,805,445,2995,515,225,3735,160,59002,2835,4366,4663,13970,12779,9744,47496,5170,2393319000,91472000,121003000,151711000,445601000,442736000,365294000,1761774000,295353000
Hawaii,"Mining, Quarrying, and Oil and Gas Extraction",2016,35,5,5,10,20,0,15,35,0,35,5,5,10,20,0,15,35,0,603,0,0,0,75,0,145,603,0,48059000,0,0,0,6048000,0,11043000,48059000,0
Hawaii,Other,2016,48,42,4,2,48,0,0,48,0,48,42,4,2,48,0,0,48,0,95,47,23,0,95,0,0,95,0,2498000,1384000,317000,0,2498000,0,0,2498000,0
Hawaii,Other Services (except Public Administration),2016,15581,10195,2545,1335,14075,1057,184,15316,265,17460,10205,2550,1375,14130,1465,575,16170,1290,127872,17798,16104,17252,51868,36829,11757,107058,14648,3938411000,582035000,522519000,561383000,1689343000,1163452000,358272000,3412386000,390205000
Hawaii,"Professional, Scientific, and Technical Services",2016,14673,9715,1825,1170,12710,919,300,13929,744,16705,9715,1830,1210,12755,1065,380,14200,2505,113638,14852,12032,15091,42514,28760,8691,82394,28404,7593547000,895978000,627280000,950543000,2498343000,1983907000,739671000,5396657000,2079329000
Hawaii,Real Estate and Rental and Leasing,2016,8071,5771,998,451,7220,333,218,7771,300,9830,5825,1015,455,7295,705,385,8385,1445,59686,9114,6354,5523,21271,10680,7277,40881,18537,2976725000,443661000,269600000,252491000,974259000,512994000,369377000,1972329000,987942000
Hawaii,Retail Trade,2016,13966,6949,2753,1477,11179,1142,493,12814,1152,23075,6995,2845,1770,11610,2030,2115,15755,7320,353212,13206,18088,18617,50702,33816,38510,132042,208014,10362171000,385602000,454615000,499568000,1363003000,1034203000,1435547000,4114048000,5759064000
Hawaii,Total,2016,25331,13928,4488,2683,21099,2563,670,24332,999,32350,13969,4546,2822,21337,3502,1988,26827,5523,528415,23884,29457,35979,89320,97652,88143,275115,253300,22892445000,1123016000,1072156000,1357393000,3552565000,3731325000,3718148000,11002038000,11890407000
Hawaii,Transportation and Warehousing,2016,3650,1415,520,445,2380,632,252,3264,386,4520,1420,520,450,2390,725,470,3585,935,144637,2375,2987,5384,11386,20230,15670,55967,72005,7370850000,109193000,99626000,181902000,413218000,857943000,610148000,2190359000,4227295000
Hawaii,Utilities,2016,139,30,20,15,65,15,15,95,44,325,30,20,15,65,85,50,200,125,8105,49,54,76,351,286,732,1812,256,771917000,2071000,4556000,4466000,22387000,19364000,75036000,154019000,15493000
Hawaii,Wholesale Trade,2016,7082,3305,1150,743,5198,792,333,6323,759,8385,3335,1175,795,5305,990,595,6890,1495,96545,6040,6922,8293,23058,21848,15883,67873,24692,5012665000,294036000,316807000,375058000,1092039000,982955000,756855000,3192839000,1567144000
Idaho,Accommodation and Food Services,2016,14636,5110,2841,3085,11036,2751,379,14166,470,18405,5130,2875,3115,11120,3405,1305,15830,2575,307814,8035,19214,41186,68455,91706,49435,210275,96551,4813325000,205515000,244569000,566795000,1017250000,1401254000,763350000,3192015000,1604088000
Idaho,Administrative and Support and Waste Management and Remediation Services,2016,11049,6995,1640,915,9550,670,249,10469,580,11730,6995,1645,930,9570,705,305,10580,1150,197604,9664,10569,11134,32056,19804,30041,86107,107827,6123230000,338068000,294533000,362977000,1018774000,664544000,626405000,2478283000,3233244000
Idaho,"Agriculture, Forestry, Fishing and Hunting",2016,2350,1710,310,135,2155,145,20,2320,30,2350,1710,310,135,2155,145,20,2320,30,16187,2420,1954,1545,6185,5990,370,13540,2512,677307000,154196000,103138000,77383000,344706000,210686000,6778000,590891000,72525000
Idaho,"Arts, Entertainment, and Recreation",2016,3834,2395,530,390,3315,400,60,3775,59,3950,2405,535,390,3330,415,105,3850,100,43988,3154,3269,5040,11884,13812,6668,35610,4109,795024000,116631000,55376000,91414000,274883000,253395000,107449000,704738000,49128000
Idaho,Construction,2016,32063,22090,5240,2750,30080,1652,179,31911,152,32215,22090,5240,2750,30080,1710,205,31995,220,191270,34505,34385,35479,104490,59187,16258,184980,3393,8573975000,1284745000,1191310000,1419958000,3900605000,2967037000,996614000,8118455000,251232000
Idaho,Educational Services,2016,2324,1190,350,280,1820,326,70,2216,108,2455,1190,350,290,1830,340,115,2285,170,74518,1851,2223,3866,8199,11207,2956,23098,50586,1485411000,50790000,42933000,84644000,184297000,252626000,109664000,559376000,906247000
Idaho,Finance and Insurance,2016,7958,5305,870,260,6435,308,240,6983,975,14495,5310,880,290,6480,765,1250,8495,6000,110857,9098,5286,2932,17843,9079,14341,42654,65951,6170227000,347121000,207597000,139518000,716982000,528460000,754887000,2074271000,3963871000
Idaho,Health Care and Social Assistance,2016,22341,11155,4530,3054,18739,2266,676,21681,660,25885,11175,4550,3195,18920,3010,1700,23630,2255,455942,18151,30897,40789,90105,85995,85075,264188,188423,19153553000,991122000,1037043000,1500474000,3536048000,2877679000,2751229000,9281404000,9771137000
Idaho,Information,2016,2363,1095,235,225,1555,288,116,1959,404,3515,1095,240,240,1575,375,160,2110,1405,64853,1564,1423,2505,5957,9027,5750,23624,37013,3314616000,69652000,48351000,103944000,242478000,418324000,367733000,1222966000,1936176000
Idaho,Management of Companies and Enterprises,2016,930,80,15,45,140,147,265,552,378,1180,80,15,45,140,160,270,570,610,38565,92,80,179,362,1844,5459,7670,30895,2976430000,7267000,5130000,10353000,23587000,77790000,408545000,510385000,2466045000
Idaho,Manufacturing,2016,8630,3620,1630,1050,6300,1343,457,8100,530,8970,3620,1635,1050,6305,1400,505,8210,760,267429,5753,9186,11479,29255,42738,31184,128211,100721,13599537000,196904000,287166000,411631000,997087000,1783727000,1399469000,5263189000,5566162000
Idaho,"Mining, Quarrying, and Oil and Gas Extraction",2016,531,270,60,40,370,70,47,487,44,565,270,60,40,370,70,55,495,70,11974,369,338,369,1228,1356,1908,6763,2163,1012772000,28869000,16114000,24655000,81812000,88853000,156216000,504122000,211037000
Idaho,Other,2016,86,83,2,0,85,1,0,86,0,86,83,2,0,85,1,0,86,0,122,90,0,0,100,0,0,122,0,1822000,1530000,0,0,1729000,0,0,1822000,0
Idaho,Other Services (except Public Administration),2016,16237,10575,3000,1454,15029,772,140,15941,296,17215,10580,3010,1565,15155,1150,200,16505,710,100761,18434,19188,18399,56607,22987,7627,89219,7537,2708177000,489981000,512415000,483595000,1504243000,559423000,210801000,2323548000,279323000
Idaho,"Professional, Scientific, and Technical Services",2016,21472,15210,2700,1500,19410,914,348,20672,800,22945,15210,2710,1525,19445,1110,425,20980,1965,164256,21897,17636,18702,58873,25524,11849,99966,49792,9196364000,971316000,748818000,904997000,2657576000,1309268000,653235000,4816718000,3105023000
Idaho,Real Estate and Rental and Leasing,2016,10763,8940,795,403,10138,238,126,10502,261,12030,8960,815,430,10205,590,465,11260,770,36587,11751,4923,4874,21930,5951,2606,31242,5034,1299575000,426277000,143557000,156422000,742647000,237752000,77612000,1095353000,189937000
Idaho,Retail Trade,2016,20820,10515,4213,2469,17197,1772,522,19491,1329,30215,10525,4235,2740,17500,2665,2215,22380,7835,420347,17414,27709,32082,77811,54680,35884,175051,235566,11536263000,470525000,647807000,888656000,2025145000,1743029000,1293725000,5230570000,6009293000
Idaho,Total,2016,38436,23165,6192,3872,33229,3036,804,37069,1367,45826,23190,6230,4039,33459,4029,2150,39638,6188,562282,35791,40948,51057,127796,106706,81251,315753,246529,22243275000,1346250000,1239235000,1643174000,4228659000,3706206000,3014280000,10949145000,11294130000
Idaho,Transportation and Warehousing,2016,8256,5430,1020,600,7050,561,220,7831,425,8980,5430,1020,600,7050,605,285,7940,1040,91564,7779,6585,7432,22187,17118,11384,55131,27339,3585688000,294914000,223233000,266474000,796517000,641618000,447235000,2054952000,1121117000
Idaho,Utilities,2016,597,360,55,50,465,60,11,536,61,1010,360,55,50,465,95,35,595,415,16309,462,347,503,1462,2279,0,3911,12012,1489159000,9797000,10642000,18361000,47302000,162993000,0,225189000,1237822000
Idaho,Wholesale Trade,2016,8167,3389,940,785,5114,1114,667,6895,1272,10590,3400,960,815,5175,1425,1130,7730,2860,156357,5256,5464,8822,21186,30158,26830,82768,62765,9885754000,228731000,237346000,397233000,925220000,1352232000,1241925000,3735843000,4950737000
Illinois,Accommodation and Food Services,2016,109318,41679,21374,20334,83387,21906,2312,107605,1713,142350,41725,21400,20665,83790,24460,7825,116075,26275,2641975,72054,142311,276751,491139,807816,352484,1651619,989987,50964900000,2042031000,2106402000,4352480000,8501364000,14102780000,7030722000,29638599000,21309751000
Illinois,Administrative and Support and Waste Management and Remediation Services,2016,73517,46920,9605,5678,62203,6222,2268,70693,2824,85165,46945,9625,5735,62305,6660,2895,71860,13305,2703610,57997,61944,74994,195015,238666,308658,744651,1953937,95344415000,3376772000,2589101000,3324635000,9292827000,10483274000,10776795000,30666999000,64538409000
Illinois,"Agriculture, Forestry, Fishing and Hunting",2016,1585,1185,215,80,1480,40,30,1550,35,1745,1185,215,80,1480,55,55,1590,155,9931,1743,1221,819,3896,1117,466,5921,3983,436436000,55973000,47268000,40845000,148316000,41772000,19278000,228386000,206727000
Illinois,"Arts, Entertainment, and Recreation",2016,22638,13225,3195,2620,19040,2668,530,22238,400,24425,13230,3220,2635,19085,2900,820,22805,1620,413761,17398,20658,35881,74167,105250,77383,259456,136476,14975265000,797285000,493782000,694028000,1991460000,2503774000,4545239000,9153390000,4808350000
Illinois,Construction,2016,143621,104875,18610,10115,133600,8081,1160,142841,780,144520,104875,18620,10140,133635,8185,1380,143200,1320,1041980,148710,120305,133587,402675,301360,158749,863730,169348,75306715000,7333515000,6371015000,8558261000,22268585000,23773450000,13582508000,59718595000,14933930000
Illinois,Educational Services,2016,19784,9420,2985,2365,14770,3488,924,19182,602,21710,9425,2995,2425,14845,3760,1475,20080,1630,855970,14105,20118,31769,66150,142762,129425,338425,515430,34221120000,520850000,471802000,715024000,1712145000,4182196000,4828240000,10723375000,23471338000
Illinois,Finance and Insurance,2016,62373,40788,8581,3290,52659,4136,2253,59048,3325,107620,40840,8755,3685,53280,7685,8760,69725,37895,1724350,70420,54719,42426,167709,142714,199440,511072,1203118,169437090000,3690860000,3261644000,3898575000,10874307000,12327938000,21044796000,44385650000,123545428000
Illinois,Health Care and Social Assistance,2016,132312,68110,26274,16704,111088,13328,4912,129328,2984,170125,68195,26590,17710,112495,17780,13995,144270,25855,4026451,117247,174660,224745,516697,514785,723643,1755844,2268333,184391876000,6190200000,7577190000,10617105000,24385600000,21454000000,25316780000,71196859000,113089340000
Illinois,Information,2016,16079,8490,2025,1380,11895,1522,952,14369,1710,28200,8535,2060,1430,12025,1780,1345,15150,13050,614406,11766,13084,17716,43027,53891,79880,178957,433055,50061619000,743602000,661907000,975319000,2401277000,3631572000,6019824000,12179508000,37797898000
Illinois,Management of Companies and Enterprises,2016,7488,490,95,210,795,1218,1941,3954,3534,11735,495,95,215,805,1245,2075,4125,7610,1069070,610,373,1297,2290,14930,68700,85920,983150,118108690000,136740000,24525000,118162000,279680000,1205140000,5494560000,6979380000,111129310000
Illinois,Manufacturing,2016,63019,22284,10205,8818,41307,12589,4469,58365,4654,66905,22300,10220,8890,41410,13285,5020,59715,7190,2659150,40579,67127,117278,229237,499728,543631,1308676,1291744,157458823000,1915173000,2845736000,5487179000,10448322000,26133695000,29307792000,67775442000,85923000000
Illinois,"Mining, Quarrying, and Oil and Gas Extraction",2016,2217,1260,295,225,1780,192,84,2056,161,2585,1260,295,230,1785,245,205,2235,350,39042,2069,1800,2882,6804,4961,8677,22443,16429,2710900000,82511000,91469000,160481000,338185000,314885000,695579000,1509433000,1189064000
Illinois,Other,2016,482,464,15,2,481,1,0,482,0,482,464,15,2,481,1,0,482,0,620,488,89,0,599,0,0,620,0,14339000,11700000,1931000,0,14327000,0,0,14339000,0
Illinois,Other Services (except Public Administration),2016,150094,93760,29688,14512,137960,9516,1551,149027,1067,162055,93870,29985,15245,139100,11890,3280,154270,7785,1244687,171511,193180,191266,556127,325570,160049,1045402,196546,44247512000,4746018000,5359040000,5852483000,15963657000,10635114000,7390466000,34138607000,10031986000
Illinois,"Professional, Scientific, and Technical Services",2016,183618,134184,20449,12144,166777,9935,3319,180031,3587,194645,134250,20520,12415,167185,11310,4320,182815,11830,1949850,179455,132801,159190,471590,341326,290012,1104845,844168,173720820000,12203085000,8105266000,10928848000,31264045000,27766948000,25807114000,84981060000,88675132000
Illinois,Real Estate and Rental and Leasing,2016,51375,38658,5498,2603,46759,2514,1008,50281,1094,64675,38715,5645,2800,47160,3490,2465,53115,11560,390322,49735,35295,33536,118670,80964,63379,264320,125827,23019231000,2592700000,1686390000,1667698000,5951815000,4785079000,4081374000,14901750000,8085639000
Illinois,Retail Trade,2016,119212,69867,22402,11278,103547,9600,2758,115905,3307,193660,70090,22900,12295,105285,13425,8765,127475,66185,3159685,127950,147639,147707,423327,356443,243114,1029012,2069280,81416160000,3486432000,3828155000,4221292000,11536803000,13020837000,9418228000,34178783000,45290237000
Illinois,Total,2016,256603,157789,39572,24781,222142,23532,6163,251837,4766,319605,157980,39991,25822,223793,28992,14904,267689,51916,5513071,242278,259664,330796,832738,882269,770850,2485857,3027214,295308470000,11200731000,10284139000,14185555000,35670425000,41072770000,40518755000,117261950000,178046520000
Illinois,Transportation and Warehousing,2016,71491,53494,5885,3747,63126,3959,1794,68879,2612,79085,53495,5890,3815,63200,4305,2365,69870,9215,1222903,63907,37685,48467,150649,127854,113154,395761,809795,59937640000,2288000000,1561472000,2171793000,6051017000,5876390000,5484523000,17613367000,41413641000
Illinois,Utilities,2016,920,360,90,50,500,185,60,745,175,2495,360,90,65,515,270,100,885,1610,141984,640,543,474,1862,7258,2565,13415,128118,15383199000,33179000,18943000,31088000,95347000,573467000,229249000,1013256000,14334827000
Illinois,Wholesale Trade,2016,75940,37736,10677,8347,56760,10140,4075,70975,4965,91915,37790,10760,8625,57175,12225,7375,76775,15140,1609360,60520,70095,107601,238510,329631,266274,837485,764295,121603120000,3677850000,4188373000,6831312000,14710295000,21783773000,17936673000,54623855000,66587127000
Indiana,Accommodation and Food Services,2016,47537,15380,8815,9949,34144,10740,1338,46222,1315,66845,15390,8870,10050,34310,12090,5220,51620,15225,1382820,24805,60014,137833,222675,399668,187171,811420,571250,21479405000,663745000,788508000,1843740000,3296470000,5613269000,2534548000,11478115000,9998080000
Indiana,Administrative and Support and Waste Management and Remediation Services,2016,31308,17895,5070,2995,25960,2827,883,29670,1638,37010,17905,5070,3040,26015,3105,1150,30270,6740,1082404,27373,32767,40250,100762,105558,114050,324438,756122,31555502000,1080698000,1051579000,1240841000,3388304000,3858482000,3367529000,10821895000,20649977000
Indiana,"Agriculture, Forestry, Fishing and Hunting",2016,1241,950,135,65,1150,35,20,1205,36,1340,950,135,65,1150,35,30,1215,125,7028,1508,787,744,3243,580,280,4548,2445,307712000,53867000,21948000,29940000,112027000,32776000,11252000,178987000,127056000
Indiana,"Arts, Entertainment, and Recreation",2016,10245,5530,1597,1340,8467,1352,229,10048,197,10720,5535,1625,1340,8500,1510,300,10310,410,162818,7667,10548,17895,36360,52419,28175,120928,38007,5211840000,296472000,230923000,313611000,849673000,961350000,1424056000,3542686000,1435965000
Indiana,Construction,2016,64919,40480,11905,6405,58790,4923,707,64420,499,65665,40485,11910,6410,58805,5045,910,64760,905,612560,68075,77656,85355,231235,185656,92277,512760,91116,35481775000,2821795000,3137709000,4172074000,10140665000,10901166000,6356824000,27699025000,7169698000
Indiana,Educational Services,2016,7691,3450,1400,985,5835,1190,320,7345,346,8275,3450,1430,1040,5920,1300,420,7640,635,341944,5176,9560,12882,27746,49379,42606,121864,218620,9723269000,174690000,188725000,238799000,608979000,1266760000,1328468000,3325664000,6324888000
Indiana,Finance and Insurance,2016,24165,15958,3200,1233,20391,1232,811,22434,1731,47350,15990,3280,1485,20755,2755,4575,28085,19265,505522,28890,19671,15164,63996,40659,81016,188056,314419,33642910000,1248262000,953184000,860164000,3085285000,2200981000,5073785000,10564852000,22908920000
Indiana,Health Care and Social Assistance,2016,51468,21895,11455,7278,40628,6250,2569,49447,2021,83605,21915,11530,7675,41120,8565,7460,57145,26460,2117796,40376,76398,96694,213922,248223,406363,870537,1246135,92850695000,1823149000,3040607000,4107856000,8992087000,9713763000,14524411000,33354043000,59440060000
Indiana,Information,2016,5250,2350,605,621,3576,667,277,4520,730,11035,2375,640,650,3665,830,545,5040,5995,221064,3418,3857,8279,16009,21738,19250,58532,154436,13495978000,199914000,158181000,302458000,677980000,1013515000,1031879000,2799467000,10050174000
Indiana,Management of Companies and Enterprises,2016,3181,100,75,95,270,545,1002,1817,1364,4565,100,75,95,270,555,1095,1920,2645,257930,76,315,641,1033,6015,34115,41175,216755,23839520000,7405000,19615000,68903000,96114000,386055000,2059425000,2544690000,21294830000
Indiana,Manufacturing,2016,36545,10279,5852,5524,21655,7531,3381,32567,3978,40115,10285,5860,5545,21690,7850,4010,33550,6565,2480328,19625,37300,72294,133272,300278,411272,882999,1523784,132911992000,836411000,1337824000,2857263000,5211445000,13503481000,18827695000,39212250000,89336901000
Indiana,"Mining, Quarrying, and Oil and Gas Extraction",2016,852,300,165,75,540,117,57,714,138,1425,300,175,100,575,165,120,860,565,26304,529,1021,733,2421,2827,2026,9160,17435,1650898000,41347000,39002000,40849000,129563000,151749000,108547000,486686000,1179130000
Indiana,Other,2016,183,177,4,2,183,0,0,183,0,183,177,4,2,183,0,0,183,0,222,169,30,0,222,0,0,222,0,4883000,4182000,372000,0,4883000,0,0,4883000,0
Indiana,Other Services (except Public Administration),2016,74466,44670,15590,7481,67741,5063,906,73710,756,81520,44725,15670,7920,68315,6585,2765,77665,3855,637239,86223,100511,99592,286549,176727,76268,543974,71989,17399405000,2102840000,2412484000,2560271000,7082065000,4689593000,2230744000,14209510000,2747273000
Indiana,"Professional, Scientific, and Technical Services",2016,59496,39955,8360,4860,53175,3574,1105,57854,1642,64720,39975,8400,4990,53365,4315,1570,59250,5470,642915,60185,54038,63287,177875,116437,73007,371245,262125,45888870000,2708710000,2402790000,3156547000,8283915000,6992004000,5723323000,21210830000,24068972000
Indiana,Real Estate and Rental and Leasing,2016,23373,17195,2698,1180,21073,1039,575,22687,686,31680,17200,2755,1290,21245,2165,2275,25685,5995,170208,24686,17734,15059,57818,29953,29846,118991,46987,7448735000,915235000,585092000,578032000,2090664000,1287051000,1380542000,4829454000,2488407000
Indiana,Retail Trade,2016,60879,31397,12439,7323,51159,5680,1463,58302,2577,106160,31475,12805,8140,52420,8990,6330,67740,38420,1627857,61843,82151,95653,239796,197097,126722,567187,1055046,40699406000,1506325000,1942876000,2574007000,6026296000,6723589000,4281458000,17136586000,23442535000
Indiana,Total,2016,108658,58926,19362,12557,90845,11520,3064,105429,3229,146078,59006,19572,13148,91726,14748,8716,115190,30888,2720277,100678,127492,168685,396855,433544,391973,1222372,1497905,117009032000,3703540000,4123514000,5762247000,13589301000,16214045000,16465958000,46269304000,70739728000
Indiana,Transportation and Warehousing,2016,23001,12440,3125,2290,17855,2326,923,21104,1897,26455,12455,3125,2305,17885,2495,1100,21480,4975,616737,18897,20357,30350,70122,75595,53406,204814,408283,26643356000,824293000,785681000,1275921000,2900405000,3232768000,2199815000,8566305000,17939183000
Indiana,Utilities,2016,945,325,175,105,605,185,30,820,125,2705,325,175,105,605,245,85,935,1770,74718,723,1074,1430,3297,7822,2309,14551,53879,7086746000,25904000,45594000,80275000,157402000,586071000,244506000,1070448000,5440060000
Indiana,Wholesale Trade,2016,30253,13277,4265,3305,20847,4279,2153,27279,2974,38285,13310,4310,3485,21105,5140,3620,29865,8420,590795,21679,27991,42851,93153,130285,102273,330805,252316,34913037000,1107102000,1334785000,2236514000,4704839000,7027577000,5598486000,17553087000,16878114000
Iowa,Accommodation and Food Services,2016,28283,9966,5525,5865,21356,5485,745,27586,697,35715,9975,5550,5955,21480,6400,2905,30785,4930,607160,16105,37313,79804,133395,194291,94649,422830,184114,9212580000,386775000,445540000,1003639000,1839165000,2621161000,1343345000,5810995000,3397532000
Iowa,Administrative and Support and Waste Management and Remediation Services,2016,16231,10000,2295,1457,13752,1170,375,15297,934,18565,10010,2300,1475,13785,1335,485,15605,2960,356490,14661,14854,19032,49149,39104,45408,138546,211942,11265393000,592409000,470549000,674275000,1758091000,1257186000,1214299000,4397998000,6661609000
Iowa,"Agriculture, Forestry, Fishing and Hunting",2016,1535,1210,145,80,1435,30,45,1510,25,1785,1210,145,80,1435,40,165,1640,145,12684,1523,789,787,3310,496,2591,7434,3914,668918000,87420000,38685000,35163000,169952000,21110000,141693000,381763000,216586000
Iowa,"Arts, Entertainment, and Recreation",2016,6972,4110,1130,765,6005,685,170,6860,112,7235,4120,1130,775,6025,730,235,6990,245,101945,5788,7683,9910,23730,24375,23591,75026,21519,1875013000,176127000,129196000,166172000,483264000,404801000,391422000,1376664000,353779000
Iowa,Construction,2016,42568,28345,6984,3710,39039,2799,432,42270,298,43100,28360,6990,3720,39070,2925,565,42560,540,334370,44924,45636,50205,140805,103227,46900,294045,38406,19472305000,1932473000,1944382000,2630790000,6513195000,6214668000,3282172000,16185245000,3156367000
Iowa,Educational Services,2016,3571,1565,575,485,2625,580,178,3383,188,4040,1565,585,495,2645,630,405,3680,360,176200,2431,3894,6611,13185,22368,25664,63261,112264,4377606000,61052000,78739000,91002000,240583000,486907000,710349000,1535646000,2822106000
Iowa,Finance and Insurance,2016,17993,11464,2357,1053,14874,1295,625,16794,1199,31120,11500,2420,1350,15270,3810,3320,22400,8720,488156,19924,14284,12819,47458,45296,60743,157221,326525,34434170000,830303000,661759000,701097000,2217881000,2439267000,3874379000,8816144000,25286586000
Iowa,Health Care and Social Assistance,2016,28999,12885,4965,3585,21435,4395,1906,27736,1263,42835,12915,5040,3780,21735,6295,6560,34590,8245,1120214,23058,32820,47974,104280,180368,273044,559404,558547,45683332000,1124154000,1389511000,2090469000,4653624000,6180492000,9609598000,20518909000,25035734000
Iowa,Information,2016,4295,1820,699,526,3045,480,202,3727,568,7650,1830,710,535,3075,735,540,4350,3300,147136,3177,4703,6797,14901,14675,13103,44019,99102,7905226000,108527000,155794000,263722000,536391000,636140000,571307000,1837306000,5660186000
Iowa,Management of Companies and Enterprises,2016,1947,60,30,100,190,406,642,1238,709,2500,60,30,100,190,410,680,1280,1220,122840,10,80,330,440,5635,18955,25030,97810,9338285000,2570000,4388000,14280000,22335000,310445000,1297875000,1630655000,7707630000
Iowa,Manufacturing,2016,15325,4865,2510,1970,9345,2794,1391,13530,1795,17425,4865,2510,1980,9355,2975,2010,14340,3085,973001,9152,15126,23304,50789,100615,135900,322161,572541,50556180000,301002000,515487000,921448000,1866931000,4668767000,6602517000,14794904000,30379707000
Iowa,"Mining, Quarrying, and Oil and Gas Extraction",2016,382,145,60,20,225,67,48,340,42,950,145,60,20,225,140,210,575,375,9887,212,374,194,875,2468,3313,6949,2883,604718000,9715000,17294000,10034000,41954000,145535000,199637000,402092000,197679000
Iowa,Other,2016,141,136,3,2,141,0,0,141,0,141,136,3,2,141,0,0,141,0,178,126,24,0,178,0,0,178,0,3044000,2663000,329000,0,3044000,0,0,3044000,0
Iowa,Other Services (except Public Administration),2016,42628,27975,8480,3557,40012,1868,380,42260,368,45475,28060,8740,3900,40700,2555,975,44230,1245,261120,53301,54170,45864,153798,62157,23911,242685,13214,7014694000,1244215000,1257280000,1142455000,3658059000,1807248000,653722000,6207954000,564189000
Iowa,"Professional, Scientific, and Technical Services",2016,29198,19128,4450,2367,25945,1763,522,28230,968,31820,19135,4460,2450,26045,2335,905,29285,2535,275832,29871,28654,30388,89536,54326,29332,177689,94775,16566036000,1337072000,1216974000,1470082000,4072737000,3515032000,2050624000,9907429000,6450434000
Iowa,Real Estate and Rental and Leasing,2016,11890,9130,1115,478,10723,470,287,11480,410,14785,9130,1120,575,10825,910,930,12665,2120,68395,12353,7089,5741,25621,12063,10024,51721,14804,2742825000,448354000,233820000,185536000,890184000,509178000,518964000,2127821000,566694000
Iowa,Retail Trade,2016,36242,17745,7635,4662,30042,3507,964,34513,1729,58065,17800,7770,5115,30685,5545,3250,39480,18585,899112,32470,50155,58784,141740,110976,64791,320975,572518,22129830000,816565000,1195412000,1566452000,3586940000,3619964000,2397216000,9712619000,12259237000
Iowa,Total,2016,62639,35697,10654,6773,53124,5933,1633,60690,1949,81563,35768,10812,7207,53787,8558,5714,68059,13504,1354487,59465,69999,90263,219727,221076,210832,651635,702852,56930435000,2123372000,2217286000,3081812000,7422470000,8304382000,8845313000,24572165000,32358270000
Iowa,Transportation and Warehousing,2016,15943,10295,2075,1245,13615,1070,399,15084,859,17820,10295,2090,1265,13650,1285,500,15435,2385,286770,14963,13718,15953,45221,32919,21671,102243,183625,12043009000,527498000,488424000,617690000,1651800000,1432419000,1006360000,4166569000,7788032000
Iowa,Utilities,2016,462,75,50,65,190,155,27,372,90,1375,75,50,65,190,325,75,590,785,38294,113,291,853,1299,5685,424,8081,20394,3180810000,4251000,13709000,51734000,71125000,394771000,30300000,549278000,1806795000
Iowa,Wholesale Trade,2016,17213,7075,2304,2252,11631,2423,1320,15374,1839,24850,7110,2345,2390,11845,3410,3855,19110,5740,341811,11798,14969,27883,55684,72264,80283,215523,117664,18322070000,566864000,704037000,1402165000,2713883000,3836432000,4357855000,11275826000,6585692000
Kansas,Accommodation and Food Services,2016,21789,7070,4100,4214,15384,4841,648,20873,916,30630,7070,4110,4285,15465,5445,2070,22980,7650,574955,11380,27542,57895,96875,176308,72876,346805,227867,8494559000,269973000,324499000,729379000,1324963000,2494409000,1053791000,4882783000,3607735000
Kansas,Administrative and Support and Waste Management and Remediation Services,2016,16375,9355,2490,1500,13345,1458,518,15321,1054,18525,9360,2490,1530,13380,1520,620,15520,3005,408073,14697,16371,20060,51494,54764,57156,165499,240162,13793532000,560372000,484490000,742428000,1801616000,1944033000,1637730000,5480216000,8196268000
Kansas,"Agriculture, Forestry, Fishing and Hunting",2016,905,670,85,85,840,45,15,900,5,905,670,85,85,840,45,15,900,5,4293,1039,502,883,2658,1427,14,4143,0,157314000,38569000,16642000,42839000,104359000,48854000,544000,155529000,0
Kansas,"Arts, Entertainment, and Recreation",2016,5005,2865,645,660,4170,600,110,4880,125,5300,2865,645,665,4175,675,115,4965,335,80499,4437,4330,8640,17602,23784,11671,56100,19296,1556998000,112511000,81255000,132019000,330909000,402304000,276862000,1081711000,328863000
Kansas,Construction,2016,34531,21445,6400,3405,31250,2526,420,34196,335,34940,21445,6415,3405,31265,2565,460,34290,650,325405,36440,41695,45945,124315,96938,43095,267170,55097,16643050000,1367650000,1641182000,2017617000,5036865000,5401902000,2454010000,13046960000,3412080000
Kansas,Educational Services,2016,3426,1440,580,485,2505,545,203,3253,173,3640,1440,580,490,2510,560,285,3355,285,102062,2169,3684,6515,12529,22293,31204,67900,27965,2826899000,58678000,66343000,121238000,252605000,550549000,763784000,1630490000,876204000
Kansas,Finance and Insurance,2016,18373,12020,2090,999,15109,1197,562,16868,1505,30110,12040,2135,1330,15505,3185,2745,21435,8675,301718,21007,12936,12957,47476,43510,50188,142909,153854,20697991000,852541000,642276000,747766000,2278493000,2589354000,3540410000,8561081000,11833408000
Kansas,Health Care and Social Assistance,2016,30554,14590,5530,3763,23883,3842,1649,29374,1180,41575,14610,5565,3945,24120,5020,4810,33950,7625,958173,25371,37176,50302,113082,154125,244324,513866,439165,40080656000,1134760000,1457355000,2066581000,4664601000,5775876000,8831164000,19368564000,20468506000
Kansas,Information,2016,3715,1496,460,420,2376,485,223,3084,631,7155,1540,460,435,2435,725,570,3730,3425,153286,2502,2924,5332,11135,15181,16710,46645,106197,10397784000,156569000,109417000,215716000,495231000,723536000,742776000,2075860000,8301608000
Kansas,Management of Companies and Enterprises,2016,2329,145,35,85,265,440,627,1332,997,3275,145,35,85,265,455,685,1405,1870,114745,150,186,364,710,4910,18355,23975,90732,10838100000,27345000,15167000,28963000,71810000,358965000,1334245000,1765020000,9065978000
Kansas,Manufacturing,2016,12945,3950,2185,1854,7989,2312,1220,11521,1424,13955,3950,2200,1865,8015,2480,1500,11995,1960,743424,6916,13302,22333,45913,81960,128056,286406,426584,40543146000,324351000,465916000,881927000,1812023000,3712535000,6119996000,13078860000,25834013000
Kansas,"Mining, Quarrying, and Oil and Gas Extraction",2016,4644,2905,805,384,4094,292,65,4451,193,4950,2905,805,410,4120,360,95,4575,375,37828,5301,5166,4938,15439,8611,3818,28927,8862,2142671000,207691000,230773000,236902000,677112000,520230000,198948000,1445394000,694846000
Kansas,Other,2016,148,142,4,2,148,0,0,148,0,148,142,4,2,148,0,0,148,0,198,151,27,0,198,0,0,198,0,3618000,3381000,185000,0,3618000,0,0,3618000,0
Kansas,Other Services (except Public Administration),2016,37029,23890,7254,3060,34204,2075,359,36638,391,39195,23930,7300,3165,34395,2570,845,37810,1385,254729,44275,46657,39034,130361,70549,29390,235676,16938,6749415000,1056137000,1113588000,1004181000,3186847000,1839910000,947607000,6192278000,511066000
Kansas,"Professional, Scientific, and Technical Services",2016,32546,21760,4520,2557,28837,1782,672,31291,1255,35730,21760,4545,2630,28935,2240,1065,32240,3490,326996,34030,29585,33011,97135,54490,48509,204300,120779,20623363000,1621570000,1342716000,1722516000,4711925000,3395059000,3237113000,11575020000,8940041000
Kansas,Real Estate and Rental and Leasing,2016,13130,9993,1250,610,11853,500,288,12641,489,16465,10035,1285,685,12005,795,1080,13880,2585,74890,13695,7852,7675,29580,12478,11952,54358,18793,3037936000,509607000,276090000,307891000,1106667000,485582000,419138000,2033532000,948267000
Kansas,Retail Trade,2016,33976,16478,7820,3974,28272,2975,821,32068,1908,50985,16525,7995,4230,28750,4255,2360,35365,15620,729248,31820,51376,49884,133514,90446,59994,288545,436901,18073471000,766247000,1155305000,1203826000,3133576000,2848618000,2105644000,8215903000,9743312000
Kansas,Total,2016,58246,32712,9948,6138,48798,5606,1639,56043,2203,74884,32776,10065,6439,49280,7553,4598,61431,13453,1184710,55481,65519,81692,202692,206357,195166,604215,580495,51016318000,2023269000,2110930000,2840002000,6974201000,7800009000,8285634000,23059844000,27956474000
Kansas,Transportation and Warehousing,2016,10740,6105,1372,1004,8481,894,349,9724,1016,12835,6130,1375,1025,8530,935,565,10030,2805,259559,9174,8893,12922,31438,26636,19097,81542,171254,10169209000,341956000,313201000,488954000,1158822000,1054783000,882180000,3348371000,6526846000
Kansas,Utilities,2016,363,60,20,45,125,85,42,252,111,1225,60,20,45,125,135,300,560,665,35232,121,50,578,873,3080,3989,8391,20724,3360388000,5109000,1920000,40303000,53379000,242260000,345411000,679354000,2047655000
Kansas,Wholesale Trade,2016,16268,6675,2189,1792,10656,2469,1180,14305,1963,22285,6690,2260,1875,10825,3800,2805,17430,4855,311935,11391,13718,21761,47890,68803,60261,183378,125393,18582923000,641434000,686907000,1168195000,2548434000,3736709000,3352740000,9988635000,8391303000
Kentucky,Accommodation and Food Services,2016,28621,8595,5259,5608,19462,7055,982,27499,1122,40230,8600,5285,5660,19545,8050,3370,30965,9265,869955,13340,35390,77353,126295,257249,130696,514730,355040,13057110000,390110000,475799000,1063777000,1936115000,3670741000,1797538000,7414055000,5639365000
Kentucky,Administrative and Support and Waste Management and Remediation Services,2016,17035,9345,2750,1495,13590,1600,588,15778,1257,20565,9345,2750,1515,13610,1705,745,16060,4505,606125,14533,18055,19965,53135,56703,70454,184383,420341,15268853000,525105000,553977000,699922000,1804807000,1894217000,1680888000,5531861000,9672554000
Kentucky,"Agriculture, Forestry, Fishing and Hunting",2016,1165,800,200,70,1070,35,40,1145,20,1165,800,200,70,1070,35,40,1145,20,7386,1117,1248,800,3278,768,2264,6792,140,239887000,36406000,38491000,24491000,103017000,22509000,84265000,225164000,2891000
Kentucky,"Arts, Entertainment, and Recreation",2016,6290,3360,1045,745,5150,835,173,6158,132,6620,3360,1055,770,5185,915,240,6340,280,87813,4999,6947,9466,21794,32607,16992,74614,10883,2172830000,159855000,145667000,192461000,508001000,637609000,458706000,1702484000,273571000
Kentucky,Construction,2016,35691,21855,6300,3695,31850,2995,513,35358,333,36180,21855,6300,3705,31860,3100,655,35615,565,349040,37115,41193,49710,128095,110705,65411,310020,34096,17891280000,1384710000,1503930000,2216787000,5110990000,6069633000,3977997000,15504945000,2094228000
Kentucky,Educational Services,2016,3937,1745,725,480,2950,555,220,3725,212,4550,1750,725,505,2980,575,335,3890,660,144035,2829,4775,6190,14155,20710,35306,72730,70995,3833500000,75567000,83078000,122576000,293830000,467427000,1033627000,1912015000,1905720000
Kentucky,Finance and Insurance,2016,15496,9380,2420,805,12605,984,538,14127,1369,31955,9395,2470,995,12860,2745,3425,19030,12925,371393,17573,14643,9890,42572,35219,45162,124578,245589,24319160000,755106000,633336000,512926000,1927346000,1835192000,2430103000,6310969000,17893836000
Kentucky,Health Care and Social Assistance,2016,46631,25405,8670,5477,39552,4059,1475,45086,1545,64390,25455,8710,5720,39885,5345,4720,49950,14440,1276559,43856,57646,73533,175260,155183,183754,516081,757129,57219774000,1802930000,2160812000,2782277000,6754513000,6371073000,6295318000,19519592000,37566380000
Kentucky,Information,2016,3859,1680,530,435,2645,437,210,3292,567,7995,1690,550,450,2690,645,395,3730,4265,151576,2788,3392,5569,11967,13823,9616,38596,112655,6905533000,124732000,114144000,185480000,433075000,561397000,458599000,1616654000,5269143000
Kentucky,Management of Companies and Enterprises,2016,2294,130,56,55,241,380,631,1252,1042,3500,130,60,55,245,380,700,1325,2175,155805,82,238,303,675,4270,16605,21550,134194,13669030000,17874000,14783000,32935000,70195000,284195000,1229155000,1583545000,12080745000
Kentucky,Manufacturing,2016,16816,5060,2470,2090,9620,3164,1534,14318,2498,18480,5060,2470,2090,9620,3475,1880,14975,3505,1127115,9005,15295,25489,53106,110174,144640,346756,728784,58845323000,336443000,490704000,922295000,1874877000,4700729000,7102052000,15569886000,40571509000
Kentucky,"Mining, Quarrying, and Oil and Gas Extraction",2016,1711,730,210,215,1155,293,118,1566,145,2130,730,210,215,1155,315,225,1695,435,50416,1176,1291,2654,5277,10289,8120,24380,25962,3203358000,87801000,50519000,123373000,266916000,557242000,459200000,1330892000,1867204000
Kentucky,Other,2016,420,411,6,3,420,0,0,420,0,420,411,6,3,420,0,0,420,0,541,456,46,39,541,0,0,541,0,9198000,8379000,426000,393000,9198000,0,0,9198000,0
Kentucky,Other Services (except Public Administration),2016,43345,27715,8510,3777,40002,2392,415,42809,536,47260,27735,8535,4050,40320,3315,1225,44860,2400,333888,52859,55024,49747,158053,80387,25733,268528,58068,8923781000,1262491000,1320794000,1269860000,3867814000,2282339000,772657000,7061966000,1750374000
Kentucky,"Professional, Scientific, and Technical Services",2016,37882,25290,5510,2995,33795,2170,781,36746,1136,40995,25310,5515,3070,33895,2600,1055,37550,3445,372883,40846,35914,39332,116624,68859,51601,240533,128462,17905812000,1686261000,1505583000,1920253000,5138452000,3838045000,2964039000,12137047000,5621250000
Kentucky,Real Estate and Rental and Leasing,2016,14838,11040,1613,693,13346,577,380,14303,535,18965,11050,1685,790,13525,1005,1045,15575,3390,90904,16897,10001,8537,35840,16856,8213,62428,26688,3746851000,670512000,330053000,332272000,1349675000,633684000,288841000,2333064000,1352507000
Kentucky,Retail Trade,2016,46022,23983,9695,5224,38902,4067,990,43959,2063,75305,24085,9820,5675,39580,6180,3290,49050,26255,1011466,45200,63445,67682,176689,138994,63704,386106,600220,25486966000,1061117000,1539513000,1857313000,4464198000,4651198000,2386862000,11699956000,13169284000
Kentucky,Total,2016,68726,38245,11992,7349,57586,6762,1859,66207,2519,92000,38307,12093,7710,58110,8860,5204,72174,19826,1603173,65886,78895,98216,242997,247913,211144,702054,901119,65242827000,2272711000,2417588000,3239943000,7930242000,8915505000,8461086000,25306833000,39935994000
Kentucky,Transportation and Warehousing,2016,11692,6000,1600,1160,8760,1082,488,10330,1362,14520,6000,1600,1190,8790,1150,630,10570,3950,386457,9847,10489,14064,35218,35449,27653,103784,279106,18216693000,341603000,348563000,548427000,1261501000,1421343000,1307652000,4239392000,13711024000
Kentucky,Utilities,2016,480,135,45,45,225,75,60,360,120,1675,135,45,45,225,140,260,625,1050,42486,262,273,491,1136,4189,5941,12194,29835,3801506000,11413000,8235000,17794000,41563000,292537000,407011000,778651000,2988968000
Kentucky,Wholesale Trade,2016,16840,6967,2409,1846,11222,2223,1159,14604,2236,21420,6995,2450,1965,11410,2625,1785,15820,5600,357503,11938,15425,22220,50791,62795,54856,178288,170057,20220512000,542410000,640805000,1066606000,2302007000,3282709000,2909946000,9010362000,10602185000
Louisiana,Accommodation and Food Services,2016,35762,11321,7005,7107,25433,8392,989,34814,948,47740,11340,7065,7200,25605,9115,3790,38510,9230,1091445,19545,48609,98565,166770,308276,161841,637435,452627,19241840000,583900000,680033000,1444996000,2709685000,4893850000,2862380000,10473375000,8751996000
Louisiana,Administrative and Support and Waste Management and Remediation Services,2016,20391,10920,3270,2092,16282,2236,763,19281,1110,23705,10920,3280,2125,16325,2485,995,19805,3900,526910,18011,21597,27735,67700,85413,86496,243179,280885,19249590000,700173000,716486000,1015728000,2442441000,2976014000,2721845000,8287099000,10857454000
Louisiana,"Agriculture, Forestry, Fishing and Hunting",2016,2924,1676,670,355,2701,170,20,2891,33,2980,1680,670,355,2705,170,30,2905,75,20393,2730,4365,4301,11596,4420,139,17268,725,869245000,111315000,173547000,182826000,477117000,202037000,8926000,782490000,21424000
Louisiana,"Arts, Entertainment, and Recreation",2016,6778,3680,1140,702,5522,930,180,6632,146,7195,3680,1140,710,5530,1035,300,6865,330,125436,6050,7657,9275,23440,33798,21954,84505,24337,3684342000,226373000,162553000,160830000,564115000,618186000,962748000,2848825000,564298000
Louisiana,Construction,2016,39958,23110,7347,4490,34947,3720,684,39351,607,40470,23110,7350,4495,34955,3780,770,39505,965,677715,38745,48003,60498,147365,146245,86523,383500,276454,40706840000,1599945000,1834436000,2578267000,6017295000,7844137000,5312979000,19467595000,20081315000
Louisiana,Educational Services,2016,5697,2115,855,720,3690,1415,378,5483,214,6205,2120,855,755,3730,1550,515,5795,410,219645,3317,5635,9760,18835,66758,55508,143910,75282,7866855000,106333000,173141000,215025000,499749000,1974882000,2013753000,4585405000,3263828000
Louisiana,Finance and Insurance,2016,19616,11845,3460,1302,16607,1175,604,18386,1230,37800,11870,3610,1640,17120,3625,4605,25350,12450,322157,21509,21992,16321,60394,44077,57061,163043,157233,21319119000,1037676000,1031172000,816801000,2943748000,2542711000,3546323000,9167352000,11993455000
Louisiana,Health Care and Social Assistance,2016,49483,22510,10585,6553,39648,6368,2196,48212,1271,61950,22565,10645,6830,40040,8175,5100,53315,8635,1473205,39298,70009,86843,196369,257470,323155,780479,692393,62162670000,2503415000,2750613000,3378939000,8637752000,8226850000,10776022000,27784727000,34364817000
Louisiana,Information,2016,3458,1555,435,383,2373,457,148,2978,480,7600,1585,440,420,2445,620,375,3440,4160,150474,2444,2630,4574,10309,15495,7791,36048,100854,6362617000,96378000,112421000,194993000,423263000,784531000,340022000,1686930000,4645786000
Louisiana,Management of Companies and Enterprises,2016,2446,155,61,70,286,525,723,1534,912,3290,155,65,70,290,530,745,1565,1725,127895,185,335,173,695,7950,29995,38640,89203,10229015000,22360000,17270000,6523000,46155000,439590000,1866660000,2352405000,7868283000
Louisiana,Manufacturing,2016,14757,5195,2590,2185,9970,2469,869,13308,1449,16045,5200,2590,2185,9975,2610,1235,13820,2225,565442,9571,15500,27020,55236,83838,76059,237141,292482,39122902000,426315000,537884000,1117979000,2216455000,4094806000,4622110000,12046261000,24586592000
Louisiana,"Mining, Quarrying, and Oil and Gas Extraction",2016,5973,2845,789,635,4269,795,377,5441,532,7600,2855,795,650,4300,925,515,5740,1860,215107,4538,5095,8487,18190,26959,35572,80828,134279,16421471000,277894000,293020000,475345000,1048684000,1838936000,2503422000,5398451000,11023020000
Louisiana,Other,2016,138,128,7,2,137,1,0,138,0,138,128,7,2,137,1,0,138,0,232,137,44,0,205,0,0,232,0,4813000,2980000,654000,0,4701000,0,0,4813000,0
Louisiana,Other Services (except Public Administration),2016,45386,26820,9835,4409,41064,3197,502,44763,623,48680,26825,9925,4610,41360,4015,875,46250,2430,379040,51872,63450,56935,172575,117252,38482,333330,36160,11423515000,1373265000,1594129000,1614603000,4590605000,3272991000,1417759000,9450780000,1710017000
Louisiana,"Professional, Scientific, and Technical Services",2016,54341,37208,7638,4144,48990,3174,832,52996,1345,59740,37215,7685,4245,49145,3760,1345,54250,5490,485540,56790,49494,54313,160985,104603,71961,342280,138504,31092485000,2968155000,2438041000,3226386000,8652380000,7079468000,5018545000,21027210000,9880356000
Louisiana,Real Estate and Rental and Leasing,2016,18554,13350,2169,962,16481,967,506,17954,600,24885,13360,2230,1085,16675,1415,2770,20860,4025,153670,20475,13581,11919,46344,28475,27747,105458,46836,6930378000,730294000,494968000,542173000,1782217000,1387309000,1259698000,4545389000,2333197000
Louisiana,Retail Trade,2016,51426,26802,10891,5985,43678,4883,989,49550,1876,82770,26925,11125,6575,44625,7085,2925,54635,28135,1129663,53175,71683,78526,203750,178447,86030,474390,647206,28942523000,1347712000,1742093000,2210822000,5308465000,5873517000,3295961000,14645385000,14084609000
Louisiana,Total,2016,81020,43682,14853,9230,67765,8812,2128,78705,2315,105732,43766,15036,9701,68503,11283,6132,85918,19814,1709226,75725,97838,123604,297167,334313,271278,902758,806468,75125447000,3088915000,3307990000,4421108000,10818013000,12463535000,11969816000,35251364000,39874083000
Louisiana,Transportation and Warehousing,2016,15122,8004,2035,1510,11549,1518,685,13752,1370,19410,8035,2035,1560,11630,1640,990,14260,5150,339956,12766,12810,20191,46303,50060,50595,152101,161875,19201855000,538984000,529471000,849794000,1936151000,2454443000,3216642000,7827192000,9855468000
Louisiana,Utilities,2016,1010,540,235,45,820,50,38,908,102,2630,540,235,50,825,85,155,1065,1565,56075,1151,1457,459,3191,1783,4976,11260,36386,4988367000,30288000,44098000,17740000,96298000,93762000,280089000,531034000,3615730000
Louisiana,Wholesale Trade,2016,20781,8185,3345,2777,14307,3056,1306,18669,2112,27275,8210,3405,2935,14550,3790,2625,20965,6310,378612,14976,21682,35033,72620,91840,63243,234206,138173,21259294000,691568000,1084593000,1763986000,3577906000,4820725000,3489281000,12259744000,8684759000
Maine,Accommodation and Food Services,2016,18339,8685,3130,3225,15040,2745,263,18048,291,20870,8705,3130,3270,15105,3310,1070,19485,1385,259018,9554,20788,44275,74775,94518,34412,204535,53746,5724834000,670814000,512554000,949413000,2135390000,1916389000,676600000,4749960000,963330000
Maine,Administrative and Support and Waste Management and Remediation Services,2016,10198,6815,1295,710,8820,673,168,9661,537,11025,6820,1295,740,8855,795,230,9880,1145,122556,9638,8347,9150,27914,24500,15351,72588,49132,3726855000,392650000,247103000,320672000,987006000,784021000,474603000,2421676000,1260634000
Maine,"Agriculture, Forestry, Fishing and Hunting",2016,4505,3800,370,165,4335,140,20,4495,10,4550,3800,370,165,4335,155,40,4530,20,15800,4277,2378,1888,8797,4522,370,15565,0,731377000,182573000,87716000,82542000,362638000,208397000,23208000,707182000,0
Maine,"Arts, Entertainment, and Recreation",2016,4357,2905,565,395,3865,380,67,4312,45,4455,2905,565,395,3865,420,125,4410,45,39059,3677,3539,4778,12505,13860,6151,34156,2456,934317000,183116000,105202000,121155000,428167000,311376000,80341000,856198000,46837000
Maine,Construction,2016,24603,18580,3210,1602,23392,1006,107,24505,98,24705,18580,3210,1605,23395,1040,120,24555,150,127530,28674,20329,20935,70340,33863,8924,117630,5523,6693950000,1158985000,840476000,1016965000,3035305000,1955133000,642213000,5924030000,433099000
Maine,Educational Services,2016,2373,1175,360,305,1840,295,135,2270,103,2475,1175,360,305,1840,300,165,2305,170,89759,1772,2412,4166,8433,11419,16677,38174,51388,2819380000,54936000,55203000,100024000,213155000,344216000,582125000,1232160000,1580533000
Maine,Finance and Insurance,2016,4594,2330,580,290,3200,436,227,3863,731,9350,2335,590,345,3270,1205,1365,5840,3510,141191,4298,3364,3429,11420,17108,21179,51792,84021,9291322000,198556000,164809000,211127000,599893000,982428000,1333599000,3051936000,5825065000
Maine,Health Care and Social Assistance,2016,15949,7600,2893,2020,12513,1726,959,15198,751,23935,7610,2915,2110,12635,2830,3535,19000,4935,557091,13501,19193,27257,60547,70310,118551,250889,299326,24445758000,487552000,760507000,1113579000,2390125000,2283886000,3691981000,8440936000,15710864000
Maine,Information,2016,2715,1335,380,265,1980,280,108,2368,347,4040,1340,385,270,1995,335,260,2590,1450,59325,2181,2253,3418,8081,7771,6985,27142,31392,3214410000,65282000,88743000,133501000,297057000,339517000,278770000,1196560000,1989253000
Maine,Management of Companies and Enterprises,2016,837,50,40,15,105,175,281,561,276,1075,50,40,15,105,175,295,575,500,48284,55,160,40,255,1573,8159,9994,38230,4204022000,2040000,12245000,4135000,18420000,83025000,407227000,509482000,3691972000
Maine,Manufacturing,2016,8081,3555,1440,955,5950,1228,416,7594,487,8300,3555,1440,955,5950,1280,475,7705,595,214610,5782,8373,10240,27250,39317,31345,114664,72392,10826628000,201202000,273634000,381004000,955146000,1792309000,1443313000,4962393000,4300088000
Maine,"Mining, Quarrying, and Oil and Gas Extraction",2016,106,70,10,5,85,15,0,100,6,110,70,10,5,85,15,0,100,10,548,70,0,0,219,224,0,503,0,29328000,5025000,0,0,11320000,9324000,0,23549000,0
Maine,Other,2016,88,81,7,0,88,0,0,88,0,88,81,7,0,88,0,0,88,0,148,100,48,0,148,0,0,148,0,3001000,2396000,605000,0,3001000,0,0,3001000,0
Maine,Other Services (except Public Administration),2016,17508,11925,3345,1183,16453,612,163,17228,280,18530,11930,3365,1265,16560,890,405,17855,675,93215,21985,21184,14960,58555,17927,6995,86544,4407,2785190000,590566000,578169000,440096000,1626833000,588094000,182964000,2497234000,205347000
Maine,"Professional, Scientific, and Technical Services",2016,16628,11250,2453,1148,14851,845,222,15918,710,17580,11250,2470,1175,14895,1040,290,16225,1355,114606,17780,15880,14545,48785,25323,10969,89527,21848,7118008000,812280000,751694000,800072000,2391425000,1677517000,942906000,5313334000,1620078000
Maine,Real Estate and Rental and Leasing,2016,7763,6160,768,320,7248,244,55,7547,216,8580,6160,785,350,7295,350,180,7825,755,33267,7901,4812,3571,16576,6430,1549,26617,5087,1383378000,353788000,197389000,141674000,703784000,233012000,66612000,1096674000,216325000
Maine,Retail Trade,2016,21854,11062,4415,2893,18370,1799,442,20611,1243,31310,11100,4515,3090,18705,2630,1770,23105,8205,406989,19101,29570,36995,86519,55727,37661,186604,208157,10873335000,565649000,744173000,991334000,2326955000,1843383000,1454496000,5830105000,4726573000
Maine,Total,2016,33927,20896,5378,3281,29555,2605,637,32797,1130,41178,20924,5433,3432,29789,3633,2253,35675,5503,511936,32366,35339,43938,111643,95775,81738,289156,222780,21349199000,1284316000,1191555000,1533854000,4009725000,3575029000,3277621000,10862375000,10486824000
Maine,Transportation and Warehousing,2016,5673,3490,775,445,4710,459,140,5309,364,6150,3490,780,455,4725,530,190,5445,705,78124,4775,4729,4967,15264,15066,5667,42149,28157,3214547000,191202000,157269000,177797000,551585000,569354000,239715000,1552035000,1309081000
Maine,Utilities,2016,232,80,30,10,120,15,35,170,62,560,80,40,10,130,15,130,275,285,12425,125,165,0,483,270,1395,3141,5263,1035621000,4391000,5052000,0,25135000,16580000,98419000,206804000,479348000
Maine,Wholesale Trade,2016,6825,3260,850,593,4703,715,426,5844,981,7850,3260,865,635,4760,850,620,6230,1620,88755,5318,5098,6442,18154,16413,16029,56070,29529,4788286000,250548000,224333000,315489000,858189000,821296000,855581000,2861970000,1738569000
Maryland,Accommodation and Food Services,2016,46397,17541,8620,8150,34311,9829,1070,45210,1187,58965,17545,8650,8215,34410,10675,2835,47920,11045,1147573,30370,57444,111510,199450,373268,131845,705219,440965,22366754000,1004545000,1000592000,1960562000,3968170000,7051365000,2526592000,13560697000,8775906000
Maryland,Administrative and Support and Waste Management and Remediation Services,2016,36491,20200,5520,3645,29365,4107,1258,34730,1761,42015,20215,5525,3680,29420,4240,1520,35180,6835,974099,31413,36536,48570,116991,157559,156289,434130,537995,39401390000,1358646000,1418135000,1933667000,4734701000,6324160000,5911156000,17144753000,22143583000
Maryland,"Agriculture, Forestry, Fishing and Hunting",2016,1020,780,130,50,960,35,5,1000,20,1020,780,130,50,960,35,5,1000,20,6275,1281,836,506,2796,759,0,4101,864,236675000,40593000,24034000,21874000,94020000,30302000,0,146830000,35754000
Maryland,"Arts, Entertainment, and Recreation",2016,9668,5250,1380,1135,7765,1355,282,9402,266,10580,5255,1380,1150,7785,1470,415,9670,910,194051,6740,8748,14977,30975,52053,37970,126256,63063,5979800000,385618000,222956000,305194000,931887000,1304190000,900149000,3308648000,2592719000
Maryland,Construction,2016,69948,43740,10770,7115,61625,6544,1149,69318,630,70470,43740,10775,7115,61630,6595,1305,69530,940,751420,69895,70491,97275,237695,249523,152132,641570,107648,44742045000,3245870000,3204876000,5155832000,11608340000,15071992000,9638565000,36446705000,8129457000
Maryland,Educational Services,2016,9983,4720,1485,1317,7522,1598,571,9691,292,10855,4725,1490,1385,7600,1680,890,10170,685,419525,7358,9962,17745,35118,66378,80052,182470,235728,20272485000,280770000,273902000,439590000,995465000,2096472000,3665422000,6939470000,13303571000
Maryland,Finance and Insurance,2016,20993,12395,3285,1343,17023,1349,806,19178,1815,37325,12415,3320,1525,17260,2740,2695,22695,14630,500755,21799,20735,17005,59867,49124,65411,176003,319265,48269539000,1540809000,1366697000,1593015000,4528795000,4643115000,5970589000,15308693000,32629182000
Maryland,Health Care and Social Assistance,2016,62731,30280,13795,7947,52022,6663,2217,60902,1829,82810,30370,14020,8320,52710,9430,8110,70250,12560,1848749,56825,91246,106854,255112,244097,330380,832193,1012449,92724346000,2963024000,4291472000,5111752000,12370264000,11406010000,12469629000,36400302000,56106380000
Maryland,Information,2016,7086,3600,815,550,4965,790,351,6106,980,12865,3605,815,575,4995,865,495,6355,6510,262052,5285,5183,6769,17867,25503,33403,79947,181109,21081150000,311175000,325395000,473644000,1157280000,1803633000,2497822000,5644295000,15348743000
Maryland,Management of Companies and Enterprises,2016,3115,210,35,86,331,517,905,1753,1362,6365,210,35,90,335,540,970,1845,4520,280048,205,195,615,1015,6449,35174,42638,237410,27456516000,63350000,15615000,103140000,182105000,579212000,3190814000,3952131000,23504385000
Maryland,Manufacturing,2016,14134,5665,2375,1874,9914,2232,883,13029,1105,14735,5665,2375,1875,9915,2315,1050,13280,1455,445137,9704,14253,21941,49830,74301,68447,216015,191221,28199552000,426479000,585087000,932828000,2147130000,3794674000,3765351000,11001449000,14484709000
Maryland,"Mining, Quarrying, and Oil and Gas Extraction",2016,292,80,40,25,145,50,33,228,64,360,80,40,25,145,50,75,270,90,5010,115,206,146,570,1201,931,3464,1206,400605000,7190000,8440000,7756000,28521000,73035000,61063000,207611000,101022000
Maryland,Other,2016,252,245,6,1,252,0,0,252,0,252,245,6,1,252,0,0,252,0,320,267,34,0,320,0,0,320,0,6904000,6028000,670000,0,6904000,0,0,6904000,0
Maryland,Other Services (except Public Administration),2016,64430,38260,12751,7090,58101,4917,755,63773,657,68985,38270,12815,7220,58305,5700,1385,65390,3595,569302,72572,82997,93052,248938,174577,70663,497487,57903,22286040000,2366346000,2555465000,3041483000,7975115000,6529095000,3374608000,18005730000,3244602000
Maryland,"Professional, Scientific, and Technical Services",2016,91928,61415,11503,6945,79863,7358,2295,89516,2412,103820,61435,11535,7075,80045,8015,2850,90910,12910,1383105,88590,75405,91363,255705,263056,225603,748670,624916,120588205000,6274810000,5135067000,6762051000,18195270000,22725047000,19985708000,61139360000,58764996000
Maryland,Real Estate and Rental and Leasing,2016,23363,16623,2559,1216,20398,1427,650,22475,888,32535,16635,2605,1430,20670,1920,2710,25300,7235,228960,22950,16293,15346,54965,43111,43195,143105,85701,13990489000,1174515000,777144000,923872000,2896965000,2988932000,2773354000,8828250000,5150628000
Maryland,Retail Trade,2016,56879,30809,11551,6511,48871,4219,1292,54382,2497,91005,30925,11740,6925,49590,5795,3545,58930,32075,1470630,56360,76240,85102,218114,143116,113109,480188,958842,41258140000,1613798000,2034786000,2458063000,6121004000,5324163000,4852552000,16516997000,23909029000
Maryland,Total,2016,109507,62432,18327,11805,92564,11214,2806,106584,2923,138480,62509,18479,12204,93192,13460,6712,113364,25116,2282725,102745,120697,158148,381590,418452,343149,1143191,1139534,121952023000,4947308000,5002165000,6885118000,16834591000,20233398000,18291815000,55359804000,66592219000
Maryland,Transportation and Warehousing,2016,15550,8515,1975,1654,12144,1533,577,14254,1296,17385,8515,1980,1660,12155,1630,680,14465,2920,342465,12708,12815,21154,47363,48993,29052,129996,147906,16217322000,471585000,467846000,764561000,1734665000,1893338000,1226058000,5084449000,7859098000
Maryland,Utilities,2016,280,70,15,20,105,25,35,165,115,760,70,15,20,105,45,75,225,535,47541,88,36,70,300,104,1824,3224,41811,5662732000,7300000,2714000,8176000,26633000,10688000,165500000,294914000,5083756000
Maryland,Wholesale Trade,2016,23303,10860,3103,2604,16567,3079,1342,20988,2315,28285,10865,3120,2680,16665,3560,1950,22175,6110,455038,17403,20385,33194,71622,97881,76599,251617,198302,32398093000,1121696000,1124384000,2043474000,4321513000,6358915000,4961833000,15934038000,16094620000
Massachusetts,Accommodation and Food Services,2016,70035,27045,14025,12536,53606,14308,1130,69044,991,87250,27075,14080,12655,53810,16015,4220,74045,13205,1501740,44750,93048,172648,310535,526903,164628,1002635,498819,33565055000,2051260000,1738319000,3284284000,7075670000,11124342000,3807359000,22023235000,11536397000
Massachusetts,Administrative and Support and Waste Management and Remediation Services,2016,48058,31045,6565,3743,41353,3606,1324,46283,1775,54135,31055,6575,3780,41410,3760,1485,46655,7480,1002787,39333,42626,49452,131780,140198,185630,461655,539060,49266102000,2577074000,2015595000,2556272000,7196138000,6871190000,8057514000,22332483000,26779415000
Massachusetts,"Agriculture, Forestry, Fishing and Hunting",2016,1720,1385,220,80,1685,30,0,1715,5,1720,1385,220,80,1685,30,0,1715,5,5189,1715,1307,809,4103,302,0,5153,0,199443000,78194000,24149000,24769000,138387000,15861000,0,196311000,0
Massachusetts,"Arts, Entertainment, and Recreation",2016,15719,8440,2325,1862,12627,2388,434,15449,270,16975,8445,2325,1900,12670,2615,780,16065,910,300412,11745,15277,25275,52553,91906,57707,205733,84146,11011701000,948624000,469921000,822791000,2257904000,2208970000,2053704000,6655490000,3414959000
Massachusetts,Construction,2016,92800,65525,14100,6875,86500,4996,856,92352,448,93090,65525,14100,6875,86500,5025,900,92425,665,658465,101445,90530,91617,283650,185510,112057,585665,71371,48428420000,5553875000,5030740000,6119129000,16708090000,14775615000,9875073000,41760545000,6529432000
Massachusetts,Educational Services,2016,14822,6845,2553,1780,11178,2095,981,14254,568,15810,6855,2565,1830,11250,2175,1335,14760,1050,1095809,10913,16975,23930,52008,86102,152763,291809,802812,47712127000,454411000,452937000,667312000,1581341000,3114956000,6458232000,11181577000,36501327000
Massachusetts,Finance and Insurance,2016,26421,14625,3951,1990,20566,2157,1304,24027,2394,47940,14760,4095,2300,21155,3605,5460,30220,17720,937110,26603,24693,26131,77614,74218,121505,276130,657231,129087651000,2352530000,2243377000,2985117000,7596695000,8971743000,12372070000,29648423000,99138179000
Massachusetts,Health Care and Social Assistance,2016,66106,28190,14310,9244,51744,8346,3451,63541,2565,95270,28255,14395,9705,52355,10970,9850,73175,22095,3219617,52346,94910,123094,270664,320958,545222,1137965,2081442,164787598000,3072525000,4706595000,6248670000,14042213000,15103440000,21481142000,50689525000,114077501000
Massachusetts,Information,2016,11244,5043,1540,1115,7698,1318,747,9763,1481,18610,5070,1540,1145,7755,1430,820,10005,8605,572918,8117,10016,14433,33025,49689,74960,162713,407872,63364290000,570169000,627221000,967163000,2189740000,4731277000,8912386000,16497480000,46673248000
Massachusetts,Management of Companies and Enterprises,2016,3987,300,65,145,510,480,1023,2013,1974,6385,300,65,150,515,490,1065,2070,4315,494025,352,385,1030,1767,6195,39142,47104,446383,59878070000,30667000,45045000,88940000,164652000,549280000,3491271000,4205203000,55605123000
Massachusetts,Manufacturing,2016,31615,11505,5435,4489,21429,6314,1803,29546,2069,32640,11505,5445,4500,21450,6455,1990,29895,2745,1098558,21068,34925,57725,118446,238227,190303,588092,456739,77606437000,1158124000,1662357000,2993647000,6067589000,13608024000,12424165000,34478061000,39959341000
Massachusetts,"Mining, Quarrying, and Oil and Gas Extraction",2016,313,95,60,45,200,64,17,281,32,370,95,60,45,200,80,50,330,40,4362,162,339,478,1083,1317,474,3413,448,368256000,15303000,15873000,26251000,63867000,109257000,33786000,242397000,44077000
Massachusetts,Other,2016,580,535,31,12,578,2,0,580,0,580,535,31,12,578,2,0,580,0,930,552,178,158,888,0,0,930,0,29745000,20325000,4905000,3749000,28979000,0,0,29745000,0
Massachusetts,Other Services (except Public Administration),2016,83735,51330,18055,8558,77943,4432,708,83083,652,90240,51390,18180,8955,78525,5315,2060,85900,4340,636120,97320,117962,110952,326420,148167,73266,551290,77367,22847725000,3168950000,3530248000,3442442000,10147570000,5351548000,2942649000,18564655000,3950091000
Massachusetts,"Professional, Scientific, and Technical Services",2016,101771,68000,13575,7646,89221,6978,2422,98621,3150,108150,68015,13580,7770,89365,7485,2685,99535,8615,1419315,105704,88690,99735,294545,249946,225012,773595,642635,154268980000,7648371000,6311255000,8458782000,22442360000,26548346000,25147346000,74393355000,79644950000
Massachusetts,Real Estate and Rental and Leasing,2016,27595,20268,3245,1485,24998,1373,519,26890,705,35805,20325,3405,1615,25345,1915,1750,29010,6795,233135,30549,20600,19191,70665,43947,43262,159685,68872,15664590000,1793202000,1110648000,1160936000,4086680000,2842696000,2914843000,9921635000,5034353000
Massachusetts,Retail Trade,2016,80250,46907,15830,7890,70627,5569,1526,77722,2528,121725,47105,16185,8510,71800,7680,5015,84495,37230,1867347,88114,103947,101514,293630,196428,125100,620865,1215749,54821299000,2743293000,3106572000,3547078000,9398333000,8528805000,5543751000,23680863000,30310165000
Massachusetts,Total,2016,143042,82725,24713,14992,122430,13743,3555,139728,3314,177631,82872,24944,15554,123370,16343,8573,148286,29345,3254781,136691,162125,200169,498985,517486,473945,1490416,1764365,204747200000,7361852000,7252721000,9678491000,24293064000,27873412000,28503609000,80670085000,124077115000
Massachusetts,Transportation and Warehousing,2016,17296,9215,2420,1914,13549,1827,751,16127,1169,19370,9215,2435,1930,13580,1905,970,16455,2915,420641,12930,15969,24515,54117,63400,55948,179534,203783,20066438000,617223000,658091000,993661000,2304623000,2571757000,1975577000,7117773000,11102705000
Massachusetts,Utilities,2016,510,195,35,30,260,45,57,362,148,1375,195,35,30,260,45,105,410,965,60508,203,159,245,771,1454,789,3863,55231,6697019000,16420000,16563000,16027000,57540000,172973000,84122000,419357000,6167948000
Massachusetts,Wholesale Trade,2016,33023,15105,5255,3818,24178,4250,1815,30243,2780,38395,15115,5280,3935,24330,4710,2325,31365,7030,717771,26518,34174,50210,111298,140793,123067,380433,327461,61800662000,1796898000,2306002000,3562675000,7690515000,10610742000,9605573000,28354780000,32419513000
Michigan,Accommodation and Food Services,2016,76506,26696,14066,15591,56353,17476,1457,75286,1220,99760,26845,14125,15775,56745,19815,6240,82800,16960,1929400,40585,95655,215492,351790,635011,230644,1217755,709947,32184900000,1332250000,1311970000,3031749000,5676740000,9888370000,3412392000,18987765000,13161605000
Michigan,Administrative and Support and Waste Management and Remediation Services,2016,50110,30715,6560,4452,41727,4708,1679,48114,1996,57940,30730,6590,4540,41860,4985,2095,48940,9000,1689155,41336,43138,59937,144620,189621,276222,612788,1074966,55338408000,2311419000,1618657000,2441042000,6382685000,7178802000,8826532000,22503196000,32760578000
Michigan,"Agriculture, Forestry, Fishing and Hunting",2016,2916,2040,460,170,2670,176,40,2886,30,2925,2040,460,170,2670,180,40,2890,35,19162,3123,2773,1938,8059,4896,3601,18417,689,781228000,117539000,106852000,62824000,297677000,205411000,140195000,727533000,46636000
Michigan,"Arts, Entertainment, and Recreation",2016,16255,9530,2225,1935,13690,1949,365,16004,251,16995,9535,2240,1985,13760,2035,585,16380,615,241888,12090,14433,25885,52650,73768,53102,183690,51449,8600149000,688146000,395927000,560827000,1657176000,1589226000,4166204000,7495520000,915564000
Michigan,Construction,2016,93277,63655,14790,7993,86438,5647,777,92862,415,94015,63655,14790,8005,86450,5740,1000,93190,825,694600,95415,97160,106425,299000,204545,104365,612765,73612,43679870000,5101640000,4664290000,5978240000,15744170000,13325790000,7899253000,37296155000,5886146000
Michigan,Educational Services,2016,10412,4885,1660,1335,7880,1741,461,10082,330,11685,4895,1660,1350,7905,1975,715,10595,1090,363290,7789,11076,17664,36647,70056,67900,176385,186481,10674521000,243665000,227179000,406388000,881730000,1736437000,2337713000,5009470000,5655374000
Michigan,Finance and Insurance,2016,34485,21797,5647,2078,29522,2078,1107,32707,1778,64990,21820,5710,2395,29925,4770,5525,40220,24770,799473,40999,35989,27061,104249,75043,113945,294823,497861,59029221000,1999175000,1858392000,1731180000,5600580000,4617537000,7489631000,17828969000,40592826000
Michigan,Health Care and Social Assistance,2016,100391,45289,24000,14783,84072,10945,3368,98385,2006,134005,45355,24190,15425,84970,15085,11135,111190,22815,3075515,82892,161205,196638,440844,416800,521439,1379950,1692858,143019360000,4042331000,6707566000,9021977000,19775907000,17300430000,19112124000,56234529000,86654587000
Michigan,Information,2016,12032,7020,1542,955,9517,1035,420,10972,1060,19915,7020,1560,975,9555,1235,575,11365,8550,329204,10253,9900,12032,32693,36785,36689,109194,219104,22635133000,450737000,414312000,613478000,1503154000,2110902000,2307557000,6133293000,16465402000
Michigan,Management of Companies and Enterprises,2016,5254,265,70,125,460,905,1579,2944,2310,7995,265,70,130,465,920,1675,3060,4935,626330,271,270,875,1417,10280,53190,64890,561405,68742935000,66314000,26915000,62605000,156093000,720085000,3594310000,4470750000,64264742000
Michigan,Manufacturing,2016,57835,19340,9559,9097,37996,11619,4460,54075,3760,61755,19340,9560,9150,38050,12155,5590,55795,5960,2879962,35994,62460,121124,224739,458259,588293,1301120,1510442,166362832000,1800020000,2619820000,5645712000,10304724000,23442510000,30819295000,66116717000,96198088000
Michigan,"Mining, Quarrying, and Oil and Gas Extraction",2016,1502,715,265,140,1120,191,45,1356,146,1665,715,270,150,1135,225,50,1410,255,20466,1300,1571,1812,4768,5673,381,11533,8407,1406078000,80139000,89444000,101242000,273880000,401912000,34052000,778068000,595794000
Michigan,Other,2016,847,816,26,4,846,1,0,847,0,847,816,26,4,846,1,0,847,0,1129,894,170,41,1105,0,0,1129,0,14395000,11853000,2391000,103000,14347000,0,0,14395000,0
Michigan,Other Services (except Public Administration),2016,107285,65520,23310,10641,99471,6236,885,106592,693,115660,65590,23475,11255,100320,8295,2695,111310,4350,798054,124702,151519,139608,415929,211708,85872,717884,68497,23276697000,3260493000,3809561000,3626272000,10699462000,6173874000,3046900000,20073557000,2703381000
Michigan,"Professional, Scientific, and Technical Services",2016,99317,66353,13816,8170,88339,6502,1886,96727,2590,107825,66385,13885,8375,88645,7630,3200,99475,8350,1334345,98605,91410,107395,297600,229509,203040,734755,591685,103497705000,5643410000,4995579000,6672677000,17328880000,16361646000,15006232000,49042635000,54016369000
Michigan,Real Estate and Rental and Leasing,2016,30185,21800,3824,1811,27435,1399,621,29455,730,39740,21830,3940,1935,27705,2320,2260,32285,7455,258495,32630,24045,23240,80125,46702,45125,173885,82152,11199155000,1328970000,844171000,1016521000,3199970000,1874136000,2171343000,7351070000,3817400000
Michigan,Retail Trade,2016,111878,63894,22980,11902,98776,8611,1893,109280,2598,172465,64060,23395,13095,100550,13040,7820,121410,51055,2354965,123030,151730,156488,431390,314393,212637,963585,1381931,61987900000,3215746000,3667575000,4195156000,11081375000,11073023000,7474104000,29788665000,31945654000
Michigan,Total,2016,173416,98315,30932,19628,148875,17290,3962,170127,3289,220412,98459,31226,20519,150204,22069,11381,183654,36758,3805578,163100,204837,263529,631466,657136,580283,1868885,1936693,183192569000,7002194000,7381795000,10158632000,24542621000,26979347000,26979946000,78501914000,104690655000
Michigan,Transportation and Warehousing,2016,27201,16620,3245,2458,22323,2521,887,25731,1470,31890,16635,3250,2500,22385,2700,1245,26330,5560,571627,22998,21215,32212,76975,86604,63543,232745,336563,27967355000,925068000,907007000,1364365000,3232056000,3813730000,2877944000,10185677000,17627840000
Michigan,Utilities,2016,588,200,65,45,310,70,42,422,166,1910,200,65,70,335,80,210,625,1285,109266,347,402,332,1228,2184,4156,8094,88636,12272105000,22946000,17499000,16680000,68026000,169377000,367878000,650213000,10278812000
Michigan,Wholesale Trade,2016,44652,21289,6680,5035,33004,5894,2333,41231,3421,54690,21300,6765,5295,33360,7155,4250,44765,9925,902160,36049,44187,65254,145910,198051,167661,516420,378246,61464165000,2269842000,2474075000,3942135000,8703950000,12114953000,10234609000,31338670000,29700175000
Minnesota,Accommodation and Food Services,2016,43039,14088,7209,9001,30298,10601,1136,42035,1004,58540,14100,7235,9100,30435,12020,3560,46015,12525,1215905,20140,49805,126401,196380,395422,157851,750284,462867,21556440000,750460000,679190000,1742170000,3172575000,6620229000,2756548000,12562129000,8930546000
Minnesota,Administrative and Support and Waste Management and Remediation Services,2016,33422,21285,4580,2700,28565,2621,758,31944,1478,38205,21300,4595,2715,28610,2835,1060,32505,5700,832226,28990,29734,35910,94907,101004,103058,303628,526575,30765284000,1452449000,1096976000,1400758000,3961054000,4130133000,2935794000,11228876000,19363850000
Minnesota,"Agriculture, Forestry, Fishing and Hunting",2016,2665,1815,490,200,2505,100,20,2625,40,2710,1815,490,200,2505,105,20,2630,80,13428,2778,3203,2444,8708,2281,304,12318,902,544645000,120060000,108071000,92312000,326950000,129086000,7310000,490970000,40177000
Minnesota,"Arts, Entertainment, and Recreation",2016,13726,8400,2025,1319,11744,1443,312,13499,227,14470,8400,2030,1325,11755,1540,340,13635,835,240226,11475,13091,17429,42248,50631,44720,142025,88778,7568851000,471770000,275743000,321464000,1074027000,996881000,1064750000,3573601000,3719276000
Minnesota,Construction,2016,81164,59755,10830,5260,75845,4187,673,80705,459,81800,59760,10830,5260,75850,4290,765,80905,895,590165,82994,69775,69876,222760,154032,90503,470915,113984,41795105000,4564078000,3888497000,4471017000,12936855000,11377982000,6990296000,31601530000,9838658000
Minnesota,Educational Services,2016,9214,4015,1430,1285,6730,1867,335,8932,282,9850,4015,1430,1295,6740,2005,555,9300,550,361078,6373,9305,17175,32919,77836,55992,170358,184018,10308710000,207267000,203888000,400544000,812739000,2145813000,2096295000,5175155000,4975440000
Minnesota,Finance and Insurance,2016,30668,20375,3777,1752,25904,1963,807,28674,1994,47465,20400,3855,2095,26350,4205,3430,33985,13480,811001,35223,23721,21805,80908,68875,69611,222014,587229,73807843000,1793785000,1359043000,1514337000,4678020000,5163251000,5090012000,15133316000,58486925000
Minnesota,Health Care and Social Assistance,2016,52659,23440,9063,6993,39496,7864,3427,50787,1872,82610,23485,9155,7315,39955,10770,12060,62785,19825,2293111,39018,61331,95697,196208,325503,538957,1062870,1229072,98264120000,1869822000,2548840000,3854601000,8283642000,11255556000,17357540000,37024309000,61188459000
Minnesota,Information,2016,8141,3965,1105,765,5835,943,336,7114,1027,13395,3965,1105,770,5840,1165,570,7575,5820,293632,6166,7058,9470,23210,33619,34040,94691,188801,21893855000,294814000,322720000,484191000,1125155000,1969141000,2152331000,5406892000,15455032000
Minnesota,Management of Companies and Enterprises,2016,4037,260,75,90,425,650,1166,2241,1796,6060,260,75,90,425,655,1230,2310,3750,664470,280,325,484,1095,7495,38235,46825,617620,67993400000,27260000,31660000,24079000,83165000,447115000,2959540000,3489820000,64484781000
Minnesota,Manufacturing,2016,33815,12665,5485,4410,22560,6376,2264,31200,2615,36260,12665,5500,4410,22575,6710,2800,32085,4175,1487670,21609,35089,57203,118111,249315,265694,673125,742391,85468297000,1036049000,1486870000,2602905000,5333521000,12790677000,15357355000,35659724000,45644254000
Minnesota,"Mining, Quarrying, and Oil and Gas Extraction",2016,696,320,130,50,500,75,36,611,85,800,320,130,55,505,80,40,625,175,28156,529,719,395,1871,1985,1457,6152,20797,2143647000,39941000,54327000,28212000,136204000,219515000,98473000,519389000,1549443000
Minnesota,Other,2016,266,256,8,2,266,0,0,266,0,266,256,8,2,266,0,0,266,0,316,233,53,0,316,0,0,316,0,7446000,5873000,1261000,0,7446000,0,0,7446000,0
Minnesota,Other Services (except Public Administration),2016,72946,43590,15265,7523,66378,5202,765,72345,601,78580,43620,15460,7890,66970,6725,2380,76075,2505,590468,80090,98937,99189,278651,174107,75686,532568,49537,16837179000,2148007000,2499602000,2518808000,7179906000,4877157000,2447211000,14667789000,1957427000
Minnesota,"Professional, Scientific, and Technical Services",2016,79487,58000,8685,5207,71892,4079,1470,77441,2046,83900,58010,8750,5360,72120,4755,1815,78690,5210,915345,74796,56458,69030,200650,140082,141819,484985,426247,72049510000,5049649000,3152656000,4355873000,12581735000,11124122000,11772801000,35630320000,36192352000
Minnesota,Real Estate and Rental and Leasing,2016,27452,21680,2250,1084,25014,1112,594,26720,732,34090,21700,2290,1155,25145,1665,2520,29330,4760,197223,25981,14298,13462,53830,35629,39709,130680,65325,9726287000,1254797000,613384000,571511000,2442405000,1500738000,1646254000,5661830000,3937033000
Minnesota,Retail Trade,2016,60777,29865,13207,7897,50969,5816,1512,58297,2480,95040,29910,13375,8640,51925,8665,5385,65975,29065,1536330,54247,87203,102924,244630,207529,137893,593725,937705,41240615000,1522252000,2065762000,2700902000,6293958000,6380084000,4461387000,17257355000,23876665000
Minnesota,Total,2016,119039,70717,18498,12150,101365,11859,2960,116184,2855,150115,70781,18682,12674,102137,15099,8526,125762,24353,2661627,107054,121848,163742,392644,453476,408838,1254958,1406669,137135936000,4991865000,4591015000,6270075000,15852955000,18997272000,18663568000,53513795000,83622141000
Minnesota,Transportation and Warehousing,2016,21244,13040,2400,1814,17254,2102,649,20005,1239,23620,13040,2415,1835,17290,2225,860,20375,3245,415657,17995,15588,24330,58442,75234,53959,189561,224165,18698717000,761458000,644376000,934204000,2360186000,2728332000,2116111000,7265204000,11327502000
Minnesota,Utilities,2016,651,120,65,45,230,181,75,486,165,1675,125,65,45,235,240,130,605,1070,67370,190,394,609,1298,6303,4857,12873,50287,6358302000,9479000,18889000,41737000,76551000,493360000,415839000,1007861000,5034992000
Minnesota,Wholesale Trade,2016,33103,15695,4535,3670,23900,4229,1982,30111,2992,40175,15735,4585,3805,24125,4840,3110,32075,8100,690504,24608,29862,47529,102763,139365,111891,359640,325202,54317441000,1505910000,1744910000,2973824000,6266100000,9534600000,7174701000,23335145000,30588312000
Mississippi,Accommodation and Food Services,2016,20226,6655,3778,4145,14578,4341,527,19446,780,27710,6690,3790,4180,14660,4855,1880,21395,6315,641530,10995,25013,56340,92525,156944,71645,321630,319420,10531745000,325752000,324054000,738768000,1390877000,2077456000,903613000,4379187000,6116851000
Mississippi,Administrative and Support and Waste Management and Remediation Services,2016,9736,5175,1530,1010,7715,859,388,8962,774,11270,5175,1530,1010,7715,960,505,9180,2090,275059,8695,9878,13436,32351,30944,41687,107586,159133,7048715000,263583000,265560000,405724000,948110000,910475000,935770000,2881048000,3940693000
Mississippi,"Agriculture, Forestry, Fishing and Hunting",2016,3293,1665,895,445,3005,210,35,3250,43,3400,1665,895,445,3005,210,65,3280,120,25675,2908,6077,5473,14767,6325,620,22822,1479,1059143000,116922000,216384000,200693000,554615000,242699000,25111000,868985000,111417000
Mississippi,"Arts, Entertainment, and Recreation",2016,3285,1795,465,510,2770,385,50,3205,80,3440,1795,465,515,2775,400,140,3315,125,45442,2835,2756,6601,12593,13437,4853,33331,10469,939984000,86356000,61147000,104435000,259252000,218624000,90210000,661999000,236791000
Mississippi,Construction,2016,18746,11100,3440,2090,16630,1625,230,18485,261,18980,11100,3440,2090,16630,1650,260,18540,440,222755,19440,22658,27544,70025,59128,31136,164360,44540,10604785000,675430000,772924000,1091563000,2554190000,2878766000,1813177000,7472685000,2440263000
Mississippi,Educational Services,2016,2540,1000,415,330,1745,515,140,2400,140,3040,1000,415,330,1745,550,260,2555,485,78870,1549,2706,4370,8920,22754,17395,50405,27777,1946005000,38106000,47245000,74694000,166270000,546387000,586690000,1336314000,592387000
Mississippi,Finance and Insurance,2016,11284,7345,1405,597,9347,613,380,10340,944,23565,7410,1560,970,9940,2025,3010,14975,8590,176024,13957,8710,6970,29957,20615,28115,80138,95626,9098057000,515759000,339545000,353917000,1226055000,1041459000,1376526000,3720280000,5346912000
Mississippi,Health Care and Social Assistance,2016,24176,10475,5695,3582,19752,2629,913,23294,882,31030,10475,5725,3770,19970,3395,2430,25795,5235,828345,19189,38006,46776,104544,99311,119524,326660,485652,36477724000,1090954000,1483940000,1927212000,4517443000,3764453000,3919006000,12308412000,23927401000
Mississippi,Information,2016,2096,820,350,250,1420,180,105,1705,391,4850,855,355,260,1470,280,180,1930,2920,66983,1593,2129,2858,6946,4668,3995,17004,49966,3128318000,54285000,65578000,85823000,215467000,184808000,166537000,625849000,2500221000
Mississippi,Management of Companies and Enterprises,2016,1261,71,30,51,152,225,386,763,498,1735,80,30,55,165,230,430,825,910,42495,90,68,308,474,2280,8950,11705,30790,2906980000,14570000,8659000,15838000,40535000,130420000,575230000,746245000,2160735000
Mississippi,Manufacturing,2016,9693,2735,1597,1100,5432,1897,954,8283,1410,10705,2735,1600,1100,5435,1975,1185,8595,2110,662096,5061,9161,12504,29408,64104,93148,211817,369734,30143279000,174708000,270357000,401294000,935462000,2453139000,3652109000,8066714000,17310611000
Mississippi,"Mining, Quarrying, and Oil and Gas Extraction",2016,1446,824,200,99,1123,135,80,1338,108,1640,825,200,100,1125,160,115,1400,240,18326,1158,1327,1052,3664,4400,2935,11267,5244,1321336000,50077000,65411000,58669000,179086000,353079000,209015000,761004000,429688000
Mississippi,Other,2016,112,109,2,1,112,0,0,112,0,112,109,2,1,112,0,0,112,0,137,116,0,0,137,0,0,137,0,1992000,1759000,0,0,1992000,0,0,1992000,0
Mississippi,Other Services (except Public Administration),2016,30220,18690,6795,2605,28090,1533,222,29845,375,31930,18700,6845,2745,28290,1940,580,30810,1120,194518,37049,43609,33830,114848,50118,12849,180510,11524,4854351000,818052000,974251000,811138000,2612241000,1267473000,371242000,4324118000,458452000
Mississippi,"Professional, Scientific, and Technical Services",2016,20984,14080,3052,1565,18697,1145,387,20229,755,23270,14080,3080,1620,18780,1720,575,21075,2195,150438,22973,19217,20109,62763,33096,19905,118016,30165,7859636000,964167000,903790000,919882000,2811915000,1846533000,1184970000,5954344000,1852636000
Mississippi,Real Estate and Rental and Leasing,2016,9533,7230,983,398,8611,349,231,9191,342,12035,7230,1010,490,8730,520,710,9960,2075,51282,11170,6036,4844,22360,8134,5997,38205,11858,1789519000,339431000,184379000,164732000,696335000,307350000,223952000,1308360000,442746000
Mississippi,Retail Trade,2016,36619,19949,7594,4058,31601,2830,600,35031,1588,58040,20000,7760,4410,32170,4105,2680,38955,19085,684440,37383,49707,51517,138880,96916,46751,286665,391555,16191904000,880403000,1149207000,1385112000,3422790000,3155739000,1360040000,8071400000,7898343000
Mississippi,Total,2016,44414,24028,8299,4918,37245,4219,1136,42600,1814,58850,24082,8420,5221,37723,5578,3390,46691,12159,939322,42961,54291,65083,162335,153145,124919,440399,498923,34356961000,1427295000,1613257000,1997942000,5038494000,5101705000,4546963000,14687162000,19669799000
Mississippi,Transportation and Warehousing,2016,8900,4550,1395,810,6755,846,340,7941,959,10270,4550,1400,810,6760,900,405,8065,2205,193772,7115,8721,9709,26143,26651,16765,75423,114079,8201368000,249622000,300546000,353000000,924672000,1048116000,722296000,2953640000,5003227000
Mississippi,Utilities,2016,1801,1085,425,65,1575,90,67,1732,69,3040,1085,425,85,1595,165,300,2060,980,46266,2559,2527,728,6013,5212,9168,21341,12172,3606567000,59044000,80322000,29659000,177503000,315245000,651664000,1192629000,1120894000
Mississippi,Wholesale Trade,2016,10777,4395,1525,1055,6975,1473,698,9146,1631,13740,4415,1565,1115,7095,1850,1240,10185,3555,185366,7641,9459,12121,30564,38105,30206,104167,76514,9359753000,346332000,395270000,568127000,1364389000,1857519000,1535506000,4999904000,4119438000
Missouri,Accommodation and Food Services,2016,45197,14825,7835,8623,31283,11262,1349,43894,1303,62980,14835,7870,8720,31425,12710,4820,48955,14025,1302150,23916,52764,118934,195625,416752,188388,801675,499737,21527640000,658353000,738327000,1706330000,3103060000,6301435000,2981358000,12404490000,9109876000
Missouri,Administrative and Support and Waste Management and Remediation Services,2016,33317,19970,5070,2975,28015,2756,830,31601,1716,38045,19975,5070,2985,28030,2880,1065,31975,6070,871235,30745,33522,39833,104400,101731,108544,318189,549676,27283770000,1091807000,1072916000,1376905000,3553891000,3555624000,2980915000,10248498000,16924940000
Missouri,"Agriculture, Forestry, Fishing and Hunting",2016,1415,1050,190,65,1305,55,15,1375,40,1425,1050,190,65,1305,60,15,1380,45,8072,1657,1192,681,3707,1608,0,6927,1142,278159000,64114000,38734000,19638000,129719000,44438000,0,215294000,62369000
Missouri,"Arts, Entertainment, and Recreation",2016,10259,5840,1380,1242,8462,1324,232,10018,241,10910,5840,1380,1255,8475,1420,340,10235,675,204385,8483,8896,16402,34348,51596,27305,118263,83087,8558063000,294514000,173609000,287265000,766396000,1076599000,1405291000,3374280000,3995940000
Missouri,Construction,2016,65627,41310,12014,6204,59528,4890,737,65155,472,66315,41310,12015,6210,59535,4975,985,65495,820,607470,70345,78924,82800,232095,179225,93046,510550,85647,35774945000,2743710000,3138395000,4088755000,9972890000,11013929000,6966894000,28365360000,6543748000
Missouri,Educational Services,2016,7434,3225,1205,985,5415,1315,390,7120,314,8170,3225,1205,1000,5430,1390,485,7305,865,369353,5358,8123,13371,27010,55050,68887,152638,216305,15479045000,151368000,137519000,236930000,530633000,1470056000,2336123000,4389470000,11069084000
Missouri,Finance and Insurance,2016,28771,19315,3397,1377,24089,1819,824,26732,2039,54085,19345,3510,1735,24590,5120,4220,33930,20155,651917,34311,21169,17580,73308,67776,79401,222853,423704,47003527000,1480185000,1075629000,983212000,3556750000,3939121000,5207709000,12897035000,33534970000
Missouri,Health Care and Social Assistance,2016,130742,99727,11575,7623,118925,7439,2444,128808,1934,155065,99760,11640,7925,119325,9610,7840,136775,18290,2100361,118990,77951,101928,298955,312818,341490,954500,1140429,90020157000,2900241000,3142521000,3954187000,10000228000,10446424000,11052578000,31556569000,58263622000
Missouri,Information,2016,6327,2835,884,750,4469,677,290,5436,891,12795,2845,885,795,4525,900,445,5870,6925,285740,4562,5635,9415,19925,21397,15092,60636,221359,18834012000,186184000,209956000,392752000,803286000,1067336000,799911000,2824155000,15770049000
Missouri,Management of Companies and Enterprises,2016,4007,235,70,136,441,705,1242,2388,1619,7515,235,70,140,445,710,1340,2495,5020,432065,285,225,619,1130,7195,36770,45095,386795,40114060000,24765000,18850000,33747000,77455000,493400000,2921330000,3492185000,36610634000
Missouri,Manufacturing,2016,27229,9930,4330,4088,18348,4762,1779,24889,2340,29165,9930,4335,4100,18365,5105,2175,25645,3520,1252921,18608,27364,51416,102267,174809,184853,500950,609553,66645274000,697856000,951475000,1943570000,3813117000,7936356000,9533115000,23208348000,33920151000
Missouri,"Mining, Quarrying, and Oil and Gas Extraction",2016,822,300,130,110,540,132,66,738,84,1315,300,130,120,550,290,185,1025,290,15297,552,779,1318,2907,3631,3041,9988,4547,895558000,27002000,29970000,55962000,124461000,198374000,166140000,506733000,310482000
Missouri,Other,2016,1751,1736,12,3,1751,0,0,1751,0,1751,1736,12,3,1751,0,0,1751,0,1663,1539,82,0,1663,0,0,1663,0,14015000,12416000,875000,0,14015000,0,0,14015000,0
Missouri,Other Services (except Public Administration),2016,71971,45785,13755,6353,65893,4525,823,71241,730,77715,45850,13920,6675,66445,5560,2440,74445,3270,562634,84984,88739,82462,256484,160047,67567,488789,66513,15996288000,2109459000,2231572000,2244060000,6593938000,4291439000,2239728000,13285048000,2417743000
Missouri,"Professional, Scientific, and Technical Services",2016,63058,42110,9195,4840,56145,3649,1324,61118,1940,69855,42140,9205,4960,56305,4415,1885,62605,7250,784790,65138,59974,62705,188380,119641,98533,408910,367001,55265755000,3100471000,2896209000,3454391000,9480275000,8359334000,7098061000,25057595000,29812676000
Missouri,Real Estate and Rental and Leasing,2016,25202,18870,2561,1229,22660,1168,552,24380,822,31540,18920,2595,1325,22840,1860,1320,26020,5520,184456,27645,15943,15148,59005,34928,29499,126435,55467,8036684000,960930000,577307000,582481000,2131795000,1684622000,1098919000,5027465000,2913629000
Missouri,Retail Trade,2016,62701,32722,12540,7257,52519,6067,1475,60061,2640,105140,32820,12815,8035,53670,9505,5000,68175,36965,1540987,60826,82173,93092,236460,207196,109688,559480,973988,39942291000,1508314000,2014526000,2445494000,5977045000,6954876000,4113300000,17200515000,22570102000
Missouri,Total,2016,126038,78550,18631,11719,108900,11329,2745,122974,3064,160912,78650,18817,12287,109754,14813,7836,132403,28509,2494720,121512,122940,156267,400719,427843,340163,1168725,1325995,112072115000,4001282000,4152995000,5465995000,13620272000,16126850000,14913025000,44660147000,67411968000
Missouri,Transportation and Warehousing,2016,20499,12060,2620,1889,16569,1791,732,19092,1407,23615,12065,2620,1895,16580,1915,1025,19520,4095,435538,19122,17337,23888,60966,57330,47259,170760,230250,18362916000,689144000,627986000,932561000,2280428000,2374324000,1915284000,6714789000,10175114000
Missouri,Utilities,2016,557,125,70,25,220,190,47,457,100,1880,125,70,25,220,300,280,800,1080,69227,182,373,216,918,9636,4114,15983,51138,6935536000,3985000,12942000,11309000,36332000,713678000,318160000,1142430000,5633560000
Missouri,Wholesale Trade,2016,30902,13968,4460,3258,21686,4416,1922,28024,2878,38275,14000,4500,3455,21955,5340,3315,30610,7665,630850,23460,29591,41621,95290,135931,111031,347720,248407,35360525000,1208915000,1498587000,2245162000,4981400000,7764384000,6350430000,19441760000,14664308000
Montana,Accommodation and Food Services,2016,15740,5695,3407,3145,12247,3000,232,15479,261,17620,5700,3425,3225,12350,3355,650,16355,1265,257229,8470,22956,42789,74369,107280,29374,212009,44925,4429007000,264535000,320590000,645358000,1236865000,1829123000,536248000,3625362000,794793000
Montana,Administrative and Support and Waste Management and Remediation Services,2016,8514,5785,1235,640,7660,388,125,8173,341,8985,5785,1240,650,7675,440,175,8290,695,99220,7826,7804,7659,24138,11853,8602,48323,35030,3025491000,294054000,216724000,248166000,791165000,353122000,278482000,1556775000,1024624000
Montana,"Agriculture, Forestry, Fishing and Hunting",2016,1735,1460,165,45,1670,25,15,1710,25,1770,1460,165,45,1670,25,40,1735,35,4649,1665,1108,419,3300,733,0,4374,95,210742000,88928000,31201000,22162000,147083000,23755000,0,194242000,4516000
Montana,"Arts, Entertainment, and Recreation",2016,5364,3165,990,595,4750,475,82,5307,57,6005,3165,1000,620,4785,580,130,5495,510,53495,3840,6645,7660,18465,15791,10715,47415,3009,957700000,135945000,113737000,123052000,377245000,261060000,128143000,817770000,68592000
Montana,Construction,2016,26437,20090,3740,1585,25415,770,128,26313,124,26630,20090,3740,1585,25415,815,145,26375,255,124904,28535,24297,20243,73425,27333,10617,117004,4948,6566593000,1138945000,987442000,972971000,3114990000,1668441000,752025000,5961373000,404876000
Montana,Educational Services,2016,1905,995,345,190,1530,250,70,1850,55,1975,995,345,190,1530,250,115,1895,80,30355,1571,2331,2440,6466,8552,8930,25305,4453,713312000,38371000,37782000,38266000,121071000,188392000,264974000,615347000,91476000
Montana,Finance and Insurance,2016,6284,4205,730,368,5303,314,132,5749,535,9895,4215,735,435,5385,895,565,6845,3050,82199,7601,4378,4532,16956,12002,8458,39375,41875,4770196000,282052000,191489000,208313000,708409000,628382000,431660000,1897729000,2809928000
Montana,Health Care and Social Assistance,2016,15426,8175,3000,1740,12915,1357,656,14928,498,18355,8175,3015,1780,12970,1725,1900,16595,1760,350355,13574,19739,22381,56204,53320,82927,194843,148708,15510922000,581151000,708551000,930011000,2243426000,2002078000,2933605000,7281493000,7964812000
Montana,Information,2016,2123,1085,330,155,1570,138,117,1825,298,3315,1085,330,155,1570,170,405,2145,1170,42412,1751,2084,1869,6000,2764,8624,19607,21805,2132413000,61316000,61500000,67741000,203419000,138338000,515879000,931510000,1157897000
Montana,Management of Companies and Enterprises,2016,610,80,5,35,120,130,125,375,235,720,80,5,35,120,130,125,375,345,19015,78,0,118,207,1070,3074,4375,14635,1542115000,8406000,0,5571000,14749000,74845000,275219000,365870000,1175758000
Montana,Manufacturing,2016,6343,3160,1195,900,5255,652,218,6125,218,6455,3160,1195,900,5255,685,245,6185,270,83590,5035,6651,10396,24513,16029,9234,62382,11257,3923960000,159382000,199030000,353222000,793824000,605527000,367451000,2313711000,963018000
Montana,"Mining, Quarrying, and Oil and Gas Extraction",2016,1679,1030,200,85,1315,110,50,1475,204,1775,1030,200,85,1315,115,60,1490,285,26619,1434,1153,1015,3680,2740,2067,9063,11533,2199066000,76459000,61906000,47398000,189143000,231008000,129707000,580406000,1113583000
Montana,Other,2016,75,72,2,1,75,0,0,75,0,75,72,2,1,75,0,0,75,0,99,73,0,0,99,0,0,99,0,2189000,1934000,0,0,2189000,0,0,2189000,0
Montana,Other Services (except Public Administration),2016,15375,10165,2910,1302,14377,723,85,15185,190,15975,10165,2915,1335,14415,960,120,15495,480,82098,18172,18914,16758,54434,19689,2145,79519,1694,2330077000,481958000,499753000,456511000,1456206000,548620000,99708000,2233096000,70822000
Montana,"Professional, Scientific, and Technical Services",2016,17622,12915,2273,997,16185,608,229,17022,600,18740,12915,2295,1020,16230,935,445,17610,1130,103038,18148,14744,12553,45959,17412,10391,76164,22641,4872520000,782938000,636049000,658754000,2100411000,997188000,733331000,3970476000,813819000
Montana,Real Estate and Rental and Leasing,2016,8917,7525,610,358,8493,193,59,8745,172,9910,7530,620,480,8630,345,345,9320,590,28870,9048,3583,4425,17512,4430,1043,24517,3861,1009446000,332245000,105100000,131115000,583427000,146273000,29473000,826007000,162387000
Montana,Retail Trade,2016,18228,8964,4128,2367,15459,1565,403,17427,801,23845,9015,4200,2545,15760,2165,1325,19250,4595,286562,16353,26974,30705,74479,47843,28587,157204,119908,7668530000,447478000,683174000,870169000,2014794000,1522460000,933653000,4719284000,2675809000
Montana,Total,2016,32450,20338,5362,3084,28784,2257,516,31557,893,37626,20357,5405,3233,28995,3028,1548,33571,4055,378463,30832,35290,41093,107215,80094,58102,245411,133052,14542766000,1123465000,1070016000,1320044000,3513525000,2711258000,2310827000,8535610000,6007156000
Montana,Transportation and Warehousing,2016,6013,4019,695,415,5129,412,150,5691,322,6765,4020,695,415,5130,470,260,5860,905,63884,5730,4383,4926,15781,11895,7328,38084,17312,2789562000,193140000,144599000,192813000,558467000,530697000,254277000,1492687000,950880000
Montana,Utilities,2016,433,175,35,50,260,95,20,375,58,1050,175,35,55,265,130,45,440,610,15280,241,126,692,1165,2219,590,4994,4482,1310710000,5127000,8850000,41475000,62581000,179355000,44468000,368046000,404970000
Montana,Wholesale Trade,2016,6025,2665,848,573,4086,685,379,5150,875,7970,2665,860,605,4130,950,645,5725,2245,82357,3909,5056,5771,16317,17522,9916,49670,28135,4183074000,163415000,215829000,270352000,720341000,775984000,503035000,2268770000,1597988000
Nebraska,Accommodation and Food Services,2016,17257,6105,3169,3388,12662,3495,493,16650,607,22465,6105,3195,3425,12725,4175,2070,18970,3495,386920,10298,21159,46097,77650,123986,62890,265535,120924,5722545000,266242000,254981000,602236000,1124975000,1733007000,904733000,3779340000,1936706000
Nebraska,Administrative and Support and Waste Management and Remediation Services,2016,12143,7415,1700,1150,10265,855,280,11400,743,13545,7415,1710,1155,10280,920,330,11530,2015,626599,11138,10995,14342,37166,27791,34134,102936,517271,24812851000,374799000,320312000,447415000,1165958000,848518000,1078718000,3271678000,21262308000
Nebraska,"Agriculture, Forestry, Fishing and Hunting",2016,935,680,110,50,840,45,15,900,35,980,680,110,50,840,45,30,915,65,6156,863,763,597,2316,960,122,3581,2575,313044000,43082000,31353000,24497000,102144000,54525000,6456000,172809000,140235000
Nebraska,"Arts, Entertainment, and Recreation",2016,4299,2555,555,460,3570,525,95,4190,109,4535,2565,555,460,3580,565,115,4260,275,71198,3772,3536,6101,13671,20822,10685,49328,17569,1184414000,117510000,56368000,119076000,301113000,347883000,148328000,892419000,196152000
Nebraska,Construction,2016,31539,21164,5075,2775,29014,1994,262,31270,269,31785,21165,5075,2775,29015,2040,335,31390,395,229545,33760,33134,36825,103855,74262,22440,203695,21395,11447185000,1290525000,1274481000,1642470000,4213295000,3996575000,1427685000,9815745000,1358615000
Nebraska,Educational Services,2016,2573,1050,450,355,1855,480,125,2460,113,2795,1050,450,355,1855,555,235,2645,150,94918,1485,2862,4411,9210,20437,12005,43413,51148,2591099000,35413000,40356000,80413000,176114000,450471000,339878000,987879000,1593329000
Nebraska,Finance and Insurance,2016,12994,8550,1553,650,10753,789,362,11904,1090,21670,8570,1600,840,11010,2145,1870,15025,6645,313364,14721,9688,7414,32232,26066,30623,91161,218059,22741928000,600892000,466395000,441725000,1544350000,1428760000,1959028000,5070159000,17380053000
Nebraska,Health Care and Social Assistance,2016,22622,10885,4080,2775,17740,3002,1063,21805,817,28395,10910,4100,2860,17870,4160,2625,24655,3740,649885,18355,27250,36179,82425,118076,134366,336576,301129,29403765000,994539000,1194589000,1492442000,3706276000,4653666000,5792237000,14211823000,14754026000
Nebraska,Information,2016,2709,1058,364,295,1717,367,183,2267,442,4575,1060,365,300,1725,500,255,2480,2095,95828,1616,2263,3667,7791,11453,12268,32607,56669,5736250000,57800000,86974000,135079000,293286000,562364000,739518000,1654045000,3796954000
Nebraska,Management of Companies and Enterprises,2016,1470,80,55,56,191,275,421,887,583,1870,80,55,65,200,280,445,925,945,108595,70,246,265,610,3260,11385,15255,93340,8593940000,8200000,9123000,51352000,74505000,183000000,1035160000,1292665000,7301275000
Nebraska,Manufacturing,2016,8125,2820,1340,1095,5255,1324,592,7171,954,8860,2820,1340,1105,5265,1410,725,7400,1460,425481,4663,7665,12114,27045,42847,46908,135143,254447,20169073000,176243000,239218000,445932000,962545000,1886690000,2124374000,5846555000,12497987000
Nebraska,"Mining, Quarrying, and Oil and Gas Extraction",2016,527,295,65,70,430,30,30,490,37,610,295,65,70,430,30,30,490,120,5611,455,349,798,1654,486,938,3743,1057,323705000,18490000,22948000,37429000,81672000,24204000,57386000,202393000,68946000
Nebraska,Other,2016,94,94,0,0,94,0,0,94,0,94,94,0,0,94,0,0,94,0,100,100,0,0,100,0,0,100,0,2061000,2061000,0,0,2061000,0,0,2061000,0
Nebraska,Other Services (except Public Administration),2016,27113,17963,4850,2169,24982,1469,328,26779,334,29150,17985,4915,2280,25180,1970,1020,28170,980,180875,32644,31233,28039,92310,49301,22019,167985,10470,4969844000,809760000,802230000,734249000,2357649000,1339279000,666113000,4484139000,427289000
Nebraska,"Professional, Scientific, and Technical Services",2016,21868,14465,3030,1807,19302,1257,392,20951,917,23415,14465,3040,1840,19345,1535,610,21490,1925,201841,21335,19508,23362,64751,40069,24719,133321,64866,12219976000,911441000,900078000,1260136000,3097611000,2427505000,1695548000,7429321000,4594321000
Nebraska,Real Estate and Rental and Leasing,2016,9715,7625,780,375,8780,318,222,9320,395,11240,7630,785,425,8840,460,585,9885,1355,56417,9585,4905,4451,19387,8382,9671,40562,14430,2341060000,347053000,169841000,143721000,676682000,348742000,400469000,1586420000,671765000
Nebraska,Retail Trade,2016,24272,11482,5238,3043,19763,2241,758,22762,1510,36265,11530,5360,3320,20210,3495,2450,26155,10110,537893,21679,34063,39481,95644,71880,51639,223531,307576,13810252000,550156000,809079000,993294000,2362893000,2231348000,2023737000,6737924000,6847286000
Nebraska,Total,2016,43409,25352,7025,4446,36823,3974,1037,41834,1575,54265,25390,7111,4676,37177,5432,3226,45835,8430,884450,41276,46091,59028,146395,145454,120442,412291,472159,37715004000,1476113000,1508999000,2006401000,4991513000,5310548000,5195411000,15497472000,22217532000
Nebraska,Transportation and Warehousing,2016,11053,7520,1234,729,9483,563,290,10336,717,12075,7520,1235,730,9485,610,410,10505,1570,152177,10877,7643,8977,28365,18615,21114,73595,60074,6732143000,358526000,269920000,366706000,1018467000,800676000,993981000,3033138000,2896215000
Nebraska,Utilities,2016,176,45,10,5,60,30,5,95,81,600,45,10,5,60,35,10,105,495,4508,59,0,0,176,508,0,846,3617,462865000,4655000,0,0,9765000,36753000,0,59506000,400015000
Nebraska,Wholesale Trade,2016,11401,4584,1534,1239,7357,1702,844,9903,1498,16025,4590,1590,1320,7500,2230,1980,11710,4315,209373,7428,9532,14251,32498,45279,38824,123120,83068,12136995000,343889000,443670000,704839000,1563931000,2237357000,2145196000,6284453000,5653644000
Nevada,Accommodation and Food Services,2016,23152,7165,4460,4655,16280,4844,892,22016,1136,32740,7175,4485,4745,16405,5715,2680,24800,7940,1606065,10966,29978,63005,104100,181695,139362,425265,1180349,47716495000,687468000,457155000,1085202000,2231923000,3542819000,3154780000,8932660000,38778692000
Nevada,Administrative and Support and Waste Management and Remediation Services,2016,20224,11615,2755,1980,16350,1955,718,19023,1201,22235,11615,2760,2040,16415,2060,785,19260,2975,586290,17458,17998,26221,62097,73260,80962,220976,360323,19455095000,725282000,552680000,903844000,2207714000,2308248000,2063494000,6738228000,12380072000
Nevada,"Agriculture, Forestry, Fishing and Hunting",2016,280,240,25,10,275,5,0,280,0,280,240,25,10,275,5,0,280,0,818,324,152,0,648,0,0,818,0,37331000,25686000,3085000,0,34031000,0,0,37331000,0
Nevada,"Arts, Entertainment, and Recreation",2016,6781,4140,725,605,5470,810,289,6569,212,7645,4140,725,610,5475,860,760,7095,550,147724,5162,4536,7952,18224,33571,39780,96419,45877,5788254000,482415000,122370000,247828000,898032000,956841000,1840283000,3797806000,1321151000
Nevada,Construction,2016,23868,11540,4585,3320,19445,3142,653,23240,628,24195,11540,4585,3335,19460,3185,705,23350,845,364085,18718,29784,44302,93013,115459,71291,282027,77750,19639950000,903937000,1273469000,2108799000,4298707000,5789788000,3573278000,13793510000,5575201000
Nevada,Educational Services,2016,3407,1760,505,305,2570,510,161,3241,166,3615,1760,510,310,2580,535,200,3315,300,57315,2535,3263,4053,10010,17048,13045,41706,14949,2035590000,92260000,88780000,85248000,271085000,488917000,495884000,1307510000,703841000
Nevada,Finance and Insurance,2016,13126,8520,1417,640,10577,603,507,11687,1439,21270,8525,1440,670,10635,985,1270,12890,8380,184009,13940,8779,7433,30931,12537,15019,61327,121465,11715411000,724877000,451885000,374298000,1613717000,765048000,978177000,3569904000,8036070000
Nevada,Health Care and Social Assistance,2016,29750,15930,6050,3485,25465,2629,669,28763,987,35825,15940,6095,3545,25580,3345,1870,30795,5030,605025,24936,40711,45650,111791,99625,87716,303627,297237,30060980000,1979980000,1780524000,2036699000,5819159000,4196773000,3103730000,13292542000,16535286000
Nevada,Information,2016,4711,2840,560,310,3710,275,125,4110,601,6765,2840,565,345,3750,290,195,4235,2530,84443,4027,3475,3720,11757,8935,2715,26976,57148,5436930000,285712000,232864000,211436000,754199000,556006000,118363000,1609476000,3809116000
Nevada,Management of Companies and Enterprises,2016,2019,445,35,80,560,205,457,1222,797,2485,445,40,80,565,205,515,1285,1200,90745,444,18,599,1153,1300,11154,13603,77142,8840902000,44530000,776000,56814000,201847000,418790000,744262000,1364894000,7476008000
Nevada,Manufacturing,2016,8903,3575,1635,1125,6335,1271,587,8193,710,9190,3575,1635,1125,6335,1290,650,8275,915,196503,5734,9431,12926,31071,37069,33709,119577,60737,10330522000,243074000,349516000,501396000,1212024000,1684868000,1578479000,5422210000,3908391000
Nevada,"Mining, Quarrying, and Oil and Gas Extraction",2016,924,405,143,90,638,124,70,832,92,975,405,145,90,640,130,70,840,135,59149,542,856,1028,2611,3122,9381,15818,42686,5970716000,48576000,70964000,140496000,275467000,219920000,946668000,1486280000,4426072000
Nevada,Other,2016,111,104,7,0,111,0,0,111,0,111,104,7,0,111,0,0,111,0,140,95,45,0,140,0,0,140,0,4490000,3240000,1250000,0,4490000,0,0,4490000,0
Nevada,Other Services (except Public Administration),2016,20275,12510,3965,1755,18230,1216,333,19779,496,22705,12510,4020,1850,18380,1665,885,20930,1775,170929,21356,25731,22359,69935,43729,20322,136909,29073,5425216000,693493000,764138000,693677000,2167717000,1263172000,599290000,4128976000,1114355000
Nevada,"Professional, Scientific, and Technical Services",2016,41753,30505,4638,2565,37708,2067,724,40499,1254,44610,30515,4640,2660,37815,2255,1060,41130,3480,298115,40695,29442,33305,103980,66069,33077,207640,87865,18702460000,2704715000,1592193000,2108352000,6426050000,4206039000,1922501000,12755590000,5858972000
Nevada,Real Estate and Rental and Leasing,2016,17818,13475,1803,803,16081,665,405,17151,667,22085,13505,1830,855,16190,880,1190,18260,3825,151065,19044,11575,9905,41115,16849,21247,81358,69286,6731075000,818928000,439608000,386091000,1670390000,793430000,920326000,3479492000,3210638000
Nevada,Retail Trade,2016,26129,12734,4825,3292,20851,2056,944,23851,2278,43540,12765,4900,3555,21220,3005,2590,26815,16725,691868,21635,31608,42039,95764,61743,55428,216476,464198,19545948000,702951000,851806000,1115431000,2685272000,2007046000,2226992000,7028210000,12148682000
Nevada,Total,2016,51591,29500,8079,5328,42907,4806,1580,49293,2298,64815,29525,8154,5530,43209,5756,3430,52395,12420,1165298,44621,53160,70825,168606,169349,149452,487407,677891,49207817000,2399417000,1994899000,2680771000,7075087000,6566510000,6185461000,19827058000,29380759000
Nevada,Transportation and Warehousing,2016,6769,3220,725,654,4599,753,436,5788,981,7785,3220,725,665,4610,780,495,5885,1900,257939,4316,4743,7979,17505,23114,27393,71758,179260,11267517000,207488000,174153000,281836000,679411000,890434000,941354000,2661992000,8313225000
Nevada,Utilities,2016,262,90,20,26,136,30,37,203,59,615,90,20,30,140,45,100,285,330,19006,174,61,240,577,555,1403,2810,8641,1996373000,4293000,2787000,8728000,19755000,57269000,126245000,237654000,935987000
Nevada,Wholesale Trade,2016,13185,6300,1575,1100,8975,1437,1012,11424,1761,14960,6300,1590,1130,9020,1545,1130,11695,3265,181887,9734,9775,12990,33588,31782,27968,97514,78549,10882663000,544238000,480733000,653408000,1730718000,1743657000,1822107000,5530928000,4901409000
New Hampshire,Accommodation and Food Services,2016,15271,5445,2920,3158,11523,3077,331,14931,340,18510,5445,2935,3185,11565,3445,1035,16045,2465,287475,7500,19850,42955,70440,106438,35906,213120,74309,5718170000,310010000,367072000,750022000,1428590000,2104236000,683346000,4225625000,1486822000
New Hampshire,Administrative and Support and Waste Management and Remediation Services,2016,10725,6570,1635,910,9115,717,243,10075,650,11805,6575,1640,915,9130,810,300,10240,1565,278536,10163,10455,11510,32751,26053,18855,83064,143558,12999687000,466742000,388963000,452608000,1331880000,1211505000,883679000,3674339000,6502948000
New Hampshire,"Agriculture, Forestry, Fishing and Hunting",2016,700,510,110,55,675,20,0,695,5,705,510,110,55,675,25,0,700,5,2940,940,662,775,2410,444,0,2854,0,133570000,33612000,24487000,42020000,101397000,28957000,0,130354000,0
New Hampshire,"Arts, Entertainment, and Recreation",2016,3831,2075,570,460,3105,555,74,3734,97,3985,2075,570,460,3105,565,100,3770,215,61583,2695,3537,5887,12611,18437,10484,43032,15583,1381731000,257390000,99280000,133443000,508975000,418863000,139385000,1136380000,178420000
New Hampshire,Construction,2016,19911,13915,2955,1475,18345,1288,165,19798,113,20035,13915,2955,1475,18345,1305,245,19895,140,131025,22170,19306,19560,61520,44913,14479,123440,6254,8190812000,1105382000,974816000,1105671000,3220802000,3133728000,1137657000,7665442000,440678000
New Hampshire,Educational Services,2016,2904,1280,450,430,2160,491,140,2791,113,3085,1280,455,435,2170,575,150,2895,190,129162,2159,2821,5876,10929,18126,14269,47457,80808,5212230000,67349000,61130000,144870000,275998000,532740000,565949000,1554555000,3558189000
New Hampshire,Finance and Insurance,2016,5337,2855,650,309,3814,317,309,4440,897,9930,2855,650,390,3895,565,1350,5810,4120,141886,4966,3801,3542,12771,10960,19019,44634,90279,12634745000,291145000,280702000,299120000,898947000,965790000,1162893000,3201635000,8695784000
New Hampshire,Health Care and Social Assistance,2016,13393,5225,3155,1915,10295,1673,702,12670,723,18525,5235,3170,1995,10400,2245,2060,14705,3820,456171,10741,21151,25243,57515,62446,90972,212782,238444,23195030000,447662000,956794000,1281050000,2701880000,2658575000,3465637000,8895821000,13791547000
New Hampshire,Information,2016,2277,880,305,220,1405,264,144,1813,464,3640,890,305,230,1425,330,190,1945,1695,69542,1514,1913,2482,6344,7300,12099,27726,40766,5933479000,99342000,131546000,134195000,399254000,524628000,782624000,1837112000,4057670000
New Hampshire,Management of Companies and Enterprises,2016,824,30,10,25,65,105,226,396,428,1115,30,10,30,70,105,230,405,710,43933,39,0,128,222,1385,7973,9583,34350,3739284000,6893000,0,12614000,22052000,126950000,597139000,746414000,2992870000
New Hampshire,Manufacturing,2016,8711,3235,1400,1229,5864,1664,464,7992,719,8995,3235,1400,1235,5870,1715,525,8110,885,303174,5565,7957,13777,30437,59246,32351,140082,139882,19659866000,265940000,366913000,701591000,1498012000,3222613000,1929260000,7583248000,10458900000
New Hampshire,"Mining, Quarrying, and Oil and Gas Extraction",2016,237,150,10,30,190,15,15,220,17,260,150,10,30,190,15,25,230,30,1111,235,0,185,643,11,177,970,17,85218000,14085000,0,15457000,48276000,582000,13305000,71482000,1919000
New Hampshire,Other,2016,68,65,3,0,68,0,0,68,0,68,65,3,0,68,0,0,68,0,71,52,19,0,71,0,0,71,0,2152000,1460000,692000,0,2152000,0,0,2152000,0
New Hampshire,Other Services (except Public Administration),2016,17615,11100,3695,1565,16360,808,157,17325,290,18715,11105,3715,1595,16415,1070,315,17800,915,112267,20979,24225,19550,65295,24197,5701,98603,9968,3497428000,657258000,668498000,579799000,1927911000,752333000,230809000,3087700000,307393000
New Hampshire,"Professional, Scientific, and Technical Services",2016,17465,10965,2505,1570,15040,1212,355,16607,858,18665,10975,2510,1600,15085,1390,455,16930,1735,161361,17532,16254,20002,54136,37038,16605,111451,48174,11427255000,1138159000,1026063000,1551253000,3735153000,3040859000,1460831000,8539055000,2791387000
New Hampshire,Real Estate and Rental and Leasing,2016,5841,4155,750,323,5228,241,117,5586,255,7145,4180,780,360,5320,330,630,6280,865,36025,6884,4565,3797,15801,7152,5448,29561,5468,1778296000,311095000,183029000,164075000,684942000,434663000,228613000,1439301000,280980000
New Hampshire,Retail Trade,2016,19237,9465,3907,2058,15430,1806,493,17729,1508,29985,9480,3985,2155,15620,2435,1235,19290,10695,499035,17904,25639,25324,69622,57666,32375,163907,322788,13931789000,532620000,737305000,871141000,2164654000,2356198000,1589407000,6243964000,7346117000
New Hampshire,Total,2016,30627,16732,5382,3331,25445,3038,774,29257,1370,37868,16761,5423,3436,25620,3679,1963,31262,6606,594243,28527,35662,44174,108363,108656,78876,295895,298348,29193307000,1324245000,1433587000,1880188000,4638020000,5014990000,3866723000,13519733000,15673574000
New Hampshire,Transportation and Warehousing,2016,3605,1940,550,362,2852,320,138,3310,295,4040,1940,550,365,2855,340,170,3365,675,69188,3129,3490,4223,11561,9613,7700,35338,32890,2826922000,137080000,128158000,164221000,459422000,383744000,326366000,1437312000,1354230000
New Hampshire,Utilities,2016,227,70,25,5,100,10,45,155,72,595,70,25,5,100,15,190,305,290,14249,160,138,0,376,0,1622,2234,11205,1356229000,8505000,6415000,0,19596000,0,125854000,161672000,1120476000
New Hampshire,Wholesale Trade,2016,8192,3519,1325,662,5506,1006,469,6981,1211,9265,3535,1325,665,5525,1115,610,7250,2015,119252,6020,8190,7615,22973,27276,16030,71761,43099,8822661000,400460000,545421000,514149000,1537912000,1829972000,1197802000,5008369000,3570333000
New Jersey,Accommodation and Food Services,2016,91115,45702,16813,13563,76078,12990,1036,90104,1011,104765,45735,16830,13650,76215,13800,2760,92775,11990,1552776,76540,110584,184063,371190,472048,129899,973597,578874,32048649000,2323107000,1932300000,3169265000,7424708000,8834816000,2534350000,18801324000,13236563000
New Jersey,Administrative and Support and Waste Management and Remediation Services,2016,62518,40445,8178,5262,53885,4974,1617,60476,2042,70530,40455,8180,5305,53940,5100,2020,61060,9470,1630770,56241,54020,70831,181233,190674,237172,612393,1013349,65807630000,3149591000,2180339000,3152554000,8492991000,8165341000,9406265000,26263399000,38968330000
New Jersey,"Agriculture, Forestry, Fishing and Hunting",2016,1050,765,165,45,975,55,10,1040,10,1050,765,165,45,975,55,10,1040,10,4954,1012,977,493,2650,1480,0,4870,0,182531000,36088000,35854000,13109000,96876000,44914000,0,175659000,0
New Jersey,"Arts, Entertainment, and Recreation",2016,16889,9333,2390,1905,13628,2449,510,16587,302,18070,9350,2395,1920,13665,2485,735,16885,1185,318101,12026,15611,25588,53421,97773,79420,234952,73252,9734735000,750492000,501137000,559231000,1814837000,2135548000,2807457000,7164159000,1705317000
New Jersey,Construction,2016,106473,74615,15930,8240,98785,6364,776,105925,548,106945,74615,15930,8250,98795,6390,855,106040,905,776230,118710,103715,108530,330955,238574,111043,684170,90578,53949930000,5625185000,5389340000,6646015000,17660540000,17975884000,9893529000,45823965000,7984185000
New Jersey,Educational Services,2016,17886,7855,3290,2690,13835,2895,799,17529,357,19330,7855,3300,2720,13875,3165,990,18030,1300,546375,12905,22378,35825,71155,121437,109025,304730,240817,20741260000,377120000,462969000,677180000,1518700000,3994962000,4823438000,10555585000,10153551000
New Jersey,Finance and Insurance,2016,31223,19625,4383,1749,25757,2176,1053,28986,2237,58900,19665,4470,1965,26100,3670,3720,33490,25410,986583,34094,27972,22296,84765,76572,72059,237400,745550,114020860000,2192318000,1919894000,2113291000,6263978000,6802452000,6827375000,20506263000,93003273000
New Jersey,Health Care and Social Assistance,2016,109296,51935,25040,14595,91570,12153,3481,107204,2092,137775,52080,25210,15165,92455,14950,10150,117555,20220,2923163,102446,164632,194085,461365,452101,505033,1423884,1497698,140788984000,5174530000,7296562000,9352517000,21831079000,20863222000,19335079000,62369618000,78299818000
New Jersey,Information,2016,10096,5504,1180,860,7544,1054,449,9047,1049,19105,5505,1180,890,7575,1165,510,9250,9855,433762,8279,7621,11299,27875,34926,34156,100672,329726,44741893000,617162000,459604000,772157000,1891273000,2761761000,3342136000,8303173000,36047465000
New Jersey,Management of Companies and Enterprises,2016,4702,410,145,110,665,602,1094,2361,2341,7510,410,145,110,665,620,1155,2440,5070,621945,540,680,670,1890,9982,42122,54085,567860,83865885000,93485000,41765000,60790000,196040000,895211000,4069839000,5169290000,78696595000
New Jersey,Manufacturing,2016,35431,13354,6220,4884,24458,6735,2173,33366,2065,36705,13355,6235,4905,24495,6885,2535,33915,2790,1087104,24625,40149,62433,132817,252483,250727,678104,360206,70692786000,1284383000,1831851000,3025877000,6518025000,14088004000,14565764000,37417603000,30107506000
New Jersey,"Mining, Quarrying, and Oil and Gas Extraction",2016,366,165,30,40,235,46,32,313,53,425,165,30,40,235,55,40,330,95,5517,206,143,373,837,783,472,2469,2416,403130000,17201000,7941000,22283000,52924000,55287000,31175000,168685000,195785000
New Jersey,Other,2016,337,328,6,2,336,1,0,337,0,337,328,6,2,336,1,0,337,0,389,299,38,0,365,0,0,389,0,11502000,9159000,799000,0,10679000,0,0,11502000,0
New Jersey,Other Services (except Public Administration),2016,114217,74910,21443,10150,106503,6216,789,113508,709,118855,74960,21530,10420,106910,6855,1605,115370,3485,775925,137220,138117,133099,408635,217706,73315,703110,67110,24127650000,3672700000,3711973000,3947211000,11340160000,6472293000,2931337000,20926630000,3053550000
New Jersey,"Professional, Scientific, and Technical Services",2016,137921,96340,16863,10025,123228,8948,2796,134972,2949,146165,96385,16900,10150,123435,9725,3580,136740,9425,1641735,146055,108809,131229,386450,309105,256526,955725,683230,146734345000,9440000000,6884976000,9308079000,25660065000,25781551000,23298404000,74970505000,71593434000
New Jersey,Real Estate and Rental and Leasing,2016,37103,26285,5267,2429,33981,1751,529,36261,842,45540,26310,5375,2610,34295,2315,1335,37945,7595,294235,42365,34287,31782,108670,59896,28098,198060,94214,17011800000,1892200000,1513261000,1605222000,5028060000,3598648000,1527864000,10315830000,6569309000
New Jersey,Retail Trade,2016,110763,70333,19379,9771,99483,6948,1633,108064,2699,157230,70515,19755,10375,100645,8710,4095,113450,43780,2323015,128745,127000,127823,383635,255320,153061,796523,1477818,67919190000,3703765000,3497185000,3766504000,10969165000,10397972000,6901981000,28432102000,38178942000
New Jersey,Total,2016,194218,118233,32213,19162,169608,17189,4013,190810,3408,231974,118374,32443,19699,170516,19557,8392,198465,33509,3636293,198156,211098,255098,664352,638671,507084,1810107,1826186,214757817000,9095704000,8622694000,11252906000,28971304000,31503187000,28314570000,88789061000,125968756000
New Jersey,Transportation and Warehousing,2016,33501,19370,4572,2890,26832,3536,1425,31793,1708,37580,19380,4585,2915,26880,3780,1800,32460,5120,821531,28391,30219,37441,96586,122128,123008,349921,462325,43147850000,1175373000,1221975000,1462597000,3884305000,5180531000,5522892000,15143221000,27442714000
New Jersey,Utilities,2016,521,215,50,30,295,60,42,397,124,1855,215,55,30,300,65,95,460,1395,97381,341,260,311,1069,1031,1900,5956,84223,11925402000,21898000,12166000,54589000,98012000,108312000,198166000,571611000,10495808000
New Jersey,Wholesale Trade,2016,63018,32488,9882,6864,49234,7577,2818,59629,3389,69850,32510,9915,7020,49445,7990,3970,61405,8445,1321050,57885,65317,89703,213165,262078,244009,723460,594975,124219975000,3763945000,4058240000,6095916000,13943275000,18302618000,17850573000,50521525000,73507815000
New Mexico,Accommodation and Food Services,2016,15679,4760,2605,3190,10555,3912,543,15010,669,21380,4765,2620,3275,10660,4395,1825,16880,4500,448490,8065,18003,44921,71120,137510,73092,282700,165274,7651105000,203620000,254340000,679775000,1140275000,2204626000,1341220000,4711760000,2912357000
New Mexico,Administrative and Support and Waste Management and Remediation Services,2016,8477,4705,1390,800,6895,648,243,7786,691,9405,4705,1390,810,6905,715,340,7960,1445,159219,7624,8707,10265,27286,20517,25005,75984,78913,5315023000,252720000,308102000,321754000,916731000,646840000,522770000,2192306000,2813354000
New Mexico,"Agriculture, Forestry, Fishing and Hunting",2016,476,320,80,55,455,16,0,471,5,490,320,85,55,460,25,0,485,5,1855,423,452,511,1523,32,0,1665,0,66836000,17808000,15189000,19317000,59049000,959000,0,63011000,0
New Mexico,"Arts, Entertainment, and Recreation",2016,3288,1890,430,405,2725,360,110,3195,93,3500,1890,430,425,2745,400,150,3295,205,67605,2520,2446,5019,10506,12338,15975,42025,20775,1494293000,88541000,53759000,99031000,253495000,240086000,392968000,966943000,432329000
New Mexico,Construction,2016,21467,12970,3685,2390,19045,1934,274,21253,214,21645,12970,3690,2390,19050,1970,335,21355,290,194730,21744,23948,31254,77233,70897,34557,187035,6178,8592580000,754201000,791937000,1212061000,2769150000,3306604000,1814190000,8093990000,412143000
New Mexico,Educational Services,2016,2788,1400,415,345,2160,375,140,2675,113,2930,1400,415,345,2160,375,205,2740,190,44052,2196,2551,4797,9744,13414,14960,39872,3371,1383689000,79520000,55252000,103383000,246675000,398722000,528656000,1248614000,102806000
New Mexico,Finance and Insurance,2016,7130,4355,905,305,5565,430,268,6263,867,13560,4365,935,360,5660,1210,1455,8325,5235,120633,8483,5537,3635,17957,13385,21606,55214,62878,6761729000,317434000,218537000,169824000,730973000,634042000,1178462000,3085390000,3557060000
New Mexico,Health Care and Social Assistance,2016,20305,9295,4030,2749,16074,2474,852,19400,905,25590,9305,4050,2785,16140,3155,1790,21085,4505,609200,15600,26752,36597,79292,93310,124885,300498,304486,25876980000,793305000,1078809000,1442926000,3340598000,3398697000,4103483000,10965905000,14756744000
New Mexico,Information,2016,2171,1030,237,200,1467,197,93,1757,414,3880,1030,240,205,1475,290,165,1930,1950,75321,1562,1329,2401,5860,5709,4350,16916,51087,2713008000,57653000,50891000,91971000,222676000,267078000,189703000,728692000,1929558000
New Mexico,Management of Companies and Enterprises,2016,962,55,35,40,130,166,260,556,406,1165,55,35,40,130,170,275,575,590,32580,45,210,171,440,1689,5665,7900,24680,2080450000,5105000,14750000,12668000,33750000,75286000,380218000,495275000,1585175000
New Mexico,Manufacturing,2016,6585,3035,1185,925,5145,792,250,6187,398,6760,3035,1185,925,5145,835,270,6250,510,115759,5001,6391,10041,24172,20145,9804,68524,30366,5782977000,168907000,215581000,359359000,846238000,827151000,454900000,2801981000,1885465000
New Mexico,"Mining, Quarrying, and Oil and Gas Extraction",2016,3198,1225,505,400,2130,567,155,2852,346,3655,1225,505,410,2140,595,180,2915,740,83773,2101,3446,5301,10906,18988,10131,41043,38941,5887101000,99419000,164222000,291119000,557118000,1052401000,692919000,2385245000,3165557000
New Mexico,Other,2016,68,65,2,0,67,1,0,68,0,68,65,2,0,67,1,0,68,0,109,73,0,0,87,0,0,109,0,1364000,1313000,0,0,1337000,0,0,1364000,0
New Mexico,Other Services (except Public Administration),2016,19050,11485,3960,1975,17420,1065,234,18719,331,20355,11495,3960,2045,17500,1330,650,19480,875,132470,21433,25829,25398,73146,33997,10172,121283,8540,3651550000,584100000,654765000,662411000,1917322000,890203000,339839000,3274414000,294522000
New Mexico,"Professional, Scientific, and Technical Services",2016,21126,14135,2848,1678,18661,1065,439,20165,961,23230,14135,2865,1730,18730,1275,555,20560,2670,289985,21615,18306,21820,62160,30103,21241,115895,171325,21123675000,1127676000,878448000,1214215000,3236510000,1956226000,1682631000,6991300000,14017905000
New Mexico,Real Estate and Rental and Leasing,2016,9331,7050,985,375,8410,323,154,8887,444,11650,7065,1020,395,8480,525,755,9760,1890,48185,11004,6149,4366,21726,7871,3299,33899,13427,1934735000,377504000,200834000,150412000,735904000,342039000,162678000,1285014000,619033000
New Mexico,Retail Trade,2016,19699,9916,3817,2239,15972,1655,552,18179,1520,32390,9960,3875,2420,16255,2465,1850,20570,11820,457311,18557,24943,28119,72147,52982,35126,164822,280231,12066554000,491881000,637014000,800267000,1944603000,1816802000,1140625000,5037898000,6725690000
New Mexico,Total,2016,34372,18814,5798,3861,28473,3381,908,32762,1610,43771,18844,5846,4012,28702,4305,2356,35363,8408,628723,32003,38180,51475,121658,118333,94954,334945,293778,25029224000,1177051000,1232235000,1709259000,4118545000,4130531000,3644235000,11893311000,13135913000
New Mexico,Transportation and Warehousing,2016,5706,3030,805,465,4300,586,211,5097,609,6670,3030,805,470,4305,620,270,5195,1475,85632,4813,4961,5417,15981,17632,8511,45293,29340,3564381000,153598000,148411000,172004000,496906000,653615000,332212000,1576291000,1570329000
New Mexico,Utilities,2016,673,365,90,40,495,75,20,590,83,1070,365,90,40,495,135,40,670,400,20170,756,520,488,1859,2967,492,6272,14161,1746216000,15329000,17981000,24822000,63211000,196132000,25972000,334269000,1422735000
New Mexico,Wholesale Trade,2016,7463,2779,1025,887,4691,915,496,6102,1361,9190,2780,1025,935,4740,1035,670,6445,2745,104064,5158,6245,9513,22230,19382,9565,56522,43561,5288600000,214982000,250892000,436976000,963965000,922546000,439710000,2539519000,2552902000
New York,Accommodation and Food Services,2016,234672,110827,44891,37695,193413,36356,3230,232999,1673,265995,110845,44940,37910,193695,38505,8880,241080,24915,3932115,195265,296880,515570,1007715,1318182,492504,2818750,1110309,96624455000,5665188000,5356755000,10198515000,21220458000,31012434000,13235582000,65472861000,31081553000
New York,Administrative and Support and Waste Management and Remediation Services,2016,123909,83227,15536,9397,108160,9614,3318,121092,2817,135650,83235,15555,9525,108315,9960,4200,122475,13175,2972040,112320,101171,125605,339152,373427,519513,1234120,1731142,159694815000,6650800000,4379963000,6073940000,17106810000,17001058000,19314912000,53584410000,104842340000
New York,"Agriculture, Forestry, Fishing and Hunting",2016,2940,2215,470,140,2825,65,30,2920,20,2955,2215,470,140,2825,70,35,2930,25,14104,3410,2942,1753,8240,2259,958,12959,458,527050000,102118000,95690000,75072000,278341000,91901000,41502000,481220000,18332000
New York,"Arts, Entertainment, and Recreation",2016,59316,41068,6482,4600,52150,5350,1194,58694,622,63420,41090,6505,4640,52235,5600,1665,59500,3920,922425,47565,42097,61803,151730,219405,193016,567970,346773,45088440000,7143505000,2005844000,2357686000,11521950000,8009854000,8043363000,27705125000,17032333000
New York,Construction,2016,240868,170155,33545,19459,223159,14925,2153,240237,631,242155,170160,33550,19480,223190,15075,2530,240795,1360,1802050,252105,220275,261475,733855,550810,338490,1624815,169077,123059940000,11697410000,10617825000,15132005000,37447240000,39709280000,29378069000,106660025000,15781557000
New York,Educational Services,2016,38072,18358,5605,4420,28383,6612,2003,36998,1074,41360,18405,5645,4480,28530,7080,2920,38530,2830,2116850,28226,37684,59767,125715,285618,347975,759815,1356760,91422465000,1265544000,954424000,1561885000,3784040000,10561271000,15283972000,29649240000,61757497000
New York,Finance and Insurance,2016,78968,50555,11718,5021,67294,5558,2575,75427,3541,134095,50620,11950,5595,68165,7995,8120,84280,49815,2744692,85139,74207,64289,223725,199340,292504,717532,2025184,534060198000,7145557000,7034988000,8504379000,22701899000,38714506000,66318421000,128169777000,405418010000
New York,Health Care and Social Assistance,2016,226510,123943,43914,24306,192163,19895,8594,220652,5858,288095,124150,44235,25080,193465,26025,24020,243510,44585,7722025,223374,288685,323877,836076,765697,1411635,3014600,4700986,379344830000,12507148000,12968222000,15470676000,40962420000,34907837000,52905442000,128866161000,250085215000
New York,Information,2016,40330,24729,4780,3319,32828,3668,1602,38098,2232,59180,24845,4805,3410,33060,4150,2050,39260,19920,1483640,33737,31868,44029,109810,130673,178575,422175,1052388,157342730000,3074643000,1796408000,2517929000,7471715000,9379763000,15922221000,33044605000,123653550000
New York,Management of Companies and Enterprises,2016,9461,955,220,302,1477,1609,2583,5669,3792,15070,955,220,315,1490,1640,2715,5845,9225,921065,970,1024,2025,4030,24170,97845,126045,795020,120630045000,275180000,103860000,180160000,559750000,2581965000,9517035000,12658750000,107971295000
New York,Manufacturing,2016,76027,33240,13144,10696,57080,12522,3446,73048,2979,78640,33240,13160,10750,57150,12900,4085,74135,4505,2074603,59529,85716,141105,290457,482654,420287,1236423,771828,115449175000,2466616000,3156447000,5827153000,11641792000,23394781000,21815089000,59162581000,52415098000
New York,"Mining, Quarrying, and Oil and Gas Extraction",2016,1266,680,165,120,965,120,85,1170,96,1570,680,165,120,965,140,160,1265,305,18342,1137,1087,1330,3635,2909,4589,13236,4887,1187620000,77408000,48351000,76812000,206823000,223567000,309828000,927280000,245689000
New York,Other,2016,1244,1181,56,7,1244,0,0,1244,0,1244,1181,56,7,1244,0,0,1244,0,1633,1206,335,92,1633,0,0,1633,0,51424000,41711000,8518000,1195000,51424000,0,0,51424000,0
New York,Other Services (except Public Administration),2016,277226,189560,48210,22746,260516,13613,1917,276046,1180,291200,189730,48375,23155,261260,15890,4700,281850,9350,1976220,338915,315347,299302,953680,468519,248868,1673320,293145,72810505000,9593540000,9276596000,10058003000,28933645000,17726284000,12444396000,59184165000,13246492000
New York,"Professional, Scientific, and Technical Services",2016,290961,212361,35170,19100,266631,15461,4640,286732,4229,308035,212425,35275,19365,267065,17130,6580,290775,17260,3237515,310027,229127,249043,788255,544978,489138,1823370,1401356,304133120000,20698978000,14291184000,17944541000,52937115000,45999280000,46531651000,145548905000,157183534000
New York,Real Estate and Rental and Leasing,2016,150767,116627,17299,8418,142344,5922,1296,149562,1205,167695,116765,17465,9150,143380,7790,3930,155100,12595,900870,177190,112563,109496,399350,200641,116950,719305,178884,54762995000,7786540000,5343409000,5909534000,19044345000,12334185000,8600204000,40316085000,14246887000
New York,Retail Trade,2016,297265,201469,48806,23566,273841,16915,3158,293914,3351,394255,201720,49425,25065,276210,21870,9800,307880,86375,4725330,363329,315293,310355,988989,617036,317098,1927676,2716991,137031845000,10124878000,9444920000,9982270000,29552578000,22931142000,13692888000,66301996000,68236502000
New York,Total,2016,465139,302288,71719,42192,416199,36325,7901,460425,4714,544073,302574,72170,43426,418170,42466,19149,479785,64288,8178455,487886,469649,563813,1521348,1367699,1217039,4106086,4072369,521872694000,23292631000,19344932000,25055103000,67692666000,70777953000,74127812000,212598431000,309274263000
New York,Transportation and Warehousing,2016,57713,36217,7467,5103,48787,5029,1924,55740,1973,64430,36225,7490,5145,48860,5530,3025,57415,7015,1260477,51541,49642,67435,169031,174561,194360,545190,703433,59162865000,1878485000,1906850000,2616478000,6426719000,7401058000,7500895000,21695221000,36422364000
New York,Utilities,2016,1082,465,145,75,685,135,61,881,201,3165,470,145,75,690,170,220,1080,2085,197808,699,917,952,2604,4391,2884,11039,174674,20361730000,49976000,76558000,57887000,186922000,410789000,276784000,944577000,18378619000
New York,Wholesale Trade,2016,144323,89112,21116,13300,123528,13290,3741,140559,3764,157180,89190,21195,13695,124080,14810,6110,145000,12180,1816000,148425,137955,175035,461555,459973,341241,1266635,534777,130598130000,7925940000,7724470000,10487901000,26149415000,30703959000,24718710000,81863220000,47156015000
North Carolina,Accommodation and Food Services,2016,74932,24710,13814,15708,54232,17545,1590,73367,1565,104045,24745,13865,15940,54550,19875,5930,80355,23690,2088048,39135,94131,218720,352025,633084,231371,1216790,871031,33636062000,1255520000,1404687000,3320695000,5981280000,9955401000,3511657000,19453335000,14178798000
North Carolina,Administrative and Support and Waste Management and Remediation Services,2016,54529,32230,9080,4963,46273,4681,1405,52359,2170,63470,32255,9115,5005,46375,5215,1940,53530,9940,1912120,51493,59080,66288,177045,173318,181872,534795,1376188,64189341000,1845318000,1822233000,2181174000,5856246000,6564640000,6164924000,18682446000,45462280000
North Carolina,"Agriculture, Forestry, Fishing and Hunting",2016,3923,2255,1020,405,3680,140,40,3860,63,3965,2255,1020,415,3690,140,60,3890,75,24254,3831,6594,4978,15675,3339,1586,22249,1560,964961000,144007000,241285000,198238000,592541000,129000000,52662000,836886000,84363000
North Carolina,"Arts, Entertainment, and Recreation",2016,17649,10399,2488,1829,14716,2174,429,17319,330,18780,10415,2490,1845,14750,2330,615,17695,1085,324714,14031,16348,24804,55431,83488,62982,206549,109063,9713701000,601941000,414903000,525316000,1551929000,1801093000,1790065000,5233151000,4272785000
North Carolina,Construction,2016,109945,72400,17525,10134,100059,7892,1174,109125,820,111460,72400,17540,10145,100085,8020,1475,109580,1880,936470,114690,115745,136076,366545,286630,134441,791760,140034,45574200000,4481430000,4330020000,5707460000,14520180000,14126405000,7633011000,36522200000,8777106000
North Carolina,Educational Services,2016,13570,7035,1950,1720,10705,1915,551,13171,399,14400,7100,1950,1725,10775,1985,670,13430,970,490076,10305,12817,23153,46519,81932,90855,221621,267066,19723330000,361795000,272745000,510894000,1154558000,2344583000,2959645000,6613480000,13020090000
North Carolina,Finance and Insurance,2016,33519,22568,4695,1778,29041,1429,847,31317,2202,66825,22595,4810,2225,29630,3300,3660,36590,30235,908931,38472,29099,21590,89769,44967,54165,191947,702804,81582803000,1961813000,1475782000,1482463000,5025881000,3175837000,4420210000,12777863000,67997297000
North Carolina,Health Care and Social Assistance,2016,86386,37252,19350,13108,69710,11602,3045,84357,2029,117735,37355,19460,13450,70265,15035,10420,95720,22015,2911540,63167,129638,174669,367551,451399,454925,1276810,1628434,131623883000,3186506000,5642730000,7085780000,15916928000,16261938000,16765988000,49080909000,82210632000
North Carolina,Information,2016,9518,5080,1225,760,7065,925,463,8453,1065,18715,5125,1240,825,7190,1225,925,9340,9375,416017,7510,7639,9666,25422,32885,45450,105672,306907,29708285000,442466000,337605000,461624000,1273025000,2101732000,3421174000,6931760000,22602055000
North Carolina,Management of Companies and Enterprises,2016,5011,255,95,115,465,880,1391,2736,2275,9030,255,95,115,465,890,1490,2845,6185,466805,364,365,655,1384,11473,44585,57605,409173,46946855000,39420000,18820000,28950000,87190000,804456000,3278731000,4182140000,42762058000
North Carolina,Manufacturing,2016,39897,14195,6345,5035,25575,7280,3015,35870,4027,43695,14205,6355,5050,25610,7450,3655,36715,6980,2109793,25793,40770,64292,135676,283394,310999,770715,1271080,103120795000,1034685000,1407257000,2425858000,5086794000,11660707000,13655847000,32273096000,67286512000
North Carolina,"Mining, Quarrying, and Oil and Gas Extraction",2016,578,215,110,55,380,67,36,483,95,1020,215,110,55,380,90,70,540,480,12877,387,661,652,1926,2240,1523,6623,5811,746243000,18407000,25904000,28709000,88532000,109953000,103467000,356645000,357154000
North Carolina,Other,2016,452,423,21,5,449,3,0,452,0,452,423,21,5,449,3,0,452,0,700,447,131,60,638,62,0,700,0,15573000,9722000,2882000,2212000,14816000,757000,0,15573000,0
North Carolina,Other Services (except Public Administration),2016,109941,71187,21448,9403,102038,6202,936,109176,765,118165,71210,21600,9915,102725,7970,2780,113475,4690,787370,129783,139076,122334,391270,216250,86265,697590,78544,21401988000,3290151000,3517360000,3221389000,10032098000,5668222000,2447650000,18289178000,2669201000
North Carolina,"Professional, Scientific, and Technical Services",2016,111810,80225,13838,7438,101501,5638,1820,108959,2851,121400,80260,13900,7615,101775,6920,2795,111490,9910,1102335,115880,89660,98570,304375,182708,124912,616593,473005,82334140000,6100535000,4654139000,5412645000,16180665000,12048656000,9379252000,37892913000,43284500000
North Carolina,Real Estate and Rental and Leasing,2016,43585,35035,3770,1494,40299,1591,699,42589,996,57505,35100,3830,1680,40610,2830,3365,46805,10700,265915,47465,24179,18757,90620,49605,34713,175965,86871,12272120000,1996910000,927830000,775460000,3708595000,2346554000,1397452000,7498145000,4676523000
North Carolina,Retail Trade,2016,101059,58338,19973,10458,88769,7811,1673,98253,2806,173760,58530,20380,11780,90690,13400,7380,111470,62290,2319891,103981,130070,134429,368625,266794,146118,785045,1528265,59118107000,2763782000,3278062000,3793617000,9840305000,8958586000,5408751000,24308135000,34561746000
North Carolina,Total,2016,174314,102859,29230,18150,150239,16530,3771,170540,3774,227347,103044,29507,18995,151546,21139,10625,183310,44037,3794926,166115,192500,242837,601452,610829,459769,1672050,2122876,170980033000,6553245000,6576180000,8357689000,21487114000,22120611000,19651606000,63259331000,107720702000
North Carolina,Transportation and Warehousing,2016,25242,15634,3084,1939,20657,1902,906,23465,1777,29440,15645,3085,1985,20715,2065,1285,24065,5375,601103,23445,19896,25204,69566,60216,48485,185670,351514,26663248000,866199000,691092000,927721000,2518593000,2226918000,2135172000,7103066000,17062893000
North Carolina,Utilities,2016,767,270,100,70,440,115,108,663,104,2905,270,100,70,440,210,245,895,2010,87941,438,636,825,1980,5455,9389,17504,32268,9277592000,16663000,24074000,34179000,86132000,408265000,804959000,1348177000,3557733000
North Carolina,Wholesale Trade,2016,46106,23091,6407,4836,34334,5540,2535,42409,3697,58160,23170,6485,5110,34765,6730,4365,45860,12300,955270,37466,42067,61001,140990,164433,151210,462625,490099,66828640000,2166672000,2218003000,3337262000,7747260000,9042916000,9120558000,26179030000,40532644000
North Dakota,Accommodation and Food Services,2016,8983,3065,1665,1760,6490,1929,340,8759,224,10550,3065,1685,1795,6545,2170,925,9640,910,189338,4777,11200,24256,40390,67307,45564,154388,34854,3199903000,128317000,141164000,349005000,620420000,1063984000,890992000,2597501000,600155000
North Dakota,Administrative and Support and Waste Management and Remediation Services,2016,5045,2950,775,470,4195,391,132,4718,327,5625,2955,780,485,4220,425,175,4820,805,71116,4085,4666,5699,15161,12035,9994,38488,28551,2565451000,168602000,163542000,193471000,556884000,536574000,269050000,1413081000,1004989000
North Dakota,"Agriculture, Forestry, Fishing and Hunting",2016,550,430,65,25,520,10,0,530,20,555,430,65,25,520,10,0,530,25,2193,553,381,288,1258,0,0,1588,594,107315000,30065000,17402000,10367000,58675000,0,0,76060000,30586000
North Dakota,"Arts, Entertainment, and Recreation",2016,2076,1300,220,255,1775,210,59,2044,32,2285,1300,220,255,1775,300,175,2250,35,28158,1538,1241,2865,6216,7271,6897,21655,1301,425651000,56401000,20561000,43230000,135317000,132388000,80206000,366665000,11852000
North Dakota,Construction,2016,14899,9810,2390,1375,13575,950,183,14708,191,15185,9810,2395,1375,13580,1035,250,14865,320,116810,15407,15337,18118,49235,35145,16883,103200,12426,7786365000,787038000,758129000,1146397000,2717165000,2470757000,1319420000,6616750000,1089001000
North Dakota,Educational Services,2016,780,285,120,115,520,145,60,725,55,800,285,120,125,530,145,60,735,65,21957,451,762,1281,2692,5123,5294,13581,2050,524073000,12467000,12895000,18459000,47806000,107236000,136555000,306310000,55592000
North Dakota,Finance and Insurance,2016,5480,3710,485,315,4510,342,151,5003,477,8780,3735,515,480,4730,975,965,6670,2110,84475,6196,2934,4028,13550,10654,13515,38995,43758,4928436000,270293000,135825000,216495000,644911000,587256000,893709000,2200566000,2621474000
North Dakota,Health Care and Social Assistance,2016,8220,3540,1550,1235,6325,1037,512,7874,346,10150,3550,1565,1275,6390,1235,1160,8785,1365,303716,6268,10151,16326,33378,39646,55192,131639,166857,13963309000,265292000,399099000,643499000,1342733000,1250870000,1821792000,4540981000,9016666000
North Dakota,Information,2016,1155,360,190,140,690,187,72,949,206,1725,360,190,165,715,285,85,1085,640,36143,633,1006,1521,3678,6659,3691,15053,14949,2256012000,28045000,30842000,41106000,122843000,401428000,226111000,803442000,918305000
North Dakota,Management of Companies and Enterprises,2016,552,45,5,25,75,70,135,280,272,670,45,5,25,75,70,140,285,385,27360,95,0,95,225,960,2145,3330,24030,2119285000,12840000,0,7395000,20715000,44475000,151310000,216500000,1902785000
North Dakota,Manufacturing,2016,3346,1255,525,480,2260,448,284,2992,354,3635,1255,525,480,2260,455,350,3065,570,93548,2051,2913,4229,10795,9186,14240,46600,32771,4394860000,82454000,97309000,186415000,437756000,389446000,690698000,2087803000,1613903000
North Dakota,"Mining, Quarrying, and Oil and Gas Extraction",2016,2215,860,325,250,1435,300,150,1885,330,2615,860,325,265,1450,370,180,2000,615,81917,1312,2034,3102,6488,10035,7832,25223,56287,7430855000,100289000,153540000,247223000,503372000,862655000,555318000,2005197000,5407925000
North Dakota,Other,2016,47,42,3,2,47,0,0,47,0,47,42,3,2,47,0,0,47,0,72,27,19,0,72,0,0,72,0,1038000,648000,90000,0,1038000,0,0,1038000,0
North Dakota,Other Services (except Public Administration),2016,11955,7742,2280,1047,11069,629,72,11770,185,12375,7745,2295,1090,11130,760,125,12015,360,69854,14292,14315,13554,42678,18205,1392,64568,3466,2009902000,367451000,395648000,365776000,1147101000,506767000,54920000,1776911000,171895000
North Dakota,"Professional, Scientific, and Technical Services",2016,8499,5330,1220,704,7254,569,273,8096,403,9240,5330,1220,725,7275,790,435,8500,740,78464,8204,7822,9040,25720,17525,11444,58280,18220,4800631000,399563000,387916000,510396000,1336070000,1134983000,818835000,3520480000,1184269000
North Dakota,Real Estate and Rental and Leasing,2016,4578,3395,410,240,4045,206,110,4361,217,5455,3395,420,245,4060,260,170,4490,965,27322,4971,2513,2599,10646,4692,1617,18992,5947,1199124000,191947000,93069000,97980000,411342000,220266000,68780000,769337000,338438000
North Dakota,Retail Trade,2016,11499,4545,2565,1672,8782,1386,437,10605,894,16240,4560,2595,1800,8955,2005,1360,12320,3920,243729,8367,16390,21457,46923,39198,32283,123588,113991,6936764000,245367000,453808000,657011000,1375006000,1350839000,1166733000,4068066000,2693941000
North Dakota,Total,2016,19979,11040,3295,2221,16556,1951,571,19078,901,24601,11056,3328,2356,16740,2678,1566,20984,3617,346947,17979,21541,29723,69243,68992,60729,198964,147983,15816748000,731056000,773685000,1147563000,2652304000,2847676000,2591341000,8091321000,7725427000
North Dakota,Transportation and Warehousing,2016,6703,4320,845,435,5600,445,218,6263,440,7445,4325,845,440,5610,490,290,6390,1055,78664,6312,5198,5186,17323,13709,12933,46325,30921,4032195000,287228000,225664000,249400000,778923000,703604000,586407000,2150794000,1834061000
North Dakota,Utilities,2016,262,50,30,20,100,70,25,195,67,730,50,30,25,105,145,70,320,410,15537,66,172,128,500,2756,2658,6038,8615,1465704000,3581000,10399000,9706000,33969000,232650000,268613000,542003000,837133000
North Dakota,Wholesale Trade,2016,5816,2005,805,599,3409,957,467,4833,983,8710,2015,830,695,3540,1465,915,5920,2790,112749,3264,4784,6707,16063,25433,18134,63930,47014,6379742000,163703000,229686000,371134000,835423000,1460541000,1023888000,3539704000,2746637000
Ohio,Accommodation and Food Services,2016,85261,29039,16065,17330,62434,19197,1993,83624,1637,120575,29125,16100,17575,62800,22305,9010,94115,26460,2403554,47050,107880,237884,392860,704970,316875,1415105,988407,36595276000,1323007000,1419130000,3203573000,5946272000,10519509000,4460183000,20929017000,15665392000
Ohio,Administrative and Support and Waste Management and Remediation Services,2016,56514,32480,8560,5665,46705,5405,1919,54029,2485,67880,32495,8570,5700,46765,5810,2510,55085,12795,1985810,47472,56516,75841,179896,204565,278540,666167,1319040,65852505000,2087525000,1965814000,2866880000,6924070000,7257985000,8542084000,22839989000,42981475000
Ohio,"Agriculture, Forestry, Fishing and Hunting",2016,1380,1010,185,95,1290,45,10,1345,35,1395,1010,185,95,1290,45,10,1345,50,5986,1529,1036,1199,3906,769,0,5161,754,198469000,45055000,26097000,42122000,116953000,24770000,0,163217000,32490000
Ohio,"Arts, Entertainment, and Recreation",2016,17870,9780,2620,2217,14617,2396,531,17544,326,19085,9785,2620,2250,14655,2605,825,18085,1000,330629,14183,17502,28921,60853,90665,75038,230236,89495,12048087000,584956000,468836000,572201000,1634293000,1790927000,4749164000,8264008000,3104608000
Ohio,Construction,2016,97195,60720,16580,10258,87558,7735,1160,96453,742,98635,60720,16580,10270,87570,8015,1515,97100,1535,944320,98070,109235,136535,343840,284830,155206,785460,145977,55581425000,4578575000,4815690000,7131105000,16525370000,17338920000,10224615000,44211640000,10753083000
Ohio,Educational Services,2016,13535,5165,2240,1957,9362,3012,697,13071,464,15270,5175,2260,2035,9470,3410,1230,14110,1160,606124,8661,15265,26975,51000,126049,103274,281154,321917,17425503000,262078000,347180000,574089000,1186200000,3609347000,3313648000,8146673000,9065671000
Ohio,Finance and Insurance,2016,41020,26677,6173,2480,35330,2412,1024,38766,2254,86675,26750,6365,3140,36255,5565,4985,46805,39870,1271448,49004,38703,31419,119319,86724,87398,294284,975695,95321706000,2260532000,2034547000,1958152000,6273664000,5672917000,6171173000,18195559000,77044180000
Ohio,Health Care and Social Assistance,2016,99529,38610,22593,15369,76572,14680,5099,96351,3178,146125,38745,22830,16225,77800,20160,15775,113735,32390,4203580,75527,150430,204948,430954,584275,773708,1790181,2411997,188379955000,3465751000,5777415000,8362368000,17607640000,21121844000,25035087000,63907871000,124416964000
Ohio,Information,2016,9049,4180,1260,915,6355,1162,427,7944,1105,20175,4195,1265,940,6400,1490,650,8540,11635,423790,6042,7963,11878,26445,40221,41211,109770,313525,30519557000,310769000,325042000,560591000,1224417000,2084057000,2640648000,6044267000,24423251000
Ohio,Management of Companies and Enterprises,2016,6697,360,105,235,700,1106,2027,3833,2864,11325,360,105,235,700,1135,2105,3940,7385,754185,475,415,1425,2315,14368,66035,82750,671427,74947815000,46094000,28485000,119690000,194269000,890086000,4426635000,5512785000,69431730000
Ohio,Manufacturing,2016,64652,19079,11290,9770,40139,13558,5356,59053,5599,70000,19080,11310,9825,40215,14265,6635,61115,8885,3276665,37611,73744,128592,244264,525230,637833,1450366,1754593,181025966000,1653449000,2741349000,5622965000,10227934000,25046269000,33071580000,70471757000,106567173000
Ohio,"Mining, Quarrying, and Oil and Gas Extraction",2016,2924,1400,535,320,2255,210,163,2628,296,3605,1400,535,345,2280,250,265,2795,810,52297,2551,3543,4188,10412,6297,7817,25538,23845,3311081000,138098000,146074000,210673000,501284000,340412000,551746000,1447798000,1655421000
Ohio,Other,2016,347,332,11,3,346,1,0,347,0,347,332,11,3,346,1,0,347,0,443,309,67,40,416,0,0,443,0,8629000,7284000,837000,452000,8573000,0,0,8629000,0
Ohio,Other Services (except Public Administration),2016,122647,71255,28010,13248,112513,7837,1280,121630,1017,136975,71385,28320,13970,113675,10260,3545,127480,9495,1012138,140874,184053,172095,497203,263447,111129,872813,127326,27798065000,3438550000,4192116000,4285223000,11920065000,7305509000,3397317000,22653260000,4790387000
Ohio,"Professional, Scientific, and Technical Services",2016,107806,70195,15563,9366,95124,7474,2413,105011,2795,119645,70225,15605,9655,95485,8755,3650,107890,11755,1253830,109065,102329,124370,336015,258700,207375,808515,433931,85264640000,5490055000,5110822000,7106451000,17717935000,17130267000,15574134000,50837140000,33965562000
Ohio,Real Estate and Rental and Leasing,2016,36623,26068,4589,2186,32843,1896,909,35648,975,51805,26135,4710,2510,33355,3155,4210,40720,11085,331955,39953,29739,27088,96985,58001,50568,207525,118470,16268030000,1593396000,1040403000,1131457000,3776695000,2658220000,2820680000,9350225000,6720318000
Ohio,Retail Trade,2016,100898,53801,21483,11679,86963,8726,2190,97879,3019,180100,53985,22050,12875,88910,13460,9120,111490,68610,2869185,105816,143215,153682,402803,318544,222538,949783,1902459,73908080000,2573062000,3311345000,4018402000,9904431000,10921729000,7908935000,28906321000,44626549000
Ohio,Total,2016,184738,98170,34184,22454,154808,20764,5049,180621,4117,252201,98372,34579,23623,156574,26725,14957,198256,53945,4790178,170515,226349,300855,697719,787823,707378,2192920,2597258,218466744000,6693857000,7607214000,10946654000,25247725000,30642290000,30931426000,86821441000,131645303000
Ohio,Transportation and Warehousing,2016,29967,15455,4378,3330,23163,3128,1353,27644,2323,37485,15460,4405,3405,23270,3530,2050,28850,8635,878182,23324,28787,44053,96667,106421,85829,293249,565990,41519189000,973191000,1080711000,1762544000,3838694000,4528143000,3689509000,12282734000,27040655000
Ohio,Utilities,2016,858,230,110,80,420,240,43,703,155,3235,230,110,90,430,315,125,870,2365,114941,400,746,1018,2200,8813,3810,15661,98676,11204765000,18022000,34807000,60662000,115814000,616987000,222096000,1003529000,10159803000
Ohio,Wholesale Trade,2016,54179,23898,8803,6601,39302,7385,3342,50029,4150,69280,23940,8915,6960,39815,9090,6570,55475,13805,1164430,42656,57636,86314,187060,239459,239414,672125,485139,71284060000,2511963000,3057499000,4876185000,10465935000,13478656000,14248207000,38517560000,32426334000
Oklahoma,Accommodation and Food Services,2016,28080,10175,4725,5145,20045,6409,776,27230,850,40030,10270,4735,5215,20220,7410,3820,31450,8580,771275,17110,32207,71001,120515,239778,113910,474807,284688,11646960000,434820000,404262000,944905000,1786230000,3408695000,1648053000,6852863000,4524333000
Oklahoma,Administrative and Support and Waste Management and Remediation Services,2016,20045,11475,3225,1818,16518,1656,688,18862,1183,22625,11490,3235,1855,16580,1755,975,19310,3315,514019,17948,20826,23767,62951,61757,95789,223273,286821,18725310000,685686000,628402000,804092000,2134399000,1916303000,2734394000,6899083000,11708673000
Oklahoma,"Agriculture, Forestry, Fishing and Hunting",2016,810,550,140,60,750,30,5,785,25,810,550,140,60,750,30,5,785,25,3656,814,804,728,2560,489,0,3240,139,150033000,30310000,28521000,31268000,99610000,18802000,0,128715000,6640000
Oklahoma,"Arts, Entertainment, and Recreation",2016,5281,2975,695,555,4225,670,259,5154,127,5750,2980,695,580,4255,695,385,5335,415,148631,4473,4431,7164,16505,24543,36464,83796,63212,4685894000,156550000,86628000,114891000,368468000,479371000,1223335000,2644914000,2014323000
Oklahoma,Construction,2016,40815,25660,7040,4135,36835,3105,465,40405,410,41220,25660,7040,4140,36840,3155,550,40545,675,362850,42470,45780,54397,142660,110900,50862,309095,50162,18092885000,1501370000,1664460000,2288424000,5455080000,5452624000,2767213000,13933855000,3916667000
Oklahoma,Educational Services,2016,3638,1790,495,455,2740,460,239,3439,199,3855,1790,495,460,2745,470,320,3535,320,107105,2851,3227,6005,12312,16171,30645,60200,45484,3044290000,87473000,58105000,104151000,256612000,462122000,914134000,1694195000,1310804000
Oklahoma,Finance and Insurance,2016,20187,13770,2582,901,17253,1275,498,19026,1161,34410,13790,2675,1160,17625,3530,2800,23955,10455,298248,23847,16163,10838,51313,48435,47144,149670,144068,17754229000,1009810000,708948000,588381000,2333313000,2595562000,2550231000,7680701000,9869601000
Oklahoma,Health Care and Social Assistance,2016,42516,21233,8760,5038,35031,4850,1481,41362,1154,55570,21265,8770,5230,35265,6455,4780,46500,9070,1106740,36013,58412,66246,160860,207044,205509,574177,529715,46958810000,2097759000,2351769000,2606702000,7061282000,6933389000,6754341000,20775122000,26064696000
Oklahoma,Information,2016,3774,1740,475,444,2659,388,209,3256,518,7465,1810,475,490,2775,525,415,3715,3750,139490,2709,2976,5831,11939,11753,10609,38942,99646,7381415000,117979000,110279000,218960000,468017000,526706000,473618000,1686830000,5635803000
Oklahoma,Management of Companies and Enterprises,2016,2292,170,30,110,310,396,687,1393,899,3285,170,30,110,310,400,735,1445,1840,190500,189,105,670,965,3755,19725,24445,165992,16516260000,15850000,8075000,45745000,69775000,248825000,1492865000,1811465000,14700512000
Oklahoma,Manufacturing,2016,15759,5710,2740,2162,10612,2546,1052,14210,1549,17080,5710,2740,2175,10625,2725,1320,14670,2410,617546,10419,16761,26122,56890,88463,90720,262490,317061,31269414000,401767000,595057000,1037518000,2173543000,3941784000,4452315000,11721466000,17571936000
Oklahoma,"Mining, Quarrying, and Oil and Gas Extraction",2016,12913,8395,1620,999,11014,1014,327,12355,558,14560,8395,1625,1005,11025,1090,575,12690,1870,200575,13152,10743,13297,37352,35173,23220,96430,104065,16276690000,578117000,593302000,863776000,2042663000,2452447000,2002730000,6536984000,9734965000
Oklahoma,Other,2016,120,115,5,0,120,0,0,120,0,120,115,5,0,120,0,0,120,0,145,114,31,0,145,0,0,145,0,2442000,2288000,154000,0,2442000,0,0,2442000,0
Oklahoma,Other Services (except Public Administration),2016,42152,26708,8322,3590,38620,2584,485,41689,463,45015,26740,8390,3755,38885,3235,1375,43495,1520,315340,49213,54067,46772,150443,90819,44411,288915,19341,8174287000,1209617000,1295714000,1188435000,3707460000,2257385000,1093057000,7155782000,825691000
Oklahoma,"Professional, Scientific, and Technical Services",2016,44596,31707,6065,3045,40817,1968,691,43476,1120,48090,31715,6100,3155,40970,2285,1585,44840,3250,367570,48457,40183,39687,128722,63619,54045,253365,105186,22803915000,2185765000,1854256000,1970358000,6032751000,3784939000,3665575000,13974715000,8190505000
Oklahoma,Real Estate and Rental and Leasing,2016,17310,13273,1658,759,15690,630,332,16652,658,21345,13305,1715,885,15905,950,795,17650,3695,113930,18244,10409,9562,38478,18871,9512,69320,42524,4910850000,644733000,346450000,374167000,1371690000,714180000,460974000,2687575000,2166887000
Oklahoma,Retail Trade,2016,41038,21150,9048,4578,34776,3434,905,39115,1923,65840,21220,9210,5010,35440,5340,3625,44405,21435,870278,39898,59596,58022,157876,120360,70128,354599,497696,22369457000,1012939000,1381987000,1564128000,3967098000,3981614000,2490710000,10645464000,11289764000
Oklahoma,Total,2016,72661,42267,12356,7300,61923,6721,1782,70426,2235,93232,42361,12475,7690,62526,8853,5398,76777,16455,1360379,70464,81357,96783,248604,252475,211503,712582,647797,57193626000,2640716000,2677860000,3329526000,8648102000,9003558000,8597649000,26249309000,30944317000
Oklahoma,Transportation and Warehousing,2016,11300,6330,1390,977,8697,979,481,10157,1143,13690,6335,1405,1005,8745,1025,740,10510,3180,220934,9438,8755,12141,30711,31041,21606,87030,110564,10726007000,322356000,323905000,466274000,1128433000,1272385000,1054078000,3619683000,5811837000
Oklahoma,Utilities,2016,649,205,65,35,305,145,81,531,118,1830,205,65,35,305,205,210,720,1110,42868,397,377,298,1158,7855,5708,15378,18926,3561202000,16167000,14710000,11790000,50524000,615095000,463779000,1171211000,1693053000
Oklahoma,Wholesale Trade,2016,18138,7798,2756,1971,12525,2318,1198,16041,2097,23090,7830,2810,2125,12765,2985,1980,17730,5360,291964,13230,17462,24127,55811,61072,51071,176635,105505,16031183000,637030000,786561000,1149978000,2611401000,3052459000,2728381000,8751266000,6624089000
Oregon,Accommodation and Food Services,2016,45481,14871,10098,10533,35502,8302,963,44767,714,56935,14925,10185,10815,35925,10095,4085,50105,6830,884825,23730,68065,143000,234795,274975,133559,643756,239303,16914685000,700840000,1069120000,2436875000,4206835000,5328935000,2460110000,12001720000,4860107000
Oregon,Administrative and Support and Waste Management and Remediation Services,2016,26193,15815,4217,2312,22344,2066,683,25093,1100,29595,15815,4220,2365,22400,2245,1030,25675,3920,512998,25123,27530,30770,83905,76845,83371,248069,264481,17204542000,856090000,829159000,1045550000,2749380000,2748018000,2701594000,8355251000,8831173000
Oregon,"Agriculture, Forestry, Fishing and Hunting",2016,6541,4330,725,635,5690,675,110,6475,66,6705,4330,725,635,5690,705,160,6555,150,62118,6190,4820,8923,20208,23976,12358,57773,4171,2621141000,301161000,192735000,400095000,908301000,1055084000,431576000,2431116000,179729000
Oregon,"Arts, Entertainment, and Recreation",2016,8872,5105,1265,1065,7435,1082,218,8735,137,9320,5110,1280,1065,7455,1200,380,9035,285,136898,7812,8278,13929,30291,39575,29102,102487,25923,3515230000,277923000,172761000,302698000,761387000,788450000,791841000,2646351000,545354000
Oregon,Construction,2016,60667,41475,9690,5290,56455,3363,439,60257,410,61190,41475,9690,5300,56465,3515,520,60500,690,431010,64825,63050,69625,197500,121481,50487,373084,54612,24681635000,2624020000,2537605000,3311490000,8473115000,7468660000,3864603000,20084232000,4351366000
Oregon,Educational Services,2016,7406,3680,1135,965,5780,1190,258,7228,178,8130,3685,1140,1005,5830,1355,670,7855,275,193900,5777,7408,13045,26425,45037,38222,111416,77486,5097900000,181819000,155814000,259641000,601465000,1197604000,1059408000,2899221000,1949447000
Oregon,Finance and Insurance,2016,16991,11470,1975,748,14193,756,544,15493,1498,30005,11490,2010,825,14325,1575,1875,17775,12230,303638,20426,12414,8607,41894,25494,33445,103890,199235,22306776000,903790000,677419000,597960000,2217966000,1777399000,2272629000,6507167000,15751920000
Oregon,Health Care and Social Assistance,2016,51922,27885,10569,5853,44307,4570,1824,50701,1221,68040,27905,10625,6075,44605,6245,7490,58340,9700,1224805,48775,70460,78482,197775,180575,206284,586685,635292,62258455000,2164241000,2767649000,3208234000,8141410000,7362997000,7584974000,23220299000,38940108000
Oregon,Information,2016,7050,3715,851,715,5281,749,303,6333,717,10835,3720,870,745,5335,820,620,6775,4060,191744,5381,5360,9262,20531,23678,28467,77968,108329,13141833000,271994000,230036000,456817000,980437000,1497956000,2081362000,5043577000,7912819000
Oregon,Management of Companies and Enterprises,2016,2636,155,65,121,341,520,801,1662,974,3535,155,65,130,350,535,865,1750,1785,254050,166,270,571,1011,5294,28719,35040,218989,28424880000,20787000,28755000,33695000,83345000,276527000,2288566000,2649250000,25773286000
Oregon,Manufacturing,2016,26212,11025,4610,3505,19140,4118,1383,24641,1571,27465,11030,4615,3530,19175,4285,1610,25070,2395,792019,19118,28996,43638,96663,146509,131542,416431,313090,42752054000,739718000,1029829000,1754031000,3747198000,6771506000,6854037000,19406451000,19414914000
Oregon,"Mining, Quarrying, and Oil and Gas Extraction",2016,569,240,105,100,445,65,10,520,49,680,240,105,100,445,70,10,525,155,6891,376,583,1201,2268,1627,0,4219,2588,393955000,19661000,21395000,59033000,106203000,87850000,0,212796000,174788000
Oregon,Other,2016,332,318,13,1,332,0,0,332,0,332,318,13,1,332,0,0,332,0,431,349,68,0,431,0,0,431,0,9795000,7676000,2105000,0,9795000,0,0,9795000,0
Oregon,Other Services (except Public Administration),2016,46845,29410,9720,4229,43359,2520,448,46327,518,50545,29440,9770,4410,43620,3410,1435,48465,2080,342035,52714,63711,54136,170935,88923,35395,298935,34696,10344970000,1458908000,1631769000,1598920000,4700928000,2583991000,1258692000,8665495000,1514389000
Oregon,"Professional, Scientific, and Technical Services",2016,58790,41660,7530,4172,53362,2985,887,57234,1556,61905,41660,7535,4355,53550,3390,1080,58020,3885,455339,62892,48833,54755,166764,96730,48941,318069,132235,33522891000,3222822000,2484532000,3113548000,8832921000,6869891000,3842163000,19775246000,13444741000
Oregon,Real Estate and Rental and Leasing,2016,25982,20427,2488,1175,24090,910,406,25406,576,31815,20450,2590,1320,24360,1555,1865,27780,4035,143188,29755,15655,14645,60183,28328,19216,108700,33906,5923293000,1153778000,556284000,613540000,2326940000,1114992000,775778000,4270305000,1634696000
Oregon,Retail Trade,2016,47861,23689,10980,5895,40564,4196,1199,45959,1902,70510,23785,11265,6445,41495,6450,5035,52980,17530,1042077,43579,72285,76633,192877,137347,89681,424787,597736,30107793000,1177898000,1763447000,2123176000,5075325000,4730184000,3128902000,13119405000,16472173000
Oregon,Total,2016,93640,54952,16202,10134,81288,8088,1946,91322,2318,114551,55014,16371,10583,81968,10448,6338,98754,15797,1551192,89530,106699,135157,331386,291694,229903,852983,698209,74062716000,3496733000,3561221000,4783548000,11841502000,11809384000,10273141000,33924027000,40138689000
Oregon,Transportation and Warehousing,2016,13716,7660,1885,1325,10870,1229,606,12705,1011,15740,7665,1890,1380,10935,1320,815,13070,2670,282494,11343,12008,16886,41220,41017,30617,116666,131265,13300425000,445691000,457264000,655731000,1594165000,1785993000,1355143000,4881459000,6655782000
Oregon,Utilities,2016,636,360,40,30,430,95,20,545,91,1355,360,40,30,430,155,35,620,735,38789,764,242,368,1446,3796,102,5562,23229,3836253000,22069000,9447000,33537000,67991000,332032000,12206000,427794000,2394048000
Oregon,Wholesale Trade,2016,22157,10240,3138,2296,15674,2737,1430,19841,2316,26790,10240,3170,2380,15790,3315,2110,21215,5575,418424,16388,19758,29136,66144,76953,65481,213317,194266,31296524000,861087000,1031293000,1560817000,3493038000,4340189000,3901000000,12024256000,18507799000
Pennsylvania,Accommodation and Food Services,2016,114568,49348,22050,20070,91468,19824,1775,113067,1501,142575,49420,22110,20230,91760,22115,6480,120355,22220,2377990,85640,146785,273298,505795,726406,255034,1488240,889332,39907955000,1983500000,2083610000,3747204000,7815340000,11328331000,3903629000,23069475000,16835026000
Pennsylvania,Administrative and Support and Waste Management and Remediation Services,2016,67315,39985,10460,6318,56763,6132,1895,64790,2525,78725,39995,10470,6475,56940,6655,2855,66450,12275,1658575,57851,68833,83846,210746,231027,259755,704020,950433,58504590000,2662976000,2600831000,3198372000,8469754000,8939354000,7976663000,25496385000,32815172000
Pennsylvania,"Agriculture, Forestry, Fishing and Hunting",2016,2430,1895,290,110,2295,95,25,2415,15,2430,1895,290,110,2295,95,25,2415,15,12695,3403,1746,1368,6767,3179,904,12560,27,475395000,103694000,56183000,46707000,216804000,132018000,40217000,465550000,1969000
Pennsylvania,"Arts, Entertainment, and Recreation",2016,22351,12072,3400,2710,18182,3104,637,21923,428,23750,12080,3410,2735,18225,3325,915,22465,1285,541435,16239,22513,36534,75479,124790,93345,296400,238311,16496015000,699765000,503000000,702462000,1908775000,2592538000,4001742000,8645020000,7654376000
Pennsylvania,Construction,2016,131827,87430,21125,11945,120500,9157,1389,131046,781,133170,87435,21130,11990,120555,9320,1700,131575,1595,1188690,140490,139440,161790,441720,340565,200493,984800,194987,71636120000,6031265000,6347390000,8756740000,21135395000,21860315000,14611690000,57730225000,13418480000
Pennsylvania,Educational Services,2016,17217,7085,2525,2235,11845,3678,952,16475,742,19340,7100,2530,2290,11920,4000,1460,17380,1960,1336725,11321,17007,30014,58600,158917,147905,365855,970412,54039090000,393110000,380446000,761309000,1544515000,5201920000,6110754000,12872505000,41144831000
Pennsylvania,Finance and Insurance,2016,46796,29667,7680,2792,40139,2709,1396,44244,2552,88400,29705,7905,3265,40875,5365,6555,52795,35605,1362768,56861,48858,35826,141824,93763,133102,371114,980761,116932660000,3110698000,2924116000,2812936000,8875785000,7493689000,10199620000,26788720000,88885867000
Pennsylvania,Health Care and Social Assistance,2016,121454,52338,25961,17709,96008,15615,5944,117567,3887,188315,52485,26230,18720,97435,23235,20580,141250,47065,5025714,101951,171842,237198,511115,603973,895910,2011533,3012540,231247579000,4408601000,6776124000,9699986000,20888581000,24017128000,31460534000,76436483000,154734296000
Pennsylvania,Information,2016,12586,5680,1955,1405,9040,1617,595,11252,1334,26145,5705,1965,1490,9160,1960,1100,12220,13925,556138,9125,12771,18204,40533,56532,56022,156747,397609,47279301000,440870000,497006000,840055000,1799208000,3266202000,3704559000,9063851000,38150449000
Pennsylvania,Management of Companies and Enterprises,2016,7114,335,120,175,630,1262,2058,3950,3164,12125,335,120,175,630,1285,2270,4185,7940,882290,345,530,1045,1920,15991,83680,101595,780695,88447270000,92875000,51475000,84260000,228610000,986819000,6591545000,7811750000,80635520000
Pennsylvania,Manufacturing,2016,63570,21187,10435,9651,41273,12880,4506,58659,4911,67890,21195,10435,9700,41330,13615,5440,60385,7505,2662348,40775,68036,128664,242423,501830,531145,1317229,1273947,149331699000,1786871000,2582749000,5504198000,10133115000,24536791000,27844588000,64647928000,80718633000
Pennsylvania,"Mining, Quarrying, and Oil and Gas Extraction",2016,4202,1790,620,485,2895,575,304,3774,428,5420,1790,620,485,2895,640,470,4005,1415,109010,3083,3993,6303,13453,18129,19259,51474,57256,8075690000,219235000,183735000,292925000,699227000,1080098000,1517786000,3356597000,4704115000
Pennsylvania,Other,2016,428,406,17,2,425,3,0,428,0,428,406,17,2,425,3,0,428,0,628,431,107,0,558,70,0,628,0,18007000,15346000,1574000,0,17679000,328000,0,18007000,0
Pennsylvania,Other Services (except Public Administration),2016,168489,105230,35896,15985,157111,9068,1336,167515,974,181450,105310,36130,16520,157960,11000,3700,172660,8790,1219030,207093,232504,209336,649030,308791,125958,1086320,117111,34413690000,5036273000,5493612000,5294901000,15827785000,9035599000,4554939000,29477710000,4451529000
Pennsylvania,"Professional, Scientific, and Technical Services",2016,136022,90180,18690,11514,120384,9563,2688,132635,3387,148900,90270,18825,11805,120900,11490,4005,136395,12505,1622200,141025,121985,150110,413230,334326,226667,977135,643477,127759395000,8353030000,6989425000,10056788000,25407215000,25376626000,19315142000,70284580000,57367256000
Pennsylvania,Real Estate and Rental and Leasing,2016,36933,25243,5189,2564,32996,2003,898,35897,1036,50445,25315,5410,2805,33530,2680,3760,39970,10475,331625,40675,33574,33356,107660,62929,57317,229475,99015,18207070000,1723830000,1396316000,1530907000,4653575000,3446706000,3354093000,11534890000,6580343000
Pennsylvania,Retail Trade,2016,130229,71906,26221,14283,112410,11733,2890,127033,3196,216080,72085,26875,15790,114750,17090,9100,140940,75140,3242886,136415,173011,187806,497325,434090,293171,1230145,1935169,84461447000,3613905000,4404588000,5250309000,13271250000,14962160000,9912740000,38264455000,43894398000
Pennsylvania,Total,2016,230357,129972,41333,25976,197281,23348,5453,226082,4275,301484,130167,41781,27120,199068,29646,15650,244364,57120,5354964,226472,272090,348279,846841,889633,761050,2497524,2857440,261082307000,8947084000,9580671000,13239689000,31767444000,37275974000,35436962000,104480380000,156601927000
Pennsylvania,Transportation and Warehousing,2016,36071,19745,4790,3520,28055,4251,1441,33747,2324,43625,19745,4800,3575,28120,4755,1980,34855,8770,1111215,29032,31539,46498,107955,154626,122734,391455,715130,47407456000,1112325000,1095165000,1735358000,3985829000,5524178000,4448656000,14259296000,32896851000
Pennsylvania,Utilities,2016,1089,395,110,115,620,152,50,822,267,4140,395,110,115,620,225,140,985,3155,150522,735,720,1468,2966,5870,1269,11827,138619,16341321000,39319000,28010000,95184000,166668000,495427000,93156000,875067000,15457904000
Pennsylvania,Wholesale Trade,2016,57955,26499,9372,7046,42917,7772,3213,53902,4053,72355,26545,9455,7315,43315,9365,5715,58395,13960,1241160,47510,61465,92414,201495,256340,224964,687040,546428,88524895000,2651840000,3375493000,5484447000,11517150000,15357222000,13481157000,40618720000,47174795000
Rhode Island,Accommodation and Food Services,2016,13270,5005,2480,2460,9945,2729,212,12886,384,15460,5010,2490,2485,9985,2980,690,13655,1805,241580,7359,16914,33763,58203,96697,27550,182640,58650,4796435000,295884000,284354000,603035000,1187552000,1814998000,517017000,3523115000,1260654000
Rhode Island,Administrative and Support and Waste Management and Remediation Services,2016,8325,5535,880,575,6990,610,185,7785,540,8820,5535,885,575,6995,630,190,7815,1005,122571,6613,5631,7609,20496,21639,20655,65581,54026,4516201000,379888000,210956000,301610000,918032000,802381000,445277000,2286548000,2092359000
Rhode Island,"Agriculture, Forestry, Fishing and Hunting",2016,195,165,10,10,185,10,0,195,0,195,165,10,10,185,10,0,195,0,647,252,0,0,440,0,0,647,0,35493000,11917000,0,0,25760000,0,0,35493000,0
Rhode Island,"Arts, Entertainment, and Recreation",2016,2524,1355,345,345,2045,322,60,2427,97,2765,1355,345,350,2050,335,170,2555,210,47203,1913,2066,4143,8574,10561,6454,28868,13183,1244937000,97750000,87954000,155184000,355040000,276229000,113638000,833325000,310798000
Rhode Island,Construction,2016,15557,11520,2100,1065,14685,690,105,15480,77,15570,11520,2100,1065,14685,690,110,15485,85,90075,17783,13422,13421,45232,22127,11197,84610,4666,5759250000,861497000,649418000,778490000,2335462000,1566960000,812789000,5194500000,498591000
Rhode Island,Educational Services,2016,1903,825,265,200,1290,360,140,1790,113,2060,825,265,215,1305,405,145,1855,205,148538,1244,1629,2492,5580,13105,14381,33866,114498,5182410000,38458000,32605000,71072000,148783000,466961000,644089000,1287587000,3887646000
Rhode Island,Finance and Insurance,2016,4221,2285,510,260,3055,185,213,3453,768,7070,2285,510,270,3065,255,650,3970,3100,135625,4153,3273,2765,10637,6216,13132,33688,99567,11298057000,233147000,222613000,232976000,719777000,454693000,1006349000,2606867000,8443787000
Rhode Island,Health Care and Social Assistance,2016,12074,5110,2525,1660,9295,1413,741,11449,625,16445,5120,2535,1750,9405,1895,2340,13640,2805,437867,10263,16856,21717,49450,58266,102188,215447,221780,19740443000,437040000,754822000,956023000,2167879000,2197615000,4189147000,8780880000,10926009000
Rhode Island,Information,2016,1439,620,205,120,945,135,65,1145,294,2380,635,205,130,970,180,70,1220,1160,34602,846,1271,1400,3859,3834,1009,12007,19842,2378900000,48058000,50993000,58327000,175808000,197142000,64735000,654753000,1616906000
Rhode Island,Management of Companies and Enterprises,2016,631,40,35,10,85,70,155,310,321,1035,40,35,10,85,75,165,325,710,52825,55,165,0,310,879,6366,7585,45240,4335360000,5005000,13440000,0,23460000,89929000,387858000,503475000,3831885000
Rhode Island,Manufacturing,2016,6732,2480,1160,1045,4685,1338,346,6369,363,6850,2480,1160,1055,4695,1365,385,6445,405,177582,4391,6557,11450,24958,45489,24824,115413,43235,9867795000,163442000,259632000,485854000,1016139000,2142209000,1337919000,5617581000,2954004000
Rhode Island,"Mining, Quarrying, and Oil and Gas Extraction",2016,75,35,5,25,65,5,0,70,5,75,35,5,25,65,5,0,70,5,645,43,0,336,399,0,0,543,0,43452000,3080000,0,23181000,28617000,0,0,35993000,0
Rhode Island,Other,2016,49,48,1,0,49,0,0,49,0,49,48,1,0,49,0,0,49,0,62,54,0,0,62,0,0,62,0,1442000,1263000,0,0,1442000,0,0,1442000,0
Rhode Island,Other Services (except Public Administration),2016,13776,8715,2940,1135,12790,631,120,13541,235,14505,8720,2970,1165,12855,885,130,13870,635,86818,16286,18915,14145,49885,19911,4666,77740,6152,2778900000,477236000,538753000,430383000,1467928000,732050000,149994000,2479293000,200977000
Rhode Island,"Professional, Scientific, and Technical Services",2016,14504,9665,1985,1045,12695,865,240,13800,704,15240,9665,1990,1050,12705,905,245,13855,1385,118802,15437,12907,12852,41751,25845,11040,80537,37219,7573551000,793219000,749499000,800225000,2372567000,1873709000,904766000,5277866000,2237535000
Rhode Island,Real Estate and Rental and Leasing,2016,4554,3260,485,303,4048,203,88,4339,215,5470,3260,505,320,4085,330,265,4680,790,26708,4946,3144,3716,12443,5764,1654,20408,5972,1254295000,241178000,152823000,174166000,611885000,259350000,77493000,973815000,269030000
Rhode Island,Retail Trade,2016,13934,7820,2494,1205,11519,869,329,12717,1217,18880,7840,2575,1275,11690,1000,675,13365,5515,236872,14313,16254,14974,46570,26175,16479,93616,138668,7018766000,407557000,462462000,462731000,1364154000,1048399000,616713000,3163246000,3701655000
Rhode Island,Total,2016,24259,13887,3936,2467,20290,2249,596,23135,1124,28685,13899,3975,2533,20407,2607,1339,24353,4332,435148,22901,26114,32908,81923,81463,66588,229974,205174,20150835000,985478000,1010965000,1318385000,3314828000,3346494000,3075784000,9737106000,10413729000
Rhode Island,Transportation and Warehousing,2016,3250,2015,350,255,2620,260,90,2970,280,3480,2015,350,260,2625,275,90,2990,490,56807,2685,2005,2528,8227,6136,3709,21641,26355,2217879000,99954000,72501000,105317000,323214000,246853000,191639000,900126000,914391000
Rhode Island,Utilities,2016,99,30,5,15,50,10,0,60,39,195,30,5,15,50,10,0,60,135,3451,51,0,132,265,0,0,579,2177,383818000,3276000,0,14280000,27704000,0,0,62329000,237512000
Rhode Island,Wholesale Trade,2016,6217,2720,925,640,4285,762,346,5393,824,6685,2720,930,640,4290,805,375,5470,1215,97391,4531,5506,7287,18812,20469,11756,58809,28718,6778002000,257802000,333881000,434810000,1117367000,1317135000,715472000,3642106000,2253650000
South Carolina,Accommodation and Food Services,2016,38447,12350,6715,8035,27100,8989,1181,37270,1177,52140,12370,6735,8120,27225,9785,4260,41270,10870,1104455,20260,45961,110968,177380,337041,174859,690810,412252,18163755000,592875000,655145000,1664577000,2914750000,5452511000,2684675000,11092425000,7055380000
South Carolina,Administrative and Support and Waste Management and Remediation Services,2016,25634,14840,3990,2459,21289,2156,802,24247,1387,29580,14840,4000,2470,21310,2310,1035,24655,4925,853632,24712,25901,32875,84038,76903,95508,260173,579180,28100836000,927228000,791561000,1066753000,2804309000,2416422000,3257283000,8623369000,18419095000
South Carolina,"Agriculture, Forestry, Fishing and Hunting",2016,2570,1325,635,335,2295,205,35,2535,35,2590,1325,635,335,2295,205,45,2545,45,19571,2392,4094,4039,10848,5240,1170,18396,443,805269000,94628000,167166000,170835000,444849000,221241000,51434000,753424000,24737000
South Carolina,"Arts, Entertainment, and Recreation",2016,7746,4124,1070,925,6119,1168,285,7572,174,8335,4130,1080,935,6145,1285,435,7865,470,136085,5812,7057,12149,25380,46208,34113,109585,22112,2611959000,193201000,142916000,233363000,578315000,884598000,646979000,2206274000,330136000
South Carolina,Construction,2016,46289,28965,7870,5020,41855,3519,442,45816,473,47035,28970,7880,5020,41870,3585,625,46080,955,399135,48064,52280,66251,166625,126090,45847,342130,51663,19017990000,1818700000,1933905000,2720270000,6474235000,6143299000,2664438000,15487835000,3213479000
South Carolina,Educational Services,2016,5471,2535,810,730,4075,955,191,5221,250,5880,2535,810,755,4100,975,305,5380,500,162655,4064,5494,9939,19599,38701,31303,91435,70984,4267085000,110067000,103982000,189261000,407771000,1057470000,981762000,2515900000,1733952000
South Carolina,Finance and Insurance,2016,16976,10700,2602,952,14254,716,558,15528,1448,36765,10730,2760,1240,14730,2085,3060,19875,16890,349159,18987,16250,12061,47706,22655,36793,108291,239130,21897154000,831163000,717314000,696343000,2274449000,1222385000,2180024000,5768899000,16041178000
South Carolina,Health Care and Social Assistance,2016,38543,17075,8576,5658,31309,4639,1277,37225,1318,51720,17105,8655,5815,31575,5730,3835,41140,10580,1153036,30409,57743,75580,164044,179191,176066,520896,629317,51742017000,1895323000,2444664000,2945833000,7292558000,6641681000,5543532000,20132612000,31521517000
South Carolina,Information,2016,3780,1930,415,265,2610,340,145,3095,685,7470,1950,415,305,2670,405,280,3355,4115,178690,2830,2632,3083,9064,11206,9439,33657,143966,10781889000,137819000,107721000,128011000,388398000,608560000,683384000,1891299000,8865119000
South Carolina,Management of Companies and Enterprises,2016,2159,135,60,46,241,347,622,1210,949,3330,135,60,50,245,355,640,1240,2090,131995,115,265,227,625,3926,18954,23505,108490,10576532000,13445000,20120000,6289000,40420000,237600000,1294502000,1572522000,9004010000
South Carolina,Manufacturing,2016,17420,5525,2470,2325,10320,3089,1540,14949,2471,18915,5525,2470,2325,10320,3220,1705,15245,3670,1078249,9908,14654,28169,56942,108713,158272,355439,671103,57519793000,394647000,530054000,1155254000,2259283000,4796388000,7492916000,16072543000,38719435000
South Carolina,"Mining, Quarrying, and Oil and Gas Extraction",2016,281,85,50,50,185,20,17,222,59,410,85,50,50,185,20,30,235,175,5038,108,214,489,959,385,526,2228,2661,298463000,7097000,11160000,23103000,49144000,17950000,47374000,131359000,158368000
South Carolina,Other,2016,220,209,8,2,219,1,0,220,0,220,209,8,2,219,1,0,220,0,292,194,51,0,269,0,0,292,0,5432000,3766000,896000,0,5081000,0,0,5432000,0
South Carolina,Other Services (except Public Administration),2016,53461,32745,11485,4896,49126,3304,487,52917,544,56795,32760,11540,5060,49360,4115,920,54395,2400,408086,61804,74316,64436,200990,113893,42350,360605,43001,11035909000,1526459000,1772314000,1682040000,4992764000,2792843000,1048794000,8940559000,1978452000
South Carolina,"Professional, Scientific, and Technical Services",2016,48035,33660,6375,3278,43313,2364,963,46640,1395,52395,33675,6385,3395,43455,2960,1420,47835,4560,445970,53035,41062,42057,136640,75428,60425,274970,167598,29238105000,2582370000,1982081000,2480737000,7073035000,4566310000,4316954000,16115625000,12964271000
South Carolina,Real Estate and Rental and Leasing,2016,21734,17063,1835,889,19787,743,507,21037,697,27315,17100,1905,985,19990,1165,1040,22195,5120,130315,22867,11663,10732,45550,20652,26030,92900,35256,5442365000,925402000,453476000,459615000,1851255000,802391000,1000693000,3680971000,1682362000
South Carolina,Retail Trade,2016,52398,30515,10047,5123,45685,3604,987,50276,2122,88190,30630,10335,5665,46630,5590,3460,55680,32510,1164064,56953,64942,66078,188113,122403,67969,384910,747545,28371070000,1444141000,1594240000,1893871000,4936072000,4461867000,2332093000,11907130000,15677047000
South Carolina,Total,2016,80934,45967,13802,8770,68539,7716,2037,78292,2642,105959,46043,13972,9139,69154,9538,5203,83895,22064,1716496,77697,90907,117027,285631,282554,226526,794711,921785,69050740000,3046477000,2947790000,3915380000,9909647000,9661860000,8734215000,28305722000,40745018000
South Carolina,Transportation and Warehousing,2016,11351,6265,1333,930,8528,954,594,10076,1275,13590,6265,1340,945,8550,1015,755,10320,3270,300648,8854,8133,11537,29214,26609,26762,86840,212714,12495402000,326935000,293042000,407083000,1048056000,969088000,1166941000,3335634000,9109361000
South Carolina,Utilities,2016,451,155,45,45,245,90,60,395,56,1760,155,45,45,245,135,175,555,1205,51633,248,280,511,1147,4597,6840,12670,1903,4666175000,11177000,9302000,22482000,47150000,330004000,488150000,871185000,142808000
South Carolina,Wholesale Trade,2016,19363,8874,2700,2105,13679,2374,1155,17208,2155,24480,8885,2720,2170,13775,2745,1990,18510,5970,364898,15206,17558,25879,59517,70992,47427,183395,174497,20744300000,740282000,860964000,1302900000,2939060000,3768493000,2449062000,9452692000,11000470000
South Dakota,Accommodation and Food Services,2016,10376,3945,1840,1980,7765,1972,382,10119,257,12205,3965,1870,2020,7855,2265,990,11110,1095,202410,5450,12441,27372,45418,69468,44821,161065,41171,3341870000,202820000,164275000,389086000,759177000,1042366000,794975000,2624205000,714482000
South Dakota,Administrative and Support and Waste Management and Remediation Services,2016,5361,3355,795,430,4580,351,100,5031,330,5675,3355,795,445,4595,390,125,5110,565,57314,5143,4884,4980,15770,10891,7367,35844,19180,1954226000,170643000,153885000,144938000,496345000,265544000,237663000,1090379000,737462000
South Dakota,"Agriculture, Forestry, Fishing and Hunting",2016,735,615,75,20,710,10,5,725,10,735,615,75,20,710,10,5,725,10,1874,809,345,177,1539,0,0,1799,0,74585000,36595000,12439000,9123000,64660000,0,0,72420000,0
South Dakota,"Arts, Entertainment, and Recreation",2016,3179,1920,555,327,2802,253,69,3124,55,3450,1920,555,340,2815,335,145,3295,155,31838,2392,3531,3773,10133,8159,7709,28383,2162,625192000,87818000,64281000,62801000,224450000,162072000,134830000,568972000,36678000
South Dakota,Construction,2016,16776,11465,2920,1270,15655,900,131,16686,90,16895,11465,2920,1275,15660,900,190,16750,145,101395,18682,18677,16475,54285,30058,9549,96600,3826,4967670000,743535000,779388000,817061000,2358620000,1662444000,554185000,4706720000,219391000
South Dakota,Educational Services,2016,1145,480,190,130,800,210,85,1095,50,1180,480,190,135,805,210,95,1110,70,39301,795,1146,1433,3658,7985,16200,28221,10912,981985000,18149000,16245000,20955000,62000000,170608000,474628000,714740000,263063000
South Dakota,Finance and Insurance,2016,6272,4020,732,353,5105,363,209,5677,595,9955,4035,740,480,5255,800,1030,7085,2870,131297,7051,4456,4132,15911,9446,13655,41493,87887,7351269000,302941000,207007000,190824000,716413000,500665000,843683000,2213527000,5034360000
South Dakota,Health Care and Social Assistance,2016,9197,4225,1643,1225,7093,1195,578,8866,331,11790,4235,1655,1245,7135,1725,1860,10720,1070,335945,7012,10740,16102,34507,46448,68924,154777,172398,16209497000,334831000,381535000,713150000,1450354000,1780892000,2431454000,5847245000,9466368000
South Dakota,Information,2016,1531,605,230,180,1015,198,84,1297,234,2265,605,235,180,1020,305,240,1565,700,35929,934,1326,1908,4643,5417,5077,18768,15097,1615640000,29976000,32560000,71786000,149050000,230833000,251811000,785648000,741814000
South Dakota,Management of Companies and Enterprises,2016,641,30,0,20,50,135,236,421,220,755,30,0,20,50,135,265,450,305,35170,28,0,116,158,1255,3675,5210,29774,2618770000,2748000,0,8124000,11444000,85958000,289675000,395945000,2180036000
South Dakota,Manufacturing,2016,4804,1835,735,590,3160,781,363,4304,500,5175,1835,735,595,3165,840,515,4520,655,196839,2791,3800,5950,14545,24893,25126,86567,77524,8762050000,106877000,130606000,215625000,526417000,1107807000,1051647000,3622620000,3581198000
South Dakota,"Mining, Quarrying, and Oil and Gas Extraction",2016,310,155,35,20,210,37,19,266,44,360,155,35,20,210,40,45,295,65,4368,225,165,142,660,584,0,2632,1159,291652000,12769000,8176000,8139000,37328000,32185000,0,179311000,76468000
South Dakota,Other,2016,45,44,1,0,45,0,0,45,0,45,44,1,0,45,0,0,45,0,33,28,0,0,33,0,0,33,0,830000,767000,0,0,830000,0,0,830000,0
South Dakota,Other Services (except Public Administration),2016,13285,8755,2545,1160,12460,582,128,13170,115,13850,8760,2555,1210,12525,775,245,13545,305,73407,16475,16106,14749,47897,18778,2272,71186,1211,1867759000,404514000,409215000,353545000,1184457000,439553000,77363000,1796624000,41825000
South Dakota,"Professional, Scientific, and Technical Services",2016,9135,5861,1440,790,8091,468,139,8698,437,9715,5870,1460,800,8130,610,215,8955,760,60672,9313,9439,9506,28671,12167,6329,49000,10012,2978102000,402957000,403903000,454081000,1278122000,698990000,314969000,2373174000,534354000
South Dakota,Real Estate and Rental and Leasing,2016,4693,3620,453,195,4268,158,100,4526,167,5475,3620,455,195,4270,230,550,5050,425,20782,5220,2783,2101,10540,3989,2579,18256,2212,707203000,162769000,91133000,80473000,350813000,132956000,81035000,605610000,87753000
South Dakota,Retail Trade,2016,14525,6524,3214,2016,11754,1383,455,13592,933,19600,6540,3265,2145,11950,2020,1580,15550,4050,260347,11833,21120,25066,58750,43000,29013,136770,118569,6733457000,328605000,516246000,631292000,1495858000,1340347000,849754000,3855078000,2643901000
South Dakota,Total,2016,22205,12712,3762,2334,18808,1953,567,21328,877,26743,12732,3800,2441,18973,2680,1836,23489,3254,357950,20824,24671,30783,76278,70101,64155,210534,147416,14183056000,751822000,769154000,996623000,2517599000,2457754000,2397266000,7372619000,6810437000
South Dakota,Transportation and Warehousing,2016,5630,3790,715,434,4939,267,139,5345,285,6070,3790,715,440,4945,290,185,5420,650,50993,5493,4476,5166,15850,7275,3243,30863,17847,2113407000,199775000,170483000,198379000,592885000,297207000,152577000,1196919000,789880000
South Dakota,Utilities,2016,359,45,60,60,165,100,20,285,74,770,45,60,60,165,175,60,400,370,11124,80,379,890,1400,2932,686,5672,5443,928368000,2305000,20464000,54270000,80390000,208006000,57153000,393880000,533943000
South Dakota,Wholesale Trade,2016,5593,2120,680,549,3349,959,465,4773,820,7570,2120,680,580,3380,1345,840,5565,2005,95076,3351,3836,5899,14139,27197,17758,63984,28851,4935000000,162496000,159458000,269914000,632241000,1261380000,965133000,3105816000,1714225000
Tennessee,Accommodation and Food Services,2016,44283,14385,8116,8670,31171,10410,1319,42900,1383,64835,14420,8155,8860,31435,11820,5285,48540,16295,1400060,22510,54767,119475,196855,382670,190639,770750,627909,23843835000,732760000,817725000,1874097000,3426535000,6343650000,3012161000,12795985000,11022956000
Tennessee,Administrative and Support and Waste Management and Remediation Services,2016,28461,14895,4585,2871,22351,3058,1182,26591,1870,35395,14900,4630,2940,22470,3260,1590,27320,8075,1261610,24823,29974,38643,93908,118541,170403,386890,873422,37665710000,1176346000,1038907000,1400832000,3669438000,4445151000,4918124000,13170592000,24426082000
Tennessee,"Agriculture, Forestry, Fishing and Hunting",2016,1175,740,250,90,1080,50,25,1155,20,1185,740,250,95,1085,50,25,1160,25,9554,1399,1525,1087,4177,1161,98,5754,775,238436000,51529000,47513000,36849000,141521000,34003000,7934000,204539000,7188000
Tennessee,"Arts, Entertainment, and Recreation",2016,12422,7015,2105,1455,10575,1388,239,12202,220,13005,7020,2105,1465,10590,1475,310,12375,630,171742,10049,13940,19892,44112,53094,22945,126113,40043,7824981000,742747000,606589000,922145000,2279545000,2031612000,759814000,5457725000,1941271000
Tennessee,Construction,2016,47763,27175,8675,5765,41615,4811,770,47196,567,48660,27180,8680,5765,41625,4920,955,47500,1160,556485,47535,57375,76905,181815,179594,85885,450665,92969,29188005000,1985660000,2260875000,3544300000,7790835000,10166710000,5336649000,23514605000,5112490000
Tennessee,Educational Services,2016,6417,2620,940,880,4440,1156,510,6106,311,6865,2625,955,900,4480,1255,580,6315,550,305669,4437,6358,12125,23109,45149,80382,149734,150351,10901248000,139060000,137120000,268494000,552003000,1394496000,2934323000,4905283000,5755424000
Tennessee,Finance and Insurance,2016,23045,13855,3463,1150,18468,1552,951,20971,2074,50490,13860,3750,1600,19210,4680,4850,28740,21750,602386,25858,21256,14484,62062,56420,75562,197267,404595,43217364000,1255363000,1181440000,1168940000,3640648000,4117471000,5228833000,13250583000,29909088000
Tennessee,Health Care and Social Assistance,2016,53759,22630,12883,7774,43287,6616,1956,51859,1900,78655,22680,12940,8150,43770,9030,6185,58985,19670,2057345,44734,85262,102876,232957,251748,293383,779690,1274745,98508488000,2347204000,3455223000,4675742000,10481564000,11365546000,11799077000,33700612000,64679723000
Tennessee,Information,2016,7511,3688,1161,756,5605,757,331,6693,818,13480,3715,1170,800,5685,900,620,7205,6275,239910,5989,7604,9208,23342,24780,16551,67313,171177,13953474000,300390000,321670000,458602000,1105131000,1446163000,938153000,3705875000,10145009000
Tennessee,Management of Companies and Enterprises,2016,3792,165,40,115,320,556,1106,1982,1810,7525,165,40,120,325,565,1120,2010,5515,445365,189,188,645,1025,6195,37880,45110,400238,47539925000,91998000,10248000,43430000,145800000,610735000,2842955000,3600260000,43938225000
Tennessee,Manufacturing,2016,26467,8695,4075,3475,16245,4752,2116,23113,3354,28620,8695,4085,3505,16285,4940,2500,23725,4895,1555115,16334,25238,43572,89395,176070,208006,511702,954993,81485367000,647780000,902941000,1797149000,3571044000,8172234000,9829508000,23431367000,53059502000
Tennessee,"Mining, Quarrying, and Oil and Gas Extraction",2016,614,230,105,65,400,70,45,515,99,1020,230,105,65,400,75,100,575,445,13994,307,601,709,1943,1322,1720,5764,7745,754590000,18504000,21596000,29006000,101542000,93065000,84378000,327957000,393155000
Tennessee,Other,2016,276,264,11,0,275,1,0,276,0,276,264,11,0,275,1,0,276,0,384,292,71,0,363,0,0,384,0,8306000,6367000,1783000,0,8150000,0,0,8306000,0
Tennessee,Other Services (except Public Administration),2016,65317,39675,13555,6156,59386,4502,752,64640,677,71045,39700,13680,6555,59935,5535,1565,67035,4010,559000,75919,87966,81101,245235,160842,68017,477605,70653,15801545000,1900588000,2161695000,2256537000,6327645000,4218712000,1823082000,12586015000,2832049000
Tennessee,"Professional, Scientific, and Technical Services",2016,50701,32511,7355,4573,44439,3336,1056,48831,1870,56290,32540,7370,4695,44605,4000,1495,50100,6190,587900,53725,48359,60264,162710,103082,69730,338640,243447,38610945000,2773920000,2362767000,3312502000,8473085000,6726248000,5282062000,20665800000,17724737000
Tennessee,Real Estate and Rental and Leasing,2016,20028,13700,2738,1191,17629,1009,553,19191,837,29210,13725,2815,1270,17810,1640,2175,21625,7585,172810,22190,17623,14585,54755,31557,25052,114290,57023,8205070000,925120000,697473000,677583000,2316230000,1530889000,1104422000,5140050000,2953807000
Tennessee,Retail Trade,2016,68150,38188,13991,6876,59055,5326,1236,65617,2533,113665,38300,14240,7485,60025,7965,4480,72470,41195,1567640,70945,91754,88724,251660,184852,102496,543385,984826,41593751000,1845280000,2334368000,2567360000,6752020000,7143580000,4224938000,18252085000,22360868000
Tennessee,Total,2016,98089,51876,18036,11235,81147,10661,2906,94714,3375,135352,51966,18265,11809,82040,13740,7624,103404,31948,2592600,92136,118852,150141,361129,394165,340951,1096245,1496355,114896051000,3745133000,4086490000,5669989000,13501612000,16054336000,14877074000,44433022000,70463029000
Tennessee,Transportation and Warehousing,2016,15679,7340,2182,1705,11227,1727,902,13856,1823,20965,7340,2195,1705,11240,1920,1105,14265,6700,610019,12424,14358,22363,49947,58796,58162,174760,388581,27504706000,514576000,535928000,818227000,1905563000,2573208000,2642267000,7456629000,17994901000
Tennessee,Utilities,2016,297,30,15,25,70,95,55,220,77,700,30,15,25,70,185,245,500,200,16236,50,34,181,433,4647,7013,12578,3519,1152224000,1803000,622000,13034000,21323000,305582000,509207000,858975000,280056000
Tennessee,Wholesale Trade,2016,26356,10630,4056,2890,17576,3787,1975,23338,3018,33770,10645,4090,3045,17780,4480,2935,25195,8575,581455,18847,26145,35763,81830,108049,106003,303445,267450,35621025000,1053564000,1376468000,2043625000,4532985000,6502650000,6559521000,18137025000,16927852000
Texas,Accommodation and Food Services,2016,188053,65746,34411,36623,136780,44207,4614,185601,2452,270940,65910,34605,37210,137725,50305,20100,208130,62810,5885216,103665,231255,499780,834700,1660985,761437,3257580,2627365,103198101000,3412807000,3540375000,7752505000,14705687000,27818962000,12815492000,55342752000,47850964000
Texas,Administrative and Support and Waste Management and Remediation Services,2016,117043,64610,18375,12122,95107,13030,4557,112694,4349,140825,64640,18430,12330,95400,13965,6145,115510,25315,4898740,104573,119596,162997,387179,506625,720730,1616195,3280774,187713505000,5003969000,4727245000,6511600000,16243424000,20479937000,24760248000,61598260000,126017734000
Texas,"Agriculture, Forestry, Fishing and Hunting",2016,5185,3555,930,355,4840,220,70,5130,55,5370,3555,930,355,4840,225,210,5275,95,35635,5400,5991,4273,16035,6499,4879,28415,7022,1471882000,224957000,260648000,185250000,685957000,240945000,206196000,1162337000,290235000
Texas,"Arts, Entertainment, and Recreation",2016,32703,18195,5000,4255,27450,3911,884,32245,458,36540,18200,5020,4320,27540,4215,1365,33120,3420,722900,27328,32413,56786,116668,148613,143126,411050,300037,21269604000,1170103000,756145000,1235451000,3164193000,3008052000,5882641000,12157244000,8814336000
Texas,Construction,2016,210646,121919,37179,23521,182619,21992,4102,208713,1933,215815,121925,37185,23595,182705,22525,5670,210900,4915,3370750,203890,246900,317505,768295,860610,654756,2283795,1082205,195382505000,10080265000,10654030000,15087415000,35821710000,46039675000,39050857000,120921180000,74188088000
Texas,Educational Services,2016,31951,15545,5290,4313,25148,4815,1244,31207,744,35450,15590,5320,4360,25270,5285,2140,32695,2755,968870,23930,35101,57969,117160,192160,190291,502345,465385,36979735000,821895000,785272000,1145760000,2761225000,5362100000,7168034000,15378810000,21537334000
Texas,Finance and Insurance,2016,101399,68243,15180,5663,89086,5666,2807,97559,3840,203245,68380,15570,6690,90640,11540,15200,117380,85865,2671482,118056,96121,73014,287351,203703,317282,809238,1858924,210863357000,6239392000,5330275000,5263898000,16847138000,15094964000,25273263000,57306380000,152907411000
Texas,Health Care and Social Assistance,2016,268422,131940,58735,37234,227909,29189,7730,264828,3594,340945,132140,59105,38235,229480,36165,20650,286295,54650,7546679,226920,392437,496710,1116135,1138450,1249841,3505515,4040920,330769144000,16082624000,17039087000,20302745000,53443374000,41972760000,40535415000,136037790000,194722601000
Texas,Information,2016,24091,12875,3263,2253,18391,2542,1177,22110,1981,48385,13120,3280,2355,18755,3045,2165,23965,24420,1207860,20250,21498,29130,71080,90810,122570,288500,916003,96274700000,1365600000,1133926000,1643884000,4152780000,5978260000,8759290000,19219165000,76807381000
Texas,Management of Companies and Enterprises,2016,13362,1076,301,440,1817,2329,3862,8008,5354,24695,1080,305,445,1830,2445,4150,8425,16270,1626875,1215,1255,2651,5125,31455,134720,171300,1455575,200944255000,138170000,94580000,243233000,476105000,2368855000,11455395000,14300355000,186643900000
Texas,Manufacturing,2016,89275,33125,15494,12730,61349,16158,5572,83079,6196,98245,33125,15495,12830,61450,16820,7020,85290,12955,3814346,62206,102150,169263,337669,619770,654070,1650564,2104851,232806772000,2872618000,3799022000,7016544000,13958655000,28835377000,33174025000,77928235000,151693672000
Texas,"Mining, Quarrying, and Oil and Gas Extraction",2016,33582,18762,4813,3318,26893,4353,1229,32475,1107,41235,18785,4830,3355,26970,4795,2270,34035,7200,995877,30186,31434,44129,105955,160879,150410,418312,577309,97108917000,2619470000,1989652000,2907360000,7527105000,12287705000,14571013000,34450999000,62641437000
Texas,Other,2016,1043,978,53,11,1042,1,0,1043,0,1043,978,53,11,1042,1,0,1043,0,1492,983,329,151,1463,0,0,1492,0,36160000,29126000,5089000,1646000,35861000,0,0,36160000,0
Texas,Other Services (except Public Administration),2016,232649,138485,47550,24305,210340,18132,2720,231192,1457,256760,138685,47890,25335,211910,22395,7255,241560,15200,2229235,254265,310131,320143,884595,656672,311583,1854085,359607,69438740000,7400305000,8403127000,8943214000,24747825000,17672075000,9912309000,52368115000,16551445000
Texas,"Professional, Scientific, and Technical Services",2016,311830,221748,39436,22506,283690,18035,4996,306721,5109,343755,221850,39695,23005,284550,20865,8785,314200,29555,3541655,327500,259450,300324,887320,642799,487208,2019735,1521189,288033885000,21137255000,14953510000,19305396000,55399585000,48415811000,39349118000,143351330000,144635728000
Texas,Real Estate and Rental and Leasing,2016,108780,82536,12603,5436,100575,4510,1959,107044,1736,151790,82685,12820,6040,101545,7710,8515,117770,34020,957365,121655,80025,70495,272200,149150,161096,583315,371262,52876800000,5443530000,3452180000,3225452000,12122100000,7726839000,9321922000,29209835000,23567866000
Texas,Retail Trade,2016,231058,135634,46280,24369,206283,16817,4327,227427,3631,403260,136080,47455,26785,210320,26425,16685,253430,149830,6191043,260211,301984,317023,879266,598290,487600,1967035,4086213,170478265000,7420849000,7812118000,9184198000,24419389000,21430469000,21719205000,67617649000,99549241000
Texas,Total,2016,434145,249965,75515,48139,373619,44293,10265,428177,5968,579168,250453,76350,50217,377020,55216,29428,461664,117504,10429924,416598,497608,644532,1558738,1682345,1465781,4706864,5723060,526782643000,20310736000,19024094000,25118841000,64453671000,69188321000,69988913000,203630905000,323151738000
Texas,Transportation and Warehousing,2016,75131,42620,11144,7359,61123,7049,2958,71130,4001,96140,42650,11170,7520,61340,8035,5200,74575,21565,2226614,66397,72917,96968,236771,237676,237005,717545,1504564,121503870000,2863358000,2878151000,4187045000,9968341000,11106507000,11472523000,32981734000,88311820000
Texas,Utilities,2016,5005,2600,925,340,3865,505,267,4637,368,9895,2610,930,340,3880,610,855,5345,4550,275559,5577,5792,4470,15973,21885,34865,73434,201477,26856989000,266272000,288523000,294415000,860540000,1620878000,3016413000,5558995000,21234292000
Texas,Wholesale Trade,2016,129130,66214,21104,14965,102283,14568,6053,122904,6226,167335,66365,21450,15925,103740,18705,12760,135205,32130,2602540,114395,137879,193735,446145,472849,441340,1364670,1225624,177319925000,6689800000,7091158000,10913447000,24700695000,27817219000,28152169000,80872425000,95575642000
United States,Accommodation and Food Services,2016,2642235,996848,513307,516179,2026334,553051,50130,2629515,12720,3517640,998705,515420,523315,2037440,627220,218140,2882800,634840,68520085,1629570,3447890,7071505,12148965,20452875,8954905,41556745,26963340,1306303245000,51421810000,54149605000,113960595000,219532010000,362898350000,164628015000,747058375000,559244870000
United States,Administrative and Support and Waste Management and Remediation Services,2016,1708587,1087355,254692,155539,1497586,147453,41394,1686433,22154,2047590,1087960,255545,158380,1501885,164170,68195,1734250,313340,58142545,1618590,1668915,2092270,5379775,5828150,7242014,18450395,39690317,2302092725000,73306560000,60179320000,80719685000,214205565000,229230995000,248583132000,692047690000,1609950350000
United States,"Agriculture, Forestry, Fishing and Hunting",2016,109210,75961,17570,8440,101971,5670,1032,108673,537,112970,75970,17580,8480,102030,6085,2290,110405,2565,802055,112010,114865,110016,336925,201760,132191,672890,129059,32992560000,4953815000,4418815000,4607621000,13982230000,8774520000,4897368000,27703715000,5284135000
United States,"Arts, Entertainment, and Recreation",2016,632410,401034,81763,62776,545573,68099,14163,627835,4575,686050,401430,82135,63920,547485,74215,24210,645910,40140,11557185,502670,537290,847940,1887900,2722645,2445415,7055960,4490612,405619650000,49271280000,15780310000,20951670000,86003260000,64516340000,95464895000,245984495000,159197710000
United States,Construction,2016,3420133,2273453,545497,314877,3133827,246834,32506,3413167,6966,3483665,2273610,545710,315495,3134815,253685,48170,3436670,46995,31556320,3544295,3576755,4213525,11334575,9303415,5344605,25982595,5573203,1856280415000,158786815000,156108650000,213551800000,528447265000,555260380000,359088885000,1442796530000,413420369000
United States,Educational Services,2016,459685,224337,72949,60552,357838,76093,18599,452530,7155,516820,224865,73430,62080,360375,84600,33015,477990,38830,18386375,344865,489575,823750,1658190,3177295,3317220,8152705,10233654,692860245000,12386375000,11345930000,18822815000,42555120000,97618070000,127776940000,267950130000,424909699000
United States,Finance and Insurance,2016,1199435,856063,175564,67467,1099094,65002,22232,1186328,13107,2384925,858015,180730,81005,1119750,152450,174335,1446535,938390,31678995,1480056,1115485,886050,3481591,2576918,3541935,9600536,22078115,3058110295000,79949382000,66259065000,70843280000,217051727000,225343104000,329717100000,772120447000,2285810198000
United States,Health Care and Social Assistance,2016,3352560,1727834,703081,426458,2857373,345661,107432,3310466,42094,4452595,1731050,708605,444400,2884055,467970,349480,3701505,751090,98678540,2983045,4674395,5688435,13345875,13577785,17214665,44138325,54540215,4700173810000,164305000000,198388480000,245621365000,608314845000,547116680000,633622050000,1789053575000,2911120235000
United States,Information,2016,381939,235485,52810,36709,325004,37734,11544,374282,7657,732035,237155,53635,38750,329540,50225,30935,410700,321335,17239750,332930,349565,490685,1173180,1480480,1880097,4534180,12692032,1587505120000,26146260000,18526450000,27627140000,72299850000,101668520000,157441653000,331447380000,1255576544000
United States,Management of Companies and Enterprises,2016,136896,14081,3555,5292,22928,27963,45655,96546,40350,276920,14145,3595,5455,23195,28900,50555,102650,174270,16902185,15980,16045,31395,63420,353775,1589365,2006560,14895625,1836146880000,2534600000,1411860000,2567660000,6514120000,26172235000,127696330000,160382685000,1675764195000
United States,Manufacturing,2016,1280604,513149,231197,189909,934255,237748,69954,1241957,38647,1457715,513315,231545,191335,936195,253250,105570,1295015,162700,57944836,946963,1545664,2584156,5077019,9573696,10885310,25540034,32400364,3318306468000,43081181000,59194249000,109888360000,212243163000,460930248000,562235002000,1235731746000,2082394596000
United States,"Mining, Quarrying, and Oil and Gas Extraction",2016,102517,58096,15842,10936,84874,12079,3193,100146,2371,136170,58190,16030,11390,85610,14790,8100,108500,27670,2935085,94383,104964,146654,346108,447876,424450,1220657,1713447,246988540000,6493114000,5989345000,9192514000,21681276000,31348747000,35104560000,88292329000,158595623000
United States,Other,2016,17750,17034,568,116,17718,32,0,17750,0,17750,17034,568,116,17718,32,0,17750,0,23176,17393,3500,1529,22422,754,0,23176,0,539596000,439217000,67105000,25323000,531645000,7951000,0,539596000,0
United States,Other Services (except Public Administration),2016,3453740,2208495,685113,323758,3217366,205466,23449,3446281,7459,3771145,2210895,690480,337950,3239325,263255,86410,3588990,182155,27496220,4051470,4453555,4265675,12770700,7349660,3328197,23449550,4018587,874263970000,111858790000,119545395000,123468590000,354872775000,226520400000,128342079000,709760695000,163604857000
United States,"Professional, Scientific, and Technical Services",2016,4036525,2962153,515173,285266,3762592,212273,40868,4015733,20792,4517670,2964520,518700,296125,3779345,270940,107750,4158035,359635,43999465,4291375,3370155,3801915,11463445,7975550,6471900,25910895,18088570,3601494240000,262370315000,194927400000,247937040000,705234755000,617499340000,556967080000,1879701175000,1721793065000
United States,Real Estate and Rental and Leasing,2016,1505492,1199002,159017,72223,1430242,54334,13656,1498232,7260,1952500,1201325,163190,80885,1445400,94250,100840,1640490,312010,10557090,1673270,1020855,939490,3633615,1919210,1619656,7173245,3381907,552537005000,75904540000,42819475000,43859345000,162583360000,99731985000,88920683000,351288105000,201144946000
United States,Retail Trade,2016,3273168,1940834,666721,356147,2963702,248546,45581,3257829,15339,5345480,1947090,681675,391765,3020530,383565,224995,3629090,1716390,79839465,3576140,4389618,4677464,12643270,9154675,6094851,27893300,51863303,2188272055000,99173715000,114050323000,134139685000,347367105000,325202007000,243038790000,915621125000,1270127191000
United States,Total,2016,5954684,3665182,1013878,626900,5305960,538283,90742,5934985,19699,7757807,3671901,1025690,657781,5355372,705460,367446,6428278,1329529,126752238,5923452,6681968,8432521,21037941,21093550,17783726,59915217,66837021,6435142055000,268039737000,248985263000,329388425000,846413425000,899265224000,870788396000,2616467045000,3818675010000
United States,Transportation and Warehousing,2016,914739,590220,124812,84687,799719,78348,21275,899342,15397,1154970,590915,125695,87185,803795,94105,51645,949545,205425,23648545,853890,822326,1127782,2804117,2881459,2646530,8334930,15308858,1145812770000,34147212000,31323595000,45110039000,110589844000,122568395000,117622762000,351076652000,794337592000
United States,Utilities,2016,29980,14832,5110,2483,22425,4538,1651,28614,1366,90795,14885,5210,2710,22805,7405,7640,37850,52945,3194585,28793,32712,33682,95275,198655,261334,555380,2638663,327014490000,1199249000,1507186000,2069222000,4782525000,15024785000,21608162000,41431675000,285519742000
United States,Wholesale Trade,2016,1531586,867616,252007,175039,1294662,172077,43902,1510641,20945,2062630,870295,256700,187700,1314695,236060,144955,1695710,366920,30553740,1449945,1661505,2322145,5433595,6286900,5510500,17230995,13311973,2139297340000,80639740000,88651695000,131853830000,301145265000,378793930000,350228030000,1030167225000,1108668211000
Utah,Accommodation and Food Services,2016,20214,6476,3418,4190,14084,4847,612,19543,671,28540,6530,3455,4270,14255,5545,2365,22165,6375,580595,9230,22871,56961,89125,172361,92077,354255,226157,9529215000,337025000,336322000,787554000,1462175000,2602588000,1510764000,5597325000,3928404000
Utah,Administrative and Support and Waste Management and Remediation Services,2016,19941,12635,2565,1700,16900,1400,517,18817,1124,21965,12635,2565,1710,16910,1465,560,18935,3030,668330,17528,16656,22005,56676,50470,63758,177040,467746,24106410000,681121000,495874000,756970000,1953096000,1917399000,2134597000,6230635000,16899457000
Utah,"Agriculture, Forestry, Fishing and Hunting",2016,455,375,35,20,430,15,5,450,5,465,375,35,20,430,15,5,450,15,1704,449,157,207,896,161,0,1628,0,92183000,15064000,4950000,3652000,26107000,13277000,0,88711000,0
Utah,"Arts, Entertainment, and Recreation",2016,5392,3480,600,535,4615,515,157,5287,105,5640,3480,600,535,4615,545,210,5370,270,110288,4037,3820,7039,15278,19774,21668,61787,41886,2079211000,163847000,73165000,132906000,381512000,398583000,341651000,1265112000,659192000
Utah,Construction,2016,45485,29790,7575,4195,41560,3090,456,45106,379,45770,29795,7585,4195,41575,3130,500,45205,565,392785,45675,49737,56197,151695,116010,56555,327190,60928,19423070000,1851250000,1864056000,2420040000,6140160000,5590460000,3198853000,15099290000,3997559000
Utah,Educational Services,2016,5352,2645,705,690,4040,913,235,5188,164,5710,2645,705,690,4040,970,345,5355,355,243040,3262,4740,9386,17434,39140,31774,90660,147680,6943095000,121734000,88997000,169157000,382342000,1002492000,1011491000,2478700000,4227861000
Utah,Finance and Insurance,2016,17037,12190,1717,618,14525,771,359,15655,1382,26025,12200,1750,690,14640,1600,1390,17630,8395,325847,19251,10665,7980,38325,26837,40772,109139,211250,22252355000,834087000,513093000,496403000,1868860000,2456296000,2409752000,6957286000,14815603000
Utah,Health Care and Social Assistance,2016,33175,17765,6610,4324,28699,3152,627,32478,697,39415,17790,6625,4390,28805,4005,1955,34765,4650,694528,27439,44063,56710,128694,123843,82595,339579,349366,30135135000,1714040000,1418658000,1729125000,4879671000,3989811000,2917715000,11969117000,18027380000
Utah,Information,2016,5614,2910,630,401,3941,633,300,4874,740,7695,2910,635,415,3960,700,375,5035,2660,221807,3970,4055,5078,13500,24409,26235,68008,152956,16097945000,217724000,193204000,213855000,641736000,1590004000,2152972000,4603207000,11446676000
Utah,Management of Companies and Enterprises,2016,1903,310,30,45,385,286,401,1072,831,2525,310,30,45,385,290,405,1080,1445,121070,335,109,264,711,3890,13757,18455,102615,11023820000,18655000,15824000,19440000,54121000,225340000,933894000,1220105000,9803715000
Utah,Manufacturing,2016,16127,6380,2875,2245,11500,2485,818,14803,1324,16700,6380,2880,2245,11505,2565,880,14950,1750,564119,10455,17374,27041,58755,91683,72735,252876,253787,31364807000,405409000,585703000,1012907000,2158796000,4050790000,3737149000,11411951000,16816072000
Utah,"Mining, Quarrying, and Oil and Gas Extraction",2016,1918,965,265,215,1445,141,56,1642,276,2060,965,265,215,1445,145,60,1650,410,37183,1310,1758,2509,5896,3451,2773,14193,17953,2856735000,73094000,90777000,191222000,375170000,217950000,193232000,945937000,1526203000
Utah,Other,2016,94,92,1,1,94,0,0,94,0,94,92,1,1,94,0,0,94,0,105,81,0,0,105,0,0,105,0,3341000,2806000,0,0,3341000,0,0,3341000,0
Utah,Other Services (except Public Administration),2016,22777,14540,4140,2200,20880,1208,233,22321,456,25155,14560,4145,2310,21015,1865,660,23540,1615,262691,23988,27110,28169,79692,40237,10550,136629,59813,9084582000,701421000,778338000,806062000,2302255000,1143395000,375619000,4062634000,2387332000
Utah,"Professional, Scientific, and Technical Services",2016,49794,37370,4730,3040,45140,2426,829,48395,1399,52595,37380,4750,3085,45215,2795,1010,49020,3575,433784,46730,30731,39517,117300,83737,65531,271205,161339,24783367000,2335150000,1453607000,2088622000,5893775000,5435132000,4872997000,16429530000,8299413000
Utah,Real Estate and Rental and Leasing,2016,23586,19863,1586,737,22186,666,260,23112,474,26410,19865,1605,780,22250,945,695,23890,2520,99774,22807,10000,9265,42421,19595,12074,75671,23561,4303575000,972477000,338517000,354933000,1672658000,886889000,557263000,3187218000,1095790000
Utah,Retail Trade,2016,33311,17763,5809,4224,27796,2912,771,31479,1832,49210,17795,5890,4485,28170,4075,2660,34905,14305,777427,24791,38892,55225,119391,103508,70800,300071,461367,21696550000,827508000,982950000,1499034000,3324015000,3173078000,2452637000,9143355000,12166634000
Utah,Total,2016,64524,39901,9312,6287,55500,5528,1392,62420,2104,77504,39954,9384,6473,55811,6801,3190,65802,11702,1239348,56516,61426,83885,201827,206813,164248,572888,666460,54331488000,2443683000,2050129000,2866179000,7359991000,8089420000,7376806000,22826217000,31505271000
Utah,Transportation and Warehousing,2016,10465,6240,1238,785,8263,918,392,9573,892,11470,6245,1260,790,8295,935,465,9695,1775,281634,8595,7616,10024,26770,26751,27620,85235,191074,12634296000,316285000,282133000,416631000,1034674000,1125358000,1234559000,3489871000,9017383000
Utah,Utilities,2016,435,260,50,20,330,42,15,387,48,1090,260,50,20,330,95,25,450,640,18869,443,325,255,1058,1440,0,5235,6208,1795354000,12127000,12328000,15705000,42315000,128100000,0,461944000,589722000
Utah,Wholesale Trade,2016,15881,7183,2080,1411,10674,2101,1024,13799,2082,18610,7190,2085,1470,10745,2320,1385,14450,4160,288200,10919,12997,17461,42521,63032,46559,160418,122973,17210083000,548065000,572165000,866257000,2048657000,3446334000,2703022000,8689395000,8187522000
Vermont,Accommodation and Food Services,2016,8569,3375,1580,1715,6670,1485,157,8312,257,9645,3380,1580,1725,6685,1680,330,8695,950,165495,5430,10911,23490,39960,48684,14586,104880,60431,3107515000,156230000,183658000,408813000,755445000,1003960000,345267000,2130805000,974810000
Vermont,Administrative and Support and Waste Management and Remediation Services,2016,5506,3875,680,310,4865,265,78,5208,298,5805,3875,680,320,4875,300,85,5260,545,40306,4865,4155,3362,13017,6542,3602,26143,13151,1369890000,231269000,143430000,117542000,517114000,222001000,93644000,945783000,384081000
Vermont,"Agriculture, Forestry, Fishing and Hunting",2016,685,585,65,20,670,5,10,685,0,685,585,65,20,670,5,10,685,0,2282,912,386,48,1592,0,0,2282,0,90616000,31026000,10843000,1986000,54376000,0,0,90616000,0
Vermont,"Arts, Entertainment, and Recreation",2016,2379,1560,325,235,2120,170,59,2349,30,2455,1560,335,240,2135,180,110,2425,30,37264,2041,2062,2894,7278,5424,9092,25778,6882,738367000,109749000,50897000,88052000,257249000,104350000,135885000,571973000,99596000
Vermont,Construction,2016,13505,9920,1955,940,12815,535,85,13435,70,13540,9920,1955,940,12815,550,100,13465,75,69536,15145,12713,12089,40426,17957,5544,67146,1177,3670704000,685900000,569971000,634824000,1916199000,1010340000,363721000,3513674000,72491000
Vermont,Educational Services,2016,1875,885,330,205,1420,270,115,1805,70,2010,885,330,205,1420,380,130,1930,80,77728,1300,2070,2624,6376,10906,19161,37889,39560,2399538000,52838000,48871000,54051000,167912000,318810000,702747000,1225600000,1166307000
Vermont,Finance and Insurance,2016,2482,1350,280,128,1758,160,125,2043,439,4705,1355,305,190,1850,410,845,3105,1600,47577,2776,1725,1165,5987,5012,13341,26388,19873,3229808000,145402000,111291000,68709000,350735000,375956000,762355000,1666509000,1480101000
Vermont,Health Care and Social Assistance,2016,8515,3725,1805,1200,6730,1043,396,8169,346,10450,3740,1805,1245,6790,1310,1030,9130,1320,241366,6840,11784,15979,35025,39116,43312,120308,118549,10531914000,319718000,448839000,585469000,1376152000,1284312000,1705924000,4463822000,6007948000
Vermont,Information,2016,1886,815,340,190,1345,222,70,1637,249,2535,815,340,190,1345,295,90,1730,805,35139,1462,2155,2120,6295,7258,1331,20583,14201,2108508000,55528000,68734000,72847000,214514000,375546000,93183000,1066416000,1024857000
Vermont,Management of Companies and Enterprises,2016,366,10,15,30,55,50,95,200,166,435,10,15,30,55,50,95,200,235,10910,0,0,101,170,794,3769,4845,6065,772760000,0,0,5543000,16120000,54536000,206444000,285070000,487690000
Vermont,Manufacturing,2016,4869,2245,735,590,3570,731,300,4601,268,5075,2245,735,595,3575,755,415,4745,330,117785,3372,3635,5860,15139,23755,16653,74062,23633,6208607000,142353000,129338000,234697000,595434000,1090743000,849196000,3508227000,1482904000
Vermont,"Mining, Quarrying, and Oil and Gas Extraction",2016,196,110,25,20,155,20,5,180,16,230,110,25,20,155,35,15,205,25,1971,153,151,164,513,291,0,1143,537,161311000,9747000,7849000,16420000,37485000,16971000,0,83295000,49791000
Vermont,Other,2016,48,48,0,0,48,0,0,48,0,48,48,0,0,48,0,0,48,0,45,45,0,0,45,0,0,45,0,1330000,1330000,0,0,1330000,0,0,1330000,0
Vermont,Other Services (except Public Administration),2016,9907,6670,1950,727,9347,330,73,9750,157,10285,6680,1970,775,9425,470,120,10015,270,50811,12408,12475,9118,34314,8158,925,45289,2459,1457472000,354620000,321461000,264882000,950800000,267696000,43854000,1336301000,65294000
Vermont,"Professional, Scientific, and Technical Services",2016,10344,7155,1405,780,9340,465,113,9918,426,10720,7155,1410,795,9360,575,135,10070,650,64551,11452,9107,9306,30617,13711,5635,52668,10359,4287974000,580809000,508159000,540478000,1669235000,978993000,486432000,3356671000,829813000
Vermont,Real Estate and Rental and Leasing,2016,3309,2470,370,145,2985,148,25,3158,151,3795,2470,370,165,3005,185,240,3430,365,16353,3815,2245,1761,8153,3282,167,12163,2949,727917000,152461000,83206000,64972000,320218000,160233000,7529000,522529000,144254000
Vermont,Retail Trade,2016,11910,5260,2607,1628,9495,1222,258,10975,935,16400,5265,2675,1740,9680,1995,1010,12685,3715,198986,10159,16707,20010,48141,38439,16791,109726,85905,5492795000,278862000,455076000,577360000,1347402000,1456443000,485650000,3533460000,1876580000
Vermont,Total,2016,18148,10616,3039,1863,15518,1510,360,17388,760,21174,10627,3070,1945,15642,1998,1056,18696,2478,262705,17563,20086,24628,62277,54202,44601,161080,101625,10828353000,710078000,698144000,869148000,2277370000,2154539000,1947497000,6379406000,4448947000
Vermont,Transportation and Warehousing,2016,2233,1330,285,160,1775,205,87,2067,166,2475,1330,285,160,1775,220,130,2125,350,28545,2036,1615,1631,5820,5636,1466,16467,5512,1120740000,68631000,65547000,70684000,221760000,222327000,58935000,624257000,228117000
Vermont,Utilities,2016,150,45,20,5,70,20,25,115,35,310,45,20,5,70,25,45,140,170,6812,39,38,0,185,0,602,1892,3513,694125000,1825000,2640000,0,12308000,0,57942000,167156000,375300000
Vermont,Wholesale Trade,2016,3557,1470,445,360,2275,483,236,2994,563,4075,1470,450,365,2285,570,345,3200,875,57719,2306,2256,3476,9622,12493,11272,41156,14855,3332372000,108945000,102475000,189299000,481562000,665874000,557118000,2106311000,1095446000
Virginia,Accommodation and Food Services,2016,64745,22130,12716,13408,48254,13451,1468,63173,1572,88890,22150,12825,13535,48510,14705,5735,68950,19940,1763330,37785,85996,182133,306065,489078,207343,1003240,759497,31529350000,1157905000,1395588000,2946473000,5502685000,8437994000,3336201000,17305620000,14217392000
Virginia,Administrative and Support and Waste Management and Remediation Services,2016,45692,25930,7225,4153,37308,4515,1773,43596,2096,53580,25945,7235,4205,37385,5040,2350,44775,8805,1225396,40728,47434,55086,143430,169865,227311,542865,678973,50761820000,1630676000,1622864000,2059667000,5323900000,6864925000,8492466000,20799172000,29774133000
Virginia,"Agriculture, Forestry, Fishing and Hunting",2016,3315,2170,670,270,3110,145,35,3290,25,3330,2170,670,270,3110,145,50,3305,25,20070,3627,4064,3323,11223,3540,487,16900,0,963573000,126742000,148100000,120614000,402885000,171233000,24589000,698733000,0
Virginia,"Arts, Entertainment, and Recreation",2016,13691,7895,1865,1485,11245,1777,352,13374,317,14970,7895,1875,1500,11270,1850,595,13715,1255,298764,10715,12233,19810,43147,71115,40266,160378,112209,6956634000,440140000,249195000,417392000,1114802000,1351206000,999137000,3728052000,2232477000
Virginia,Construction,2016,95785,61875,15375,9020,86270,7593,1200,95063,722,97280,61875,15385,9030,86290,7730,1600,95620,1660,891140,101170,100880,121490,323540,279505,144801,750755,137485,47799480000,4096975000,4087295000,5729315000,13913585000,15077155000,8769593000,37960430000,9567403000
Virginia,Educational Services,2016,13948,6655,2270,1920,10845,2114,550,13509,439,15125,6660,2290,1960,10910,2255,750,13915,1210,398526,10473,15070,25810,51385,83030,79828,216198,182127,13915528000,377388000,353314000,595153000,1326403000,2737696000,3204261000,7432908000,6468865000
Virginia,Finance and Insurance,2016,28277,18443,3850,1500,23793,1436,967,26196,2081,56740,18485,3930,1720,24135,2870,4925,31930,24810,752614,32323,23653,18869,75168,48300,76288,203507,534100,65732459000,1567196000,1326349000,1495153000,4421176000,3914855000,6466597000,15211947000,48885334000
Virginia,Health Care and Social Assistance,2016,74474,33160,16678,11142,60980,9365,2093,72438,2036,100570,33200,16835,11750,61785,12610,6470,80865,19705,2190949,60167,110907,148252,319441,363667,315821,999875,1189332,108090065000,3160377000,4951093000,6608239000,14724665000,15541253000,13078768000,43407130000,64591631000
Virginia,Information,2016,10150,4715,1270,1060,7045,1207,596,8848,1302,20080,4725,1300,1075,7100,1405,830,9335,10745,435276,7030,8220,13473,29115,43611,55243,131075,298531,41210898000,426009000,457727000,938369000,1845590000,3542905000,5088631000,10692895000,29692413000
Virginia,Management of Companies and Enterprises,2016,4158,255,100,130,485,591,1164,2240,1918,6990,255,100,130,485,600,1235,2320,4670,350315,345,420,770,1535,6745,36894,45185,305122,33938580000,25685000,30600000,63360000,119645000,490056000,2813764000,3425300000,30507647000
Virginia,Manufacturing,2016,23266,8440,4054,3049,15543,3967,1498,21008,2258,24995,8440,4060,3055,15555,4190,1960,21705,3290,1158973,15074,24945,37457,82139,139986,138037,401043,677191,62795277000,618904000,885888000,1482904000,3204879000,6195703000,6415668000,17747711000,40124012000
Virginia,"Mining, Quarrying, and Oil and Gas Extraction",2016,972,340,100,115,555,195,73,823,149,1475,340,100,115,555,225,150,930,545,38272,610,473,1369,2666,7489,2552,14609,22566,2413172000,94679000,23993000,80236000,223134000,412917000,128312000,857350000,1461961000
Virginia,Other,2016,433,420,10,2,432,1,0,433,0,433,420,10,2,432,1,0,433,0,550,420,72,0,524,0,0,550,0,12671000,11120000,1187000,0,12425000,0,0,12671000,0
Virginia,Other Services (except Public Administration),2016,101375,62025,20425,10050,92500,7063,975,100538,837,109335,62070,20580,10285,92935,8335,2575,103845,5490,821110,114904,132376,131905,379340,244425,101022,726095,84185,31150895000,3265312000,3784650000,4281376000,11334725000,9548618000,5715632000,26646870000,3881607000
Virginia,"Professional, Scientific, and Technical Services",2016,132545,90321,15437,9536,115294,10448,3626,129368,3177,156260,90370,15515,9780,115665,12055,4860,132580,23680,2301400,129350,101282,126887,357785,374615,424152,1159790,1129171,209198545000,9089080000,6791482000,9623676000,25517660000,32197590000,37259222000,95219090000,112968579000
Virginia,Real Estate and Rental and Leasing,2016,34596,26251,3293,1705,31249,1428,840,33517,1079,48835,26315,3390,1945,31650,2620,3710,37980,10855,275155,37576,20755,21637,80225,42405,41886,166135,105462,14358340000,1702657000,913172000,1072626000,3696225000,2121531000,2450638000,8335020000,5650573000
Virginia,Retail Trade,2016,77966,41789,15866,9484,67139,6033,1759,74931,3035,134475,41915,16220,10435,68570,8955,5090,82615,51860,2151465,78566,104814,122064,305621,202203,145648,656196,1450846,56721370000,2041942000,2563148000,3224790000,7835292000,6954566000,6034731000,20909327000,34681682000
Virginia,Total,2016,152020,87944,25499,16465,129908,14906,3663,148477,3543,199548,88061,25777,17155,130993,18369,9421,158783,40765,3254172,144582,167812,219572,531966,549936,453234,1535136,1719036,170160430000,6352563000,6324399000,8818717000,21495679000,25022803000,24604138000,71122620000,99037810000
Virginia,Transportation and Warehousing,2016,21403,12344,2705,1920,16969,1891,874,19734,1669,24955,12365,2715,1965,17045,2100,1120,20265,4690,521138,18451,17773,24685,61482,61746,48547,175523,335286,24494453000,656785000,617335000,942947000,2242896000,2696246000,2253210000,7386150000,16547049000
Virginia,Utilities,2016,485,125,65,15,205,45,75,325,160,1675,125,75,15,215,50,210,475,1200,74690,183,312,78,620,1639,8645,11170,63429,7506644000,9005000,18788000,5748000,35270000,122722000,749669000,926073000,6575827000
Virginia,Wholesale Trade,2016,27167,12895,3675,2847,19417,3371,1709,24497,2670,36015,12905,3735,2995,19635,4100,2890,26625,9390,527911,20998,23660,35684,81255,96774,93247,276925,245092,35361118000,1150854000,1241607000,2075589000,4524200000,5546543000,5697843000,16087710000,18824926000
Washington,Accommodation and Food Services,2016,68204,24534,15330,13910,53774,12208,1240,67222,982,85750,24600,15405,14215,54220,14330,4895,73445,12305,1401160,39495,101770,188540,329805,418125,185449,936015,464538,30321275000,1233050000,1766675000,3551770000,6551495000,9018888000,4157010000,19815880000,10490853000
Washington,Administrative and Support and Waste Management and Remediation Services,2016,43550,27230,6735,3860,37825,3312,848,41985,1565,49230,27240,6755,3905,37900,3530,1065,42495,6735,776575,41122,43096,50235,134635,118701,107060,366126,408134,36176841000,1609313000,1522487000,1967801000,5108547000,5066220000,4121140000,14656214000,21397883000
Washington,"Agriculture, Forestry, Fishing and Hunting",2016,6835,4970,770,425,6165,455,140,6760,75,6965,4970,770,425,6165,470,160,6795,170,64398,5602,4867,5504,16102,17700,21409,56646,4699,3136871000,405086000,231700000,281018000,922341000,931291000,863882000,2777698000,205813000
Washington,"Arts, Entertainment, and Recreation",2016,13871,7850,2030,1420,11300,1843,478,13621,250,14870,7855,2030,1435,11320,1940,825,14085,785,308196,11987,13370,19271,44922,72178,78775,200786,102676,9397008000,465337000,336892000,417239000,1228146000,1483343000,2033668000,4919663000,4408064000
Washington,Construction,2016,111168,76363,16820,9280,102463,7035,1030,110528,640,112035,76365,16820,9285,102470,7165,1180,110815,1220,875010,115350,110159,123775,349300,263020,131022,747490,121232,56145645000,5259465000,5051692000,6689780000,17001505000,17294790000,10092844000,44753250000,10980785000
Washington,Educational Services,2016,13200,6590,2225,2000,10815,1628,355,12798,402,14165,6610,2230,2020,10860,1830,560,13250,915,274973,10318,14760,26688,51823,59329,42007,155183,119070,8044745000,342533000,348152000,652764000,1346200000,1741064000,1518535000,4706040000,3319771000
Washington,Finance and Insurance,2016,25294,16920,3375,1217,21512,1057,771,23340,1954,48870,16940,3430,1285,21655,1760,3590,27005,21865,490498,29263,20597,14670,64894,31977,70565,170438,319596,42220041000,1619613000,1270365000,1133306000,4056474000,2636592000,5201642000,12237207000,29928277000
Washington,Health Care and Social Assistance,2016,83723,43394,18625,10551,72570,7186,2322,82078,1645,103925,43450,18730,10925,73105,9830,6415,89350,14575,2032769,75548,124112,139058,338867,279017,337243,957052,1075313,108063781000,3268687000,5003085000,5923650000,14201601000,11070738000,14854982000,40214811000,67839071000
Washington,Information,2016,10928,5545,1381,1070,7996,1200,589,9785,1143,17640,5545,1390,1120,8055,1400,710,10165,7475,663105,8004,9034,13596,31029,42228,51711,128595,532633,104673048000,549331000,500209000,840051000,1912316000,2972988000,5786295000,10877420000,93599357000
Washington,Management of Companies and Enterprises,2016,3929,445,135,150,730,601,995,2326,1603,5570,445,135,150,730,615,1020,2365,3205,454400,424,575,755,1762,6415,38399,46576,407814,51649500000,87771000,57200000,53285000,199731000,482875000,3999131000,4681737000,46965477000
Washington,Manufacturing,2016,33442,13935,5834,4501,24270,5274,1734,31278,2164,34990,13935,5840,4535,24310,5380,2080,31770,3220,1260336,23531,36612,56809,121692,197755,193330,550183,661133,80479814000,979225000,1391862000,2525482000,5132624000,9838640000,10903619000,27753971000,49624130000
Washington,"Mining, Quarrying, and Oil and Gas Extraction",2016,674,285,146,50,481,74,25,580,94,885,285,150,50,485,90,70,645,240,11531,366,810,612,1940,2053,442,5475,4418,770955000,25595000,37628000,32170000,102354000,140602000,33734000,361824000,288648000
Washington,Other,2016,565,548,14,3,565,0,0,565,0,565,548,14,3,565,0,0,565,0,644,519,86,39,644,0,0,644,0,14947000,13377000,1268000,302000,14947000,0,0,14947000,0
Washington,Other Services (except Public Administration),2016,78171,49030,16115,7429,72574,4270,632,77476,695,86010,49050,16215,7750,73015,5735,2115,80865,5145,586221,89209,104756,96991,291120,140571,51029,485097,96453,19991759000,2578670000,3037605000,3029270000,8650474000,4585788000,1805348000,15149465000,4499764000
Washington,"Professional, Scientific, and Technical Services",2016,101872,72160,12260,7245,91665,5811,1985,99461,2411,108865,72175,12305,7380,91860,6515,2625,101000,7865,1008830,100810,79887,95038,276070,192841,178936,653675,351488,83592530000,6476985000,4943050000,6577587000,18017310000,16003640000,15266601000,49746550000,33703538000
Washington,Real Estate and Rental and Leasing,2016,43507,34372,4428,1855,40655,1368,685,42708,799,55185,34415,4545,2055,41015,2250,4255,47520,7665,241755,46183,27790,23103,97258,39478,41051,179379,61406,12525230000,2124346000,1140013000,1132370000,4404538000,1973896000,2112684000,8581706000,3899154000
Washington,Retail Trade,2016,73552,38075,16044,8945,63064,6625,1563,71252,2300,108505,38230,16320,9795,64345,9505,5200,79050,29455,1682860,70797,106722,117471,295335,231393,134939,668230,977575,52426795000,2078265000,2871756000,3605426000,8564990000,8901204000,6314775000,23996235000,27416445000
Washington,Total,2016,152430,91360,26071,15883,133314,12884,3168,149366,3064,186164,91482,26295,16498,134275,16080,8392,158747,27417,2685355,144212,171104,210707,526023,468702,384833,1379558,1305797,156915349000,6391288000,6479596000,8567313000,21438197000,21457084000,20833813000,63729094000,93186255000
Washington,Transportation and Warehousing,2016,22864,13355,2695,2125,18175,2014,995,21184,1680,26415,13360,2715,2195,18270,2215,1425,21910,4505,495734,18655,17714,27146,64111,65291,42874,179958,301723,27234526000,887986000,715087000,1208625000,2851825000,2850329000,2389436000,8466393000,17472621000
Washington,Utilities,2016,939,505,165,60,730,75,45,850,89,1480,505,170,60,735,140,55,930,550,43360,944,901,814,2733,2761,811,6848,36351,4527974000,23017000,29365000,55077000,113042000,251692000,81518000,492286000,4017572000
Washington,Wholesale Trade,2016,37645,18660,5374,3722,27756,4545,2292,34593,3052,46640,18695,5450,3890,28035,5700,3715,37450,9190,672015,30210,34365,46766,111975,142320,132592,390985,271548,46136450000,1813136000,1991683000,2812349000,6646870000,8959736000,7897068000,23709240000,21578842000
West Virginia,Accommodation and Food Services,2016,12958,4235,2620,2603,9458,2507,461,12426,532,17735,4240,2625,2645,9510,3070,1805,14385,3350,341530,7407,17391,35133,60143,92186,50235,203648,137784,5408174000,149566000,230553000,498007000,882115000,1370158000,672689000,2958245000,2439896000
West Virginia,Administrative and Support and Waste Management and Remediation Services,2016,6342,3455,915,595,4965,560,180,5705,637,7290,3455,915,600,4970,615,220,5805,1485,165951,5353,5664,7462,19150,18063,23901,62724,92142,5043088000,186931000,155645000,242248000,612128000,684377000,708371000,2073312000,2626132000
West Virginia,"Agriculture, Forestry, Fishing and Hunting",2016,1355,1055,230,50,1335,10,5,1350,5,1355,1055,230,50,1335,10,5,1350,5,4423,1918,1355,506,3983,0,0,4363,0,135560000,48755000,37834000,15895000,110275000,0,0,129115000,0
West Virginia,"Arts, Entertainment, and Recreation",2016,3250,1610,715,475,2800,306,85,3191,59,3700,1610,715,565,2890,540,190,3620,80,36484,2904,4259,6034,13728,9056,6154,31963,1255,633707000,80915000,66258000,101044000,258406000,162432000,72677000,540150000,28997000
West Virginia,Construction,2016,15517,9825,2790,1535,14150,967,198,15315,202,15660,9825,2790,1535,14150,995,220,15365,295,120665,16132,18187,19608,54420,33609,18288,109465,10139,6158950000,518738000,641575000,817778000,1998895000,1854640000,1280629000,5305700000,759348000
West Virginia,Educational Services,2016,1295,560,205,185,950,225,55,1230,65,1350,560,205,185,950,240,80,1270,80,44089,953,1275,2414,4790,8082,10943,24399,19357,1291608000,23520000,19999000,51194000,98996000,213114000,258141000,596293000,689234000
West Virginia,Finance and Insurance,2016,5813,3240,980,280,4500,442,175,5117,696,10470,3260,1005,375,4640,1270,815,6725,3745,85297,6573,5936,3319,16231,17020,10053,45664,38788,4228088000,219462000,213654000,157518000,618186000,723592000,481998000,1993919000,2186489000
West Virginia,Health Care and Social Assistance,2016,16243,6085,3810,2458,12353,2182,948,15483,760,24425,6085,3820,2555,12460,3285,2750,18495,5930,670899,12242,25104,32216,69775,84648,130326,285699,378177,28646840000,537256000,908294000,1287622000,2739685000,2997516000,4375419000,10145216000,18163048000
West Virginia,Information,2016,1302,410,175,205,790,107,69,966,336,3445,410,175,215,800,150,145,1095,2350,52395,665,990,2411,4488,2897,3391,11819,40466,2463189000,18435000,27345000,58458000,120984000,78311000,113941000,342437000,2115606000
West Virginia,Management of Companies and Enterprises,2016,836,45,20,30,95,160,256,511,325,1190,45,20,30,95,160,260,515,675,26980,39,112,149,305,2033,5761,8170,18723,1902885000,5246000,6574000,8839000,20725000,102930000,341363000,470310000,1420161000
West Virginia,Manufacturing,2016,5348,1745,900,742,3387,976,362,4725,623,5815,1745,900,750,3395,1075,440,4910,905,194751,2972,4955,7504,17378,28062,17393,77529,91060,10613828000,82724000,151272000,258306000,562653000,1069829000,876049000,3185432000,5853599000
West Virginia,"Mining, Quarrying, and Oil and Gas Extraction",2016,2241,1045,330,215,1590,267,123,1980,261,2830,1045,335,220,1600,295,155,2050,780,98268,1831,1983,2848,6797,9043,8812,25929,71875,7023245000,99344000,90730000,150654000,346953000,510482000,618055000,1549840000,5437542000
West Virginia,Other,2016,61,56,3,2,61,0,0,61,0,61,56,3,2,61,0,0,61,0,116,69,13,0,116,0,0,116,0,1694000,864000,240000,0,1694000,0,0,1694000,0
West Virginia,Other Services (except Public Administration),2016,20262,13085,4140,1721,18946,856,166,19968,294,21635,13100,4180,1780,19060,1145,240,20445,1190,118406,25587,26208,21727,73934,25208,3295,105889,9737,3011519000,516717000,569678000,527338000,1626285000,649553000,126356000,2525314000,406019000
West Virginia,"Professional, Scientific, and Technical Services",2016,12634,7500,2075,1055,10630,919,402,11951,683,14260,7515,2080,1105,10700,1150,620,12470,1790,123317,13115,13278,12991,40155,27958,21614,91568,29323,6242379000,502156000,531211000,629379000,1702308000,1536116000,1133984000,4480895000,1685797000
West Virginia,Real Estate and Rental and Leasing,2016,5551,3920,740,255,4915,190,108,5213,338,6935,3930,750,255,4935,280,185,5400,1535,32829,6371,4516,2907,14236,3836,934,20206,9426,1340735000,196379000,144427000,94035000,450680000,159564000,25669000,701867000,431627000
West Virginia,Retail Trade,2016,17065,7728,3710,2264,13702,1782,406,15890,1175,30205,7745,3790,2510,14045,2630,1675,18350,11855,406507,14901,24426,28682,68698,59315,26940,160194,235865,9704224000,351477000,558303000,740336000,1662615000,1932813000,704975000,4460153000,4976413000
West Virginia,Total,2016,27038,14092,5174,3141,22407,2591,741,25739,1299,36607,14115,5227,3329,22671,3695,2153,28519,8088,558905,25551,33800,41396,100747,94867,79531,275145,283760,21637981000,768459000,961573000,1293624000,3023656000,3254483000,2915452000,9193591000,12444390000
West Virginia,Transportation and Warehousing,2016,4983,2650,810,475,3935,429,194,4558,425,5865,2650,810,480,3940,460,255,4655,1210,72655,3920,5135,5751,15366,11284,4163,32570,29612,3171961000,134940000,159452000,218211000,525049000,416335000,155609000,1163646000,1555837000
West Virginia,Utilities,2016,311,90,35,50,175,20,15,210,101,1190,90,35,85,210,45,120,375,815,30380,220,200,516,1040,296,0,3977,25166,2925735000,6465000,6313000,15911000,33610000,16732000,0,238721000,2600536000
West Virginia,Wholesale Trade,2016,5579,1925,720,645,3290,826,377,4493,1086,7375,1930,740,695,3365,1060,585,5010,2365,91803,3442,4090,6632,15891,18419,11678,53235,36080,4534329000,126299000,155363000,289017000,640223000,857372000,556844000,2347853000,2054047000
Wisconsin,Accommodation and Food Services,2016,59299,22756,11437,11540,45733,11572,1063,58368,931,72995,22835,11450,11705,45990,13430,3805,63225,9770,1191120,37410,76739,158318,272510,420173,145814,839160,348170,17685415000,927780000,973052000,1968165000,3869460000,5959297000,2255461000,12095670000,5475431000
Wisconsin,Administrative and Support and Waste Management and Remediation Services,2016,29378,17825,4235,2645,24705,2308,1003,28016,1362,36375,17830,4235,2690,24755,2555,1505,28815,7560,773392,26430,27662,35539,89830,83531,140886,317547,453524,25444336000,1092633000,912978000,1295756000,3309378000,2641356000,4532805000,10626621000,14723319000
Wisconsin,"Agriculture, Forestry, Fishing and Hunting",2016,2735,2125,330,135,2590,85,25,2700,35,2760,2125,330,135,2590,85,35,2710,50,16486,3358,2098,1727,7370,1586,866,11191,2280,755922000,111590000,63532000,84412000,268543000,72054000,42327000,443297000,132276000
Wisconsin,"Arts, Entertainment, and Recreation",2016,12892,7290,1932,1514,10736,1636,314,12686,206,13665,7290,1940,1565,10795,1760,660,13215,450,225319,10220,12643,20472,43790,64232,47119,159165,55148,6069882000,394480000,284524000,355419000,1050525000,1184451000,596911000,2959607000,2736385000
Wisconsin,Construction,2016,67181,45525,10910,5700,62135,4130,560,66825,356,68010,45530,10920,5735,62185,4310,730,67225,785,540495,72600,70755,74923,218300,147595,75531,446285,92856,36956860000,3472750000,3365125000,4281611000,11121130000,10074477000,5844965000,27379590000,9493614000
Wisconsin,Educational Services,2016,7806,3155,1460,1135,5750,1505,283,7538,268,8305,3160,1460,1155,5775,1590,400,7765,540,281455,5114,9718,15417,30505,56217,38845,126200,152742,9796115000,131508000,194652000,288491000,624475000,1393270000,1309864000,3340540000,6319201000
Wisconsin,Finance and Insurance,2016,23701,15295,2975,1170,19440,1773,797,22010,1691,45630,15330,3035,1410,19775,4585,4560,28920,16710,690397,27234,18559,15372,61574,68176,81382,213595,476295,51760069000,1248613000,917783000,966996000,3174129000,4167176000,5013226000,12557182000,39052288000
Wisconsin,Health Care and Social Assistance,2016,51741,21630,10563,7714,39907,7558,2349,49814,1927,78405,21685,10645,8160,40490,11635,7250,59375,19030,1975319,38736,71148,104281,214359,294013,335687,846124,1126735,90793006000,2055192000,2692428000,4116817000,8875105000,10825102000,10070461000,29869183000,60834215000
Wisconsin,Information,2016,5532,2300,795,652,3747,716,337,4800,732,12430,2315,820,700,3835,975,590,5400,7030,278541,3722,4916,8163,17292,21519,28355,71393,206908,19992175000,182734000,227996000,330068000,761136000,1081018000,1686426000,3751481000,16215161000
Wisconsin,Management of Companies and Enterprises,2016,3604,205,30,140,375,695,1053,2123,1481,5385,205,30,140,375,715,1140,2230,3155,400360,197,185,674,1056,8165,30675,39900,360455,35855140000,72479000,10325000,45514000,128318000,479940000,2111375000,2719935000,33135083000
Wisconsin,Manufacturing,2016,39862,11990,6005,5718,23713,8974,3734,36421,3441,43955,11995,6010,5780,23785,9425,4865,38075,5880,2223595,21978,38842,74549,139978,363552,476325,1023588,1122500,119265468000,932132000,1529490000,3162104000,5821921000,17623553000,23812090000,49461982000,65504689000
Wisconsin,"Mining, Quarrying, and Oil and Gas Extraction",2016,738,275,115,95,485,117,57,659,79,875,275,115,105,495,140,130,765,110,16263,425,727,1137,2385,3639,4056,10926,5138,1044399000,27747000,50019000,71662000,156163000,274407000,204994000,684521000,342263000
Wisconsin,Other,2016,303,294,6,1,301,2,0,303,0,303,294,6,1,301,2,0,303,0,355,261,38,0,313,0,0,355,0,5083000,4206000,566000,0,4910000,0,0,5083000,0
Wisconsin,Other Services (except Public Administration),2016,67870,39855,14892,7410,62157,4540,569,67266,604,73020,39905,15025,7665,62595,6070,1690,70355,2665,538546,77503,96486,96975,271303,157224,46643,479226,55570,14607411000,2015733000,2305017000,2352990000,6685081000,4229111000,1580295000,12742496000,1754230000
Wisconsin,"Professional, Scientific, and Technical Services",2016,52961,34485,7583,4542,46610,3657,999,51266,1695,57755,34520,7645,4675,46840,4505,1590,52935,4820,536574,53234,49044,59833,162480,120773,77667,364244,171264,35589733000,2595708000,2407555000,3222736000,8238907000,7595175000,6334531000,22396933000,13082311000
Wisconsin,Real Estate and Rental and Leasing,2016,19614,14125,2530,1190,17845,914,380,19139,475,24210,14155,2580,1265,18000,1415,1735,21150,3060,132075,20037,16151,15111,51495,31388,20715,106775,23982,5318780000,803221000,593008000,625422000,2035804000,1279040000,776228000,4252470000,1048544000
Wisconsin,Retail Trade,2016,60497,28884,13104,7959,49947,6568,1557,58072,2425,95010,28985,13390,8745,51120,9785,5675,66580,28430,1572125,54918,86487,104825,246430,238311,143735,634590,928684,40800035000,1420426000,2082101000,2647356000,6153980000,7492487000,4430824000,18303555000,22262568000
Wisconsin,Total,2016,108799,58973,19278,12884,91135,12143,2802,106080,2719,140859,59078,19460,13500,92038,16151,8238,116427,24432,2524329,99144,127053,173364,399561,463807,395561,1258929,1265400,115817145000,3888930000,4203578000,5946426000,14038934000,17708694000,16967010000,48714638000,67102507000
Wisconsin,Transportation and Warehousing,2016,24074,13830,3370,2380,19580,2400,738,22718,1356,27625,13835,3370,2420,19625,2665,1260,23550,4075,517798,20417,21850,30644,73646,80446,62862,219352,292757,21951718000,823715000,840388000,1238723000,2935047000,3283433000,2359112000,8693944000,13028496000
Wisconsin,Utilities,2016,410,70,25,25,120,125,28,273,137,1600,70,25,35,130,250,95,475,1125,61843,104,77,298,655,3914,305,5081,51478,6503754000,4253000,2779000,19790000,36503000,284528000,23073000,356325000,5372142000
Wisconsin,Wholesale Trade,2016,27854,11843,4215,3280,19338,4016,1902,25256,2598,34770,11875,4245,3410,19530,4850,3475,27855,6915,602025,20052,27519,40973,89392,134363,137815,367925,229402,35686243000,1067777000,1423071000,2294974000,4825074000,7622336000,7583501000,20373938000,15010553000
Wyoming,Accommodation and Food Services,2016,7876,2835,1635,1465,5935,1420,256,7611,265,9060,2835,1640,1475,5950,1705,695,8350,710,141702,4284,11199,19964,35571,48338,30304,114429,25817,2836185000,148173000,171038000,315329000,636508000,903318000,568234000,2119062000,683275000
Wyoming,Administrative and Support and Waste Management and Remediation Services,2016,4919,3260,775,338,4373,245,35,4653,266,5215,3260,785,345,4390,265,40,4695,520,30405,4878,4865,4219,14524,6368,460,21860,7650,1092359000,195365000,157205000,154090000,527374000,200111000,9791000,759407000,291257000
Wyoming,"Agriculture, Forestry, Fishing and Hunting",2016,435,330,60,15,405,10,0,415,20,435,330,60,15,405,10,0,415,20,1322,392,240,31,883,0,0,1143,104,38918000,12303000,7197000,940000,28151000,0,0,34027000,2972000
Wyoming,"Arts, Entertainment, and Recreation",2016,2200,1505,270,210,1985,160,35,2180,20,2215,1505,270,210,1985,170,40,2195,20,19958,1804,1664,2508,6318,4911,2264,15154,0,449449000,82166000,37412000,55821000,186762000,107795000,32250000,376837000,0
Wyoming,Construction,2016,13427,8745,2400,1245,12390,768,112,13270,157,13545,8745,2400,1250,12395,810,135,13340,205,92953,14106,15759,16243,46393,24131,5789,79828,12098,4836427000,625767000,651337000,763640000,2054649000,1347768000,316351000,3909402000,863214000
Wyoming,Educational Services,2016,888,515,100,118,733,85,40,858,30,925,515,100,125,740,85,70,895,30,9946,736,570,1428,2879,2918,2662,9398,194,276957000,32166000,7297000,19423000,65535000,68541000,92231000,264966000,3531000
Wyoming,Finance and Insurance,2016,3330,2120,360,160,2640,241,101,2982,348,5265,2120,375,195,2690,695,330,3715,1550,33055,3223,2142,1857,7464,8344,4234,21357,10673,1896539000,137970000,95341000,72337000,315867000,443599000,261444000,1123732000,700191000
Wyoming,Health Care and Social Assistance,2016,8851,4525,1800,1105,7430,798,274,8502,349,9840,4540,1815,1110,7465,1100,585,9150,690,164686,7791,11833,14576,34762,29607,31095,102160,57968,7388017000,457608000,445236000,548800000,1470697000,1214530000,1341853000,4293370000,3004379000
Wyoming,Information,2016,1155,465,155,160,780,166,40,986,169,1935,465,165,165,795,300,140,1235,700,19673,619,813,1754,3815,4313,1745,11154,6726,917782000,33806000,18882000,44582000,126288000,143384000,105353000,441448000,378268000
Wyoming,Management of Companies and Enterprises,2016,396,70,10,25,105,95,70,270,126,510,70,10,25,105,95,75,275,235,5314,100,0,128,290,1054,882,2249,3034,450396000,2810000,0,7821000,12000000,74323000,82612000,172741000,270018000
Wyoming,Manufacturing,2016,2691,1375,455,290,2120,257,100,2477,214,2805,1375,460,290,2125,280,165,2570,235,36602,2010,2073,1928,7494,5529,1845,20418,9981,2377650000,68956000,66905000,68274000,256146000,298401000,121847000,958670000,877787000
Wyoming,"Mining, Quarrying, and Oil and Gas Extraction",2016,3088,1490,460,285,2235,316,120,2671,417,3670,1490,460,320,2270,360,150,2780,890,94321,2392,2957,3797,9218,9214,4671,26693,64479,7682844000,140768000,143830000,213987000,515282000,646781000,337057000,1881775000,5474692000
Wyoming,Other,2016,68,62,3,1,66,2,0,68,0,68,62,3,1,66,2,0,68,0,161,76,18,0,111,0,0,161,0,2012000,1651000,178000,0,1906000,0,0,2012000,0
Wyoming,Other Services (except Public Administration),2016,8691,5715,1725,740,8180,250,80,8510,181,9130,5725,1730,785,8240,460,90,8790,340,41980,10879,11157,9073,31708,5670,179,38747,2439,1317756000,320460000,308134000,271561000,923496000,181360000,10719000,1153872000,139256000
Wyoming,"Professional, Scientific, and Technical Services",2016,10946,8170,1245,605,10020,385,170,10575,371,11430,8170,1245,650,10065,475,270,10810,620,48358,11063,7752,7682,27135,9856,3955,43701,4052,2598498000,591484000,353451000,455219000,1431668000,561947000,228076000,2370809000,201391000
Wyoming,Real Estate and Rental and Leasing,2016,5233,4220,360,200,4780,155,83,5018,215,5880,4220,365,205,4790,275,270,5335,545,22580,6111,2227,2212,10802,3548,844,16249,6040,1024190000,215087000,79396000,74193000,378868000,166563000,23677000,612090000,400443000
Wyoming,Retail Trade,2016,9776,4705,2015,1190,7910,856,330,9096,680,13225,4725,2045,1280,8050,1135,910,10095,3130,147318,8369,13061,14788,36796,23582,12367,74697,69738,4064783000,249601000,336526000,441443000,1041380000,823657000,436991000,2362371000,1624649000
Wyoming,Total,2016,17950,10773,2963,1729,15465,1307,386,17158,792,20966,10786,2985,1815,15586,1809,940,18335,2631,208440,17131,19589,22871,59591,43128,28780,131499,76941,9303969000,733888000,653778000,804488000,2192154000,1715444000,1282376000,5189974000,4113995000
Wyoming,Transportation and Warehousing,2016,3778,2260,565,255,3080,247,121,3448,330,4590,2260,565,255,3080,270,220,3570,1020,47901,3492,3397,3091,10298,5232,4486,21628,21722,2368946000,135909000,131514000,135737000,412965000,257981000,214511000,966195000,1220022000
Wyoming,Utilities,2016,244,75,25,15,115,45,15,175,69,675,75,25,25,125,80,60,265,410,13038,80,101,160,356,1496,0,2900,9580,1195461000,1995000,3725000,12985000,20148000,114393000,0,242407000,917143000
Wyoming,Wholesale Trade,2016,3153,1185,390,318,1893,378,269,2540,613,4140,1195,395,345,1935,465,455,2855,1285,39032,1921,2162,2794,7942,5530,5252,21786,15859,2344761000,99131000,101603000,130721000,386714000,304321000,317407000,1137920000,1037204000
