state_name,industry_name,YEAR,firms_01: Total,firms_02: <5,firms_03: 5-9,firms_04: 10-19,firms_05: <20,firms_06: 20-99,firms_07: 100-499,firms_08: <500,firms_09: 500+,establishments_01: Total,establishments_02: <5,establishments_03: 5-9,establishments_04: 10-19,establishments_05: <20,establishments_06: 20-99,establishments_07: 100-499,establishments_08: <500,establishments_09: 500+,employment_01: Total,employment_02: <5,employment_03: 5-9,employment_04: 10-19,employment_05: <20,employment_06: 20-99,employment_07: 100-499,employment_08: <500,employment_09: 500+,annual_payroll_01: Total,annual_payroll_02: <5,annual_payroll_03: 5-9,annual_payroll_04: 10-19,annual_payroll_05: <20,annual_payroll_06: 20-99,annual_payroll_07: 100-499,annual_payroll_08: <500,annual_payroll_09: 500+
Alabama,Accommodation and Food Services,2014,28574,10045,5213,5683,20941,5847,898,27686,888,41975,10070,5250,5770,21090,6905,3500,31495,10480,827174,16945,34831,77724,130280,211939,124650,467124,359901,11759632000,424770000,455555000,986059000,1871680000,2956098000,1677178000,6510400000,5246187000
Alabama,Administrative and Support and Waste Management and Remediation Services,2014,18038,9675,2865,1653,14193,1783,748,16724,1314,20985,9680,2880,1680,14240,1925,990,17155,3830,643605,15660,18609,20833,57596,62488,94877,222625,399531,17090665000,504456000,565342000,632776000,1738068000,2144391000,2442859000,6527367000,9646967000
Alabama,"Agriculture, Forestry, Fishing and Hunting",2014,3914,1930,1170,490,3590,230,43,3863,51,3995,1930,1170,490,3590,245,55,3890,105,31603,3559,7166,6391,17960,6438,1123,27563,1593,1215966000,132563000,251251000,255146000,651056000,306103000,30067000,1052681000,86000000
Alabama,"Arts, Entertainment, and Recreation",2014,5141,3015,720,555,4290,644,114,5048,93,5480,3015,720,590,4325,670,170,5165,315,84352,4133,3844,6101,15785,23611,13679,56696,16062,1629520000,128591000,83892000,99590000,339753000,421757000,293590000,1123103000,293450000
Alabama,Construction,2014,35785,21040,6510,3920,31470,3426,472,35368,417,36410,21040,6510,3920,31470,3525,530,35525,885,388715,35938,42748,50763,131190,125216,52045,317515,63457,18287820000,1312082000,1419280000,2105415000,4841170000,5896571000,3140447000,14145955000,3671375000
Alabama,Educational Services,2014,3947,1690,665,545,2900,675,180,3755,192,4215,1690,665,560,2915,800,180,3895,320,122195,2446,4314,6913,14433,25337,28701,70775,22727,3465894000,71825000,73794000,111923000,265644000,561936000,853429000,1767665000,1490386000
Alabama,Finance and Insurance,2014,15968,9840,2185,830,12855,1176,579,14610,1358,35825,9850,2265,1150,13265,3415,3450,20130,15695,343755,17389,12464,7159,40609,40179,34381,122017,124008,23190381000,742524000,601103000,507872000,1923391000,2025757000,1813025000,6047251000,12873718000
Alabama,Health Care and Social Assistance,2014,40501,16400,10385,6455,33240,4751,1377,39368,1133,51565,16410,10490,6745,33645,6120,4385,44150,7415,1181003,32502,68580,84572,187061,177782,192125,567661,599983,52275536000,1751247000,2921567000,3912664000,8582884000,8369833000,7062183000,24257188000,27631552000
Alabama,Information,2014,3651,1460,580,390,2430,376,237,3043,608,7600,1460,590,400,2450,480,320,3250,4350,152531,1480,3382,4353,10548,9883,12286,43008,99420,8240486000,91187000,127922000,205606000,463479000,568000000,819405000,2095678000,5666978000
Alabama,Management of Companies and Enterprises,2014,2266,120,60,30,210,490,586,1286,980,3195,120,60,30,210,495,640,1345,1850,92500,187,216,213,624,5064,12815,18620,73864,7524080000,19875000,18460000,21001000,59510000,291055000,797405000,1149140000,6373936000
Alabama,Manufacturing,2014,19289,6155,3095,2434,11684,3556,1662,16902,2387,20895,6155,3095,2445,11695,3640,1865,17200,3695,1101458,7221,17822,26871,58665,125340,158523,380406,627775,54516572000,395578000,613319000,1060374000,2269070000,5378512000,6883486000,15977103000,33875458000
Alabama,"Mining, Quarrying, and Oil and Gas Extraction",2014,921,270,85,120,475,160,72,707,214,1190,270,85,120,475,175,85,735,455,30331,257,388,507,1863,5595,2958,11865,14867,2293623000,18477000,21362000,38245000,111656000,280828000,196057000,662445000,1446718000
Alabama,Other,2014,164,158,6,0,164,0,0,164,0,164,158,6,0,164,0,0,164,0,0,0,0,0,0,0,0,0,0,3302000,2951000,351000,0,3302000,0,0,3302000,0
Alabama,Other Services (except Public Administration),2014,50649,31120,10601,4774,46495,3212,400,50107,542,54565,31145,10640,4980,46765,4165,830,51760,2805,401770,60954,67708,62159,193358,109383,31446,342887,43928,9906496000,1374417000,1426482000,1486526000,4302556000,2420957000,801122000,7765935000,1700757000
Alabama,"Professional, Scientific, and Technical Services",2014,41491,27303,5945,3575,36823,2632,831,40286,1205,46300,27310,5965,3670,36945,3205,1075,41225,5075,463549,42216,37076,46478,130456,85822,65098,285944,170506,30668387000,1940861000,1750990000,2453843000,6173453000,5953820000,5153523000,17417816000,12950077000
Alabama,Real Estate and Rental and Leasing,2014,14753,10545,1675,855,13075,749,402,14226,527,20025,10550,1770,965,13285,1595,1585,16465,3560,110214,15852,10221,10439,38238,20571,18045,78812,30323,4370736000,569955000,360939000,357136000,1302097000,888755000,684160000,2966998000,1347131000
Alabama,Retail Trade,2014,55023,30858,11334,5415,47607,4426,971,53004,2019,90145,30930,11555,5995,48480,7910,3450,59840,30305,1048735,55262,70908,68928,199776,151207,75639,436148,570164,25545143000,1368875000,1764945000,1968722000,5144350000,5001203000,2411797000,12713137000,12139387000
Alabama,Total,2014,73154,39562,13603,8215,61380,7360,1974,70714,2440,97714,39608,13762,8646,62016,10089,5286,77391,20323,1604016,73102,89294,109479,271875,270725,229614,772214,831802,64291502000,2432346000,2801306000,3734685000,8968337000,10105607000,8942163000,28016107000,36275395000
Alabama,Transportation and Warehousing,2014,12322,6570,1684,1052,9306,1289,548,11143,1179,14465,6570,1685,1065,9320,1410,730,11460,3005,290443,8978,9775,12013,34891,39380,32741,118087,148934,12577529000,374887000,345337000,442735000,1217941000,1409179000,1618192000,4454375000,7072827000
Alabama,Utilities,2014,566,145,135,25,305,115,47,467,99,2180,145,135,25,305,215,135,655,1525,10948,301,836,260,1397,5420,2997,10593,8991,905624000,9065000,31276000,10882000,51687000,362918000,223768000,669463000,812979000
Alabama,Wholesale Trade,2014,21043,8893,3210,2526,14629,2716,1402,18747,2296,26740,8910,3250,2630,14790,3550,2455,20795,5945,349342,13513,18796,29920,65968,72643,60538,215697,114539,19287357000,715196000,955082000,1509256000,3230208000,3665689000,3173876000,10741645000,7589331000
Alaska,Accommodation and Food Services,2014,9025,4360,1691,1405,7456,1155,192,8803,222,10600,4385,1710,1425,7520,1445,770,9735,865,136728,4916,11130,17831,34517,41682,23460,101399,33816,3549901000,322644000,218784000,341887000,890345000,898891000,521249000,2361915000,1157484000
Alaska,Administrative and Support and Waste Management and Remediation Services,2014,4921,2870,785,435,4090,344,93,4527,394,5645,2870,785,460,4115,405,200,4720,925,90507,3582,4629,4350,13857,9586,5843,34602,48365,4277250000,178291000,166757000,166932000,565742000,345444000,188889000,1415760000,2564194000
Alaska,"Agriculture, Forestry, Fishing and Hunting",2014,2195,2085,25,45,2155,15,15,2185,10,2200,2085,25,45,2155,15,15,2185,15,4736,762,76,394,1706,0,0,3446,0,271152000,106270000,2946000,27921000,140487000,0,0,222392000,0
Alaska,"Arts, Entertainment, and Recreation",2014,2567,1810,290,250,2350,170,27,2547,20,2740,1815,295,290,2400,185,45,2630,110,21448,1673,1438,3231,6739,4867,2006,15364,0,489970000,119182000,31915000,67941000,226258000,102633000,29121000,386334000,0
Alaska,Construction,2014,12199,8430,1890,931,11251,572,118,11941,258,12555,8430,1890,935,11255,590,180,12025,530,100533,10754,11508,10772,35758,17146,7380,65096,32123,8633121000,899335000,830243000,903456000,2687056000,1653454000,813873000,5689274000,2727310000
Alaska,Educational Services,2014,1133,575,190,165,930,120,40,1090,43,1305,575,190,180,945,125,165,1235,70,13543,644,971,1579,3939,3288,2665,12202,1317,385068000,24953000,23318000,48405000,108313000,89800000,70005000,342483000,38919000
Alaska,Finance and Insurance,2014,2206,1170,365,105,1640,140,98,1878,328,3855,1170,370,110,1650,275,395,2320,1535,35666,1634,1971,773,4406,3100,27,9762,15553,2348866000,99260000,102153000,62571000,298255000,166464000,173812000,755735000,1125435000
Alaska,Health Care and Social Assistance,2014,10330,4890,2235,1550,8675,890,424,9989,341,12530,4890,2235,1605,8730,1160,885,10775,1755,224161,7282,14527,18922,43631,29420,57978,136955,76788,13110887000,600483000,758098000,1173182000,2655926000,1713959000,2700075000,7254131000,5184650000
Alaska,Information,2014,1030,420,175,105,700,125,73,898,132,2065,420,175,120,715,220,215,1150,915,32665,261,587,724,2195,2608,2876,9570,9094,2121939000,21969000,43474000,26647000,102248000,135188000,170795000,517478000,1469683000
Alaska,Management of Companies and Enterprises,2014,629,30,15,20,65,146,161,372,257,885,30,15,20,65,150,185,400,485,36390,0,24,0,200,1560,5803,7655,28878,4026628000,0,3544000,0,23850000,94755000,385759000,511210000,3529558000
Alaska,Manufacturing,2014,2303,1220,435,215,1870,240,35,2145,158,2645,1220,440,215,1875,265,65,2205,440,59962,903,1898,1532,6025,5210,4794,18597,39955,2565906000,85563000,124733000,79324000,367244000,234441000,249901000,962382000,1509055000
Alaska,"Mining, Quarrying, and Oil and Gas Extraction",2014,740,335,65,95,495,50,59,604,136,890,335,65,95,495,50,60,605,285,53296,202,0,884,1638,1080,4631,7810,41078,6361883000,44063000,23866000,109380000,272765000,147594000,514666000,1046592000,4998455000
Alaska,Other,2014,42,41,1,0,42,0,0,42,0,42,41,1,0,42,0,0,42,0,0,0,0,0,0,0,0,0,0,904000,722000,0,0,904000,0,0,904000,0
Alaska,Other Services (except Public Administration),2014,8419,5100,1858,725,7683,440,85,8208,211,9075,5110,1890,775,7775,605,295,8675,400,49285,8674,10955,7687,29521,11415,1438,46376,1380,1690699000,286569000,359087000,317943000,987330000,435912000,43681000,1557536000,91623000
Alaska,"Professional, Scientific, and Technical Services",2014,8614,5480,1020,725,7225,525,248,7998,616,9625,5480,1025,745,7250,645,355,8250,1375,92574,6610,5642,8437,23261,14673,12210,53622,35377,6664272000,490478000,434120000,619300000,1585135000,1122073000,960735000,3826107000,2703439000
Alaska,Real Estate and Rental and Leasing,2014,4032,2970,445,190,3605,173,71,3849,183,4525,2990,455,225,3670,275,235,4180,345,20734,3384,2395,1733,8257,3788,1508,16129,2903,1034372000,159798000,93686000,72930000,361955000,159471000,68156000,700453000,273111000
Alaska,Retail Trade,2014,9469,4683,1927,1261,7871,829,196,8896,573,12480,4745,1975,1380,8100,1305,575,9980,2500,158470,5528,10961,12727,33932,19586,8754,73242,50141,5008056000,277870000,354949000,442865000,1135156000,772764000,396164000,2553304000,1571987000
Alaska,Total,2014,16841,10081,2839,1735,14655,1220,349,16224,617,20752,10125,2885,1857,14867,1729,1141,17737,3015,266886,15106,18847,22849,56802,42704,43255,142761,124125,15275131000,833597000,821296000,1093823000,2748716000,2076749000,2326608000,7152073000,8123058000
Alaska,Transportation and Warehousing,2014,4459,2768,465,315,3548,268,205,4021,438,5705,2790,465,325,3580,385,535,4500,1205,73298,1686,1965,2291,8206,7131,5392,32021,35398,4850213000,259977000,116663000,164046000,594484000,408908000,550092000,1889019000,2561755000
Alaska,Utilities,2014,312,90,60,42,192,67,41,300,12,500,90,70,45,205,90,160,455,45,9148,12,263,453,982,1610,4172,8311,0,847430000,4289000,10660000,23343000,48795000,142616000,417112000,769094000,0
Alaska,Wholesale Trade,2014,2777,965,340,270,1575,338,243,2156,621,3725,990,345,290,1625,455,370,2450,1275,42317,834,1326,2029,5650,5727,5717,21064,11745,2797634000,64914000,94918000,121671000,342142000,318738000,361885000,1266599000,1115522000
Arizona,Accommodation and Food Services,2014,41318,13114,8000,8032,29146,9670,1266,40082,1236,59775,13120,8020,8210,29350,11005,5145,45500,14275,1337045,21958,53729,109068,185339,358322,197856,742895,583791,23251143000,636077000,725563000,1487355000,2853770000,5521058000,3031574000,11421680000,11632566000
Arizona,Administrative and Support and Waste Management and Remediation Services,2014,35697,20785,5235,3280,29300,3185,1242,33727,1970,41530,20790,5255,3315,29360,3405,1470,34235,7295,1269757,30380,33410,42736,108475,119390,160218,399739,865650,40899192000,1066167000,1030486000,1331536000,3463005000,3749934000,4858029000,12373879000,28342819000
Arizona,"Agriculture, Forestry, Fishing and Hunting",2014,950,610,150,95,855,65,15,935,15,970,610,150,95,855,75,15,945,25,6823,771,716,973,2528,2163,292,6023,0,221001000,36900000,26570000,26137000,98209000,60882000,9548000,200766000,0
Arizona,"Arts, Entertainment, and Recreation",2014,7885,4230,1075,690,5995,1183,463,7641,244,9005,4230,1075,695,6000,1280,725,8005,1000,193750,3543,5373,7573,17032,43671,65497,135515,42951,6586361000,250163000,165797000,178053000,618296000,811611000,3432257000,4963964000,1135041000
Arizona,Construction,2014,56551,34320,9560,5910,49790,5023,974,55787,764,57190,34320,9560,5915,49795,5060,1130,55985,1205,655665,50738,63013,77208,197240,196205,117074,519369,121317,29898525000,2133151000,2255150000,3043073000,7429592000,8771936000,5555616000,22134422000,7159823000
Arizona,Educational Services,2014,8884,4095,1300,1150,6545,1618,371,8534,350,10400,4100,1300,1180,6580,1775,525,8880,1520,302546,5249,8214,14769,29469,66083,44626,142626,158162,11962522000,224567000,214047000,353741000,802569000,2010655000,1460220000,4332063000,7491566000
Arizona,Finance and Insurance,2014,25334,18160,2590,904,21654,838,792,23284,2050,46925,18185,2610,970,21765,1345,2130,25240,21685,654136,22806,13846,9590,46460,22466,53339,127086,500471,44330687000,1353022000,783266000,824711000,3043127000,1573265000,3545684000,8415768000,32037201000
Arizona,Health Care and Social Assistance,2014,67423,37167,13388,7565,58120,5765,1802,65687,1736,86985,37230,13490,7825,58545,8140,5830,72515,14470,1622306,55814,87876,96540,241468,217325,286156,759075,841518,76453858000,3927826000,3757528000,4215357000,11980476000,9230357000,11607905000,33182372000,42189816000
Arizona,Information,2014,6520,3325,755,465,4545,709,354,5608,912,10555,3330,755,465,4550,845,535,5930,4625,216633,2434,3677,5255,13619,21710,22875,65276,141397,14013584000,272997000,200663000,270630000,981538000,1245247000,1580251000,4029241000,9505925000
Arizona,Management of Companies and Enterprises,2014,3216,325,50,85,460,451,862,1773,1443,4775,325,50,85,460,470,920,1850,2925,239454,396,0,0,1510,5189,31399,38309,200948,19100336000,35415000,19845000,1515000,127320000,351691000,2123165000,2602176000,16456414000
Arizona,Manufacturing,2014,20181,7880,3500,2815,14195,3338,1168,18701,1480,21120,7885,3500,2820,14205,3465,1345,19015,2105,596110,8782,19397,31311,68232,108014,79209,295053,257268,36109014000,551207000,726271000,1224241000,2757007000,4875446000,3655284000,13075397000,20665081000
Arizona,"Mining, Quarrying, and Oil and Gas Extraction",2014,939,385,130,124,639,129,52,820,119,1170,385,130,125,640,145,60,845,325,29160,359,372,1332,2329,3134,0,9037,20207,2873776000,29173000,24338000,62445000,126574000,190346000,0,577112000,3628536000
Arizona,Other,2014,236,230,5,0,235,1,0,236,0,236,230,5,0,235,1,0,236,0,0,0,0,0,0,0,0,0,0,5601000,4483000,729000,0,5212000,0,0,5601000,0
Arizona,Other Services (except Public Administration),2014,48758,29960,9490,4726,44176,3079,801,48056,702,54430,29985,9575,4930,44490,4065,2185,50740,3690,423071,52770,61148,60000,177210,104627,69522,359791,48985,12134292000,1495635000,1560315000,1682489000,4795534000,2734349000,2105697000,9819778000,1822165000
Arizona,"Professional, Scientific, and Technical Services",2014,77502,57335,8427,4473,70235,3883,1348,75466,2036,84255,57345,8450,4545,70340,4470,2190,77000,7255,676427,69756,53949,55947,188888,119938,74834,386888,284360,43008287000,4436515000,2888157000,3197989000,10570815000,7451246000,5612572000,23819332000,19227330000
Arizona,Real Estate and Rental and Leasing,2014,33928,27183,2790,1429,31402,1052,529,32983,945,41840,27235,2890,1565,31690,1580,1885,35155,6685,210824,23857,16971,16770,68060,29069,28613,133969,73203,10111292000,1647695000,605216000,700584000,2974716000,1355310000,1378926000,6279416000,3789134000
Arizona,Retail Trade,2014,49890,27514,9552,5167,42233,3935,1208,47376,2514,89720,27670,9815,5850,43335,6255,4310,53900,35820,1494933,39278,52185,56720,151579,127564,106054,402326,983278,40833779000,1220690000,1463571000,1743554000,4456004000,4320955000,4788454000,13900928000,25456583000
Arizona,Total,2014,103312,61739,16301,10125,88165,9363,2671,100199,3113,134434,61828,16454,10551,88833,11658,6785,107276,27158,2241077,97007,107650,134408,339065,344887,311719,995671,1245406,96796238000,4250601000,3671269000,4669909000,12591779000,12395797000,13034351000,38021927000,58774311000
Arizona,Transportation and Warehousing,2014,13673,7380,1705,1314,10399,1254,652,12305,1368,16030,7380,1705,1345,10430,1380,885,12695,3335,341880,7661,9369,15272,35515,39630,33497,118397,221252,14579896000,365594000,384138000,563995000,1360679000,1374882000,1197078000,4271239000,10344128000
Arizona,Utilities,2014,781,400,110,50,560,42,74,676,105,1280,400,115,50,565,65,250,880,400,29596,734,631,256,2009,350,8222,12280,104,2736717000,21903000,26870000,25299000,75391000,74070000,621707000,817813000,10912000
Arizona,Wholesale Trade,2014,27138,13440,3765,2581,19786,3016,1592,24394,2744,33035,13465,3800,2770,20035,3460,2390,25885,7150,455488,18025,22089,29205,75461,81154,51928,233390,206910,27085500000,1041325000,1111563000,1637742000,3892361000,4298203000,2975107000,12181137000,14185644000
Arkansas,Accommodation and Food Services,2014,20798,6750,3940,4295,14985,4591,576,20152,646,27270,6750,3955,4355,15060,5505,2295,22860,4410,482044,9690,25847,58729,96150,162770,73944,336697,144660,6604065000,263081000,322103000,741664000,1331113000,2127391000,911872000,4450895000,1969352000
Arkansas,Administrative and Support and Waste Management and Remediation Services,2014,11429,6630,1720,925,9275,1042,325,10642,787,12920,6635,1740,955,9330,1170,495,10995,1925,277596,10057,11161,11142,33978,34949,39243,116011,149848,6452838000,337568000,340792000,339884000,1053987000,1037898000,909063000,3244089000,2808536000
Arkansas,"Agriculture, Forestry, Fishing and Hunting",2014,3111,1760,775,320,2855,165,30,3050,61,3240,1760,775,320,2855,180,30,3065,175,21331,2807,4675,3830,12086,4507,1175,20018,781,830205000,135849000,215987000,148264000,523039000,139290000,23965000,743428000,58997000
Arkansas,"Arts, Entertainment, and Recreation",2014,3954,2350,655,405,3410,382,87,3879,75,4025,2360,655,405,3420,405,115,3940,85,43986,3563,4101,5135,13631,12173,6722,36411,3020,874761000,100107000,67656000,83988000,264000000,229725000,141648000,728927000,50838000
Arkansas,Construction,2014,25415,15865,4440,2635,22940,2038,205,25183,232,25650,15865,4440,2635,22940,2085,260,25285,365,203067,25777,28372,34644,91020,66506,20932,186320,10332,8592752000,853101000,939148000,1367512000,3194835000,2990208000,1077488000,7564145000,643706000
Arkansas,Educational Services,2014,2775,1380,420,300,2100,425,150,2675,100,3235,1380,420,310,2110,475,230,2815,420,79009,1592,2373,3925,8679,15609,24030,51229,25551,1699134000,49820000,44197000,71843000,174701000,352577000,599517000,1189454000,462148000
Arkansas,Finance and Insurance,2014,12245,8293,1520,482,10295,690,392,11377,868,21730,8295,1555,695,10545,1885,2510,14940,6790,173142,13041,8750,5928,29254,21280,26603,83129,82021,9988782000,524908000,377994000,290956000,1216731000,1107255000,1299445000,4021274000,5507236000
Arkansas,Health Care and Social Assistance,2014,29775,14250,6225,3695,24170,3293,1334,28797,978,37680,14255,6255,3800,24310,4875,3565,32750,4930,850554,23407,40955,47365,113381,138287,170557,429831,410460,33787556000,1519142000,1563526000,1861038000,4981721000,4461759000,5337720000,15017264000,18555292000
Arkansas,Information,2014,2496,1030,385,275,1690,294,108,2092,404,4935,1030,385,290,1705,360,235,2300,2635,114079,976,1929,3086,6857,8592,2278,23451,59225,6358807000,60966000,58258000,109155000,267784000,461368000,146034000,1063858000,3070053000
Arkansas,Management of Companies and Enterprises,2014,1553,85,45,30,160,315,422,897,656,5595,85,45,30,160,330,465,955,4640,182452,21,182,0,47,3380,10905,14873,167532,18312850000,17027000,14750000,0,37645000,183047000,570884000,806755000,17501014000
Arkansas,Manufacturing,2014,11863,3955,2044,1450,7449,1957,811,10217,1646,13075,3955,2045,1470,7470,2125,1005,10600,2475,664689,4937,10018,15201,35059,61290,51388,176773,431265,28394520000,212924000,363043000,541654000,1268058000,2339750000,2136189000,6704351000,18615203000
Arkansas,"Mining, Quarrying, and Oil and Gas Extraction",2014,1757,765,275,200,1240,185,91,1516,241,2025,765,275,200,1240,190,105,1535,490,39746,1049,1386,2084,5548,5445,4710,17387,21824,3046688000,56314000,69221000,101628000,262932000,287004000,362554000,964819000,2021627000
Arkansas,Other,2014,123,113,10,0,123,0,0,123,0,123,113,10,0,123,0,0,123,0,0,0,61,0,0,0,0,0,0,2799000,1902000,897000,0,2799000,0,0,2799000,0
Arkansas,Other Services (except Public Administration),2014,31343,20255,6380,2403,29038,1739,225,31002,341,32960,20270,6405,2550,29225,2280,430,31935,1025,203099,37275,40292,30319,110281,57199,16942,189630,9193,4856571000,844812000,900175000,724857000,2502146000,1197665000,448221000,4328266000,421053000
Arkansas,"Professional, Scientific, and Technical Services",2014,27121,19371,3695,1765,24831,1122,376,26329,792,29085,19375,3715,1840,24930,1470,920,27320,1765,181344,25730,22443,21943,74890,34821,16571,130430,47271,10012706000,1379220000,946771000,1039865000,3417003000,1923085000,819970000,6385726000,3244959000
Arkansas,Real Estate and Rental and Leasing,2014,11486,9033,1040,417,10490,454,208,11152,334,14335,9040,1055,490,10585,945,775,12305,2030,64640,10235,6064,4047,24387,12578,2274,43573,19062,2146787000,368631000,179229000,142143000,714271000,472200000,111117000,1416346000,693088000
Arkansas,Retail Trade,2014,34710,18050,8148,3793,29991,2631,532,33154,1556,54330,18080,8220,4185,30485,4405,2600,37490,16840,569788,32384,51459,45545,134884,80275,36537,266620,277823,13925205000,766126000,1186510000,1274510000,3249509000,2731087000,1065541000,7339607000,6300338000
Arkansas,Total,2014,50151,28359,9045,5174,42578,4618,1188,48384,1767,64670,28383,9106,5457,42946,6437,3646,53029,11641,992201,48859,59228,68880,176967,169204,134999,481170,511031,38335116000,1663357000,1732282000,2134690000,5530329000,5453465000,4705239000,15689033000,22646083000
Arkansas,Transportation and Warehousing,2014,10115,5584,1565,1005,8154,808,320,9282,833,11810,5600,1565,1035,8200,860,415,9475,2335,234454,7902,8987,11190,30840,28505,20158,81639,122476,11086210000,288778000,337285000,441710000,1094871000,1085882000,967488000,3220713000,6574158000
Arkansas,Utilities,2014,698,400,85,30,515,60,48,623,75,1640,400,85,30,515,135,165,815,825,32105,935,174,359,1753,1214,6845,11744,16668,2626399000,25979000,14833000,12824000,53636000,181165000,461296000,714733000,1575345000
Arkansas,Wholesale Trade,2014,13657,5450,1871,1600,8921,1946,944,11811,1846,17195,5450,1890,1690,9030,2505,1615,13150,4045,216855,7168,10736,18311,41170,49585,28755,135461,68969,11473714000,388807000,464189000,864048000,1805431000,2474338000,1662415000,6651590000,4370258000
California,Accommodation and Food Services,2014,310965,113401,64934,63171,241506,60642,6439,308587,2378,409095,113570,65200,64645,243415,72275,24635,340325,68770,7687190,184947,424492,841457,1450178,2273249,1091212,4846470,2790533,152573545000,5147484000,6326985000,13815437000,25113492000,42574093000,21160729000,89250655000,63294619000
California,Administrative and Support and Waste Management and Remediation Services,2014,181733,110270,27757,17283,155310,17185,5299,177794,3939,214310,110350,27870,17665,155885,18945,7690,182520,31790,6503007,175801,182110,232971,589471,651941,772054,2040714,4326528,286371491000,8014758000,6408232000,8344687000,22771543000,26468943000,27580229000,76923239000,204441264000
California,"Agriculture, Forestry, Fishing and Hunting",2014,9088,5735,1425,725,7885,844,255,8984,104,9305,5735,1425,730,7890,890,360,9140,165,131225,7605,9160,9085,26879,35939,34177,97752,25802,4821510000,468555000,426600000,446266000,1351895000,1604199000,923613000,3911040000,666410000
California,"Arts, Entertainment, and Recreation",2014,106419,81055,9301,6054,96410,7345,1873,105628,791,113135,81080,9320,6125,96525,7945,2895,107365,5770,1608290,54762,59939,79885,219390,298865,286497,818045,767041,77563100000,22156512000,2839279000,3208813000,28220015000,7499109000,13086904000,49898995000,26805284000
California,Construction,2014,333469,213620,55802,32757,302179,26021,3864,332064,1405,337725,213660,55815,32800,302275,26525,5105,333905,3820,3224885,339828,368087,440590,1151260,989370,580811,2723435,492196,185704085000,14634950000,15557100000,21301475000,51493525000,56206435000,37274744000,145118940000,40011650000
California,Educational Services,2014,59889,28908,9245,7918,46071,10110,2673,58854,1035,67870,28970,9300,8090,46360,11605,4515,62480,5390,1976511,41087,61426,107537,214349,404888,419866,1044198,929733,76115627000,1862420000,1531751000,2573642000,5979385000,13282418000,16380718000,35736527000,40294093000
California,Finance and Insurance,2014,142218,102822,18077,7466,128365,7152,2873,138390,3828,250055,103010,18355,8330,129695,11135,13555,154385,95670,2898678,128390,115453,96191,376089,253297,334843,981164,1854283,308678474000,9727007000,7475053000,9202349000,26410626000,27650600000,35259393000,89901681000,214471178000
California,Health Care and Social Assistance,2014,450561,260251,97703,46607,404561,32673,9087,446321,4240,532515,260655,98310,48730,407695,46615,28620,482930,49585,9085642,457227,637145,609405,1715855,1262304,1332661,4314404,4747774,495135632000,27099922000,26605396000,25786803000,79515502000,51638362000,50970748000,182159062000,312519883000
California,Information,2014,79479,53174,8068,5750,66992,6849,2893,76734,2745,110740,53245,8110,5910,67265,7765,4555,79585,31155,3224876,55102,51838,73989,188813,254793,365128,821435,2167024,379198910000,8120317000,3960628000,6346465000,19493772000,22533404000,40216676000,83077910000,218641216000
California,Management of Companies and Enterprises,2014,16018,1491,365,601,2457,3146,4642,10245,5773,26295,1495,370,605,2470,3260,5035,10765,15530,1513710,1449,1695,4350,7854,41053,160956,209920,1303790,199912540000,401000000,100955000,332930000,834975000,3353955000,13780070000,17970345000,181942195000
California,Manufacturing,2014,181990,74749,33392,26570,134711,31719,8458,174888,7102,191465,74765,33460,26640,134865,32640,10275,177780,13685,5658809,129080,215936,354135,716235,1231108,1050042,3078240,2336570,355959996000,5952584000,8556567000,14971422000,29760087000,59048246000,57562940000,150574487000,182029209000
California,"Mining, Quarrying, and Oil and Gas Extraction",2014,3207,1470,410,389,2269,412,192,2873,334,4195,1470,410,400,2280,425,265,2970,1225,133554,2152,2556,4741,9768,13489,19254,47885,84816,12184735000,221339000,148656000,357732000,738644000,1222771000,1470141000,3924230000,8158170000
California,Other,2014,2666,2565,80,19,2664,2,0,2666,0,2666,2565,80,19,2664,2,0,2666,0,0,0,492,243,0,0,0,0,0,83160000,69438000,10218000,3179000,82835000,0,0,83160000,0
California,Other Services (except Public Administration),2014,327001,210447,60445,29857,300749,21487,3242,325478,1523,361085,210590,60855,31020,302465,26845,9190,338500,22585,2839556,382108,389443,391203,1165317,754754,373175,2305395,496099,89393055000,10876557000,10806983000,11576645000,33257855000,23546467000,13392098000,70577420000,16998045000
California,"Professional, Scientific, and Technical Services",2014,558826,408542,70164,37345,516051,29143,7369,552563,6263,601830,408690,70415,38440,517545,34425,13375,565345,36485,6109440,542970,459637,491135,1548533,1018259,770866,3352575,2660406,528063549000,39971515000,28564035000,35175070000,103710620000,88474045000,76167082000,268837280000,256893490000
California,Real Estate and Rental and Leasing,2014,202954,157574,22798,10475,190847,8147,2246,201240,1714,254690,157785,23410,12130,193325,13610,13390,220325,34365,1378172,224843,142686,133317,501580,272917,199473,983720,362448,78103510000,11482702000,6177357000,6427411000,24071130000,14599924000,11793482000,51134795000,25829493000
California,Retail Trade,2014,348561,205313,70493,37125,312931,25701,5863,344495,4066,537345,206065,72240,41425,319730,39015,21895,380640,156705,7784776,330447,428174,465524,1222654,909607,667943,2875541,4459475,227764156000,10602759000,11714678000,13767695000,36191642000,32468417000,28441724000,98230096000,127368429000
California,Total,2014,724483,448179,121713,73249,643141,62657,12760,718558,5925,889646,448817,122884,76656,648357,79109,37068,764534,125112,13838702,725788,799010,977060,2501858,2386654,1918082,6806594,7032108,797045734000,39057230000,31160402000,39832848000,110050480000,108267133000,103423948000,321741561000,475304173000
California,Transportation and Warehousing,2014,91583,52375,14668,9312,76355,8414,3021,87790,3793,110285,52435,14780,9525,76740,9800,5430,91970,18315,2227313,77393,90975,117077,290803,276702,244332,816555,1377486,109409417000,3310755000,3383078000,4678510000,11422727000,11671979000,11547222000,35295704000,71645754000
California,Utilities,2014,2616,1365,480,235,2080,205,85,2370,246,6065,1365,490,255,2110,260,275,2645,3420,23437,2615,2958,2847,8376,6305,6372,22428,13642,2016560000,119198000,143211000,181294000,465755000,493591000,606403000,1704483000,1254333000
California,Wholesale Trade,2014,259453,146110,43492,28596,218198,26747,7912,252857,6596,296895,146325,43885,29720,219930,31555,14280,265765,31130,4201677,244359,283302,370027,907189,917314,707625,2544582,1577657,350744930000,13194488000,14334366000,19811919000,47357775000,54807340000,50511581000,153496020000,194074978000
Colorado,Accommodation and Food Services,2014,49359,16045,9512,10515,36072,10884,1188,48144,1215,65470,16055,9540,10675,36270,12435,4705,53410,12060,1304260,24023,61386,138516,224455,386198,185926,795933,471974,24316815000,871773000,963137000,2228333000,4070640000,6722478000,3327616000,14136780000,10140382000
Colorado,Administrative and Support and Waste Management and Remediation Services,2014,38811,24285,5400,3175,32860,3085,1018,36963,1848,43685,24285,5400,3215,32900,3305,1295,37500,6185,975081,30834,33227,41687,111722,111701,102479,345063,624716,42344791000,1486457000,1177085000,1569883000,4274382000,4198127000,3760743000,13022396000,29240474000
Colorado,"Agriculture, Forestry, Fishing and Hunting",2014,1550,1220,170,75,1465,50,15,1530,20,1550,1220,170,75,1465,50,15,1530,20,7739,1138,1124,763,3126,2308,0,5640,0,281720000,47200000,42640000,24936000,121062000,81240000,1106000,230741000,0
Colorado,"Arts, Entertainment, and Recreation",2014,12581,8320,1485,1110,10915,1031,357,12303,278,13245,8320,1485,1120,10925,1105,445,12475,770,258788,8413,8889,14469,33145,36443,57385,126989,120620,7792733000,467794000,224033000,298291000,1018798000,752895000,1428130000,3171063000,2734306000
Colorado,Construction,2014,81241,57445,10640,6365,74450,5227,859,80536,705,81940,57445,10645,6370,74460,5285,1065,80810,1130,679445,77672,69118,84568,236800,193662,111333,548029,118611,37548435000,3562340000,2964022000,4057995000,10585130000,10575823000,6757171000,28399525000,8548164000
Colorado,Educational Services,2014,11808,6570,1645,1365,9580,1500,390,11470,338,12460,6570,1645,1380,9595,1630,480,11705,755,251764,8725,9071,17691,38167,61077,43127,147059,100142,7868856000,355459000,265989000,425451000,1061750000,1719267000,1526913000,4467721000,3142200000
Colorado,Finance and Insurance,2014,30820,22540,3122,974,26636,1285,754,28675,2145,49560,22565,3165,1085,26815,2405,2205,31425,18135,486779,28498,18461,11608,65959,39381,45188,158337,295662,40553480000,1786995000,1110263000,934667000,3909208000,3497305000,3366826000,11092904000,27486022000
Colorado,Health Care and Social Assistance,2014,63917,35485,12280,7570,55335,5483,1698,62516,1401,76775,35505,12335,7845,55685,7240,4905,67830,8945,1379752,47788,80419,101105,241059,207077,251915,714211,642129,65523648000,3010653000,3463444000,4255211000,10796039000,8654595000,9881800000,29652805000,34770435000
Colorado,Information,2014,9778,5225,1175,740,7140,815,544,8499,1279,15510,5250,1175,765,7190,865,710,8765,6745,413659,5142,6129,8092,22528,22928,37323,91445,216667,35794882000,462537000,388534000,531134000,1403894000,1651793000,3277068000,6730767000,28304536000
Colorado,Management of Companies and Enterprises,2014,3588,355,96,125,576,501,963,2040,1548,5270,355,100,125,580,520,1010,2110,3160,279390,549,428,950,1962,5779,34235,41995,237278,31812925000,54453000,35923000,79965000,172621000,506810000,3132155000,3811820000,27982506000
Colorado,Manufacturing,2014,23992,11200,3915,3094,18209,3255,1034,22498,1494,24790,11200,3920,3125,18245,3380,1180,22805,1985,527470,14625,21460,35647,80199,105349,62582,289908,197546,29413612000,701236000,852482000,1544375000,3298133000,5075436000,3442750000,14005904000,13139149000
Colorado,"Mining, Quarrying, and Oil and Gas Extraction",2014,6198,3440,755,592,4787,622,248,5657,541,6900,3450,765,600,4815,635,305,5755,1145,150376,4598,4925,7479,17495,20216,26568,67000,79934,17579057000,462036000,381942000,714625000,1598126000,1889853000,3160272000,6854437000,10408456000
Colorado,Other,2014,292,283,6,2,291,1,0,292,0,292,283,6,2,291,1,0,292,0,0,0,41,0,0,0,0,0,0,6297000,4931000,556000,0,5978000,0,0,6297000,0
Colorado,Other Services (except Public Administration),2014,62363,39818,11643,5782,57243,3702,684,61629,734,68130,39830,11710,6045,57585,4680,1440,63705,4425,505315,67140,75448,75161,220918,133024,55249,412636,79907,16389013000,2036557000,2181764000,2291103000,6531602000,3988276000,2100875000,12748977000,3269999000
Colorado,"Professional, Scientific, and Technical Services",2014,116608,89640,11420,6083,107143,4851,1992,113986,2622,124440,89660,11455,6180,107295,5450,2535,115280,9160,957438,87942,73407,78441,271498,150794,95291,526586,420709,81619229000,6995855000,4456452000,5297010000,16805450000,11172231000,9045698000,37796854000,43367981000
Colorado,Real Estate and Rental and Leasing,2014,43041,35562,3258,1493,40313,1282,505,42100,941,49845,35605,3315,1565,40485,1905,1380,43770,6075,200698,30478,19634,17082,81117,38373,13202,142346,49130,9074750000,2078784000,771174000,749125000,3637896000,1548011000,673979000,6245929000,2787462000
Colorado,Retail Trade,2014,61719,34124,12586,6870,53580,4564,1094,59238,2481,93215,34195,12880,7435,54510,6775,3905,65190,28025,1187058,52854,72493,83302,202026,144770,63016,460922,622449,36165494000,1693511000,2108611000,2341446000,6163558000,5370704000,2985346000,14912849000,19235131000
Colorado,Total,2014,130693,83722,18967,11944,114633,10154,2694,127481,3212,158064,83788,19116,12359,115263,12523,6225,134011,24053,2181455,125500,124677,159062,409239,365910,284047,1059196,1122259,112194052000,5648759000,4685459000,6120028000,16454246000,15182756000,14307210000,45944212000,66249840000
Colorado,Transportation and Warehousing,2014,15786,9605,1785,1209,12599,1169,629,14397,1389,18105,9610,1785,1215,12610,1230,905,14745,3360,311114,10476,10303,15038,37403,36724,21231,105710,167898,15281196000,538600000,418917000,565087000,1537892000,1617476000,1034375000,4488238000,9167946000
Colorado,Utilities,2014,1059,560,140,55,755,135,89,979,80,1940,560,140,55,755,235,160,1150,790,13032,858,759,43,2152,6108,4647,12956,36,3346557000,21557000,27614000,22650000,82682000,501697000,558823000,1183819000,3185000
Colorado,Wholesale Trade,2014,30128,15829,3878,2809,22516,2823,1785,27124,3004,36030,15845,3920,2910,22675,3480,2480,28635,7395,461684,16953,24053,34357,82850,74946,58062,233314,200823,33688163000,1375575000,1292946000,2005432000,4735033000,4581305000,3788612000,13801242000,18670544000
Connecticut,Accommodation and Food Services,2014,35311,14225,7085,6337,27647,6512,510,34669,642,42270,14230,7100,6415,27745,7290,1850,36885,5385,649760,25536,47211,85667,159090,226815,64108,454771,187681,13238461000,645387000,716580000,1434418000,2803505000,4231240000,1165561000,8249250000,4979662000
Connecticut,Administrative and Support and Waste Management and Remediation Services,2014,23645,15470,2880,1880,20230,1754,576,22560,1085,26750,15475,2895,1900,20270,1860,675,22805,3945,415742,17785,17668,23381,61655,60962,63984,194239,215744,15933768000,1358126000,827933000,1081294000,3375860000,2836529000,1667920000,8188720000,7244610000
Connecticut,"Agriculture, Forestry, Fishing and Hunting",2014,360,270,65,15,350,10,0,360,0,360,270,65,15,350,10,0,360,0,1323,264,69,36,973,0,0,1323,0,47920000,14746000,10546000,841000,31065000,0,0,47920000,0
Connecticut,"Arts, Entertainment, and Recreation",2014,7587,4100,1070,845,6015,1205,201,7421,166,8325,4100,1080,855,6035,1300,450,7785,540,137201,4134,6050,10016,23784,47686,31614,110382,23051,3505816000,392494000,224414000,278629000,1003845000,1302436000,484806000,2964291000,429929000
Connecticut,Construction,2014,39056,27855,5545,2905,36305,2170,307,38782,274,39225,27860,5545,2910,36315,2190,330,38835,390,249093,41248,35667,37484,117423,74300,26105,225185,11423,16716155000,2315265000,2036241000,2465335000,6862930000,5292078000,2011315000,14719145000,1087694000
Connecticut,Educational Services,2014,6651,3195,1075,898,5168,875,385,6428,223,7025,3195,1080,905,5180,910,485,6575,450,370484,4228,7023,11719,23553,36338,53959,118841,249576,16253576000,197485000,151768000,251339000,603327000,1329342000,2758217000,4876883000,11337646000
Connecticut,Finance and Insurance,2014,17737,10443,2508,1225,14176,1251,699,16126,1611,30335,10455,2540,1310,14305,2135,2500,18940,11395,536050,17306,15032,14574,47276,40037,55739,151979,375729,77298883000,1473984000,1665652000,2362239000,5566304000,7542494000,9595549000,23422950000,52538378000
Connecticut,Health Care and Social Assistance,2014,38307,15545,8485,5766,29796,4818,2375,36989,1318,52520,15585,8625,6270,30480,6935,6840,44255,8265,1374152,30421,55448,75855,162290,178876,331578,687593,670607,64306330000,1518628000,2501451000,3654285000,7701676000,8159263000,12046061000,28345012000,35367955000
Connecticut,Information,2014,5383,2440,660,570,3670,650,281,4601,782,8605,2440,660,570,3670,710,385,4765,3840,186045,2560,3603,6879,15010,17997,19124,62813,120698,15420729000,268969000,236058000,385994000,935430000,1212812000,1241639000,4157145000,10629773000
Connecticut,Management of Companies and Enterprises,2014,2470,175,60,115,350,285,621,1256,1214,3545,175,60,115,350,295,690,1335,2210,173410,278,339,707,1324,3355,19281,24020,149390,23499371000,34167000,57621000,95081000,187326000,261505000,1481880000,1930711000,21568660000
Connecticut,Manufacturing,2014,20357,7285,3770,2845,13900,3999,1245,19144,1213,20990,7285,3770,2850,13905,4110,1370,19385,1605,579910,10077,20276,32686,70143,141179,109257,361209,180172,38683586000,568694000,990161000,1725115000,3529947000,8050952000,6588630000,20621663000,13965732000
Connecticut,"Mining, Quarrying, and Oil and Gas Extraction",2014,253,130,35,30,195,15,5,215,38,370,130,35,30,195,15,15,225,145,3842,64,206,325,754,0,0,1148,1833,434125000,12850000,11348000,28835000,58112000,0,0,102406000,295572000
Connecticut,Other,2014,158,155,3,0,158,0,0,158,0,158,155,3,0,158,0,0,158,0,0,0,22,0,0,0,0,0,0,5111000,4601000,510000,0,5111000,0,0,5111000,0
Connecticut,Other Services (except Public Administration),2014,43687,26450,9740,4382,40572,2357,290,43219,468,46505,26490,9800,4525,40815,2740,615,44170,2335,294883,49833,62360,56026,170984,74834,10300,263351,19844,9348718000,1436559000,1780762000,1698899000,4954954000,2352424000,543749000,8155746000,719273000
Connecticut,"Professional, Scientific, and Technical Services",2014,42949,28242,6418,3345,38005,2586,790,41381,1568,46145,28245,6445,3390,38080,2890,1070,42040,4105,507462,40927,41198,42623,129621,81857,49823,269578,223536,43727985000,2739991000,2607655000,3147839000,8539665000,7272058000,4166941000,20588971000,21834496000
Connecticut,Real Estate and Rental and Leasing,2014,12160,8695,1535,688,10918,551,233,11702,458,15890,8725,1565,795,11085,695,1110,12890,3000,88405,12374,9357,7738,31528,15872,10196,60839,12994,4671277000,655675000,481971000,431018000,1598834000,915236000,485567000,3184370000,1353134000
Connecticut,Retail Trade,2014,43217,24129,8414,4251,36794,3417,873,41084,2133,62710,24185,8585,4530,37300,4255,2495,44050,18660,905451,38735,50536,47596,139183,104352,56935,317088,383040,26507124000,1275529000,1512702000,1700836000,4472165000,4757799000,2338425000,12410729000,9821550000
Connecticut,Total,2014,71560,40199,12625,7748,60572,6981,1833,69386,2174,88555,40251,12740,8066,61057,8384,4574,74015,14540,1485426,69709,82918,102891,255518,252932,224300,732750,752676,87866508000,3318760000,3554049000,4771433000,11644242000,13045044000,11964554000,36653840000,51212668000
Connecticut,Transportation and Warehousing,2014,6666,3050,985,710,4745,832,347,5924,742,8100,3050,985,720,4755,900,510,6165,1935,197111,2778,4544,8142,18398,23543,19929,70186,78130,8826747000,248681000,284128000,447763000,1047003000,1309382000,736749000,3577731000,3318813000
Connecticut,Utilities,2014,327,55,30,50,135,48,45,228,99,695,60,30,55,145,55,80,280,415,2724,36,0,636,893,211,15,4634,293,217699000,6693000,10366000,36880000,61996000,5494000,1954000,462421000,35762000
Connecticut,Wholesale Trade,2014,18831,8515,2815,2114,13444,2416,1124,16984,1847,21620,8525,2820,2170,13515,2625,1400,17540,4080,347193,12402,16166,25035,56812,71347,50299,200630,124348,26721439000,1083249000,1127803000,1797169000,4211108000,5331489000,3498201000,14471342000,10822794000
Delaware,Accommodation and Food Services,2014,8276,3130,1370,1500,6000,1684,202,7886,390,10000,3155,1370,1510,6035,1780,625,8440,1560,179561,4633,9150,18791,34339,61426,23650,121276,58150,3076350000,196160000,141163000,308852000,651132000,1044987000,368477000,2102415000,975178000
Delaware,Administrative and Support and Waste Management and Remediation Services,2014,6339,3415,975,565,4955,555,200,5710,629,7005,3425,975,565,4965,570,210,5745,1260,129516,4686,5233,6944,17900,15379,17629,53995,65208,4412108000,236923000,240328000,284917000,796865000,573495000,505270000,2020693000,1989935000
Delaware,"Agriculture, Forestry, Fishing and Hunting",2014,180,120,55,5,180,0,0,180,0,180,120,55,5,180,0,0,180,0,470,98,285,0,470,0,0,470,0,21806000,2610000,14108000,0,21806000,0,0,21806000,0
Delaware,"Arts, Entertainment, and Recreation",2014,2017,1190,225,220,1635,245,65,1945,72,2145,1190,225,220,1635,260,85,1980,165,35767,999,51,2081,4077,7387,5182,22148,9873,1132099000,76345000,18892000,52531000,179955000,181371000,199950000,862492000,215365000
Delaware,Construction,2014,10811,7000,1620,1050,9670,835,175,10680,131,10860,7000,1620,1050,9670,845,180,10695,165,91257,7667,10160,12988,35859,30023,16064,84666,2617,4990060000,439516000,435606000,650272000,1554798000,1762030000,1085884000,4590682000,188156000
Delaware,Educational Services,2014,1425,615,235,185,1035,225,85,1345,80,1480,615,235,185,1035,235,90,1360,120,32196,675,1307,2135,4070,8948,9355,24434,2816,1250995000,29211000,31361000,41977000,110537000,278037000,334779000,759609000,190286000
Delaware,Finance and Insurance,2014,6098,3430,588,255,4273,356,317,4946,1152,10040,3465,640,260,4365,590,525,5480,4560,181957,2739,2910,2131,10201,8367,4768,26121,147143,16329640000,288527000,186435000,160059000,677989000,590626000,358362000,1779688000,13924333000
Delaware,Health Care and Social Assistance,2014,9548,3330,2135,1784,7249,1270,411,8930,618,12720,3330,2150,1840,7320,1730,1270,10320,2400,314160,4868,13433,23182,42846,40207,40590,133639,171253,16260574000,291983000,641909000,1112190000,2056499000,1991585000,1569620000,5989328000,10093114000
Delaware,Information,2014,1605,805,170,123,1098,175,50,1323,282,2495,805,170,130,1105,185,85,1375,1120,37175,565,797,536,2236,3775,1150,11152,18893,2303915000,95894000,57896000,36774000,244347000,242506000,80141000,769150000,960388000
Delaware,Management of Companies and Enterprises,2014,3371,1271,60,61,1392,260,438,2090,1281,4315,1310,65,65,1440,300,505,2245,2070,77238,0,0,0,17,1912,4238,8367,67272,7383906000,56135000,0,0,93367000,164049000,233487000,503119000,6797453000
Delaware,Manufacturing,2014,2840,1125,425,370,1920,409,193,2522,318,2960,1125,425,380,1930,420,215,2565,395,96737,699,1603,2742,6486,7826,7497,29967,57136,5162742000,69691000,65928000,146545000,367208000,404374000,411654000,1588400000,2906148000
Delaware,"Mining, Quarrying, and Oil and Gas Extraction",2014,72,35,10,5,50,5,5,60,12,95,35,10,5,50,5,5,60,35,193,32,0,0,32,0,0,168,0,23067000,10982000,0,0,13709000,0,0,21673000,0
Delaware,Other,2014,38,37,0,1,38,0,0,38,0,38,37,0,1,38,0,0,38,0,0,0,0,0,0,0,0,0,0,1583000,0,0,0,1583000,0,0,1583000,0
Delaware,Other Services (except Public Administration),2014,10316,6240,1965,1067,9272,725,109,10106,210,10830,6240,1975,1130,9345,820,180,10345,485,69422,11319,12208,13504,38324,20771,1222,65052,2851,2045320000,359729000,324086000,354215000,1069142000,578097000,45209000,1895741000,95324000
Delaware,"Professional, Scientific, and Technical Services",2014,12803,8315,1450,1024,10789,901,370,12060,743,13630,8315,1460,1070,10845,1075,450,12370,1260,160241,8737,8482,11556,29591,26128,16062,80653,52368,15591679000,852463000,604991000,891820000,2418761000,2092017000,2035588000,6881108000,8071372000
Delaware,Real Estate and Rental and Leasing,2014,4689,3190,400,250,3840,281,153,4274,415,5590,3195,405,265,3865,385,355,4605,985,30214,3462,2191,2034,9883,6825,5776,24285,2413,1387800000,188012000,102670000,130590000,445206000,339111000,206598000,1086267000,217373000
Delaware,Retail Trade,2014,12441,6440,2224,974,9638,911,363,10912,1529,18135,6465,2275,1080,9820,1245,755,11820,6315,255893,7601,11129,9453,31348,24557,15724,83895,145618,6688069000,315959000,334200000,290174000,1030032000,990709000,803158000,3043437000,3079005000
Delaware,Total,2014,19582,10778,2926,2000,15704,1890,634,18228,1354,24312,10813,2971,2083,15867,2287,1210,19364,4948,391636,17516,19322,26608,63446,64173,49218,176837,214799,20918838000,823644000,734593000,1071264000,2629501000,2727562000,2441900000,7798963000,13119875000
Delaware,Transportation and Warehousing,2014,2991,1590,343,259,2192,343,110,2645,346,3200,1590,345,260,2195,365,120,2680,520,63084,790,1490,2372,5183,7918,2987,21919,29662,2599996000,83847000,47823000,77842000,232900000,300630000,147688000,894267000,1331639000
Delaware,Utilities,2014,157,50,25,0,75,5,22,102,55,275,50,35,0,85,5,30,120,155,6123,0,0,0,0,0,0,0,0,673803000,6437000,13894000,0,33210000,0,0,12879000,0
Delaware,Wholesale Trade,2014,4830,2445,415,380,3240,549,305,4094,736,5415,2450,420,390,3260,620,365,4245,1170,47921,2179,1802,2979,8322,8971,5224,29897,16242,3686891000,240406000,123309000,189446000,633186000,539775000,379642000,1804373000,1769944000
District of Columbia,Accommodation and Food Services,2014,9510,3085,1665,1380,6130,2493,416,9039,471,12530,3090,1665,1410,6165,2590,750,9505,3025,324181,5400,10240,17840,33994,94877,40706,170953,118362,8777863000,206469000,204916000,362873000,782644000,2182033000,938857000,3917588000,3839700000
District of Columbia,Administrative and Support and Waste Management and Remediation Services,2014,3839,1485,380,335,2200,595,421,3216,623,5515,1505,385,345,2235,625,550,3410,2105,148766,1329,1991,3351,8186,20365,33503,71103,64859,6659046000,174479000,159989000,232775000,619990000,879942000,1351351000,3130981000,3175978000
District of Columbia,"Agriculture, Forestry, Fishing and Hunting",2014,5,5,0,0,5,0,0,5,0,5,5,0,0,5,0,0,5,0,0,0,0,0,0,0,0,0,0,0,0,0,0,0,0,0,0,0
District of Columbia,"Arts, Entertainment, and Recreation",2014,1447,785,190,140,1115,158,90,1363,84,1600,785,190,140,1115,165,130,1410,190,33634,693,857,1526,4144,5251,8088,19149,2395,2301368000,59544000,50329000,66693000,206355000,156517000,442900000,1042638000,117829000
District of Columbia,Construction,2014,2233,1065,310,295,1670,370,119,2159,74,2245,1065,310,295,1670,370,125,2165,80,43318,867,1787,3380,6883,12284,13510,35983,0,2826418000,93864000,100844000,200640000,411958000,724934000,916666000,2262558000,0
District of Columbia,Educational Services,2014,2527,880,355,245,1480,530,328,2338,189,2725,880,355,250,1485,535,410,2430,295,245726,1010,2222,2845,6617,20991,40144,71113,172585,12471713000,100050000,121131000,127004000,368653000,1084691000,1978418000,3524588000,8926437000
District of Columbia,Finance and Insurance,2014,2828,855,325,203,1383,330,229,1942,886,5055,860,325,215,1400,415,440,2255,2800,60584,480,1775,2202,5081,5676,238,15951,41381,10973210000,116862000,175010000,365304000,712274000,830679000,173578000,2081596000,8832888000
District of Columbia,Health Care and Social Assistance,2014,8892,4160,1625,1020,6805,1069,603,8477,415,10420,4160,1625,1165,6950,1295,1130,9375,1045,325268,6733,10113,12322,30146,34822,76282,145649,158269,18935547000,488715000,602011000,644045000,1772556000,1584727000,2794245000,6327137000,11739656000
District of Columbia,Information,2014,2546,895,245,215,1355,335,204,1894,652,3575,895,245,215,1355,335,215,1905,1670,101037,584,679,1814,3338,8686,10141,28315,61187,11310056000,129343000,102843000,154829000,449331000,827904000,894494000,2581659000,7590036000
District of Columbia,Management of Companies and Enterprises,2014,795,40,20,15,75,45,135,255,540,955,40,20,15,75,45,135,255,700,58800,0,100,0,244,344,4290,4980,53820,5586175000,0,9115000,0,28759000,41257000,228634000,300380000,5285795000
District of Columbia,Manufacturing,2014,480,255,95,60,410,35,5,450,30,490,255,95,60,410,35,5,450,40,2779,188,386,198,994,216,0,1289,0,155535000,15210000,16610000,10477000,54977000,9870000,0,90310000,0
District of Columbia,"Mining, Quarrying, and Oil and Gas Extraction",2014,30,10,0,0,10,5,0,15,15,30,10,0,0,10,5,0,15,15,0,0,0,0,0,0,0,0,0,0,0,0,0,0,0,0,0,0
District of Columbia,Other,2014,82,82,0,0,82,0,0,82,0,82,82,0,0,82,0,0,82,0,0,0,0,0,0,0,0,0,0,1615000,1615000,0,0,1615000,0,0,1615000,0
District of Columbia,Other Services (except Public Administration),2014,18421,7918,3565,2465,13948,2938,1168,18054,367,20760,7920,3575,2505,14000,3075,1490,18565,2195,369735,10675,22815,30275,69196,100413,120674,293803,60125,28524609000,963066000,1437146000,2203418000,4629439000,7967994000,10414878000,23102865000,4735904000
District of Columbia,"Professional, Scientific, and Technical Services",2014,22188,11635,2752,2153,16540,2370,1291,20201,1987,26940,11635,2755,2165,16555,2390,1365,20310,6630,499274,14687,16772,25471,59841,69331,75831,218184,278560,59980622000,2474738000,1895580000,2985491000,7404450000,8271393000,8549164000,24820266000,34996164000
District of Columbia,Real Estate and Rental and Leasing,2014,3916,2190,480,298,2968,397,232,3597,319,5790,2205,500,300,3005,510,540,4055,1735,51322,1465,3126,2795,8998,10367,10518,30027,15267,3575304000,219940000,167810000,236806000,629308000,722882000,721824000,2107962000,1223496000
District of Columbia,Retail Trade,2014,7049,3810,1135,583,5528,427,220,6175,874,8700,3820,1145,610,5575,535,300,6410,2290,95039,4087,5473,4888,17745,7757,1034,33974,53114,3052324000,210416000,161871000,171492000,600994000,266284000,28070000,1095142000,1774822000
District of Columbia,Total,2014,17468,8099,2680,1901,12680,2412,1041,16133,1335,22210,8111,2692,1971,12774,2625,1553,16952,5258,495453,14091,17639,24513,56243,84091,100107,240441,255012,36953396000,1106489000,1095896000,1652932000,3855317000,5368827000,6734876000,15959020000,20994376000
District of Columbia,Transportation and Warehousing,2014,730,300,80,35,415,45,70,530,200,800,300,80,35,415,45,70,530,270,8068,288,147,180,1009,292,494,3495,3798,546662000,31973000,10667000,5884000,61830000,11853000,79906000,217837000,276198000
District of Columbia,Utilities,2014,161,20,0,5,25,0,0,25,136,245,20,0,5,25,0,0,25,220,0,6,0,0,0,0,0,0,0,2807000,472000,0,0,1094000,0,0,1094000,2704000
District of Columbia,Wholesale Trade,2014,1635,695,185,115,995,137,105,1237,398,2260,695,190,125,1010,155,110,1275,985,11380,628,413,737,2571,1392,27,6092,3419,1167514000,58188000,32777000,40914000,159859000,76666000,8510000,420130000,535859000
Florida,Accommodation and Food Services,2014,143511,58385,26400,25146,109931,28079,3391,141401,2110,191400,58420,26435,25360,110215,30705,10325,151245,40155,4308277,94881,172299,341609,604148,1061872,558111,2234983,2066929,81060158000,2649955000,2579722000,5175720000,10409065000,17808473000,10117201000,38355254000,42704139000
Florida,Administrative and Support and Waste Management and Remediation Services,2014,151095,107045,18085,10255,135385,9207,2928,147520,3575,171405,107135,18140,10375,135650,10095,4235,149980,21425,7023198,141110,116439,133612,413654,356222,396131,1193930,5740606,280396452000,5349746000,3579466000,4360362000,13331976000,11470964000,13088452000,38306143000,238902225000
Florida,"Agriculture, Forestry, Fishing and Hunting",2014,4882,3310,760,435,4505,260,81,4846,36,4985,3310,760,435,4505,300,120,4925,60,45068,4120,4685,5514,15462,8009,9517,34693,9809,1399992000,173953000,164727000,198131000,555012000,295009000,193738000,1080477000,268153000
Florida,"Arts, Entertainment, and Recreation",2014,36921,24130,4060,2910,31100,3947,1242,36289,632,39650,24140,4075,2935,31150,4130,1745,37025,2625,912994,26213,25627,38083,90364,167270,199618,476273,424320,26722545000,1520622000,639022000,858926000,3041345000,3815966000,7077695000,14489637000,11355613000
Florida,Construction,2014,230336,163360,31105,18784,213249,14115,2003,229367,969,232925,163360,31120,18825,213305,14390,2810,230505,2420,1684545,239722,203720,250478,696583,521680,268481,1493660,177122,73407165000,7771740000,6927500000,9781678000,24503510000,23076285000,13476530000,61297315000,11332773000
Florida,Educational Services,2014,29793,16985,3865,3215,24065,4042,1050,29157,636,33020,16990,3875,3275,24140,4885,1505,30530,2490,789350,18541,25404,42858,93724,165433,143824,411770,372515,29069765000,821380000,586920000,985607000,2398445000,4959665000,5004157000,12700170000,16133418000
Florida,Finance and Insurance,2014,89094,64421,11407,4511,80339,3606,2029,85974,3120,156115,64495,11630,4990,81115,6460,7320,94895,61220,1702500,79462,73396,55816,220056,125124,181161,535014,1064515,125495267000,5100143000,3669654000,3497129000,12422190000,9293329000,12942126000,34805828000,89359037000
Florida,Health Care and Social Assistance,2014,235616,132875,51144,26723,210742,16687,5044,232473,3143,288310,133035,51550,27660,212245,23060,15355,250660,37650,5126563,213501,335471,350951,909178,617295,735329,2283436,2813925,240408260000,12365297000,14319910000,15362871000,42297747000,28499606000,28554109000,99737374000,138928024000
Florida,Information,2014,24578,16397,2600,1595,20592,1653,752,22997,1581,40315,16425,2615,1605,20645,1835,1175,23655,16660,840720,19427,16188,20280,60554,57999,53430,180182,648637,60292955000,1286073000,809490000,1024164000,3195744000,3162473000,3785651000,10625468000,48289149000
Florida,Management of Companies and Enterprises,2014,8197,1235,301,270,1806,1357,1893,5056,3141,14060,1235,305,275,1815,1390,1980,5185,8875,693900,25,1615,1965,5009,18134,66978,90121,603715,59859860000,338970000,189409000,160985000,689364000,1265225000,5530350000,7498245000,52361615000
Florida,Manufacturing,2014,61445,31970,9770,7192,48932,7381,2454,58767,2678,64560,31975,9775,7210,48960,7600,2895,59455,5105,1353770,47225,58280,88136,207970,264606,221385,757770,527694,69881594000,1952056000,2074134000,3462850000,7833953000,11366596000,10829173000,32280043000,34116172000
Florida,"Mining, Quarrying, and Oil and Gas Extraction",2014,1151,660,115,85,860,140,30,1030,121,1340,660,115,85,860,190,30,1080,260,18100,650,604,808,2327,4208,227,7878,9951,1200150000,48555000,19484000,59211000,136968000,234422000,19437000,459785000,725287000
Florida,Other,2014,652,629,15,4,648,4,0,652,0,652,629,15,4,648,4,0,652,0,0,0,91,45,0,0,0,0,0,18401000,14790000,1539000,508000,16837000,0,0,18401000,0
Florida,Other Services (except Public Administration),2014,210880,148190,32866,16232,197288,10858,1593,209739,1141,228615,148235,32990,16645,197870,13045,4720,215635,12980,1533908,239089,211716,216273,677681,386344,167277,1243037,282568,41687687000,6308975000,5320859000,5648010000,17296452000,10189073000,4695775000,32485947000,8966340000
Florida,"Professional, Scientific, and Technical Services",2014,348416,274311,36297,17954,328562,12743,3528,344833,3583,371020,274365,36420,18425,329210,15540,6180,350930,20090,2346801,334794,234246,233891,846218,425418,290430,1574698,730221,148962090000,20554775000,12176090000,13571036000,46318875000,27714613000,19948147000,94220035000,53320161000
Florida,Real Estate and Rental and Leasing,2014,134986,113008,11316,4499,128823,3310,1449,133582,1404,162140,113150,11570,4915,129635,4545,6310,140490,21650,760823,121507,70832,56759,268213,106016,99557,481978,230393,31831439000,5630480000,2640146000,2396252000,10662612000,4363230000,4728825000,19917835000,11784423000
Florida,Retail Trade,2014,234734,159105,38298,18823,216226,11963,2990,231179,3555,366000,159495,39050,20620,219165,19055,8590,246810,119190,4697629,232065,234447,235198,698868,397970,288944,1396485,2280097,128920525000,7039740000,6245834000,6678337000,19898711000,14677415000,13797575000,48863242000,55576231000
Florida,Total,2014,424551,290520,60777,34512,385809,27776,6389,419974,4577,519875,290793,61274,35806,387873,34605,16769,439247,80628,7441584,450324,396730,458759,1305813,1037266,839483,3182562,4259022,312959623000,17661580000,13920961000,16511634000,48094175000,39097439000,35553671000,122745285000,190214338000
Florida,Transportation and Warehousing,2014,61066,43207,6443,3849,53499,3668,1319,58486,2580,69350,43220,6475,3950,53645,4030,1755,59430,9920,1048810,46704,40581,48834,151665,115292,75103,356705,540646,48015112000,2112331000,1454204000,1848609000,5453208000,4756568000,3519125000,14090200000,25916214000
Florida,Utilities,2014,1486,765,285,77,1127,121,127,1375,111,3690,765,295,90,1150,195,380,1725,1965,131422,1286,1807,920,4105,4964,18987,32721,96571,12467527000,42769000,92095000,43300000,194843000,330262000,1421286000,2233207000,10121402000
Florida,Wholesale Trade,2014,137588,90313,19021,10761,120095,9697,3591,133383,4205,157215,90410,19100,11335,120845,11555,6415,138815,18400,1552780,118684,121062,134791,399751,305893,208960,942796,563184,85707059000,6505314000,5761591000,6739464000,19072948000,15978545000,12051114000,47936336000,35507175000
Georgia,Accommodation and Food Services,2014,70093,25245,12696,13281,51222,15751,1694,68667,1426,97045,25300,12730,13430,51460,17855,6820,76135,20910,1951605,42066,85717,181288,309915,572769,273231,1158255,793033,30399590000,1104200000,1157813000,2536335000,4799485000,8435635000,3975130000,17312685000,13080323000
Georgia,Administrative and Support and Waste Management and Remediation Services,2014,50402,30935,6570,4270,41775,4345,1766,47886,2516,60085,30945,6600,4290,41835,4545,2355,48735,11350,1699403,43570,42209,56081,144141,163858,207816,526477,1164111,58922607000,2191682000,1422628000,2033698000,5678164000,6097426000,6587157000,18686023000,39789809000
Georgia,"Agriculture, Forestry, Fishing and Hunting",2014,4565,2365,1040,625,4030,416,60,4506,59,4665,2365,1040,625,4030,425,105,4560,105,37144,3125,6258,7726,17817,12123,143,35087,1656,1481718000,149710000,241033000,298197000,700939000,497862000,53128000,1330443000,106092000
Georgia,"Arts, Entertainment, and Recreation",2014,13489,8555,1705,1290,11550,1346,314,13210,279,14640,8555,1705,1315,11575,1430,495,13500,1140,217452,9436,9779,16666,37941,51648,40491,135492,68600,7554097000,517775000,280471000,370085000,1186128000,901037000,1116456000,3356949000,3719213000
Georgia,Construction,2014,80843,53410,12060,7443,72913,6140,1014,80067,776,81835,53410,12060,7455,72925,6230,1235,80390,1445,774660,79575,79692,99961,262345,226469,118638,613743,140402,38660930000,3218280000,3071665000,4342001000,10634720000,11429743000,6401798000,28779239000,8645203000
Georgia,Educational Services,2014,13295,7200,1945,1270,10415,1895,591,12901,394,14750,7205,1945,1270,10420,2310,675,13405,1345,409662,9161,12693,17112,40759,74084,86364,205622,202864,16062525000,347449000,256359000,368353000,984590000,2114111000,3182306000,6368460000,9645656000
Georgia,Finance and Insurance,2014,39483,26188,5435,1921,33544,2184,1189,36917,2566,73730,26220,5555,2380,34155,5060,4445,43660,30070,791916,37856,32885,22898,93286,73822,85769,266898,406359,64007221000,1963641000,1664565000,1600402000,5285315000,4970892000,5974858000,16598041000,45282894000
Georgia,Health Care and Social Assistance,2014,92230,45269,20957,12203,78429,9627,2017,90073,2157,118300,45300,21080,12700,79080,12710,6640,98430,19870,2278293,74097,139336,162444,380383,356763,279219,1025860,1188504,104774795000,4270151000,5785399000,6859247000,16971883000,14690620000,10247718000,42065728000,61915886000
Georgia,Information,2014,11420,5995,1340,795,8130,1267,561,9958,1462,20265,6000,1340,795,8135,1455,835,10425,9840,523183,6336,8685,8293,27497,41533,42979,117954,404465,45292757000,497099000,449351000,584720000,1570830000,2917365000,3364957000,8081818000,37084002000
Georgia,Management of Companies and Enterprises,2014,5199,385,140,125,650,740,1246,2636,2563,8695,385,140,125,650,745,1275,2670,6025,598850,356,0,814,2020,9640,35925,47585,551241,62266365000,45774000,58074000,56503000,163665000,609480000,2934815000,3707960000,58550187000
Georgia,Manufacturing,2014,33542,12430,5095,4382,21907,5378,2535,29820,3722,36755,12435,5110,4410,21955,5710,2905,30570,6185,1661772,18639,29830,53444,111371,191974,211001,570975,994886,79897365000,886896000,1099424000,2091663000,4312660000,8413914000,9666917000,24950530000,50597937000
Georgia,"Mining, Quarrying, and Oil and Gas Extraction",2014,609,205,125,70,400,85,39,524,85,955,205,125,70,400,90,85,575,380,19005,157,385,657,1836,1816,234,9173,9545,1192826000,14577000,27708000,23933000,84542000,105674000,11688000,592581000,589938000
Georgia,Other,2014,379,367,10,2,379,0,0,379,0,379,367,10,2,379,0,0,379,0,410,315,66,0,410,0,0,410,0,9438000,7805000,956000,0,9438000,0,0,9438000,0
Georgia,Other Services (except Public Administration),2014,96747,62210,18410,8277,88897,5933,1054,95884,863,103995,62245,18530,8540,89315,7195,2185,98695,5300,766461,109319,118670,108554,339792,212867,89970,648823,101645,21328202000,2824695000,2936159000,2888723000,8658454000,5524664000,2888744000,17226597000,3680375000
Georgia,"Professional, Scientific, and Technical Services",2014,133723,100431,14020,7666,122117,6409,2243,130769,2954,143235,100460,14070,7805,122335,7150,2965,132450,10785,1234759,106250,89890,101367,325596,203988,158446,701311,504005,87214426000,7602425000,4889823000,6043258000,18560048000,14025149000,11454438000,44523768000,41625575000
Georgia,Real Estate and Rental and Leasing,2014,41371,32487,3649,1628,37764,1597,882,40243,1128,54265,32540,3715,1755,38010,2275,3515,43800,10465,270229,26866,22761,19309,80070,44846,51581,187918,71211,13500171000,1766245000,864931000,927241000,3577664000,2258583000,2813081000,8887091000,4956314000
Georgia,Retail Trade,2014,105536,67581,18628,8575,94784,6217,1543,102544,2992,168330,67725,18995,9325,96045,9300,4720,110065,58265,2103707,111908,118292,105763,336020,215489,112028,694297,1293760,53219848000,2959513000,2856582000,2993342000,8856381000,7771048000,4477826000,21436349000,30021607000
Georgia,Total,2014,171601,105209,26889,16232,148330,15136,4040,167506,4095,220605,105330,27130,16848,149308,18787,9578,177673,42932,3551163,168697,176498,216138,561333,551085,439119,1551537,1999626,163852238000,6762329000,6120241000,7857357000,20739927000,21119535000,19224584000,61084046000,102768192000
Georgia,Transportation and Warehousing,2014,25886,14955,2895,1910,19760,2252,1337,23349,2537,31310,14970,2910,1950,19830,2500,1690,24020,7290,780922,16140,17905,23917,64064,64062,61913,198900,552512,36677802000,750319000,674873000,885734000,2345928000,2529028000,2695910000,7885519000,27815621000
Georgia,Utilities,2014,679,195,75,40,310,140,127,577,102,2985,195,75,40,310,215,435,960,2025,98131,320,289,216,1266,6717,22422,32138,283,8586444000,13558000,10871000,17824000,69758000,426474000,1690702000,2296619000,15547000
Georgia,Wholesale Trade,2014,55154,28300,7824,5751,41875,5933,3159,50967,4187,65290,28355,7875,5950,42180,6735,4510,53425,11865,977366,42884,49673,69024,167767,170987,154663,508205,436947,61642419000,2445101000,2546569000,3777873000,8824707000,9701067000,9219367000,28524852000,32019349000
Hawaii,Accommodation and Food Services,2014,14142,4765,2888,2575,10228,3100,388,13716,426,17895,4765,2900,2580,10245,3540,1075,14860,3035,518768,7912,18629,33387,60606,124517,68549,256209,257906,14415446000,258574000,295366000,522836000,1077105000,2464786000,1669130000,5249891000,9160709000
Hawaii,Administrative and Support and Waste Management and Remediation Services,2014,7835,3955,1360,735,6050,906,335,7291,544,9115,3960,1370,740,6070,1010,600,7680,1435,193927,5505,7874,8995,24237,32709,39429,104815,99709,5897482000,199102000,232031000,267932000,731876000,1104112000,932384000,3021014000,3120532000
Hawaii,"Agriculture, Forestry, Fishing and Hunting",2014,145,115,10,5,130,15,0,145,0,145,115,10,5,130,15,0,145,0,161,0,0,0,133,88,0,161,0,5438000,3672000,0,0,4736000,2923000,0,5438000,0
Hawaii,"Arts, Entertainment, and Recreation",2014,2486,1160,355,265,1780,457,160,2397,89,2670,1160,355,270,1785,500,235,2520,150,55479,1231,1808,2712,6611,14846,17279,44776,3124,1324818000,54804000,40224000,65660000,179686000,325117000,449944000,1092148000,123378000
Hawaii,Construction,2014,13505,7745,2410,1735,11890,1211,212,13313,192,13675,7745,2410,1740,11895,1260,265,13420,255,137106,10765,15266,22614,50329,40757,19329,117574,15838,8782024000,572916000,724745000,1196691000,2551503000,2628126000,1570011000,7150620000,1293125000
Hawaii,Educational Services,2014,2373,1020,375,365,1760,405,100,2265,108,2570,1020,375,370,1765,485,160,2410,160,93383,1066,2218,4590,8976,15130,14812,41019,49364,3021967000,36881000,39884000,96792000,199211000,425133000,527025000,1279748000,1713523000
Hawaii,Finance and Insurance,2014,3993,2186,425,220,2831,272,191,3294,699,7230,2190,430,260,2880,570,700,4150,3080,91222,1723,2476,2309,8493,9098,12903,34240,54046,5767472000,194180000,135377000,145556000,503909000,459365000,859408000,1984922000,3680094000
Hawaii,Health Care and Social Assistance,2014,14771,7835,3687,1414,12936,1012,480,14428,343,18145,7835,3735,1505,13075,1625,1570,16270,1875,323249,13805,23606,16590,55900,38461,61204,163710,144681,16165574000,878695000,1099245000,790793000,2815722000,1573970000,2232111000,6854736000,9126807000
Hawaii,Information,2014,1559,735,190,155,1080,110,50,1240,319,2505,735,190,160,1085,200,55,1340,1165,40338,645,927,1258,3826,2232,275,8392,27230,2564725000,51438000,45299000,62521000,192174000,142011000,17108000,431509000,2017327000
Hawaii,Management of Companies and Enterprises,2014,979,30,35,50,115,210,251,576,403,1290,30,35,50,115,220,280,615,675,31582,45,0,0,320,2063,6802,9169,22413,2233592000,4585000,3936000,10855000,19900000,97030000,365878000,484880000,1752225000
Hawaii,Manufacturing,2014,3709,1730,765,450,2945,514,125,3584,125,3800,1730,765,450,2945,530,170,3645,155,45264,1565,3097,4186,10176,10923,4331,35865,4223,1651983000,89935000,102952000,124400000,373206000,329247000,156206000,1212961000,250308000
Hawaii,"Mining, Quarrying, and Oil and Gas Extraction",2014,40,5,5,15,25,0,10,35,5,40,5,5,15,25,0,10,35,5,529,0,0,0,0,0,0,0,0,35287000,0,0,0,2191000,0,0,0,0
Hawaii,Other,2014,39,37,1,1,39,0,0,39,0,39,37,1,1,39,0,0,39,0,52,31,0,0,52,0,0,52,0,969000,778000,0,0,969000,0,0,969000,0
Hawaii,Other Services (except Public Administration),2014,15506,10150,2470,1400,14020,1042,204,15266,240,17390,10165,2470,1435,14070,1470,590,16130,1260,125118,17795,14989,17344,52189,35434,11003,105101,10042,3617283000,548619000,460186000,551327000,1578578000,1039991000,304114000,3175572000,281770000
Hawaii,"Professional, Scientific, and Technical Services",2014,14461,9640,1805,1214,12659,900,283,13842,619,16435,9640,1805,1250,12695,1045,385,14125,2310,115777,12216,11493,15016,40426,29364,7401,82825,26221,7293928000,810340000,594907000,847311000,2314229000,2008958000,501336000,5108332000,2003410000
Hawaii,Real Estate and Rental and Leasing,2014,7996,5693,1008,449,7150,331,226,7707,289,9705,5720,1035,465,7220,695,385,8300,1405,50529,8621,5212,4788,20014,9719,4308,38458,8348,2673426000,388147000,250888000,228167000,889096000,417652000,224786000,1733657000,809157000
Hawaii,Retail Trade,2014,14426,7170,2865,1583,11618,1203,472,13293,1133,23195,7195,2965,1805,11965,2330,1950,16245,6950,335114,7288,14022,16114,42067,36286,32455,114888,180095,9495793000,344019000,399301000,418666000,1239674000,1068052000,1178346000,3900610000,5119241000
Hawaii,Total,2014,24997,13754,4467,2756,20977,2450,629,24056,941,31801,13778,4532,2896,21206,3448,1916,26570,5231,519130,24081,29329,36794,90204,95226,82366,267796,251334,20847140000,991709000,1014074000,1291827000,3297610000,3383748000,3093781000,9775139000,11072001000
Hawaii,Transportation and Warehousing,2014,3529,1335,510,445,2290,567,277,3134,395,4335,1340,515,450,2305,670,475,3450,885,129209,1398,1874,4955,10307,17320,17473,48839,66546,5875348000,66582000,100127000,161322000,350668000,645447000,623014000,1781104000,3489113000
Hawaii,Utilities,2014,129,25,20,15,60,10,15,85,44,300,25,20,15,60,80,50,190,110,7638,0,48,0,184,0,0,1459,0,743743000,1358000,4230000,0,22122000,0,0,110896000,6178000
Hawaii,Wholesale Trade,2014,7246,3320,1210,860,5390,770,374,6534,712,8370,3330,1265,910,5505,995,625,7125,1245,91871,4331,6106,9348,21220,17483,14727,65133,20317,4447057000,229537000,277762000,420765000,1010095000,800734000,691457000,2924106000,1238880000
Idaho,Accommodation and Food Services,2014,14215,5085,2815,3110,11010,2420,360,13790,425,17715,5090,2845,3140,11075,3135,1270,15480,2235,281424,8187,18889,41109,69029,78592,44663,193725,88030,4009739000,198097000,225113000,526603000,953079000,1125431000,620884000,2719820000,1269589000
Idaho,Administrative and Support and Waste Management and Remediation Services,2014,10477,6665,1645,785,9095,632,185,9912,565,11160,6670,1650,800,9120,675,240,10035,1125,179187,8048,9532,9151,29569,17543,22480,73927,102297,4743826000,299906000,273196000,279891000,904784000,563171000,491197000,2095837000,2568870000
Idaho,"Agriculture, Forestry, Fishing and Hunting",2014,2205,1570,295,190,2055,100,25,2180,25,2205,1570,295,190,2055,100,25,2180,25,14322,1434,1729,2258,6223,4262,395,13832,246,591446000,119092000,87353000,106643000,320276000,152454000,7799000,569316000,19139000
Idaho,"Arts, Entertainment, and Recreation",2014,3597,2300,490,340,3130,335,70,3535,62,3710,2300,490,345,3135,350,115,3600,110,42830,1779,2874,4197,10011,10904,7182,30859,5395,735809000,99391000,56432000,65712000,236849000,208550000,107567000,624699000,66573000
Idaho,Construction,2014,29651,21035,4655,2310,28000,1352,164,29516,135,29790,21035,4655,2310,28000,1410,205,29615,175,160456,31462,29858,29501,92283,45572,8837,155380,3234,6851627000,1155750000,985596000,1174753000,3324716000,2158463000,535146000,6503560000,224110000
Idaho,Educational Services,2014,2204,1040,330,310,1680,375,45,2100,104,2320,1040,330,320,1690,390,90,2170,150,63340,111,1916,3739,7179,14014,978,24017,38978,1375151000,50004000,35444000,66533000,160166000,319440000,25428000,562490000,803622000
Idaho,Finance and Insurance,2014,7791,5275,730,280,6285,315,258,6858,933,13975,5310,740,360,6410,785,1235,8430,5545,106675,7759,4156,2946,14974,5471,517,40198,60629,5649767000,324251000,165662000,131925000,645332000,432830000,338331000,1849274000,3555880000
Idaho,Health Care and Social Assistance,2014,21837,10910,4640,2840,18390,2150,630,21170,667,25085,10920,4675,2945,18540,2985,1485,23010,2075,437942,14998,30214,36008,86178,81966,69319,243606,182059,16996673000,899148000,1025766000,1288003000,3247986000,2660456000,2012734000,8194864000,8479361000
Idaho,Information,2014,2311,1051,285,220,1556,293,104,1953,358,3225,1070,285,240,1595,365,155,2115,1110,52915,1174,1056,1315,4580,7558,2583,18169,29228,2488587000,68580000,46283000,62560000,197067000,375576000,151483000,963387000,1390674000
Idaho,Management of Companies and Enterprises,2014,964,115,5,60,180,183,220,583,381,1255,115,5,60,180,195,225,600,655,39505,0,0,252,423,1681,5156,7360,32135,2865779000,11334000,0,11095000,24379000,94701000,282753000,405214000,2459438000
Idaho,Manufacturing,2014,8455,3615,1620,1075,6310,1223,444,7977,478,8765,3615,1625,1075,6315,1265,490,8070,695,205526,4367,7711,11140,27979,36848,27033,112770,78041,9102106000,178382000,269143000,378550000,955226000,1503919000,1079348000,4389816000,4107744000
Idaho,"Mining, Quarrying, and Oil and Gas Extraction",2014,621,310,90,60,460,67,45,572,49,660,310,90,60,460,70,50,580,80,10841,377,470,602,1670,1479,1225,6119,2248,873012000,23978000,31125000,44575000,116173000,96466000,180873000,502502000,196740000
Idaho,Other,2014,77,77,0,0,77,0,0,77,0,77,77,0,0,77,0,0,77,0,0,0,0,0,0,0,0,0,0,1391000,1391000,0,0,1391000,0,0,1391000,0
Idaho,Other Services (except Public Administration),2014,15897,10695,2815,1284,14794,712,140,15646,251,16895,10705,2820,1385,14910,1110,235,16255,640,93521,15300,17487,14861,52645,17774,7736,83058,4783,2347805000,492149000,441601000,403745000,1357550000,453892000,182539000,2033729000,193718000
Idaho,"Professional, Scientific, and Technical Services",2014,20537,14650,2660,1345,18655,879,306,19840,697,21935,14650,2675,1365,18690,1080,440,20210,1725,151594,17241,17123,15546,54732,22153,10166,92003,47002,7933250000,878326000,712573000,758309000,2402929000,1206075000,575636000,4323899000,3413781000
Idaho,Real Estate and Rental and Leasing,2014,9717,8020,695,378,9093,238,135,9466,251,10985,8025,720,425,9170,550,405,10125,860,33278,8374,3258,4302,16085,4421,1970,29446,3171,1088011000,344903000,119086000,125305000,617379000,193962000,52099000,922246000,148263000
Idaho,Retail Trade,2014,19864,9710,4073,2461,16244,1821,478,18543,1321,29090,9730,4115,2785,16630,2830,2040,21500,7590,389355,14557,24752,30002,74605,52196,20697,165359,203325,10447260000,423912000,564419000,809241000,1823958000,1689563000,683688000,4764068000,5233911000
Idaho,Total,2014,36793,22302,5979,3658,31939,2829,757,35525,1268,43816,22332,6020,3849,32201,3900,1988,38089,5727,530490,35668,39402,48022,123092,98376,72425,293893,236597,20015180000,1239809000,1143791000,1461434000,3845034000,3313864000,2524425000,9683323000,10331857000
Idaho,Transportation and Warehousing,2014,8114,5390,1025,560,6975,531,185,7691,423,8655,5390,1025,565,6980,570,250,7800,855,84510,7190,6017,5538,21016,17061,10674,52094,21232,3211352000,284378000,225256000,260533000,796485000,632162000,412934000,1934467000,878401000
Idaho,Utilities,2014,596,355,60,45,460,60,15,535,61,1020,355,60,45,460,100,35,595,425,1248,422,350,289,1370,2200,0,3622,0,46841000,11048000,9609000,12437000,44374000,150376000,0,200287000,0
Idaho,Wholesale Trade,2014,8090,3374,985,790,5149,1136,630,6915,1175,10250,3375,1000,830,5205,1535,950,7690,2560,125574,4458,5278,8023,19692,28980,18212,76750,42496,7056271000,218160000,232954000,356642000,869215000,1378945000,953409000,3473556000,3416868000
Illinois,Accommodation and Food Services,2014,105549,41991,20887,18953,81831,19891,2176,103898,1651,137855,42030,20945,19135,82110,22435,7055,111600,26255,2483870,72653,139035,258152,470744,726600,316110,1516609,877794,44522825000,1752268000,1918709000,3724253000,7411423000,11818184000,5656170000,24919233000,19506560000
Illinois,Administrative and Support and Waste Management and Remediation Services,2014,73317,47330,8970,5650,61950,6143,2460,70553,2764,84560,47345,9005,5715,62065,6570,3125,71760,12800,2357489,55748,56942,73547,191476,234002,320086,759796,1578351,79745379000,3471477000,2436124000,2977251000,8901115000,9525938000,12443094000,31297293000,47665489000
Illinois,"Agriculture, Forestry, Fishing and Hunting",2014,1495,1135,205,50,1390,50,25,1465,30,1640,1135,205,50,1390,65,75,1530,110,5799,1381,848,243,3444,1226,0,5668,0,407957000,54564000,30895000,20656000,134971000,44755000,41238000,225878000,0
Illinois,"Arts, Entertainment, and Recreation",2014,21376,12725,2790,2395,17910,2568,533,21011,365,23080,12735,2825,2415,17975,2730,805,21510,1570,389804,12481,17823,32505,66983,98727,74407,245626,126440,13121645000,746319000,452825000,628672000,1866550000,2277814000,4065857000,8367500000,3859415000
Illinois,Construction,2014,140535,104165,17880,9620,131665,7165,985,139815,720,141430,104170,17900,9630,131700,7285,1210,140195,1235,913745,138025,116484,128048,386168,257988,132994,783045,118710,64614975000,7237805000,6328765000,8122266000,21689610000,19891776000,11159938000,53060260000,10625829000
Illinois,Educational Services,2014,19380,9335,2805,2300,14440,3388,970,18798,582,21275,9340,2805,2405,14550,3660,1445,19655,1620,822031,11975,18685,30913,63969,140374,143466,350721,464178,32353485000,461191000,423050000,640861000,1531702000,3810019000,4961776000,10433925000,21736217000
Illinois,Finance and Insurance,2014,62755,41011,8512,3505,53028,4384,2149,59561,3194,110335,41085,8660,3995,53740,8230,8855,70825,39510,1625200,68992,52951,43778,169606,154356,190414,521509,1072714,153272665000,3577860000,3247141000,3834964000,10724061000,13340343000,17312336000,41892820000,109750419000
Illinois,Health Care and Social Assistance,2014,133137,68414,27351,16461,112226,13155,4889,130270,2867,167270,68505,27620,17465,113590,17820,14055,145465,21805,3934787,117447,178500,221003,509325,509168,702141,1753683,2159732,174253938000,6338901000,7935145000,10496102000,24818896000,20862621000,23705316000,70151353000,102931937000
Illinois,Information,2014,15638,8170,1885,1346,11401,1581,984,13966,1672,27130,8170,1905,1390,11465,1755,1390,14610,12520,620774,8701,9481,15372,38401,52778,73275,173388,437114,47835208000,628581000,644686000,977089000,2289135000,3571055000,5775513000,11935146000,35268309000
Illinois,Management of Companies and Enterprises,2014,7512,555,110,215,880,1267,1953,4100,3412,11760,555,110,215,880,1300,2050,4230,7530,997405,0,549,1369,2277,14755,66145,83480,913704,109994965000,177130000,36420000,114230000,327815000,1146205000,5112760000,6586780000,103408185000
Illinois,Manufacturing,2014,63982,22574,10150,9370,42094,12614,4599,59307,4675,67655,22600,10165,9455,42220,13220,5200,60640,7015,2644432,34013,60576,119596,228788,487511,524093,1305550,1204405,152956477000,1830699000,2699202000,5456611000,10340645000,24902636000,27993011000,66592434000,79423908000
Illinois,"Mining, Quarrying, and Oil and Gas Extraction",2014,2447,1360,320,297,1977,215,89,2281,166,2820,1360,320,305,1985,265,225,2475,345,44314,889,1861,3685,8030,6402,7738,26276,13809,3331809000,116896000,101854000,195345000,422060000,409715000,764876000,1864371000,1148137000
Illinois,Other,2014,445,426,15,3,444,1,0,445,0,445,426,15,3,444,1,0,445,0,0,0,90,35,0,0,0,0,0,9524000,8379000,728000,370000,9477000,0,0,9524000,0
Illinois,Other Services (except Public Administration),2014,147296,91735,29218,14449,135402,9320,1529,146251,1045,159085,91925,29525,15185,136635,11730,3270,151635,7450,1223570,170361,190731,189618,552197,322563,151836,1038706,158316,40940260000,4536076000,5065888000,5445322000,15057167000,10046060000,6679367000,31976700000,7203420000
Illinois,"Professional, Scientific, and Technical Services",2014,184424,135502,20614,11873,167989,9783,3260,181032,3392,194930,135560,20690,12200,168450,11280,4320,184050,10880,2093007,157282,133794,153781,465369,326671,278968,1084413,926303,160505733000,12028390000,7865324000,10387075000,30341100000,25547221000,23774411000,80061000000,78795902000
Illinois,Real Estate and Rental and Leasing,2014,49622,36716,5733,2691,45140,2461,915,48516,1106,62170,36830,5850,2940,45620,3530,2545,51695,10475,373134,41580,36496,33654,117184,78110,48159,254098,109826,21027151000,2395712000,1655029000,1691787000,5749655000,4144368000,3235803000,13347345000,7067747000
Illinois,Retail Trade,2014,120958,70680,23252,11347,105279,9775,2584,117638,3320,196260,70845,23780,12445,107070,14140,9170,130380,65880,3021641,107236,144605,140960,393775,351747,211126,993838,1757809,76666350000,3270557000,3708440000,4054867000,11113040000,12679205000,8150211000,32339065000,40880191000
Illinois,Total,2014,254089,156555,39534,24454,220543,22879,6083,249505,4584,316120,156760,39961,25566,222287,28606,14950,265843,50277,5312290,245172,259786,326663,831621,853471,756903,2441995,2870295,273437956000,10965104000,10139496000,13648337000,34752937000,38613041000,38328473000,111694451000,161743505000
Illinois,Transportation and Warehousing,2014,65382,47665,5679,3658,57002,3919,1734,62655,2727,72195,47680,5715,3685,57080,4255,2230,63565,8630,1025081,44441,36336,45286,136017,121664,106571,380444,533844,46370231000,2069827000,1520738000,1994391000,5632667000,5663094000,4970405000,16695806000,25192174000
Illinois,Utilities,2014,902,350,95,80,525,165,66,756,146,2460,350,95,95,540,250,130,920,1540,102574,517,497,887,2128,6308,5468,16311,89905,10758625000,28541000,18035000,65410000,119700000,467420000,508069000,1254332000,9617340000
Illinois,Wholesale Trade,2014,78830,39403,11492,8705,59600,10302,4179,74081,4749,94465,39450,11610,9090,60150,12505,7595,80250,14215,1554584,49737,73427,111374,251138,332441,257292,854595,667917,114146099000,3785093000,4317613000,6778513000,14939585000,21133091000,16909146000,53669638000,58127522000
Indiana,Accommodation and Food Services,2014,46436,15680,8965,9354,33999,9857,1316,45172,1264,65715,15710,8990,9510,34210,11325,4935,50470,15245,1324312,25813,60231,129275,216290,358632,177863,756103,559252,18798084000,612051000,714046000,1595563000,2927780000,4724898000,2308528000,10006075000,8630752000
Indiana,Administrative and Support and Waste Management and Remediation Services,2014,30926,18190,4565,2915,25670,2783,892,29345,1581,35770,18215,4575,2965,25755,3015,1255,30025,5745,983083,25286,29145,38431,95474,101778,92095,304073,668636,28922017000,1107465000,893716000,1146676000,3164573000,3232210000,2770790000,9838382000,18762986000
Indiana,"Agriculture, Forestry, Fishing and Hunting",2014,1206,930,135,65,1130,20,31,1181,25,1295,930,135,65,1130,20,50,1200,95,6473,1165,396,599,2718,310,0,4507,0,280978000,45419000,19826000,20585000,97106000,17154000,0,168679000,0
Indiana,"Arts, Entertainment, and Recreation",2014,9940,5550,1447,1280,8277,1247,236,9760,180,10395,5555,1485,1280,8320,1390,295,10005,390,156315,7316,8548,16996,33790,47349,26230,112525,22039,4486874000,263576000,183780000,321315000,792501000,854790000,657913000,2504280000,517510000
Indiana,Construction,2014,64108,41120,11495,6065,58680,4268,639,63587,521,64855,41125,11495,6075,58695,4370,855,63920,935,575350,68049,74444,80365,223690,155119,73537,463355,99891,31708540000,2712843000,2920820000,3801227000,9446420000,8928336000,4990994000,24143320000,6833453000
Indiana,Educational Services,2014,7427,3305,1248,1065,5618,1202,265,7085,342,8065,3305,1260,1140,5705,1320,380,7405,660,335942,4902,7912,13810,27657,51046,34334,114977,216949,9206975000,153020000,149923000,257195000,567780000,1253615000,1045405000,2957010000,6067278000
Indiana,Finance and Insurance,2014,24111,16124,3112,1115,20351,1294,818,22463,1648,47440,16145,3205,1365,20715,2980,4630,28325,19115,474453,27907,18199,13608,62555,43420,78582,188554,284954,31362258000,1225394000,898597000,744142000,2945981000,2205060000,4305178000,9777187000,21317905000
Indiana,Health Care and Social Assistance,2014,51568,22395,11675,7160,41230,5833,2491,49554,2014,77070,22420,11730,7485,41635,8565,6760,56960,20110,2011881,39798,77344,94418,213938,229483,378574,829579,1143265,82651438000,1847311000,3030361000,3868278000,8763659000,8797021000,12810566000,30583868000,51529956000
Indiana,Information,2014,5322,2340,686,570,3596,674,288,4558,764,10640,2375,695,600,3670,795,620,5085,5555,207549,2858,4182,6662,15272,21122,18531,61023,146158,11712256000,142696000,165795000,271511000,596183000,963355000,936961000,2638150000,9028581000
Indiana,Management of Companies and Enterprises,2014,3173,120,50,85,255,581,941,1777,1396,4615,120,50,85,255,595,1045,1895,2720,292460,108,22,550,766,6532,27865,35540,256920,28321255000,20185000,8240000,46595000,75020000,417155000,1619885000,2125725000,26195530000
Indiana,Manufacturing,2014,36863,10434,5895,5500,21829,7718,3429,32976,3887,40180,10440,5895,5530,21865,8140,3960,33965,6215,2282962,16768,35683,68679,128948,294868,375764,850993,1287922,121729463000,707614000,1323600000,2738596000,4963896000,13148357000,16990631000,37278181000,76505520000
Indiana,"Mining, Quarrying, and Oil and Gas Extraction",2014,938,380,125,110,615,112,62,789,149,1450,390,125,135,650,160,115,925,525,27899,353,617,305,2601,2698,0,10993,12742,2147192000,54576000,26818000,50868000,196758000,150968000,349904000,1049749000,981043000
Indiana,Other,2014,188,185,3,0,188,0,0,188,0,188,185,3,0,188,0,0,188,0,0,0,0,0,0,0,0,0,0,3453000,3278000,175000,0,3453000,0,0,3453000,0
Indiana,Other Services (except Public Administration),2014,74957,44789,15950,7636,68375,4986,855,74216,741,81980,44825,16060,8055,68940,6695,2125,77760,4220,626405,86422,102085,99960,290956,173949,61939,534373,63840,16610191000,2016033000,2292254000,2437509000,6765438000,4347959000,1785488000,13216102000,2553623000
Indiana,"Professional, Scientific, and Technical Services",2014,59390,40335,8165,4942,53442,3337,1106,57885,1505,64165,40350,8205,5065,53620,4175,1635,59430,4735,549519,59538,51685,63999,178661,104524,68263,356280,173072,33366797000,2621299000,2223336000,3153083000,8025403000,5861065000,4962820000,19186911000,13496584000
Indiana,Real Estate and Rental and Leasing,2014,22522,16610,2430,1188,20228,1057,555,21840,682,30720,16650,2455,1285,20390,2315,2290,24995,5725,151817,21409,15046,14816,55433,29061,17912,110012,32872,6242331000,839063000,503645000,498241000,1862444000,1249054000,949258000,4173357000,1608935000
Indiana,Retail Trade,2014,62077,32565,12858,7015,52438,5587,1494,59519,2558,107155,32675,13235,7910,53820,8955,6765,69540,37615,1564126,50075,79865,86191,232465,184944,115741,554168,913377,37965555000,1455235000,1889226000,2365973000,5734300000,6155918000,3788680000,16136173000,20426845000
Indiana,Total,2014,108309,59449,19290,12343,91082,11057,3037,105176,3133,143826,59546,19483,12964,91993,14553,8497,115043,28783,2602895,103173,126859,165529,395561,411143,376499,1183203,1419692,107451529000,3577611000,3926505000,5465281000,12969397000,14792937000,15176366000,42938700000,64512829000
Indiana,Transportation and Warehousing,2014,22593,12210,3030,2335,17575,2197,957,20729,1864,25715,12215,3040,2375,17630,2410,1150,21190,4525,575872,17293,19541,29555,69057,70437,58197,203728,307280,23849920000,714258000,708207000,1189181000,2631501000,2836977000,2395317000,8133533000,13403713000
Indiana,Utilities,2014,925,300,185,100,585,185,30,800,125,2545,300,185,115,600,225,85,910,1635,59713,744,1134,258,3246,7403,1632,13452,38079,6149901000,26717000,41262000,50390000,138020000,524048000,154242000,929934000,4376196000
Indiana,Wholesale Trade,2014,30485,13040,4542,3553,21135,4359,2183,27677,2808,38420,13060,4580,3780,21420,5315,3535,30270,8150,573777,18563,28144,44149,96667,128126,91476,331714,218711,32133126000,1053986000,1357623000,2266159000,4780318000,6704329000,4754707000,17010461000,14397149000
Iowa,Accommodation and Food Services,2014,27743,9885,5625,5585,21095,5259,700,27054,689,34850,9905,5635,5670,21210,6250,2785,30245,4605,571829,15197,37664,77361,132221,184472,86687,404022,167174,7927778000,353467000,419526000,848214000,1630740000,2320713000,1069260000,5087347000,2788029000
Iowa,Administrative and Support and Waste Management and Remediation Services,2014,15806,9940,2045,1349,13334,1153,370,14857,949,17910,9950,2050,1375,13375,1285,485,15145,2765,342471,12828,12708,16737,43466,36764,37335,127068,207056,10081575000,552495000,396787000,601995000,1578611000,1120106000,1059603000,3909765000,5931138000
Iowa,"Agriculture, Forestry, Fishing and Hunting",2014,1490,1165,175,45,1385,40,55,1480,10,1730,1165,175,45,1385,50,240,1675,55,11264,1159,864,109,2816,834,3310,8208,0,591064000,72537000,44391000,11674000,138360000,26988000,177339000,401384000,0
Iowa,"Arts, Entertainment, and Recreation",2014,7070,4295,1085,750,6130,665,170,6965,105,7315,4295,1090,755,6140,725,220,7085,230,98830,5775,6920,9527,23030,22570,22896,71208,17722,1711193000,178147000,130481000,144813000,462609000,353758000,338064000,1257306000,435825000
Iowa,Construction,2014,41849,28805,6584,3370,38759,2457,358,41574,275,42305,28815,6590,3370,38775,2605,445,41825,480,298849,44657,42938,43758,132034,87765,36980,261113,29228,16891285000,1971142000,1868263000,2293308000,6145623000,5232179000,2583421000,14238280000,2072970000
Iowa,Educational Services,2014,3414,1500,545,465,2510,535,163,3208,206,3950,1500,545,510,2555,590,375,3520,430,218389,1573,2800,6148,12352,20091,24477,59084,159326,5385063000,53837000,64212000,101471000,224517000,408315000,638897000,1357509000,3969912000
Iowa,Finance and Insurance,2014,18233,11862,2243,1112,15217,1243,674,17134,1099,30515,11895,2320,1460,15675,3730,3485,22890,7625,438306,18489,12980,13466,47871,42342,63810,157772,231096,30112918000,789979000,589384000,720613000,2141337000,2168169000,3750767000,8260004000,18653455000
Iowa,Health Care and Social Assistance,2014,28692,12560,5220,3530,21310,4211,1962,27483,1209,41095,12580,5280,3745,21605,6190,6065,33860,7235,1079385,22329,34181,45865,105035,171885,277794,561601,478110,41761639000,1022405000,1391678000,1944934000,4414453000,5720564000,9112386000,19424503000,22274044000
Iowa,Information,2014,4296,1710,795,565,3070,445,199,3714,582,7385,1720,810,575,3105,755,455,4315,3070,146184,2741,5294,7288,16017,11927,11683,46218,99862,7449607000,92174000,163122000,271573000,538561000,575621000,581521000,1948334000,5449696000
Iowa,Management of Companies and Enterprises,2014,1982,90,30,91,211,390,643,1244,738,2480,90,30,100,220,390,680,1290,1190,110955,60,88,300,490,3840,19155,23545,87210,8526265000,7861000,3908000,13635000,26570000,255240000,1355215000,1637025000,6879074000
Iowa,Manufacturing,2014,15601,5020,2555,1955,9530,2834,1484,13848,1753,17710,5020,2570,1965,9555,3005,1985,14545,3165,834156,6832,13241,20826,46152,95785,126140,314810,474015,40827064000,290815000,500919000,865894000,1797015000,4383843000,5842831000,14053670000,25032946000
Iowa,"Mining, Quarrying, and Oil and Gas Extraction",2014,379,145,35,45,225,64,46,335,44,985,145,35,45,225,190,160,575,410,9917,81,203,478,964,2447,3462,7150,414,572681000,10502000,6154000,25133000,50065000,137708000,214568000,420433000,110295000
Iowa,Other,2014,108,105,2,1,108,0,0,108,0,108,105,2,1,108,0,0,108,0,130,0,0,0,130,0,0,130,0,2641000,2171000,0,0,2641000,0,0,2641000,0
Iowa,Other Services (except Public Administration),2014,42351,27825,8660,3367,39852,1783,353,41988,363,45300,27905,8915,3745,40565,2550,870,43985,1315,255332,53117,54562,42840,151590,57506,17240,236125,11886,6534403000,1180522000,1210151000,1056981000,3469014000,1581509000,506188000,5747206000,542373000
Iowa,"Professional, Scientific, and Technical Services",2014,28817,18900,4530,2397,25827,1663,510,28000,817,31440,18910,4535,2495,25940,2260,820,29020,2420,252775,28485,27601,29201,88893,50399,19734,168276,74289,14478144000,1237669000,1143694000,1395063000,3816275000,3140964000,1293526000,8718859000,5518662000
Iowa,Real Estate and Rental and Leasing,2014,11451,8848,1035,510,10393,413,273,11079,372,14070,8850,1040,620,10510,765,890,12165,1905,58828,7920,5919,5730,24110,10117,5550,44535,8820,2233542000,390963000,184026000,187932000,792497000,395775000,273091000,1685059000,392318000
Iowa,Retail Trade,2014,37581,18685,7825,4921,31431,3495,925,35851,1730,59140,18770,7945,5445,32160,5675,3060,40895,18245,856517,30772,48689,57351,144789,108910,53106,320146,431354,20158974000,833395000,1148448000,1568297000,3578394000,3503349000,1878992000,9163179000,9257377000
Iowa,Total,2014,62344,35780,10676,6636,53092,5763,1619,60474,1870,80466,35848,10826,7122,53796,8503,5535,67834,12632,1316447,60930,70109,88035,219074,213438,208776,641288,675159,52562772000,2038489000,2144826000,2886917000,7070232000,7718682000,8342873000,23131787000,29430985000
Iowa,Transportation and Warehousing,2014,15925,10360,2030,1155,13545,1109,413,15067,858,17685,10360,2045,1210,13615,1325,530,15470,2215,274085,6845,12822,13942,43261,32252,20603,101759,170016,11052560000,521173000,453829000,546845000,1551002000,1324581000,1002037000,4032048000,6915281000
Iowa,Utilities,2014,466,85,50,60,195,155,27,377,89,1355,85,50,60,195,325,70,590,765,38133,12,171,813,1295,5780,0,7844,20145,3059345000,2997000,14928000,46252000,66113000,373706000,0,487101000,1740735000
Iowa,Wholesale Trade,2014,17234,6745,2433,2249,11427,2667,1363,15457,1777,24570,6755,2460,2415,11630,3850,4055,19535,5035,325960,10131,14823,25869,54341,73456,81609,219118,90692,17065550000,491454000,736601000,1271119000,2615590000,3916128000,4406303000,11454125000,5214790000
Kansas,Accommodation and Food Services,2014,21525,7275,4026,4060,15361,4693,600,20654,871,29925,7285,4035,4110,15430,5365,1950,22745,7180,552317,11872,26771,55422,94720,168534,70543,334085,217030,7808969000,294149000,305574000,646433000,1248784000,2227013000,933623000,4415499000,3377555000
Kansas,Administrative and Support and Waste Management and Remediation Services,2014,16100,9330,2350,1480,13160,1368,545,15073,1027,17845,9335,2355,1505,13195,1420,640,15255,2590,370861,12767,14267,19060,48517,48349,61392,164209,183326,12208876000,529054000,432802000,693506000,1699680000,1579856000,1868113000,5348019000,6183359000
Kansas,"Agriculture, Forestry, Fishing and Hunting",2014,970,720,100,90,910,40,15,965,5,970,720,100,90,910,40,15,965,5,4566,977,560,978,2632,1089,0,4442,0,172324000,37870000,20841000,41969000,108984000,31286000,0,172279000,0
Kansas,"Arts, Entertainment, and Recreation",2014,4850,2705,655,655,4015,595,125,4735,115,5150,2705,655,660,4020,675,155,4850,300,75946,3472,3722,7709,16628,22032,13853,55608,14960,1437243000,107181000,72661000,131835000,337994000,373033000,295817000,1056931000,257423000
Kansas,Construction,2014,34225,21710,6213,3210,31133,2380,365,33878,347,34600,21710,6230,3215,31155,2440,395,33990,610,304547,36282,40258,42744,120479,89901,32531,248457,39122,15679070000,1330334000,1501508000,1793144000,4643350000,4938118000,1935852000,11765645000,2604209000
Kansas,Educational Services,2014,3366,1445,585,430,2460,515,203,3178,188,3610,1445,585,435,2465,530,285,3280,330,106271,1601,3669,5474,11166,19265,32491,66972,33152,3016778000,86521000,67596000,98391000,262984000,460696000,743567000,1613947000,1072442000
Kansas,Finance and Insurance,2014,18141,11810,2090,1020,14920,1246,533,16699,1442,29470,11820,2190,1405,15415,3270,2570,21255,8215,290471,19688,12579,12691,47004,41899,42154,135740,147670,19303115000,792347000,596546000,765908000,2195382000,2307762000,2787723000,7605378000,11246656000
Kansas,Health Care and Social Assistance,2014,29256,13140,5625,3949,22714,3748,1683,28145,1111,39045,13155,5660,4115,22930,5070,4760,32760,6285,965532,19368,36782,52537,114120,152032,238871,515971,439459,38332598000,1052157000,1473738000,2374762000,4933432000,5769831000,8360023000,19395619000,18283990000
Kansas,Information,2014,3611,1425,455,410,2290,484,208,2982,629,6675,1440,455,430,2325,675,545,3545,3130,169487,1717,2251,4485,9983,15703,7894,44621,120731,11929383000,94658000,95861000,181668000,418583000,786438000,523901000,2004342000,9764063000
Kansas,Management of Companies and Enterprises,2014,2294,110,50,85,245,430,596,1271,1023,3015,110,50,85,245,450,635,1330,1685,111004,104,197,409,749,5368,16690,22910,88197,10586160000,12863000,20263000,24688000,58305000,386840000,1294230000,1739375000,8839282000
Kansas,Manufacturing,2014,13186,4130,2180,1939,8249,2326,1190,11765,1421,14155,4130,2190,1945,8265,2485,1465,12215,1940,733496,5351,11582,19062,41627,75018,118362,272230,402782,38535352000,240027000,427287000,842259000,1671174000,3282885000,5522715000,12237669000,23095630000
Kansas,"Mining, Quarrying, and Oil and Gas Extraction",2014,5174,3050,800,500,4350,456,128,4934,240,5510,3050,800,525,4375,535,165,5075,435,54220,5156,5268,6272,16826,14687,9505,42217,10876,3363672000,241275000,269902000,367051000,882666000,870809000,573351000,2384261000,897371000
Kansas,Other,2014,139,131,6,2,139,0,0,139,0,139,131,6,2,139,0,0,139,0,0,0,0,0,0,0,0,0,0,2238000,1812000,273000,0,2238000,0,0,2238000,0
Kansas,Other Services (except Public Administration),2014,37393,24295,7183,3090,34568,2070,374,37012,381,39715,24325,7245,3210,34780,2690,810,38280,1435,255357,43274,45723,38249,129663,67697,29561,235389,12959,6520227000,1008780000,1035008000,933668000,2999346000,1693753000,901054000,5962699000,445533000
Kansas,"Professional, Scientific, and Technical Services",2014,33125,22110,4820,2547,29477,1782,692,31951,1174,36030,22110,4850,2610,29570,2185,1205,32960,3070,318190,30575,29489,32508,94595,52593,51739,208827,72244,19815434000,1504362000,1308067000,1661342000,4533757000,3073141000,3269431000,11221531000,5701553000
Kansas,Real Estate and Rental and Leasing,2014,12635,9581,1295,547,11423,512,247,12182,453,15675,9615,1345,570,11530,825,1065,13420,2255,70494,10700,7959,6203,28395,11335,12420,54207,15979,2675051000,466511000,278941000,247645000,1013389000,412824000,410546000,1911955000,643437000
Kansas,Retail Trade,2014,35238,17485,7752,4284,29521,2984,789,33294,1944,51955,17520,7840,4635,29995,4395,2175,36565,15390,689533,28618,48121,51434,135339,84197,51133,287963,377459,16590624000,818447000,1070786000,1287315000,3204458000,2713838000,1707695000,7870631000,7970005000
Kansas,Total,2014,58219,32744,9996,6179,48919,5542,1641,56102,2117,74055,32787,10106,6517,49410,7618,4512,61540,12515,1178062,56354,65582,82043,203979,203149,197078,604206,573856,49712832000,1926052000,2059296000,2851301000,6836649000,7497955000,8096585000,22431189000,27281643000
Kansas,Transportation and Warehousing,2014,10568,5987,1420,990,8397,818,394,9609,959,12590,5990,1420,1035,8445,890,695,10030,2560,223553,8279,8759,11546,30140,23046,16489,76961,108597,9378928000,336368000,317670000,462882000,1145666000,948620000,950374000,3111722000,5374358000
Kansas,Utilities,2014,342,45,30,40,115,90,41,246,96,1160,45,30,40,115,140,280,535,625,33709,0,69,561,839,3440,1219,8396,19475,2861927000,1038000,4458000,37302000,47286000,239268000,322470000,637964000,1725204000
Kansas,Wholesale Trade,2014,16591,6747,2417,1838,11002,2551,1199,14752,1839,22485,6770,2465,1955,11190,4010,2750,17950,4535,314871,9759,14370,20354,47827,68127,48589,179043,114881,18133381000,553673000,749155000,1135153000,2525401000,3544192000,2896210000,9648047000,7622600000
Kentucky,Accommodation and Food Services,2014,27833,8689,5125,5608,19422,6381,1000,26803,1030,39290,8700,5135,5655,19490,7435,3635,30560,8730,804845,13113,34446,77031,126038,229736,135864,493495,314181,11365453000,343965000,414829000,1011782000,1777380000,2951110000,1804164000,6558800000,4696300000
Kentucky,Administrative and Support and Waste Management and Remediation Services,2014,16838,9630,2350,1495,13475,1510,655,15640,1198,19995,9630,2350,1520,13500,1630,840,15970,4025,541686,13207,14398,19266,50853,52063,63763,173602,357085,13863597000,535521000,477714000,633891000,1708941000,1775158000,1586732000,5241685000,8438195000
Kentucky,"Agriculture, Forestry, Fishing and Hunting",2014,1120,780,205,35,1020,50,35,1105,15,1120,780,205,35,1020,50,35,1105,15,6694,976,1325,268,2862,1571,1889,6453,57,219703000,35171000,39993000,8077000,91069000,47090000,74640000,214825000,1147000
Kentucky,"Arts, Entertainment, and Recreation",2014,6080,3295,1020,735,5050,776,127,5953,127,6385,3295,1030,760,5085,860,190,6135,250,80956,4457,5873,8923,20323,29109,9340,66522,12208,2003727000,154998000,126333000,175202000,483459000,612080000,281724000,1501953000,255627000
Kentucky,Construction,2014,35184,22120,6189,3365,31674,2840,384,34898,286,35695,22120,6190,3380,31690,2965,520,35175,520,314918,35820,39761,44679,121747,105947,40955,275287,22166,15165185000,1327496000,1425364000,1876678000,4638725000,5618444000,2530509000,13123935000,1192668000
Kentucky,Educational Services,2014,3889,1785,670,468,2923,547,218,3688,201,4470,1790,685,485,2960,555,385,3900,570,146282,2193,4152,5619,13196,18579,37979,73023,66036,3581155000,73652000,71436000,106774000,261434000,459885000,991800000,1813830000,1580575000
Kentucky,Finance and Insurance,2014,15565,9550,2278,815,12643,1064,557,14264,1301,31975,9570,2340,1015,12925,2955,3665,19545,12430,326947,16954,13433,9555,41396,36878,48114,131684,183699,21597756000,710969000,587068000,510285000,1846991000,1845707000,2397567000,6313400000,13169534000
Kentucky,Health Care and Social Assistance,2014,47306,25605,9295,5423,40323,4071,1393,45787,1519,63515,25640,9325,5700,40665,5645,3895,50205,13310,1233919,44240,60790,70949,177183,147846,175735,509596,707010,51333905000,1667550000,2189036000,2653150000,6521430000,6348594000,5364878000,18396768000,32360233000
Kentucky,Information,2014,3961,1675,530,480,2685,457,223,3365,596,7560,1675,535,495,2705,675,390,3770,3790,164219,1507,2833,5495,10888,11593,6820,38063,123994,6893708000,95161000,118809000,172370000,405944000,583198000,378993000,1642875000,5078283000
Kentucky,Management of Companies and Enterprises,2014,2304,145,40,56,241,395,645,1281,1023,3400,145,40,60,245,395,705,1345,2055,143095,144,14,0,60,4995,18620,24435,118625,12375825000,13536000,11375000,20895000,46780000,377348000,1290360000,1720285000,10652132000
Kentucky,Manufacturing,2014,17171,5235,2625,2200,10060,3048,1578,14686,2485,18775,5245,2625,2200,10070,3340,1940,15350,3425,1018082,8015,14353,25181,51666,100214,130327,317883,629038,51388789000,346320000,456406000,966446000,1921880000,4124886000,6072929000,14020945000,33718235000
Kentucky,"Mining, Quarrying, and Oil and Gas Extraction",2014,2122,865,230,300,1395,418,132,1945,177,2595,865,230,300,1395,445,250,2090,505,79422,1367,1453,3893,6521,14931,15963,38599,38858,5546012000,140932000,66019000,211930000,421108000,893071000,984243000,2346516000,3177778000
Kentucky,Other,2014,526,515,10,1,526,0,0,526,0,526,515,10,1,526,0,0,526,0,0,0,55,0,0,0,0,0,0,10999000,10545000,284000,0,10999000,0,0,10999000,0
Kentucky,Other Services (except Public Administration),2014,43049,27655,8465,3590,39710,2439,367,42516,533,47005,27685,8550,3775,40010,3325,1180,44515,2490,328265,52495,54725,45427,155683,79975,18422,262955,36598,8384482000,1225253000,1258222000,1142882000,3654529000,2105446000,572219000,6528263000,1696902000
Kentucky,"Professional, Scientific, and Technical Services",2014,38020,25735,5355,2995,34085,2145,736,36966,1054,41160,25750,5370,3030,34150,2640,1075,37865,3295,353217,39608,34487,37965,115044,66615,47867,237249,103610,16684597000,1607604000,1401988000,1743496000,4800669000,3652563000,2589229000,11273134000,5062943000
Kentucky,Real Estate and Rental and Leasing,2014,14201,10480,1553,640,12673,602,366,13641,560,17970,10490,1655,720,12865,1145,865,14875,3095,80885,15649,9925,7260,34503,17152,7139,61381,20628,3122730000,501651000,306630000,267820000,1102659000,616020000,320919000,2159486000,952450000
Kentucky,Retail Trade,2014,46658,24759,9576,5448,39783,3911,881,44575,2083,76115,24795,9725,6070,40590,6195,3050,49835,26280,941690,41001,60107,68479,175400,128509,56322,375123,399123,22863793000,1082066000,1409104000,1808409000,4321093000,4261158000,1840490000,10581025000,9572276000
Kentucky,Total,2014,68827,38769,11935,7276,57980,6588,1809,66377,2450,91418,38813,12056,7668,58537,8867,5071,72475,18943,1535417,68154,78635,96783,243572,239158,204564,687294,848123,60162070000,2220371000,2322254000,3048958000,7591583000,8536485000,7721195000,23849263000,36312807000
Kentucky,Transportation and Warehousing,2014,11817,6085,1730,1045,8860,1089,453,10402,1415,14215,6085,1730,1065,8880,1170,590,10640,3575,339183,9209,10624,11938,32804,30861,24411,96568,224901,16021531000,345816000,371629000,437318000,1191446000,1252944000,1185470000,3900338000,11273623000
Kentucky,Utilities,2014,473,135,45,50,230,80,65,375,98,1645,135,45,50,230,160,275,665,980,41299,69,282,520,1161,4610,5852,11929,17338,3477016000,9771000,9297000,19223000,45798000,311034000,385359000,790018000,1596681000
Kentucky,Wholesale Trade,2014,17076,7075,2442,1865,11382,2330,1190,14902,2174,21575,7095,2465,2020,11580,2750,1870,16200,5375,328934,10165,14591,20877,48376,61387,46414,173603,129603,18032263000,539879000,627912000,988266000,2249663000,3084798000,2477503000,8593506000,8093835000
Louisiana,Accommodation and Food Services,2014,34564,11100,6648,7275,25023,7707,954,33684,880,46380,11115,6665,7405,25185,8485,3390,37060,9320,1028386,18672,43917,98706,162532,284252,143610,595391,405190,17860505000,510011000,586384000,1357365000,2455897000,4470300000,2557280000,9517695000,8316272000
Louisiana,Administrative and Support and Waste Management and Remediation Services,2014,20542,11105,3255,2002,16362,2256,842,19460,1082,23535,11105,3270,2015,16390,2485,1135,20010,3525,523654,17283,20437,24445,65874,81966,96493,251512,252526,18846832000,722500000,668375000,882420000,2307719000,2912505000,2983927000,8526145000,9434046000
Louisiana,"Agriculture, Forestry, Fishing and Hunting",2014,2971,1666,720,320,2706,220,10,2936,35,2995,1670,720,320,2710,220,10,2940,55,18586,1809,4613,3646,10785,5694,0,17113,560,842232000,110073000,188231000,141377000,459146000,249941000,0,731108000,43108000
Louisiana,"Arts, Entertainment, and Recreation",2014,6608,3575,1120,717,5412,890,165,6467,141,7040,3575,1120,725,5420,1005,290,6715,325,100961,4668,6556,8733,21061,30110,12390,71708,19198,2735153000,190752000,167406000,147082000,523143000,576718000,248449000,1716150000,507885000
Louisiana,Construction,2014,38851,21945,7437,4375,33757,3766,722,38245,606,39380,21945,7440,4380,33765,3830,855,38450,930,632770,37016,48286,57737,145317,141989,95408,391340,227034,36118350000,1503055000,1806894000,2452898000,5775910000,7252466000,6137109000,19246440000,15657445000
Louisiana,Educational Services,2014,5445,2145,760,620,3525,1348,378,5251,194,5975,2145,765,625,3535,1515,505,5555,420,211754,2602,5100,7836,16980,62133,54005,133921,68461,7547878000,135069000,160879000,159532000,468172000,1777922000,1972890000,4252990000,3017367000
Louisiana,Finance and Insurance,2014,19744,12030,3485,1234,16749,1226,568,18543,1201,38460,12060,3640,1590,17290,3895,4510,25695,12765,314201,17862,21776,14783,58660,45366,53900,162262,144447,19583595000,998069000,1001231000,784923000,2835372000,2370235000,3037757000,8470224000,10707686000
Louisiana,Health Care and Social Assistance,2014,48865,21940,11045,6368,39353,6141,2187,47681,1184,59840,21965,11115,6590,39670,7970,4970,52610,7230,1427459,38706,72412,82830,197505,252565,333062,785684,568390,57592885000,2579472000,2822966000,3110741000,8582316000,8048968000,10133542000,26855615000,29973232000
Louisiana,Information,2014,3394,1500,415,373,2288,467,163,2918,476,7030,1500,420,395,2315,585,440,3340,3690,118595,1929,2316,3478,8952,14144,4565,35028,81259,6591869000,106131000,75262000,187639000,412439000,674200000,231243000,1634743000,4373754000
Louisiana,Management of Companies and Enterprises,2014,2386,115,55,60,230,560,703,1493,893,3180,115,55,60,230,565,730,1525,1655,115576,0,295,319,800,8480,28326,37695,77401,11851096000,15317000,13430000,16305000,45820000,491245000,1982811000,2525035000,9279906000
Louisiana,Manufacturing,2014,15023,5265,2530,2170,9965,2679,896,13540,1483,16275,5265,2530,2175,9970,2825,1210,14005,2270,535475,7614,13973,23062,49776,90670,68636,240461,260962,34970073000,364666000,557895000,1077467000,2187999000,4729400000,4016880000,12588745000,19452099000
Louisiana,"Mining, Quarrying, and Oil and Gas Extraction",2014,6995,3475,865,574,4914,1035,437,6386,609,8560,3475,870,590,4935,1185,580,6700,1860,287270,5104,5719,7878,18812,39751,51837,110455,176715,24515251000,364562000,362444000,515197000,1242788000,2907113000,4640922000,8793776000,15719935000
Louisiana,Other,2014,154,145,8,1,154,0,0,154,0,154,145,8,1,154,0,0,154,0,0,0,0,0,0,0,0,0,0,4963000,3451000,1107000,0,4963000,0,0,4963000,0
Louisiana,Other Services (except Public Administration),2014,44616,26545,9260,4569,40374,3110,524,44008,608,47860,26555,9300,4790,40645,3935,965,45545,2315,387682,51538,60045,58183,171987,108640,38817,327477,44316,11667145000,1278492000,1442686000,1579835000,4321586000,2975388000,1389596000,8903617000,2346656000
Louisiana,"Professional, Scientific, and Technical Services",2014,56760,39598,7718,4243,51559,3192,803,55554,1206,60990,39620,7765,4310,51695,3875,1260,56830,4160,501163,58861,49911,55581,166361,103251,71054,345934,121080,30925701000,3137172000,2321498000,3076122000,8558902000,6937850000,5440820000,21257393000,8905924000
Louisiana,Real Estate and Rental and Leasing,2014,18385,12970,2239,1054,16263,985,532,17780,605,24045,12970,2285,1200,16455,1495,2320,20270,3775,164103,18599,13662,12996,45820,28775,37635,116083,35998,8408020000,709359000,508720000,599492000,1828115000,1470671000,2029634000,5469769000,2412061000
Louisiana,Retail Trade,2014,52350,27655,10964,6096,44715,4805,967,50487,1863,82980,27765,11205,6650,45620,7065,2950,55635,27345,1009453,48999,70904,74024,204040,171030,72929,460012,486183,25812966000,1330997000,1744748000,2096587000,5232957000,5677053000,2652533000,13846479000,11373955000
Louisiana,Total,2014,81289,44000,14877,9251,68128,8748,2176,79052,2237,104976,44058,15042,9697,68797,11357,5972,86126,18850,1717797,77572,97805,123199,298576,331997,279793,910366,807431,76730689000,3114495000,3270797000,4303312000,10688604000,12606893000,12598080000,35893577000,40837112000
Louisiana,Transportation and Warehousing,2014,15286,7830,2185,1512,11527,1679,706,13912,1374,19645,7835,2185,1535,11555,1830,1030,14415,5230,332737,11413,11658,18192,44299,54228,45474,158381,149961,20500077000,602330000,501848000,853682000,2011782000,2708441000,3522259000,8615216000,10375295000
Louisiana,Utilities,2014,1090,590,250,60,900,55,48,1003,87,2530,590,255,60,905,90,165,1160,1370,4107,1245,1562,573,3527,2180,4947,11947,208,819861000,29667000,43909000,23125000,100621000,102316000,311307000,574423000,223346000
Louisiana,Wholesale Trade,2014,21179,8280,3495,2911,14686,3137,1325,19148,2031,27410,8295,3565,3065,14925,3930,2545,21400,6010,377385,13810,21374,35711,74858,92566,58110,236726,124980,21935853000,738926000,1128996000,1867998000,3787188000,5099826000,3435590000,12748308000,8260098000
Maine,Accommodation and Food Services,2014,17976,8760,3135,2965,14860,2550,270,17680,296,20495,8800,3135,3020,14955,3085,1080,19120,1375,243000,9423,21044,41038,71780,89087,31870,196244,43129,4837686000,621210000,450307000,768304000,1844984000,1673899000,518129000,4094200000,685407000
Maine,Administrative and Support and Waste Management and Remediation Services,2014,9687,6470,1210,655,8335,668,185,9188,499,10340,6470,1215,675,8360,800,230,9390,950,108756,7456,7174,7549,22273,20920,14465,61879,37976,3324148000,349498000,219816000,220661000,825224000,693851000,395189000,2108855000,957923000
Maine,"Agriculture, Forestry, Fishing and Hunting",2014,4140,3435,330,170,3935,175,20,4130,10,4185,3435,330,170,3935,190,40,4165,20,15729,186,2018,2220,7266,5469,0,15464,0,686285000,155951000,68117000,86498000,319541000,232108000,0,662425000,0
Maine,"Arts, Entertainment, and Recreation",2014,4242,2800,625,340,3765,365,62,4192,50,4325,2800,625,350,3775,390,110,4275,50,34598,2638,3738,4045,10882,11918,5931,32988,2470,815909000,172302000,108133000,94128000,394759000,262972000,61123000,762596000,48718000
Maine,Construction,2014,23549,18120,2850,1457,22427,973,75,23475,74,23645,18120,2850,1460,22430,1010,80,23520,125,113861,25950,18046,18826,64288,31307,4784,105438,2783,5535510000,1056881000,723093000,881187000,2684802000,1700665000,319155000,5025200000,169287000
Maine,Educational Services,2014,2324,1135,385,285,1805,308,110,2223,101,2440,1135,385,285,1805,330,145,2280,160,90103,1137,2476,3846,7536,11202,15552,36624,53250,2553627000,48209000,55048000,101430000,212362000,303153000,507838000,1111665000,1434905000
Maine,Finance and Insurance,2014,4627,2400,605,295,3300,466,210,3976,651,9430,2400,620,365,3385,1305,1635,6325,3105,123565,3619,3261,3175,11020,17469,21850,52518,62451,8493721000,176413000,159823000,204597000,561333000,991492000,1195918000,2884233000,4986981000
Maine,Health Care and Social Assistance,2014,16058,7600,3065,1915,12580,1741,981,15302,756,23660,7615,3085,1980,12680,2950,3715,19345,4315,534817,12740,19751,23678,58001,70751,120414,252840,272914,23081220000,466654000,770285000,1059432000,2355520000,2226925000,3962881000,8624109000,14076252000
Maine,Information,2014,2673,1335,380,205,1920,304,118,2342,331,3830,1335,380,210,1925,370,250,2545,1285,43846,1838,1786,1886,6355,8997,7537,27881,11920,2539697000,62854000,63592000,78243000,238810000,388330000,350718000,1161462000,853905000
Maine,Management of Companies and Enterprises,2014,867,60,20,40,120,160,286,566,301,1095,60,20,40,120,160,300,580,515,42232,52,36,0,200,1916,6961,9100,32880,3286699000,5070000,4652000,0,18030000,97690000,316504000,433399000,2851124000
Maine,Manufacturing,2014,7947,3544,1300,995,5839,1208,408,7455,492,8225,3560,1300,1000,5860,1275,470,7605,620,174401,3546,5878,9302,22452,34703,23104,101047,59499,8733162000,190461000,225554000,396192000,917184000,1639610000,1088591000,4367844000,3523556000
Maine,"Mining, Quarrying, and Oil and Gas Extraction",2014,96,75,0,0,75,15,0,90,6,100,75,0,0,75,15,0,90,10,0,69,0,0,69,0,0,0,0,15643000,4978000,0,0,4978000,0,0,11614000,0
Maine,Other,2014,77,73,4,0,77,0,0,77,0,77,73,4,0,77,0,0,77,0,0,0,22,0,0,0,0,0,0,2005000,1739000,266000,0,2005000,0,0,2005000,0
Maine,Other Services (except Public Administration),2014,17283,11865,3275,1063,16203,672,143,17018,265,18280,11875,3315,1145,16335,945,365,17645,635,89857,20916,19923,12965,55158,18103,4431,83771,3493,2494463000,561766000,525904000,359637000,1453684000,530041000,100485000,2253439000,135586000
Maine,"Professional, Scientific, and Technical Services",2014,16529,11290,2443,1100,14833,882,208,15923,606,17430,11290,2450,1130,14870,1080,280,16230,1200,114997,12349,15369,13408,46805,25753,10558,86790,23115,6970452000,756736000,703227000,696457000,2183378000,1543516000,853341000,4836030000,1829809000
Maine,Real Estate and Rental and Leasing,2014,7204,5625,718,330,6673,219,70,6962,242,8005,5625,735,360,6720,375,145,7240,765,29801,7003,4004,3472,15098,4968,1153,23782,3959,1190116000,296074000,158222000,136724000,611413000,177603000,47771000,924088000,188714000
Maine,Retail Trade,2014,22216,11397,4358,2921,18676,1913,400,20989,1227,31520,11410,4465,3160,19035,2860,1635,23530,7990,376333,16881,25134,33266,77318,55538,30842,179107,99345,9782647000,520072000,657237000,857071000,2103328000,1715323000,1160747000,5304442000,2819598000
Maine,Total,2014,33292,20616,5269,3133,29018,2598,609,32225,1067,40369,20644,5328,3302,29274,3687,2288,35249,5120,492690,31760,34569,41877,108206,95629,79670,283505,209185,19631807000,1199982000,1098095000,1389798000,3687875000,3369995000,3014739000,10072609000,9559198000
Maine,Transportation and Warehousing,2014,5568,3490,704,470,4664,400,134,5198,370,6090,3490,720,480,4690,460,200,5350,740,58231,4436,3870,4629,14886,12092,4650,34837,11965,2254714000,172655000,132182000,179479000,527356000,433367000,182997000,1257908000,597975000
Maine,Utilities,2014,241,95,25,20,140,10,35,185,56,490,95,25,30,150,10,125,285,205,5389,86,88,0,449,0,110,3406,0,581836000,7017000,1865000,13501000,34688000,0,7250000,236312000,320185000
Maine,Wholesale Trade,2014,6858,3260,960,601,4821,721,393,5935,923,7875,3265,965,650,4880,825,635,6340,1535,78833,3964,4749,5544,17044,14055,11160,52227,19477,4281770000,213969000,208246000,285088000,801326000,696541000,600504000,2526814000,1240261000
Maryland,Accommodation and Food Services,2014,45331,18095,8315,7536,33946,9349,975,44270,1061,57580,18115,8355,7585,34055,10260,2425,46740,10840,1060684,31456,54655,101945,189134,353717,114673,661313,397910,19184919000,975442000,859940000,1614196000,3461242000,6112831000,2020011000,11695600000,7463119000
Maryland,Administrative and Support and Waste Management and Remediation Services,2014,36021,20430,5165,3513,29108,4032,1281,34421,1600,41555,20455,5175,3550,29180,4195,1620,34995,6560,900631,29738,33494,45698,111102,154316,148090,425548,471507,35573070000,1471637000,1246136000,1828256000,4586319000,5888613000,5058463000,16121262000,19235940000
Maryland,"Agriculture, Forestry, Fishing and Hunting",2014,953,740,115,35,890,35,10,935,18,965,740,115,35,890,35,10,935,30,6120,91,421,272,2092,725,0,3717,952,208280000,32867000,22381000,8221000,69023000,24273000,0,130129000,31018000
Maryland,"Arts, Entertainment, and Recreation",2014,9465,5260,1280,1020,7560,1365,285,9210,255,10320,5260,1280,1035,7575,1485,460,9520,800,186436,5187,7850,12968,27544,53122,33554,119198,38541,5446449000,361234000,210138000,270827000,875269000,1195284000,1150235000,3310283000,634405000
Maryland,Construction,2014,68936,43510,10680,6785,60975,6292,1065,68332,604,69415,43510,10685,6785,60980,6355,1200,68535,880,720708,68627,69416,90606,229822,238336,141408,615340,84205,41701866000,3083796000,3108484000,4626187000,10820973000,13656699000,8327204000,33148375000,6947606000
Maryland,Educational Services,2014,9631,4555,1460,1197,7212,1548,574,9334,297,10405,4555,1470,1255,7280,1675,755,9710,695,404500,5860,9305,15809,31869,63002,77276,174493,223800,18705660000,254540000,242949000,380032000,889769000,1948536000,3261680000,6139583000,12314619000
Maryland,Finance and Insurance,2014,20984,12475,3244,1398,17117,1273,860,19250,1734,38055,12485,3290,1650,17425,2630,2740,22795,15260,467527,20755,20230,16983,59734,41975,61738,170925,254430,44302003000,1223511000,1261939000,1450860000,4004170000,3603090000,6114168000,14216314000,27038287000
Maryland,Health Care and Social Assistance,2014,62433,30170,13780,8126,52076,6458,2171,60705,1728,80775,30265,13965,8575,52805,9695,7405,69905,10870,1778266,56587,90626,105490,256090,238918,319263,826102,924017,84132310000,2880751000,4249512000,5111962000,12260969000,11079561000,11984381000,35736787000,46863795000
Maryland,Information,2014,7121,3470,805,610,4885,862,330,6077,1044,12690,3475,805,630,4910,965,435,6310,6380,258573,3243,4291,7224,17419,25027,30817,79135,174168,20245314000,321880000,331359000,525102000,1214373000,1772592000,2515372000,5854728000,13964434000
Maryland,Management of Companies and Enterprises,2014,3098,160,35,110,305,557,912,1774,1324,5915,160,35,110,305,585,950,1840,4075,259050,0,22,471,960,7324,30156,38440,220610,24748611000,35070000,18768000,82485000,137480000,713990000,2062751000,2914221000,21834390000
Maryland,Manufacturing,2014,14454,5925,2260,1899,10084,2347,882,13313,1141,15005,5925,2260,1915,10100,2420,1015,13535,1470,419468,7607,11645,20292,45430,70468,57303,204505,160763,26218807000,408259000,472090000,886917000,2008879000,3606506000,3178501000,10228918000,12453778000
Maryland,"Mining, Quarrying, and Oil and Gas Extraction",2014,300,75,60,35,170,55,20,245,55,360,75,60,35,170,55,40,265,95,5190,0,305,0,698,1073,0,1948,1529,307002000,5737000,16210000,0,39897000,79335000,0,165495000,93672000
Maryland,Other,2014,292,280,8,4,292,0,0,292,0,292,280,8,4,292,0,0,292,0,0,0,51,0,0,0,0,0,0,7298000,6597000,403000,0,7298000,0,0,7298000,0
Maryland,Other Services (except Public Administration),2014,63701,37935,12546,7007,57488,4841,712,63041,660,68220,37960,12595,7170,57725,5510,1365,64600,3620,563245,69436,81454,91264,246970,171611,61530,489399,44106,20810823000,2224911000,2370702000,2812068000,7437370000,6090893000,2936705000,16809585000,2838931000
Maryland,"Professional, Scientific, and Technical Services",2014,90524,60846,11345,6903,79094,6899,2264,88257,2267,101780,60865,11390,7040,79295,7420,2875,89590,12190,1380210,72908,73761,89954,254157,244356,214997,720830,648474,118750384000,5855063000,4801397000,6274207000,16957899000,20177655000,17676437000,55300389000,62066866000
Maryland,Real Estate and Rental and Leasing,2014,22321,15793,2436,1204,19433,1393,686,21512,809,31090,15815,2455,1340,19610,1945,2980,24535,6555,212508,15768,15008,14351,51970,40958,41311,138301,55845,12346760000,1050308000,643257000,884166000,2602078000,2796539000,2438934000,8042949000,3694723000
Maryland,Retail Trade,2014,57165,31024,11732,6390,49146,4222,1303,54671,2494,90855,31165,11980,6855,50000,5795,3945,59740,31115,1405700,50197,71186,74394,197063,132214,104018,468528,846300,37455688000,1488549000,1949420000,2275348000,5801565000,4927293000,4269622000,15469807000,20830110000
Maryland,Total,2014,108445,62356,18107,11526,91989,10900,2768,105657,2788,136501,62443,18266,11957,92666,13245,6601,112512,23989,2216867,104564,119224,153378,377166,405431,333403,1116000,1100867,114337860000,4680790000,4747845000,6458042000,15886677000,18695681000,17116795000,51699153000,62638707000
Maryland,Transportation and Warehousing,2014,15313,8400,2030,1545,11975,1486,568,14029,1284,16980,8400,2030,1560,11990,1580,715,14285,2695,308714,12087,12404,19049,45462,46109,23163,120179,128183,13286000000,464865000,444844000,666592000,1627461000,1778020000,976357000,4635851000,6058933000
Maryland,Utilities,2014,259,85,20,15,120,15,25,160,99,690,85,25,15,125,15,65,205,485,47393,9,0,0,185,0,1695,1903,42204,5220628000,8146000,2962000,0,24796000,0,179715000,201753000,4661212000
Maryland,Wholesale Trade,2014,24065,11500,3303,2538,17341,3126,1363,21830,2235,28390,11505,3320,2625,17450,3605,2005,23060,5330,431461,15173,19600,30531,72534,92414,78728,254293,149186,29399071000,989592000,1142220000,1932161000,4190814000,5963468000,4683258000,15300506000,12316167000
Massachusetts,Accommodation and Food Services,2014,68935,27590,13661,12495,53746,13133,1083,67962,973,86345,27645,13695,12625,53965,14775,4355,73095,13250,1379887,45891,90581,170836,308321,477102,154756,942250,422827,29051590000,1719995000,1569238000,2870760000,6161530000,9145395000,3117774000,18465275000,9309586000
Massachusetts,Administrative and Support and Waste Management and Remediation Services,2014,45913,30160,5630,3538,39328,3489,1390,44207,1706,52000,30165,5645,3590,39400,3645,1575,44620,7380,946884,36105,35945,46040,119859,131453,184901,444983,487687,43721319000,2470953000,1741050000,2202710000,6494886000,6020252000,7660266000,20512947000,22177121000
Massachusetts,"Agriculture, Forestry, Fishing and Hunting",2014,1680,1335,225,85,1645,30,0,1675,5,1680,1335,225,85,1645,30,0,1675,5,4916,217,1352,783,3849,192,0,4880,0,186584000,64210000,26511000,18839000,122651000,10604000,0,174456000,0
Massachusetts,"Arts, Entertainment, and Recreation",2014,14989,8170,2255,1812,12237,2108,409,14754,235,16250,8175,2255,1845,12275,2330,780,15385,865,272260,9361,14752,23718,50001,79593,52098,187641,63878,9555742000,682623000,495598000,769462000,1979073000,1831135000,1962024000,6109237000,1430858000
Massachusetts,Construction,2014,86292,61605,12940,6295,80840,4378,674,85892,400,86540,61605,12940,6295,80840,4410,710,85960,580,578630,93888,83447,82901,262090,160951,90416,520930,50074,41191050000,4986375000,4552822000,5433110000,14982555000,12706914000,7837536000,36155310000,4339529000
Massachusetts,Educational Services,2014,14084,6335,2323,1840,10498,2080,972,13550,534,15065,6335,2335,1895,10565,2230,1290,14085,980,1072221,10049,15267,24345,49843,85973,154273,292991,774976,44625907000,381103000,423614000,595323000,1414660000,3084103000,6222762000,10762512000,33706802000
Massachusetts,Finance and Insurance,2014,26871,14955,3969,2002,20926,2387,1337,24650,2221,47605,14970,4125,2330,21425,4140,5560,31125,16480,884303,21123,24144,23559,76703,78184,119157,279788,595202,115360021000,2414007000,2328681000,2724228000,7685659000,9153210000,11251467000,28319210000,86150645000
Massachusetts,Health Care and Social Assistance,2014,66217,28890,14138,9483,52511,7840,3397,63748,2469,92905,28930,14250,9900,53080,10590,10160,73830,19075,3035115,53597,93232,125640,275582,296565,519054,1101822,1750563,151192630000,3021834000,4375993000,6405243000,13846134000,13679735000,19777434000,47645007000,99707311000
Massachusetts,Information,2014,11399,4985,1590,1105,7680,1475,762,9917,1482,18560,4985,1590,1110,7685,1600,905,10190,8370,549062,6271,9814,12733,30413,49756,72614,164662,377679,58494602000,514476000,596428000,1002407000,2155993000,4724744000,8187876000,15417199000,42291744000
Massachusetts,Management of Companies and Enterprises,2014,3833,295,90,85,470,580,962,2012,1821,6075,295,90,90,475,600,1000,2075,4000,437100,394,475,685,1561,8574,35212,45347,391753,52984495000,96720000,46230000,49245000,201453000,744946000,3285218000,4234925000,48732513000
Massachusetts,Manufacturing,2014,32316,11625,5850,4595,22070,6365,1785,30220,2096,33270,11625,5855,4615,22095,6510,1950,30555,2715,1030718,17036,33964,55989,117077,231433,174073,573854,396874,70639017000,990172000,1712236000,2907551000,5937194000,13037605000,11655724000,33462547000,32937222000
Massachusetts,"Mining, Quarrying, and Oil and Gas Extraction",2014,338,130,55,60,245,49,19,313,25,395,130,55,60,245,65,55,365,30,3132,141,0,575,980,730,58,2687,0,243215000,18678000,11500000,39084000,67928000,73369000,3698000,198646000,0
Massachusetts,Other,2014,509,476,25,6,507,2,0,509,0,509,476,25,6,507,2,0,509,0,754,0,159,0,686,0,0,754,0,22858000,15796000,4861000,1210000,21867000,0,0,22858000,0
Massachusetts,Other Services (except Public Administration),2014,81561,49860,17545,8512,75917,4278,706,80901,660,88110,49895,17670,8965,76530,5120,2030,83680,4430,614461,94719,113609,110472,321131,140087,64159,535707,60414,20272720000,2951553000,3220972000,3235534000,9417544000,4693909000,2600090000,17079351000,2353031000
Massachusetts,"Professional, Scientific, and Technical Services",2014,101346,67777,13640,7745,89162,6936,2279,98377,2969,107350,67790,13665,7845,89300,7445,2670,99415,7935,1305230,91858,87882,99586,288559,240569,207071,750189,532508,133843708000,7297547000,5843596000,7961511000,21168990000,24432481000,21715049000,67876941000,65470194000
Massachusetts,Real Estate and Rental and Leasing,2014,25878,18843,3175,1380,23398,1279,496,25173,705,33615,18935,3315,1485,23735,1930,1965,27630,5985,210269,28324,18978,16962,66580,40137,37090,149836,55695,13761529000,1544410000,997816000,1059387000,3638865000,2409890000,2224626000,8462135000,4652873000
Massachusetts,Retail Trade,2014,80641,47080,15787,8198,71065,5562,1482,78109,2532,120680,47285,16145,8870,72300,8010,4715,85025,35655,1767566,74312,94678,94007,271482,171651,105389,577515,736562,49999397000,2574202000,2852963000,3302834000,8715359000,7566560000,4673321000,21893378000,19886645000
Massachusetts,Total,2014,140226,81264,24134,14937,120335,13241,3484,137060,3166,173575,81381,24367,15502,121250,16057,8626,145933,27642,3087030,136504,158228,199456,494188,493534,458360,1446082,1640948,185352860000,6886131000,6815850000,9179790000,22881771000,25804134000,26466970000,75152875000,110199985000
Massachusetts,Transportation and Warehousing,2014,16179,8605,2185,1764,12554,1695,753,15002,1177,18130,8610,2190,1785,12585,1810,915,15310,2820,394137,10823,13190,21817,48588,55332,52939,166304,181820,17838899000,545547000,509786000,880416000,2023011000,2142148000,1868561000,6333587000,9225318000
Massachusetts,Utilities,2014,487,180,35,25,240,55,69,364,123,1380,180,35,25,240,55,130,425,955,38511,0,110,0,581,1888,4046,7132,1170,4052580000,11843000,13428000,6683000,40153000,197739000,489624000,787925000,3234708000
Massachusetts,Wholesale Trade,2014,34228,15620,5610,3961,25191,4448,1873,31512,2716,39375,15635,5630,4065,25330,4980,2365,32675,6700,676442,24343,35141,48317,113357,141833,108600,384872,265467,57166956000,1776666000,2326567000,3422581000,7643362000,10496471000,8504656000,28019141000,27622747000
Michigan,Accommodation and Food Services,2014,75358,27710,13951,15226,56887,15952,1327,74166,1192,98280,27755,14025,15380,57160,18425,5590,81175,17105,1779055,42976,93600,208754,346375,573777,204568,1126232,639109,28165030000,1229249000,1158976000,2621203000,5015855000,8256571000,2731156000,16013758000,12116180000
Michigan,Administrative and Support and Waste Management and Remediation Services,2014,50241,31140,6525,4297,41962,4639,1702,48303,1938,58835,31155,6560,4375,42090,4890,2205,49185,9650,1595514,38374,42977,56546,141533,183311,282923,611304,954886,49927436000,2156870000,1481846000,2032413000,5698707000,6639948000,9204620000,21692572000,27359031000
Michigan,"Agriculture, Forestry, Fishing and Hunting",2014,2659,1890,410,150,2450,144,35,2629,30,2665,1890,410,150,2450,145,35,2630,35,17173,2416,2461,1999,7571,4291,2578,15730,810,663776000,101030000,82174000,71919000,260305000,162950000,100458000,604476000,51073000
Michigan,"Arts, Entertainment, and Recreation",2014,16075,9720,2170,1810,13700,1824,330,15854,221,16870,9735,2185,1860,13780,1945,490,16215,655,222694,10190,13726,23803,50271,65561,40429,168034,35784,7603959000,681644000,348269000,500902000,1567423000,1404140000,3414182000,6634750000,699701000
Michigan,Construction,2014,91030,64665,13415,7073,85153,4862,610,90625,405,91705,64665,13415,7080,85160,5005,805,90970,735,605715,91006,87275,92945,274061,171256,78020,531690,56177,37023645000,4897750000,4193368000,5159921000,14274490000,11067297000,5483725000,31396005000,4056763000
Michigan,Educational Services,2014,10568,5140,1655,1350,8145,1616,478,10239,329,11895,5150,1660,1360,8170,1830,765,10765,1130,368262,6803,11042,17265,36703,66174,69866,176237,188069,10324404000,247085000,221182000,384107000,856883000,1558673000,2289701000,4804549000,5445700000
Michigan,Finance and Insurance,2014,34583,22140,5394,2223,29757,2120,1017,32894,1689,65020,22185,5440,2585,30210,5185,4980,40375,24645,740220,38069,33743,27864,104300,78666,97181,284591,350327,51766038000,1875471000,1654789000,1754950000,5361749000,4407760000,5759502000,15782059000,35810197000
Michigan,Health Care and Social Assistance,2014,101888,46035,25036,15056,86127,10485,3260,99872,2016,131895,46095,25245,15655,86995,14790,11065,112850,19045,2963776,86354,167399,196755,453023,398648,492937,1351562,1595751,132197815000,4036346000,6739702000,8762920000,19592822000,16338332000,16957526000,53081612000,78240018000
Michigan,Information,2014,11443,6530,1490,962,8982,977,385,10344,1099,18825,6530,1490,985,9005,1180,605,10790,8035,337430,4854,8343,11637,30511,33835,29933,107320,226081,22906154000,356894000,344864000,578747000,1292865000,1751023000,1534842000,5488943000,17336557000
Michigan,Management of Companies and Enterprises,2014,5270,245,75,125,445,1060,1510,3015,2255,7960,245,80,130,455,1085,1595,3135,4825,561217,364,25,986,1688,12085,46589,60282,500935,59924470000,58139000,927000,82273000,179967000,852315000,2959437000,3996085000,55935186000
Michigan,Manufacturing,2014,58135,19585,9834,8927,38346,11838,4350,54534,3601,61805,19590,9835,8960,38385,12360,5455,56200,5605,2594977,31716,60853,115650,218118,457589,528743,1265375,1230820,144681136000,1561389000,2541087000,5457896000,9890453000,23074281000,27682801000,63078466000,75721127000
Michigan,"Mining, Quarrying, and Oil and Gas Extraction",2014,1593,785,225,174,1184,195,56,1435,158,1750,785,230,185,1200,215,65,1480,270,24172,414,1272,2202,4800,5843,2245,13431,7151,1764878000,87222000,72539000,152606000,316935000,416441000,136264000,914185000,786317000
Michigan,Other,2014,539,521,12,5,538,1,0,539,0,539,521,12,5,538,1,0,539,0,0,0,0,60,0,0,0,0,0,9175000,7882000,881000,362000,9125000,0,0,9175000,0
Michigan,Other Services (except Public Administration),2014,106357,65195,23205,10301,98701,6138,855,105694,663,114695,65255,23400,10905,99560,8275,2405,110240,4455,771239,123663,150422,130088,409465,204025,76941,701735,45615,21244753000,3031869000,3530546000,3269724000,9894821000,5695188000,2546949000,18493781000,1930532000
Michigan,"Professional, Scientific, and Technical Services",2014,99643,67448,13883,7851,89182,6112,1870,97164,2479,107340,67480,13935,8060,89475,7330,3355,100160,7180,1225236,95143,90589,102968,293444,213791,178173,693817,518858,88794757000,5305335000,4821790000,6121584000,16293590000,15008929000,12450154000,44079245000,44581233000
Michigan,Real Estate and Rental and Leasing,2014,29530,21005,3922,1800,26727,1407,671,28805,725,38260,21085,4050,1925,27060,2395,2380,31835,6425,242568,30690,24226,21671,78851,44231,36967,162347,79297,10162533000,1147094000,837835000,828149000,2830394000,1779238000,1540669000,6355861000,3447345000
Michigan,Retail Trade,2014,113059,66276,22796,11182,100254,8391,1837,110482,2577,173430,66435,23225,12475,102135,13185,8035,123355,50075,2276667,110327,139996,136939,393223,300377,186789,926483,1235247,57262174000,2974885000,3422880000,3773052000,10271950000,10337430000,6285766000,27334991000,28155671000
Michigan,Total,2014,172661,99263,30745,19125,149133,16524,3809,169466,3195,218281,99391,31055,20022,150468,21611,11114,183193,35088,3610530,165398,203279,256126,624803,627066,545626,1797495,1813035,165444213000,6638337000,7003224000,9495430000,23136991000,25130104000,24027512000,72294607000,93149606000
Michigan,Transportation and Warehousing,2014,25512,15460,3059,2254,20773,2412,859,24044,1468,29400,15460,3075,2285,20820,2635,1185,24640,4760,476696,10506,19212,28118,70189,82741,62562,222594,202143,21918496000,832613000,751016000,1150492000,2766840000,3460653000,2827228000,9349871000,10100089000
Michigan,Utilities,2014,556,195,60,40,295,50,59,404,152,1910,195,60,65,320,60,220,600,1310,61005,115,280,0,764,1649,5366,8270,9628,10036148000,13102000,13905000,21495000,62943000,119662000,415252000,615787000,5339170000
Michigan,Wholesale Trade,2014,46341,22634,6840,5391,34865,5824,2438,43127,3214,56170,22660,6895,5665,35220,7115,4335,46670,9500,856495,28850,42871,67811,152392,189441,143157,508379,318379,55509980000,2327306000,2420155000,4049755000,8880550000,11454708000,8841939000,30230805000,23899449000
Minnesota,Accommodation and Food Services,2014,42262,13723,7638,8927,30288,9938,1070,41296,966,56975,13765,7650,9040,30455,11405,3475,45335,11640,1153770,19631,52176,122247,193293,370106,149745,721026,423563,18815435000,646455000,640789000,1542626000,2833245000,5599022000,2329763000,10845795000,7894897000
Minnesota,Administrative and Support and Waste Management and Remediation Services,2014,32674,20545,4472,2680,27697,2712,873,31282,1392,37135,20550,4500,2705,27755,2975,1115,31845,5290,826390,25120,28293,34242,91703,96502,112600,318339,489750,30036716000,1262389000,992512000,1223139000,3509478000,3537633000,3400332000,11421321000,17819902000
Minnesota,"Agriculture, Forestry, Fishing and Hunting",2014,2490,1695,445,195,2335,105,15,2455,35,2540,1695,445,195,2335,110,35,2480,60,12333,2105,2690,1583,7854,3088,162,11758,526,481279000,98774000,103216000,63657000,277545000,147178000,6600000,450723000,26996000
Minnesota,"Arts, Entertainment, and Recreation",2014,13325,8410,1840,1252,11502,1348,285,13135,190,14115,8410,1840,1305,11555,1465,345,13365,750,224515,8922,11431,13566,35889,46106,41168,131477,43099,6591564000,417694000,249649000,276083000,964004000,835402000,946183000,2839199000,2633680000
Minnesota,Construction,2014,80112,59815,10525,5094,75434,3663,563,79660,452,80620,59815,10525,5095,75435,3795,635,79865,755,532425,80746,67583,66391,217388,135081,68870,426690,65993,36921510000,4393820000,3523604000,4023525000,11959829000,9587029000,5295369000,27197193000,5898569000
Minnesota,Educational Services,2014,8864,3985,1285,1125,6395,1827,345,8567,297,9515,3985,1285,1140,6410,1970,475,8855,660,357941,5866,8299,15034,29562,75543,51580,160048,188685,9745415000,202093000,174689000,317057000,706733000,2015226000,1723114000,4490790000,4979998000
Minnesota,Finance and Insurance,2014,30455,20110,3921,1722,25753,1951,854,28558,1897,46740,20145,4025,2060,26230,4285,3705,34220,12520,745322,27087,24250,20977,75276,66086,68757,221356,470626,63561895000,1625445000,1310905000,1410981000,4371039000,4707787000,4439372000,14103023000,47482840000
Minnesota,Health Care and Social Assistance,2014,51838,23195,9249,6833,39277,7466,3387,50130,1708,79190,23225,9325,7215,39765,10395,12180,62340,16850,2206250,32266,62062,88927,192327,304901,531121,1039423,1148354,89335343000,1675555000,2501495000,3335259000,7535883000,10731930000,15818188000,34360071000,53820207000
Minnesota,Information,2014,8349,4010,1085,905,6000,968,340,7308,1041,13035,4015,1085,910,6010,1215,860,8085,4950,267867,4460,6437,11089,24637,30962,37887,98105,165493,20264731000,337793000,272165000,568622000,1220943000,1842978000,2408291000,5660692000,14124002000
Minnesota,Management of Companies and Enterprises,2014,3885,155,75,100,330,675,1171,2176,1709,5905,155,75,100,330,715,1225,2270,3635,714775,0,292,597,1046,9010,38720,48925,665644,66641895000,23532000,30749000,25077000,73600000,533940000,2937590000,3555830000,63030653000
Minnesota,Manufacturing,2014,34094,12805,5520,4410,22735,6477,2334,31546,2548,36375,12805,5520,4430,22755,6755,2855,32365,4010,1394085,18104,31886,53001,112351,245737,251179,656077,608959,78377249000,917846000,1382389000,2439720000,4958346000,12566632000,13885128000,33909562000,37146311000
Minnesota,"Mining, Quarrying, and Oil and Gas Extraction",2014,696,385,85,70,540,60,31,631,65,805,385,85,75,545,65,40,650,155,29879,572,213,323,1522,1369,228,5142,24576,2805451000,44446000,36891000,37962000,146436000,111129000,19088000,443354000,2321148000
Minnesota,Other,2014,261,253,6,2,261,0,0,261,0,261,253,6,2,261,0,0,261,0,0,0,36,0,0,0,0,0,0,5226000,4551000,491000,0,5226000,0,0,5226000,0
Minnesota,Other Services (except Public Administration),2014,71478,42600,14794,7825,65219,4927,745,70891,587,77265,42630,14965,8280,65875,6445,2080,74400,2865,578818,78556,95811,103151,279939,162134,67421,518864,40375,15623730000,2000271000,2211662000,2496437000,6734052000,4327618000,2248067000,13470491000,1849367000
Minnesota,"Professional, Scientific, and Technical Services",2014,78890,57965,8455,5047,71467,4090,1382,76939,1951,83050,57995,8525,5200,71720,4725,1755,78200,4850,829754,62569,53579,64595,189527,137343,113092,451767,359789,63154163000,4330593000,2892059000,3817146000,11101170000,10574448000,8964720000,31038490000,31626681000
Minnesota,Real Estate and Rental and Leasing,2014,25934,20228,2338,1028,23594,1106,555,25255,679,32450,20250,2440,1105,23795,1865,2105,27765,4685,181764,23210,14463,12961,52946,35892,31216,121969,45265,8206461000,1048389000,542316000,501371000,2082932000,1426533000,1129586000,4677344000,3226317000
Minnesota,Retail Trade,2014,61698,30546,13423,7988,51957,5729,1571,59257,2441,94965,30605,13645,8770,53020,8810,5780,67610,27355,1379230,50501,83655,98060,238737,197168,128617,589048,703971,36362050000,1457384000,1935354000,2548574000,5995680000,6011790000,4232205000,16581178000,18223761000
Minnesota,Total,2014,117789,70076,18451,12110,100637,11468,2937,115042,2747,147483,70148,18656,12698,101502,14894,8578,124974,22509,2566086,107485,121789,162330,391604,437088,401670,1230362,1335724,126186474000,4559098000,4315383000,5809982000,14684463000,17701411000,17294965000,49680839000,76505635000
Minnesota,Transportation and Warehousing,2014,20884,12670,2405,1864,16939,2042,710,19691,1193,22995,12675,2425,1875,16975,2185,975,20135,2860,342013,4258,15103,22976,51742,70316,52882,188442,136221,13908497000,676099000,614463000,845789000,2182890000,2425351000,2077190000,6843635000,6733883000
Minnesota,Utilities,2014,634,110,40,75,225,176,81,482,152,1675,110,40,80,230,235,130,595,1080,18072,0,0,856,1343,5934,4851,12386,396,1540165000,5783000,6442000,66285000,93391000,461541000,392903000,963116000,31075000
Minnesota,Wholesale Trade,2014,34003,16219,4812,3747,24778,4327,1973,31078,2925,40760,16260,4850,3900,25010,5055,3120,33185,7575,657125,23399,30274,45159,101805,135728,102046,361143,229261,49243687000,1487259000,1824494000,2823891000,6289484000,9029742000,6483484000,22649861000,18924416000
Mississippi,Accommodation and Food Services,2014,19574,6705,3875,3938,14518,3860,497,18875,699,26855,6710,3875,3985,14570,4460,1695,20725,6130,596511,11036,25919,53497,91085,138666,68810,299256,296107,9676125000,265423000,309340000,664556000,1242411000,1803600000,839786000,3896377000,5764241000
Mississippi,Administrative and Support and Waste Management and Remediation Services,2014,9591,5095,1560,1036,7691,778,358,8827,764,10850,5095,1560,1040,7695,860,450,9005,1845,258343,8363,9181,12706,31793,27459,39735,105675,140440,6572113000,277241000,252938000,371300000,943319000,748509000,981312000,2834827000,3436829000
Mississippi,"Agriculture, Forestry, Fishing and Hunting",2014,3243,1715,850,435,3000,175,25,3200,43,3335,1715,850,435,3000,175,45,3220,115,21331,2395,5574,5217,14544,4536,0,20682,566,851537000,124393000,184112000,184931000,505783000,199310000,0,761889000,57021000
Mississippi,"Arts, Entertainment, and Recreation",2014,3180,1790,460,420,2670,375,65,3110,70,3330,1795,460,425,2680,395,165,3240,90,36891,2523,2292,5162,11466,11742,2590,31118,0,694069000,72747000,57973000,79634000,247171000,190305000,33299000,575201000,0
Mississippi,Construction,2014,18810,11380,3330,2055,16765,1615,225,18605,205,19035,11380,3330,2055,16765,1645,275,18685,350,209501,19120,21331,26985,69681,57690,28283,160167,27497,9258910000,679794000,681950000,1049933000,2428315000,2565911000,1617742000,6770021000,1229273000
Mississippi,Educational Services,2014,2485,970,405,295,1670,515,150,2335,150,3045,970,405,295,1670,550,295,2515,530,91050,1446,2309,3843,8061,22722,15682,47708,42150,2057650000,40397000,49113000,59882000,156834000,506117000,430950000,1120292000,910426000
Mississippi,Finance and Insurance,2014,11340,7505,1405,546,9456,652,360,10468,872,23335,7520,1580,935,10035,2165,2710,14910,8425,163433,13345,7892,5856,29193,21364,26066,79665,80045,8613842000,514249000,303761000,301462000,1163337000,1040820000,1207094000,3513627000,5014630000
Mississippi,Health Care and Social Assistance,2014,24307,10585,6085,3400,20070,2512,907,23489,818,30700,10595,6115,3555,20265,3265,2490,26020,4680,793837,20036,39673,44467,105296,93897,112964,321116,438819,34968157000,1027543000,1573258000,1822775000,4443520000,3581616000,3748826000,12014743000,22468779000
Mississippi,Information,2014,1991,740,330,250,1320,206,99,1625,366,4690,740,335,260,1335,275,220,1830,2860,56081,908,1524,2732,6207,4985,2863,16565,39016,2573125000,42438000,49745000,79303000,195534000,179426000,158551000,644277000,1922190000
Mississippi,Management of Companies and Enterprises,2014,1287,55,41,66,162,245,391,798,489,1650,55,50,70,175,250,420,845,805,39520,80,0,0,424,2121,9370,12035,27373,2993885000,13909000,0,20795000,42171000,106325000,536310000,685395000,2308230000
Mississippi,Manufacturing,2014,9843,2975,1505,1255,5735,1763,939,8437,1406,10835,2975,1505,1260,5740,1815,1165,8720,2115,565865,4005,6925,12737,27340,52554,73375,175857,338317,23924811000,198851000,229093000,446317000,1008976000,2097831000,2676533000,6558324000,15035503000
Mississippi,"Mining, Quarrying, and Oil and Gas Extraction",2014,1757,1069,160,129,1358,165,80,1603,154,1930,1070,160,130,1360,170,110,1640,290,29754,1318,926,1433,3461,5394,4298,14623,12949,2409175000,102019000,51869000,74635000,232764000,472415000,274322000,1055329000,1168771000
Mississippi,Other,2014,108,98,6,4,108,0,0,108,0,108,98,6,4,108,0,0,108,0,173,101,33,39,173,0,0,173,0,2187000,1655000,266000,266000,2187000,0,0,2187000,0
Mississippi,Other Services (except Public Administration),2014,30231,18735,6725,2670,28130,1548,201,29879,352,31915,18745,6780,2780,28305,2015,470,30790,1125,191920,35800,42338,33222,114674,49500,11085,180913,8029,4495675000,784887000,892993000,766775000,2471234000,1205497000,288994000,4095998000,315559000
Mississippi,"Professional, Scientific, and Technical Services",2014,21548,14675,3117,1530,19322,1091,408,20821,727,23805,14680,3145,1600,19425,1655,535,21615,2190,151679,23472,19662,17953,63640,30240,19763,117387,29304,7850505000,1019090000,791789000,860853000,2716453000,1689507000,1015072000,5644234000,2149289000
Mississippi,Real Estate and Rental and Leasing,2014,9393,7150,968,383,8501,364,196,9061,332,11935,7150,970,470,8590,550,590,9730,2205,46895,10156,5814,4297,21829,8029,3615,36395,5895,1643004000,312723000,162476000,175168000,662998000,285873000,142633000,1210798000,381090000
Mississippi,Retail Trade,2014,36778,20129,7651,4050,31830,2774,559,35163,1615,57775,20170,7780,4430,32380,4285,2355,39020,18755,638543,37078,47658,46893,137437,89736,41330,281549,337574,14814943000,833903000,1149994000,1331267000,3347967000,2889734000,1074050000,7580601000,6732390000
Mississippi,Total,2014,44465,24378,8323,4873,37574,4041,1125,42740,1725,58541,24402,8442,5184,38028,5482,3216,46726,11815,912014,45025,54341,64692,164058,146761,121412,432231,479783,32776761000,1423015000,1542155000,1951981000,4917151000,4781872000,4207268000,13906291000,18870470000
Mississippi,Transportation and Warehousing,2014,8731,4460,1270,860,6590,846,307,7743,988,10240,4460,1290,860,6610,900,375,7885,2355,165998,7148,7759,9938,25974,25342,14111,69018,73888,6930511000,249190000,256963000,368820000,904319000,937395000,588890000,2650177000,3317379000
Mississippi,Utilities,2014,1801,1115,395,60,1570,100,72,1742,59,2965,1115,395,70,1580,185,300,2065,900,43834,2604,2336,748,5688,5119,9543,21271,0,3227990000,55613000,68866000,29867000,154346000,294718000,621410000,1110184000,0
Mississippi,Wholesale Trade,2014,11042,4570,1560,1170,7300,1401,824,9525,1517,13940,4580,1595,1245,7420,1795,1415,10630,3310,169260,6536,8687,13173,29872,34203,26775,101740,57335,8301022000,326083000,374018000,627408000,1387597000,1620708000,1348173000,4844630000,3095319000
Missouri,Accommodation and Food Services,2014,45029,15890,7890,8375,32155,10371,1257,43783,1246,62415,15935,7920,8460,32315,11840,4605,48760,13655,1243360,25902,53089,115154,194406,378625,180887,755761,486151,19217225000,599760000,663030000,1527484000,2792685000,5335764000,2539093000,10683460000,8513505000
Missouri,Administrative and Support and Waste Management and Remediation Services,2014,33023,20085,4795,2980,27860,2599,848,31307,1716,37510,20105,4800,2990,27895,2775,1115,31785,5725,825930,29240,31226,37576,100928,93927,90905,302683,501057,25192158000,1002109000,929112000,1223278000,3225738000,3079536000,2749949000,9404139000,15105589000
Missouri,"Agriculture, Forestry, Fishing and Hunting",2014,1305,950,170,80,1200,50,25,1275,30,1320,950,170,80,1200,55,25,1280,40,7874,1347,900,849,3352,1471,714,6355,980,253260000,45436000,30612000,21584000,105564000,44008000,32022000,195315000,47334000
Missouri,"Arts, Entertainment, and Recreation",2014,9859,5470,1400,1222,8092,1304,222,9618,241,10505,5470,1400,1250,8120,1425,325,9870,635,194376,7626,8600,14926,32577,45987,18271,107941,72885,7243919000,303366000,162201000,262868000,741857000,907593000,724611000,2887619000,1586540000
Missouri,Construction,2014,64194,41490,11300,5784,58574,4522,618,63714,480,64830,41490,11300,5795,58585,4610,830,64025,805,540709,68897,73004,77109,219484,160016,65197,454270,63757,30474185000,2610270000,2817938000,3638134000,9129425000,9316500000,4721167000,23665990000,4996451000
Missouri,Educational Services,2014,7092,2970,1030,1040,5040,1355,370,6765,327,7910,2970,1030,1055,5055,1430,445,6930,980,367312,4166,6597,13237,25861,55641,60016,144544,218063,14594638000,127262000,121720000,239782000,496244000,1460938000,1960647000,3951041000,10474689000
Missouri,Finance and Insurance,2014,28712,19375,3417,1220,24012,1968,839,26819,1893,53810,19395,3515,1540,24450,5435,4315,34200,19610,589415,33567,20339,14818,70167,68960,70415,223510,357183,42580180000,1340893000,1007923000,818323000,3193424000,3709870000,4523134000,11857338000,30231620000
Missouri,Health Care and Social Assistance,2014,108447,77235,12000,7830,97065,7054,2445,106564,1883,129510,77255,12060,8120,97435,9290,7565,114290,15220,2020789,33210,78950,103988,238253,295901,340835,923245,1076489,81941184000,2491553000,3105374000,4009462000,9605244000,9951377000,10189935000,30026235000,50950684000
Missouri,Information,2014,6305,2915,839,720,4474,692,313,5479,826,12025,2940,840,760,4540,875,545,5960,6065,276366,4433,5107,8184,18240,21381,17793,63721,209628,17740096000,177654000,202544000,336135000,757302000,1147715000,906243000,3034971000,14576258000
Missouri,Management of Companies and Enterprises,2014,4040,235,65,156,456,710,1188,2354,1686,6050,235,65,160,460,715,1245,2420,3630,418570,212,0,814,1322,7545,34748,43675,374755,40473200000,17979000,0,138038000,190840000,440340000,2595664000,3231540000,37233752000
Missouri,Manufacturing,2014,27816,10330,4536,4133,18999,4698,1819,25516,2300,29730,10330,4545,4150,19025,4990,2230,26245,3485,1071755,16003,25744,48484,98982,162503,169668,481927,505179,54070810000,639214000,894478000,1906545000,3622513000,7254799000,8333167000,21488872000,28069515000
Missouri,"Mining, Quarrying, and Oil and Gas Extraction",2014,854,305,160,105,570,122,70,762,92,1360,305,160,115,580,285,170,1035,325,13790,320,863,1321,2912,84,2509,8783,699,799142000,25804000,39514000,60237000,132082000,149347000,164764000,479588000,132355000
Missouri,Other,2014,1586,1572,12,1,1585,1,0,1586,0,1586,1572,12,1,1585,1,0,1586,0,0,0,0,0,0,0,0,0,0,8977000,8380000,291000,0,8681000,0,0,8977000,0
Missouri,Other Services (except Public Administration),2014,70842,44665,13877,6380,64922,4491,748,70161,681,76620,44715,14040,6735,65490,5760,2215,73465,3155,542581,83246,89381,82553,258329,153403,47541,473812,45280,14576223000,2007122000,2094009000,2038335000,6161656000,4018683000,1481098000,12097843000,1703264000
Missouri,"Professional, Scientific, and Technical Services",2014,61324,40780,8970,4940,54690,3576,1278,59544,1780,67935,40805,8990,5075,54870,4355,2000,61225,6710,764613,61501,57671,63367,184232,114395,87329,392549,340190,50204804000,2856139000,2609444000,3250641000,8771493000,7330250000,6099162000,22519656000,25742090000
Missouri,Real Estate and Rental and Leasing,2014,24479,18275,2533,1239,22047,1130,531,23708,771,30675,18310,2590,1350,22250,1745,1540,25535,5140,166870,24244,15387,15053,59028,32349,24086,120676,42760,7054903000,874703000,538342000,547842000,1980435000,1421616000,966270000,4486598000,2291768000
Missouri,Retail Trade,2014,63692,33613,12572,7530,53715,5875,1442,61032,2660,106140,33795,12785,8450,55030,9680,5060,69770,36370,1390821,56469,80268,94130,237508,193811,97949,545660,795591,34951336000,1443863000,1870558000,2420834000,5777010000,6554775000,3516043000,16192964000,18144047000
Missouri,Total,2014,120469,73666,18526,11726,103918,10898,2698,117514,2955,153945,73777,18703,12314,104794,14603,7819,127216,26729,2404701,117395,121635,156035,395065,407709,323135,1125909,1278792,104217584000,3734871000,3874212000,5207107000,12816190000,14794718000,13259722000,40870630000,63346954000
Missouri,Transportation and Warehousing,2014,19900,11625,2555,1740,15920,1807,744,18471,1429,22685,11630,2555,1745,15930,1945,1040,18915,3770,393877,17387,16416,21782,56410,56281,45001,163386,196493,16089464000,627197000,559826000,801351000,2040100000,2143922000,1789944000,6101603000,8639112000
Missouri,Utilities,2014,537,150,30,25,205,190,47,442,95,1820,150,30,25,205,300,260,765,1055,70547,243,0,49,681,9515,4037,14338,38898,6692035000,7599000,2966000,10807000,25245000,676053000,299865000,1029133000,3905579000
Missouri,Wholesale Trade,2014,31650,14218,4600,3520,22338,4487,2035,28860,2790,38945,14240,4660,3710,22610,5500,3565,31675,7270,620626,22012,28787,41888,98716,131338,98556,347231,234935,32395612000,1192305000,1451375000,2232548000,4960378000,7261277000,5758156000,18731570000,12651942000
Montana,Accommodation and Food Services,2014,15713,5925,3452,3100,12477,2760,255,15492,221,17355,5935,3470,3185,12590,3095,685,16370,985,237034,9146,23035,42605,75636,95769,31408,203804,19662,3847487000,265655000,306902000,602768000,1186664000,1503807000,493241000,3212392000,568359000
Montana,Administrative and Support and Waste Management and Remediation Services,2014,8180,5620,1155,595,7370,413,88,7871,309,8640,5620,1160,600,7380,515,130,8025,615,76289,6592,6810,6500,21881,13486,6535,43969,2436,2253481000,262764000,191278000,179536000,670138000,388557000,186861000,1307348000,96166000
Montana,"Agriculture, Forestry, Fishing and Hunting",2014,1705,1415,145,90,1650,15,20,1685,20,1740,1415,145,90,1650,15,45,1710,30,4522,1202,864,911,3322,146,0,3986,0,205777000,65517000,30127000,37299000,144822000,6489000,0,190252000,1019000
Montana,"Arts, Entertainment, and Recreation",2014,5223,3100,1030,548,4678,411,82,5171,52,5845,3105,1040,575,4720,515,115,5350,495,52363,3006,6400,7011,17681,13552,10481,43157,3682,947341000,127717000,119114000,103178000,359073000,223103000,132139000,739574000,83084000
Montana,Construction,2014,25289,19570,3515,1240,24325,720,105,25150,139,25435,19570,3520,1240,24330,730,120,25180,255,113299,25606,22701,15452,65765,23053,7466,104119,5886,5843756000,1100085000,975184000,764456000,2867334000,1421543000,498661000,5268551000,400534000
Montana,Educational Services,2014,1830,940,330,205,1475,230,75,1780,50,1895,940,330,205,1475,230,120,1825,70,29527,1193,1856,2319,6045,8028,9560,24727,0,671026000,33471000,26340000,36141000,109785000,173068000,265737000,576631000,37758000
Montana,Finance and Insurance,2014,6216,4140,740,362,5242,349,137,5728,488,9765,4150,750,430,5330,925,580,6835,2930,77265,6743,3975,3856,15754,11683,5011,36710,36105,4121528000,254854000,156940000,169880000,631050000,532859000,325399000,1637060000,2322004000
Montana,Health Care and Social Assistance,2014,14970,7850,3020,1635,12505,1306,730,14541,429,17645,7865,3020,1680,12565,1665,1995,16225,1420,337152,12572,19794,20012,54530,51000,89179,196889,123263,13912319000,519679000,675934000,860058000,2111209000,1749209000,3021725000,6931370000,6668821000
Montana,Information,2014,2082,1000,325,185,1510,133,122,1765,317,3265,1000,325,185,1510,145,430,2085,1180,45041,576,1716,1988,5219,1976,6632,16879,23691,2057743000,47952000,52625000,73018000,187789000,78049000,367167000,828465000,1128138000
Montana,Management of Companies and Enterprises,2014,605,65,5,30,100,125,155,380,225,680,65,5,30,100,125,155,380,300,17690,0,0,73,0,976,4878,5985,11705,1289098000,3950000,0,5035000,9384000,56541000,353436000,426212000,862886000
Montana,Manufacturing,2014,6153,3170,1090,814,5074,661,200,5935,218,6255,3170,1090,820,5080,690,215,5985,270,70210,3417,5161,8475,20201,13680,9311,53581,9026,3178548000,146593000,171500000,295413000,701322000,542843000,375884000,2010518000,772242000
Montana,"Mining, Quarrying, and Oil and Gas Extraction",2014,1971,1180,260,135,1575,130,55,1760,211,2135,1180,260,135,1575,135,55,1765,370,24526,165,1379,1205,2675,3072,2887,12172,13119,2219152000,90330000,81072000,70478000,279876000,333262000,206478000,922596000,1337986000
Montana,Other,2014,67,65,2,0,67,0,0,67,0,67,65,2,0,67,0,0,67,0,0,0,0,0,0,0,0,0,0,1166000,1082000,0,0,1166000,0,0,1166000,0
Montana,Other Services (except Public Administration),2014,15175,10060,2905,1307,14272,648,85,15005,170,15815,10060,2915,1350,14325,900,135,15360,455,76905,16896,18260,16025,51896,17382,1811,74861,691,2053632000,454738000,454042000,413199000,1340726000,452092000,83906000,1963983000,41099000
Montana,"Professional, Scientific, and Technical Services",2014,17214,12725,2160,1002,15887,613,219,16719,495,18225,12725,2175,1030,15930,890,450,17270,955,88597,14355,12919,11983,40805,13514,10079,73493,12092,4559446000,769604000,587273000,628617000,2006103000,846232000,750040000,3807412000,664468000
Montana,Real Estate and Rental and Leasing,2014,8222,6820,645,323,7788,203,64,8055,167,9220,6830,680,455,7965,280,355,8600,620,26069,6685,3036,3684,15452,4285,750,22892,2421,885762000,274476000,82244000,96880000,487480000,117801000,48415000,749870000,100341000
Montana,Retail Trade,2014,18238,9092,4153,2213,15458,1590,361,17409,829,23785,9120,4235,2415,15770,2215,1210,19195,4590,275881,14382,24974,25765,70435,45194,22968,147991,108569,7017882000,426716000,635596000,718677000,1841617000,1490768000,724497000,4274317000,2347779000
Montana,Total,2014,31810,20041,5316,2926,28283,2175,505,30963,847,36791,20061,5363,3093,28517,2913,1579,33009,3782,363650,31082,35014,38821,104917,76681,58312,239910,123740,13367122000,1067458000,1035964000,1205350000,3308772000,2513070000,2195399000,8017241000,5349881000
Montana,Transportation and Warehousing,2014,6255,4214,790,370,5374,404,165,5943,312,6975,4215,790,370,5375,425,290,6090,885,63505,5381,4688,3902,15751,10965,8199,39392,14931,2573485000,236796000,184129000,184029000,628424000,475203000,261143000,1547995000,663608000
Montana,Utilities,2014,443,185,35,60,280,85,25,390,53,1045,185,35,65,285,120,50,455,590,14147,110,130,345,1019,0,0,4808,4247,1213510000,6058000,6620000,51199000,78507000,148120000,0,351129000,399999000
Montana,Wholesale Trade,2014,6090,2830,843,576,4249,700,351,5300,790,7900,2830,860,605,4295,950,760,6005,1895,71709,1953,4136,5609,14385,15693,7765,46879,19816,3623099000,157838000,207295000,255344000,683808000,738947000,416548000,2223542000,1151485000
Nebraska,Accommodation and Food Services,2014,17082,6235,3199,3226,12660,3403,439,16502,580,22120,6280,3215,3265,12760,4180,1745,18685,3435,362336,10194,21317,42799,74758,116038,53088,244999,116764,5036762000,220640000,234697000,489973000,952082000,1540399000,742830000,3246972000,1779517000
Nebraska,Administrative and Support and Waste Management and Remediation Services,2014,11615,7230,1605,1005,9840,770,268,10878,737,13160,7230,1605,1010,9845,845,335,11025,2135,283251,10041,9386,11507,32988,25020,28708,91782,178003,9732375000,363775000,278726000,379316000,1062526000,787100000,834862000,2838914000,6548077000
Nebraska,"Agriculture, Forestry, Fishing and Hunting",2014,895,675,90,45,810,35,20,865,30,935,675,90,45,810,35,30,875,60,5567,654,564,477,1873,424,172,2854,2605,289123000,41103000,22808000,20774000,86355000,25234000,8000000,141223000,142955000
Nebraska,"Arts, Entertainment, and Recreation",2014,4164,2455,575,475,3505,450,95,4050,114,4370,2460,575,475,3510,495,125,4130,240,63946,2869,3113,5358,12603,18190,9362,45710,14540,1047948000,96900000,59518000,100985000,270479000,320874000,128951000,821067000,156063000
Nebraska,Construction,2014,30448,20595,5145,2480,28220,1754,215,30189,259,30690,20595,5145,2480,28220,1790,300,30310,380,205740,30115,33001,32775,98872,65766,14594,185281,13106,10053814000,1167482000,1222559000,1472896000,3885237000,3509558000,1008521000,8755441000,852440000
Nebraska,Educational Services,2014,2486,1040,405,330,1775,475,125,2375,111,2760,1040,405,330,1775,565,250,2590,170,90961,1253,2574,4234,8658,19596,12337,42058,48105,2443298000,35205000,34391000,70840000,154414000,407727000,343665000,961733000,1438830000
Nebraska,Finance and Insurance,2014,12993,8545,1577,666,10788,850,337,11975,1018,21460,8555,1675,865,11095,2205,1815,15115,6345,257068,13836,9210,7679,31621,26102,27642,88207,145636,17684201000,536528000,437268000,394120000,1406951000,1403952000,1593327000,4559845000,11827564000
Nebraska,Health Care and Social Assistance,2014,22035,10485,4100,2830,17415,2888,1002,21305,730,27060,10515,4115,2905,17535,3980,2385,23900,3160,610705,15373,26671,37137,82737,110925,117842,320689,263143,25704229000,876801000,1079619000,1548615000,3548089000,4386690000,4345347000,12498342000,11440137000
Nebraska,Information,2014,2767,993,344,340,1677,407,178,2262,505,4475,995,345,340,1680,550,245,2475,2000,99314,901,1843,3922,7669,11912,5896,32333,37668,6111737000,44891000,69862000,155688000,298755000,706082000,303761000,1682580000,3381226000
Nebraska,Management of Companies and Enterprises,2014,1387,60,35,66,161,270,345,776,611,1825,60,35,75,170,275,365,810,1015,92515,0,170,32,558,2789,10477,13945,78239,7362070000,5388000,5538000,36078000,47094000,147720000,688453000,889685000,6463360000
Nebraska,Manufacturing,2014,8274,2950,1360,1070,5380,1341,648,7369,905,8975,2950,1360,1075,5385,1425,785,7595,1380,394082,3241,5885,9552,22119,40507,43153,128442,214356,18103337000,142888000,229414000,413188000,893947000,1799313000,1993512000,5671391000,9919361000
Nebraska,"Mining, Quarrying, and Oil and Gas Extraction",2014,572,355,75,50,480,30,27,537,35,650,355,75,50,480,30,30,540,110,4482,214,387,419,1073,127,1117,2725,997,315700000,27667000,25246000,22690000,80631000,6784000,73005000,212342000,58213000
Nebraska,Other,2014,91,89,2,0,91,0,0,91,0,91,89,2,0,91,0,0,91,0,0,0,0,0,0,0,0,0,0,1944000,1732000,0,0,1944000,0,0,1944000,0
Nebraska,Other Services (except Public Administration),2014,26625,17453,4900,2117,24470,1541,295,26306,319,28780,17465,4950,2215,24630,2080,980,27690,1090,180842,28391,30676,26771,90257,49852,16033,164842,8894,4684720000,742137000,744732000,642234000,2154304000,1311988000,473987000,4165098000,464302000
Nebraska,"Professional, Scientific, and Technical Services",2014,21005,13765,3105,1752,18622,1146,409,20177,828,22550,13770,3110,1815,18695,1415,665,20775,1775,300824,16246,18400,20321,58939,33504,28393,131178,165752,16095738000,810547000,886921000,1118136000,2860133000,2000419000,1826502000,7031274000,8865755000
Nebraska,Real Estate and Rental and Leasing,2014,8882,6860,710,370,7940,307,241,8488,394,10330,6865,740,400,8005,350,660,9015,1315,51129,5566,4089,4166,17429,7531,9776,35708,9174,2050519000,301986000,136419000,156655000,609806000,281015000,448041000,1564357000,459334000
Nebraska,Retail Trade,2014,24673,11698,5393,3025,20116,2303,702,23121,1552,36200,11715,5505,3275,20495,3655,2095,26245,9955,505120,19228,33593,36639,93724,74244,36836,217791,252621,12776122000,514861000,756424000,897321000,2204295000,2311066000,1497165000,6332900000,6058423000
Nebraska,Total,2014,42507,24702,7088,4308,36098,3891,1004,40993,1514,52991,24736,7179,4532,36447,5375,3095,44917,8074,851128,41033,46369,57177,144579,142366,113561,400506,450622,34953442000,1345860000,1434050000,1878546000,4658456000,5077304000,4630946000,14366706000,20586736000
Nebraska,Transportation and Warehousing,2014,10702,7160,1274,699,9133,578,268,9979,723,11755,7160,1275,705,9140,615,465,10220,1535,131263,9203,7540,7664,25818,17248,15885,66271,44469,5858023000,334431000,275277000,301198000,927666000,713237000,788749000,2600481000,2313397000
Nebraska,Utilities,2014,167,35,5,15,55,25,10,90,77,595,35,5,15,55,30,15,100,495,766,0,0,0,0,465,0,751,281,74776000,264000,0,0,17582000,29155000,0,55779000,49889000
Nebraska,Wholesale Trade,2014,11467,4509,1614,1234,7357,1811,891,10059,1408,15810,4515,1660,1320,7495,2355,2185,12035,3775,206646,5867,8696,12611,29224,47940,35912,126072,61389,11519396000,312177000,419935000,671684000,1498806000,2339184000,1969876000,6263942000,4039171000
Nevada,Accommodation and Food Services,2014,21461,6830,4380,4100,15310,4208,853,20371,1090,30725,6845,4390,4215,15450,5265,2510,23225,7500,1553382,10428,28127,54152,92861,156139,133699,384814,1143474,45005284000,579058000,441336000,925588000,1942357000,3004046000,2704856000,7672653000,36788962000
Nevada,Administrative and Support and Waste Management and Remediation Services,2014,19209,10945,2691,1855,15491,1890,730,18111,1098,21135,10945,2700,1885,15530,2025,810,18365,2770,530004,13578,16302,22840,57284,64516,76652,201531,305784,16845062000,652495000,530849000,774349000,2003705000,2141963000,1852513000,6298950000,10074849000
Nevada,"Agriculture, Forestry, Fishing and Hunting",2014,235,210,15,5,230,5,0,235,0,235,210,15,5,230,5,0,235,0,59,90,0,0,251,0,0,59,0,29707000,10994000,0,0,26497000,0,0,29707000,0
Nevada,"Arts, Entertainment, and Recreation",2014,6136,3670,670,568,4908,767,262,5937,199,6990,3670,670,575,4915,820,755,6490,500,132290,2656,3777,6961,15850,32066,36023,90456,30480,3890428000,243265000,118853000,254657000,807403000,774681000,995314000,2731881000,728623000
Nevada,Construction,2014,22853,11875,4120,3150,19145,2642,526,22313,540,23145,11875,4120,3155,19150,2690,580,22420,725,289883,17278,26496,42674,88533,98125,48438,237345,45018,14806433000,925239000,1099739000,1912600000,3949972000,4527556000,2486704000,11022715000,3149604000
Nevada,Educational Services,2014,3240,1700,410,360,2470,455,155,3080,160,3515,1700,410,365,2475,485,190,3150,365,53898,2110,2586,4735,10000,15098,10562,37308,10811,1920745000,101367000,63469000,113552000,285721000,449875000,416046000,1339972000,426774000
Nevada,Finance and Insurance,2014,12746,8345,1372,600,10317,628,468,11413,1333,20435,8355,1400,625,10380,930,1105,12415,8020,167127,7636,7785,6815,27254,11537,8652,52201,111099,9931161000,652531000,377035000,352333000,1431996000,732993000,609672000,2934679000,6903341000
Nevada,Health Care and Social Assistance,2014,28280,14900,6000,3505,24405,2416,578,27399,881,32965,14900,6050,3610,24560,3275,1605,29440,3525,537025,20641,39398,45277,109145,86389,73480,277349,242211,25965231000,1800354000,1684023000,2042342000,5561882000,3811577000,2894784000,12447296000,13219068000
Nevada,Information,2014,4448,2630,530,305,3465,275,126,3866,582,6230,2630,535,315,3480,300,185,3965,2265,78885,2411,2451,3005,8019,6574,4492,25639,40786,5145042000,248479000,189529000,180018000,664304000,431519000,225937000,1703570000,2746679000
Nevada,Management of Companies and Enterprises,2014,2127,445,60,50,555,305,428,1288,839,2585,445,65,50,560,315,480,1355,1230,96251,412,246,43,1034,3044,9967,14103,82148,8278233000,39112000,14115000,15963000,70963000,329614000,713418000,1113995000,7164238000
Nevada,Manufacturing,2014,8529,3515,1460,1040,6015,1293,550,7858,671,8750,3515,1460,1040,6015,1325,590,7930,820,164903,3723,7362,9286,24329,35555,23615,103412,41768,8492171000,210005000,292315000,378486000,1020321000,1552514000,1074287000,4628680000,2504050000
Nevada,"Mining, Quarrying, and Oil and Gas Extraction",2014,1003,470,130,68,668,154,85,907,96,1065,470,130,70,670,155,95,920,145,67167,37,597,541,2217,4119,15554,22785,43911,6044955000,55662000,56796000,49546000,200644000,282590000,1317193000,1871167000,4148306000
Nevada,Other,2014,107,100,5,1,106,1,0,107,0,107,100,5,1,106,1,0,107,0,0,0,34,0,0,0,0,0,0,4143000,2342000,1107000,0,3514000,0,0,4143000,0
Nevada,Other Services (except Public Administration),2014,19053,11800,3635,1600,17035,1217,308,18560,493,21285,11815,3660,1670,17145,1720,640,19505,1780,155053,19529,22562,19322,63517,39186,15798,123824,18012,4739822000,624416000,645942000,592436000,1890569000,1063936000,447403000,3565157000,831781000
Nevada,"Professional, Scientific, and Technical Services",2014,39666,29155,4240,2415,35810,2012,748,38570,1096,42380,29165,4245,2525,35935,2220,1100,39255,3125,278719,29922,26003,29786,93507,58822,25853,186196,56888,16758353000,2585751000,1398565000,1764820000,5793732000,3682050000,1599827000,11383543000,3966142000
Nevada,Real Estate and Rental and Leasing,2014,16782,12565,1753,750,15068,658,433,16159,623,20535,12590,1780,815,15185,850,1340,17375,3160,136528,6741,10599,9505,37830,16613,19606,76161,54912,5506608000,677210000,372528000,363964000,1436086000,664087000,783283000,2995098000,2427419000
Nevada,Retail Trade,2014,25367,12403,4845,2849,20097,2073,855,23025,2342,42560,12440,4905,3145,20490,3160,1940,25590,16970,660982,14969,29786,32549,80540,59509,37120,190169,428307,18278367000,595549000,792178000,867541000,2344005000,1951888000,1612729000,6192363000,11526812000
Nevada,Total,2014,49191,28300,7743,4987,41030,4496,1505,47031,2160,61625,28326,7804,5194,41324,5569,3126,50019,11606,1090071,43535,51086,65882,160503,155652,133949,450104,639967,43673405000,2206282000,1800869000,2427186000,6434337000,5864920000,5122175000,17421432000,26251973000
Nevada,Transportation and Warehousing,2014,6575,3120,775,680,4575,617,409,5601,974,7485,3120,775,695,4590,640,455,5685,1800,204543,3449,3732,6020,14625,15364,21779,61584,124511,7704729000,176188000,156460000,241499000,600322000,612134000,809750000,2368324000,4547890000
Nevada,Utilities,2014,279,100,40,15,155,36,36,227,52,650,100,40,20,160,60,105,325,325,1086,127,42,0,524,212,1146,2390,0,111637000,3993000,7718000,5368000,27426000,67129000,120774000,207126000,0
Nevada,Wholesale Trade,2014,13236,6340,1638,1147,9125,1468,993,11586,1650,14920,6340,1645,1185,9170,1600,1145,11915,3005,160225,7197,8115,11908,29722,28771,16962,86265,56743,9360245000,514234000,457439000,604539000,1679468000,1699141000,1006697000,4722243000,3482800000
New Hampshire,Accommodation and Food Services,2014,15114,5615,2970,3073,11658,2742,362,14762,352,18210,5635,2980,3090,11705,3165,970,15840,2370,263831,8183,19823,41715,70192,93760,36263,200584,63769,5007576000,320940000,327913000,662329000,1312250000,1728709000,629067000,3682736000,1189329000
New Hampshire,Administrative and Support and Waste Management and Remediation Services,2014,10406,6580,1460,820,8860,700,242,9802,604,11485,6580,1470,825,8875,790,300,9965,1520,191227,8443,8659,10045,29354,24154,21415,83059,109128,8344357000,459323000,341383000,400368000,1263881000,1015028000,857139000,3458811000,4927754000
New Hampshire,"Agriculture, Forestry, Fishing and Hunting",2014,695,485,140,40,665,25,0,690,5,700,485,140,40,665,30,0,695,5,3025,1007,826,461,2397,560,0,2957,0,126958000,31847000,25273000,24278000,85422000,38872000,0,124294000,0
New Hampshire,"Arts, Entertainment, and Recreation",2014,3641,2095,490,420,3005,430,99,3534,107,3810,2095,490,420,3005,435,145,3585,225,58863,2436,2656,5152,10879,13290,9575,37110,13337,1194612000,216652000,110140000,117723000,457325000,284312000,116454000,910772000,178002000
New Hampshire,Construction,2014,19056,13615,2685,1420,17720,1093,145,18958,98,19175,13615,2685,1420,17720,1115,215,19050,125,114874,17988,17554,18748,58919,34323,10558,110531,2279,6855131000,990541000,871868000,1058247000,2957844000,2448303000,799368000,6562755000,174097000
New Hampshire,Educational Services,2014,2846,1285,460,426,2171,430,130,2731,115,3040,1285,465,485,2235,460,145,2840,200,113763,126,2626,5192,10831,14910,13413,43662,70235,4530193000,63359000,67762000,132914000,275966000,434006000,545002000,1358935000,3181743000
New Hampshire,Finance and Insurance,2014,5165,2705,620,299,3624,397,305,4326,839,9725,2705,625,385,3715,625,1550,5890,3835,114430,3406,3488,3132,11468,11782,19865,46847,59175,10782345000,279318000,240874000,251720000,811510000,943807000,1278249000,3281094000,5134223000
New Hampshire,Health Care and Social Assistance,2014,13501,5505,3130,1935,10570,1593,679,12842,659,18065,5505,3140,2030,10675,2145,1820,14640,3425,419554,10528,20530,24561,56003,56015,89394,207120,199943,20057009000,455341000,854863000,1268683000,2605944000,2427834000,3397811000,8573610000,10910230000
New Hampshire,Information,2014,2347,855,380,240,1475,313,120,1908,439,3715,855,380,240,1475,420,155,2050,1665,68280,751,1925,1992,5547,9863,6378,26167,31588,5665694000,58002000,104421000,135970000,387510000,634882000,470058000,1725400000,2846369000
New Hampshire,Management of Companies and Enterprises,2014,832,50,10,35,95,105,200,400,432,1085,50,10,35,95,110,205,410,675,39836,84,0,205,341,1100,7207,8696,31111,3330287000,14702000,0,16065000,32162000,86120000,395160000,513442000,2814402000
New Hampshire,Manufacturing,2014,8710,3260,1520,1125,5905,1697,401,8003,707,9030,3260,1520,1125,5905,1750,455,8110,920,246485,4540,6351,10086,25246,57772,21824,124845,94818,15133219000,239438000,329967000,551050000,1303451000,3046411000,1246161000,6588444000,6437835000
New Hampshire,"Mining, Quarrying, and Oil and Gas Extraction",2014,212,120,25,25,170,15,15,200,12,235,120,25,25,170,15,25,210,25,1029,62,115,0,401,0,234,909,0,75028000,8904000,10278000,14518000,41774000,0,13617000,62010000,0
New Hampshire,Other,2014,63,62,1,0,63,0,0,63,0,63,62,1,0,63,0,0,63,0,50,0,0,0,50,0,0,50,0,1725000,1489000,0,0,1725000,0,0,1725000,0
New Hampshire,Other Services (except Public Administration),2014,17245,10795,3800,1425,16020,748,187,16955,290,18355,10795,3820,1465,16080,985,340,17405,950,107542,19760,24307,17126,63548,21978,6352,96256,6706,3203045000,607074000,629125000,476386000,1744544000,641694000,256265000,2805548000,231697000
New Hampshire,"Professional, Scientific, and Technical Services",2014,17771,11565,2525,1495,15585,1132,380,17097,674,18960,11565,2540,1530,15635,1325,505,17465,1495,147690,17191,16048,18528,53358,31775,16575,109166,36754,9836493000,1121080000,981266000,1325841000,3451819000,2468091000,1423165000,7710553000,2063401000
New Hampshire,Real Estate and Rental and Leasing,2014,5681,4040,710,313,5063,226,147,5436,245,6990,4065,730,360,5155,380,620,6155,835,33283,6005,3640,3104,14177,5654,5525,27836,4441,1506499000,272587000,173568000,154092000,613484000,314429000,228233000,1259484000,248358000
New Hampshire,Retail Trade,2014,19608,9495,4002,2254,15751,1851,485,18087,1521,30220,9525,4060,2400,15985,2545,1385,19915,10305,418060,13301,22398,26218,65510,53987,30090,158447,181202,12550402000,511184000,702476000,846359000,2121337000,2180649000,1422807000,5941889000,4417388000
New Hampshire,Total,2014,30389,16787,5349,3286,25422,2884,781,29087,1302,37396,16819,5389,3414,25622,3555,1960,31137,6259,563323,29203,35296,43771,108270,101034,80610,289914,273409,26936688000,1266340000,1345903000,1764753000,4376996000,4499071000,3690608000,12566675000,14370013000
New Hampshire,Transportation and Warehousing,2014,3623,1880,595,392,2867,295,128,3290,333,3990,1880,595,400,2875,315,150,3340,650,59268,1562,3229,3396,10586,6936,4107,28603,13381,2356995000,119885000,116995000,142174000,417263000,274342000,147258000,1093322000,650432000
New Hampshire,Utilities,2014,251,90,15,10,115,10,48,173,78,640,125,15,10,150,15,170,335,305,10721,149,0,0,363,0,1406,3035,8110,1078981000,15009000,4545000,0,26841000,0,117442000,243672000,871973000
New Hampshire,Wholesale Trade,2014,8319,3624,1250,782,5656,1041,524,7221,1098,9235,3640,1250,785,5675,1150,645,7470,1765,115219,5161,6505,8664,23125,24249,17765,74154,36253,8550437000,391646000,445720000,573356000,1495096000,1660267000,1183167000,4840793000,3356362000
New Jersey,Accommodation and Food Services,2014,89207,45662,16440,13129,75231,12101,917,88249,958,102950,45695,16450,13250,75395,12875,2365,90635,12315,1495201,77319,107176,177253,362795,444094,108802,917651,577198,29246114000,2181589000,1787736000,2869686000,6841828000,7717384000,1990902000,16580839000,12655047000
New Jersey,Administrative and Support and Waste Management and Remediation Services,2014,62614,41330,7835,4842,54007,5015,1621,60643,1971,70885,41335,7840,4885,54060,5190,1995,61245,9640,1513049,51895,50341,65304,173006,187157,224932,593574,910204,56599750000,3273830000,2135850000,2790999000,8249155000,7788980000,7401408000,23604984000,32345905000
New Jersey,"Agriculture, Forestry, Fishing and Hunting",2014,1025,770,140,45,955,55,5,1015,10,1025,770,140,45,955,55,5,1015,10,4148,67,755,407,2128,1473,0,4116,0,172421000,40452000,24004000,13301000,93522000,58494000,0,166389000,0
New Jersey,"Arts, Entertainment, and Recreation",2014,16426,9395,2078,1912,13385,2249,533,16167,259,17630,9400,2085,1940,13425,2280,750,16455,1175,287587,11454,12875,23897,50279,88365,79317,230570,49867,8562226000,743275000,380419000,556423000,1734820000,1953668000,3427737000,7316566000,929813000
New Jersey,Construction,2014,104214,74315,15445,7849,97609,5467,616,103692,522,104665,74315,15445,7870,97630,5495,690,103815,850,695380,113737,99646,104689,320780,203808,82415,616505,65125,46052115000,5537262000,5082815000,6420996000,17050555000,14384826000,7344108000,39545620000,5317664000
New Jersey,Educational Services,2014,17141,7770,3020,2370,13160,2920,699,16779,362,18435,7770,3020,2390,13180,3155,900,17235,1200,498280,11440,20536,31364,65309,118969,95554,288660,182257,18701171000,391016000,445283000,620448000,1461260000,3744855000,4119378000,9765030000,7825005000
New Jersey,Finance and Insurance,2014,31499,19645,4468,1886,25999,2250,1041,29290,2209,59950,19685,4570,2120,26375,3940,3840,34155,25795,943216,31169,27199,23174,86159,76091,72099,239145,703308,105575021000,2070208000,1970444000,1893860000,6030768000,6887659000,6280401000,19878571000,85521579000
New Jersey,Health Care and Social Assistance,2014,110468,53275,25530,14474,93279,11806,3315,108400,2068,135445,53380,25685,15230,94295,14915,9510,118720,16725,2806388,105568,166032,190900,466515,441540,492381,1406303,1380583,133518335000,5072235000,7288738000,9358278000,21773045000,20326233000,17963561000,60450741000,71966712000
New Jersey,Information,2014,10243,5494,1145,920,7559,1127,467,9153,1090,18665,5510,1145,930,7585,1285,540,9410,9255,437154,6361,6554,10834,26287,34714,37175,103167,322358,42628500000,609956000,482305000,744467000,1906576000,2703468000,3826286000,8668846000,33004824000
New Jersey,Management of Companies and Enterprises,2014,4669,390,125,135,650,622,1028,2300,2369,7390,395,125,135,655,640,1090,2385,5005,687625,0,706,984,2330,10631,42366,55515,630280,88883610000,66349000,61045000,165355000,295330000,820710000,3634303000,4761635000,83807571000
New Jersey,Manufacturing,2014,36554,13989,6484,4864,25337,6926,2195,34458,2096,37685,13995,6500,4880,25375,7050,2480,34905,2780,1064964,21479,38575,59925,131318,252341,232208,667619,314170,68352580000,1134337000,1791813000,2978454000,6204145000,13747274000,13260351000,35955482000,26568088000
New Jersey,"Mining, Quarrying, and Oil and Gas Extraction",2014,330,125,35,45,205,51,26,282,48,390,125,35,45,205,60,30,295,95,5576,88,45,617,874,1348,64,2867,0,382113000,9976000,5076000,34192000,54750000,65224000,4066000,187042000,129758000
New Jersey,Other,2014,340,323,12,3,338,2,0,340,0,340,323,12,3,338,2,0,340,0,479,268,71,38,377,0,0,479,0,9935000,7349000,1045000,575000,8969000,0,0,9935000,0
New Jersey,Other Services (except Public Administration),2014,112431,75120,20103,9840,105063,5854,791,111708,723,117130,75175,20185,10120,105480,6475,1565,113520,3610,760940,140109,129386,129555,400634,203024,65288,682515,57721,22636150000,3571979000,3336051000,3755714000,10682985000,5835005000,2235118000,19293175000,2789986000
New Jersey,"Professional, Scientific, and Technical Services",2014,139975,99358,16755,9888,126001,8593,2681,137275,2700,147760,99390,16785,10035,126210,9350,3550,139110,8650,1584789,145655,107630,127466,388734,292781,240578,928808,574558,135854507000,8893613000,6436321000,8884033000,24246168000,23852358000,20206046000,68675542000,64742276000
New Jersey,Real Estate and Rental and Leasing,2014,35818,25285,5052,2489,32826,1666,515,35007,811,43570,25315,5180,2655,33150,2250,1425,36825,6745,265712,40624,32296,31156,107130,52745,25093,186805,69170,15183189000,1714325000,1401510000,1472238000,4665382000,3021113000,1316541000,9158149000,5291428000
New Jersey,Retail Trade,2014,112541,72556,19118,9566,101240,6886,1713,109839,2702,158425,72650,19585,10160,102395,9120,3910,115425,43000,2231595,106613,118214,110087,341233,221144,134940,711707,1279757,65102221000,3522786000,3296864000,3650697000,10358713000,9165987000,7012284000,26630357000,36711114000
New Jersey,Total,2014,194052,119718,31742,18782,170242,16573,3903,190718,3334,230600,119829,31993,19359,171181,19180,8076,198437,32163,3526716,202649,207447,250114,660210,613189,491594,1764993,1761723,202658061000,8866175000,8310727000,10873864000,28050766000,29293555000,26100384000,83444705000,119213356000
New Jersey,Transportation and Warehousing,2014,32620,18775,4580,2924,26279,3176,1399,30854,1766,36200,18780,4620,2935,26335,3440,1765,31540,4660,780856,25118,28331,36899,95929,110216,110538,329381,379182,38747922000,1221042000,1133836000,1555005000,4009154000,4533067000,4632250000,13693219000,20120451000
New Jersey,Utilities,2014,546,220,50,35,305,50,32,387,159,1920,220,55,35,310,55,90,455,1465,66439,16,0,224,186,762,0,4828,57663,9540719000,20533000,4454000,23848000,65685000,97212000,0,481250000,8584280000
New Jersey,Wholesale Trade,2014,64960,33595,10403,6995,50993,7745,2893,61631,3329,71180,33625,10455,7120,51200,8260,3880,63340,7840,1267998,56831,66230,90482,219172,259903,232929,723186,525632,113227436000,3659424000,4084902000,5917919000,13780442000,17414047000,17521780000,49428751000,61866633000
New Mexico,Accommodation and Food Services,2014,15540,4950,2575,2985,10510,3869,552,14931,609,20945,4975,2590,3060,10625,4515,1810,16950,3995,418316,8091,17208,40943,66760,140549,75499,284019,133810,6916384000,192352000,231535000,589570000,1016223000,2170178000,1303955000,4512284000,2399662000
New Mexico,Administrative and Support and Waste Management and Remediation Services,2014,8320,4625,1315,740,6680,673,198,7551,769,9295,4625,1315,750,6690,740,300,7730,1565,153246,2778,7568,8792,25999,21697,19430,70800,74568,4684428000,236863000,238156000,279483000,794798000,652185000,427359000,2039333000,2460889000
New Mexico,"Agriculture, Forestry, Fishing and Hunting",2014,421,285,80,35,400,16,0,416,5,435,285,85,35,405,25,0,430,5,1166,297,104,164,996,0,0,1104,0,60362000,19444000,12212000,7888000,53091000,0,0,57930000,0
New Mexico,"Arts, Entertainment, and Recreation",2014,3267,1955,440,330,2725,365,100,3190,77,3420,1955,455,330,2740,425,135,3300,120,59943,2054,2379,3261,8783,11974,16457,41096,12423,1350981000,91202000,56800000,71627000,245709000,215307000,421986000,936805000,219444000
New Mexico,Construction,2014,21282,12847,3760,2370,18977,1792,287,21056,226,21455,12850,3765,2370,18985,1830,350,21165,290,190810,21482,23698,31668,78137,62199,25786,179295,6906,8405529000,705096000,785137000,1256249000,2782611000,2917449000,1437946000,7744384000,416722000
New Mexico,Educational Services,2014,2748,1405,420,330,2155,355,135,2645,103,2870,1405,420,330,2155,360,160,2675,195,44544,1912,2634,4369,9679,12818,16064,39717,3267,1305071000,73003000,55727000,79703000,215205000,342470000,546673000,1142803000,105625000
New Mexico,Finance and Insurance,2014,7493,4585,1040,285,5910,510,256,6676,817,13795,4605,1065,350,6020,1340,1235,8595,5200,107003,6860,5956,2824,17454,14477,18548,53585,38504,6007633000,309495000,245065000,135444000,713395000,697810000,948703000,2519640000,2941394000
New Mexico,Health Care and Social Assistance,2014,20202,9430,4005,2839,16274,2267,842,19383,819,24765,9430,4025,2870,16325,2970,1845,21140,3625,577443,13478,26046,37440,79743,81846,109656,281880,261195,23981455000,723922000,1046865000,1566414000,3388656000,3085961000,3674067000,10444793000,12991628000
New Mexico,Information,2014,2243,1170,207,175,1552,217,80,1849,394,3765,1170,210,180,1560,300,225,2085,1680,57558,1772,591,1482,5090,4967,4292,18079,30656,2631367000,75368000,22524000,64413000,198271000,241414000,217928000,714090000,1830551000
New Mexico,Management of Companies and Enterprises,2014,915,30,40,45,115,175,235,525,390,1095,30,40,45,115,175,250,540,555,32600,29,0,211,445,1390,5031,6935,25619,1916475000,5794000,10789000,6976000,25635000,62595000,343120000,433935000,1478568000
New Mexico,Manufacturing,2014,6579,2965,1305,890,5160,760,235,6155,424,6750,2965,1305,890,5160,790,255,6205,545,100128,3214,5867,8151,21230,17498,5660,56049,33155,5184623000,142867000,206398000,291075000,775157000,764429000,295282000,2337097000,2272571000
New Mexico,"Mining, Quarrying, and Oil and Gas Extraction",2014,3516,1510,380,429,2319,607,181,3107,409,3940,1510,380,435,2325,615,235,3175,765,100378,1394,2597,5511,10707,22698,16449,52218,48442,8212650000,158064000,138834000,342069000,647433000,1459867000,1195384000,3512339000,4707524000
New Mexico,Other,2014,76,73,3,0,76,0,0,76,0,76,73,3,0,76,0,0,76,0,70,54,0,0,70,0,0,70,0,2178000,1867000,0,0,2178000,0,0,2178000,0
New Mexico,Other Services (except Public Administration),2014,19134,11395,4150,1850,17395,1237,170,18802,332,20430,11395,4160,1935,17490,1635,445,19570,860,129735,20204,26225,23493,71790,39345,4787,120749,4699,3512080000,557974000,667593000,594678000,1838435000,984174000,197711000,3170285000,214082000
New Mexico,"Professional, Scientific, and Technical Services",2014,21550,14650,2815,1660,19125,1121,472,20718,832,23520,14650,2820,1710,19180,1315,605,21100,2420,194692,20964,17316,20462,61391,30226,18833,116542,69310,11550228000,1071897000,839596000,1091994000,3051687000,1979284000,1604450000,6872222000,4918437000
New Mexico,Real Estate and Rental and Leasing,2014,9329,6940,1032,390,8362,361,168,8891,438,11740,6955,1055,425,8435,590,835,9860,1880,49961,9219,5897,3578,19661,8237,807,36510,10929,2114157000,345191000,199447000,129902000,710917000,503201000,189240000,1468501000,627485000
New Mexico,Retail Trade,2014,20378,10227,3976,2265,16468,1748,587,18803,1575,32785,10245,4070,2420,16735,2700,1725,21160,11625,396672,13861,23818,25870,72514,52698,32125,169466,203721,10795019000,465280000,655837000,748625000,1899146000,1746224000,1169825000,5047699000,5273243000
New Mexico,Total,2014,34702,19169,5891,3794,28854,3396,896,33146,1556,43748,19195,5948,3945,29088,4421,2257,35766,7982,602632,33133,38648,50522,122303,119521,94860,336684,265948,23629149000,1150755000,1218763000,1705562000,4075080000,4157892000,3740889000,11973861000,11655288000
New Mexico,Transportation and Warehousing,2014,5827,3215,760,525,4500,526,226,5252,575,6950,3220,760,530,4510,550,285,5345,1605,81212,4103,3831,6403,15558,15793,8520,45855,16940,3562567000,183382000,154030000,292468000,654900000,700783000,471989000,1962513000,1067144000
New Mexico,Utilities,2014,733,455,70,35,560,75,15,650,83,1130,455,70,35,560,150,20,730,400,17661,982,413,329,1873,1454,0,4278,6829,1421296000,24379000,14088000,22515000,61763000,211098000,0,307711000,845892000
New Mexico,Wholesale Trade,2014,7709,2874,1134,965,4973,963,436,6372,1337,9275,2885,1135,1025,5045,1080,570,6695,2580,98009,3675,6038,8985,21948,16937,8181,54015,39385,5222969000,223700000,273127000,465049000,1038019000,873909000,403188000,2572963000,2515776000
New York,Accommodation and Food Services,2014,227370,111727,43498,34979,190204,32428,3161,225793,1577,258410,111765,43570,35140,190475,34720,8985,234180,24230,3719285,199052,284981,477896,963580,1193870,481569,2641330,1074668,83908835000,5022765000,4686800000,8520564000,18237085000,25862855000,12163084000,56321215000,27528120000
New York,Administrative and Support and Waste Management and Remediation Services,2014,121160,81955,14665,9074,105694,9233,3422,118349,2811,133055,81955,14695,9190,105840,9625,4360,119825,13230,2814651,106372,94163,118260,325002,359209,506207,1195754,1589438,147184861000,5800629000,4257262000,5321666000,15396295000,15597249000,18422448000,49657159000,96740061000
New York,"Agriculture, Forestry, Fishing and Hunting",2014,2885,2230,400,150,2780,75,15,2870,15,2890,2230,400,150,2780,80,15,2875,15,12801,2968,2247,1925,7448,2259,0,11782,422,472510000,100773000,76940000,72731000,255918000,88283000,0,431513000,16728000
New York,"Arts, Entertainment, and Recreation",2014,56950,39185,6292,4670,50147,5033,1141,56321,629,60905,39190,6305,4695,50190,5320,1580,57090,3815,849505,38242,40770,62446,150441,199838,166631,524486,313695,39130990000,6531100000,2054179000,2125256000,10720172000,7012108000,6804266000,24749255000,13963591000
New York,Construction,2014,230936,166050,31290,18184,215524,13120,1705,230349,587,232230,166055,31300,18205,215560,13325,2005,230890,1340,1588555,243590,204985,244060,693835,491380,258998,1449505,127668,105386360000,11273915000,9615531000,13925785000,34820765000,35086900000,22147365000,92370700000,11923357000
New York,Educational Services,2014,36880,17975,5120,4385,27480,6465,1912,35857,1023,39710,17990,5165,4455,27610,6930,2810,37350,2360,2107890,25658,34219,60000,121755,277277,321119,721225,1310357,85980450000,998007000,917780000,1654325000,3572540000,10243005000,13376150000,27240480000,58095344000
New York,Finance and Insurance,2014,80065,50965,11856,5338,68159,5799,2655,76613,3452,135790,51020,12155,5900,69075,8675,8395,86145,49645,2656799,80644,73695,67418,227695,203804,284935,721170,1891592,537078921000,7765454000,7032245000,9296517000,24242404000,41665674000,66698642000,133867419000,399067802000
New York,Health Care and Social Assistance,2014,228484,125700,44959,24268,194927,19326,8585,222838,5646,284925,125815,45295,25135,196245,26105,24605,246955,37970,7294791,219696,294891,324235,849563,741506,1377885,2977227,4303880,349411599000,12052962000,13111398000,15092034000,40275748000,33347693000,49994246000,123739327000,224905331000
New York,Information,2014,39137,23511,4580,3454,31545,3875,1500,36920,2217,57530,23535,4585,3520,31640,4410,1860,37910,19620,1373521,27392,27195,43340,104790,134591,158985,405711,958884,142660166000,2821059000,1658868000,2597742000,7126211000,9560486000,14521535000,31732433000,110205293000
New York,Management of Companies and Enterprises,2014,9369,1065,205,262,1532,1637,2462,5631,3738,14985,1070,205,270,1545,1665,2600,5810,9175,914956,1219,1003,2000,4239,24361,95812,124485,790544,121163386000,334090000,99389000,178250000,611729000,2397600000,8429110000,11447660000,109724947000
New York,Manufacturing,2014,78009,34445,13384,10770,58599,12982,3534,75115,2894,80380,34450,13385,10825,58660,13310,4140,76110,4270,2019568,54384,81956,137730,289872,484443,395772,1234359,658524,109091186000,2503778000,3172104000,5656794000,11602581000,22447076000,20302966000,57536776000,43674897000
New York,"Mining, Quarrying, and Oil and Gas Extraction",2014,1303,675,180,150,1005,100,90,1195,108,1535,675,180,150,1005,125,160,1290,245,17925,661,915,1686,3910,1877,4226,13008,3441,1311263000,73369000,43220000,97338000,230727000,157800000,334250000,902476000,265181000
New York,Other,2014,1109,1062,39,6,1107,2,0,1109,0,1109,1062,39,6,1107,2,0,1109,0,0,0,263,66,0,0,0,0,0,36641000,30089000,4612000,1333000,36034000,0,0,36641000,0
New York,Other Services (except Public Administration),2014,270297,187730,45066,21504,254300,12994,1862,269156,1141,284690,187865,45280,21935,255080,14885,4695,274660,10030,1871195,326218,294001,281820,917439,450329,234899,1612817,206294,66666080000,8819288000,8500277000,9258701000,26590308000,16650996000,11266133000,54766111000,9749066000
New York,"Professional, Scientific, and Technical Services",2014,289089,210606,35469,19436,265511,15333,4279,285123,3966,305600,210675,35560,19785,266020,16935,6875,289830,15770,3132972,295261,229834,254787,790207,531596,433234,1770612,1310320,276263012000,19377127000,14297670000,18224978000,51928217000,43715162000,39372335000,135328082000,137974260000
New York,Real Estate and Rental and Leasing,2014,147558,114898,16799,7793,139490,5594,1305,146389,1169,164095,115035,17025,8390,140450,7785,4695,152930,11165,841281,146223,109554,101429,388424,184299,115241,694066,135435,51540977000,7536860000,5200597000,5083291000,17838889000,11038704000,8285037000,37391362000,13472842000
New York,Retail Trade,2014,297003,202158,48964,22836,273958,16470,3098,293526,3477,393815,202435,49535,24570,276540,21865,10175,308580,85235,4536543,305961,310650,285709,929824,572752,277183,1853579,2425945,130428516000,9715400000,9018579000,9259332000,28004903000,20886043000,11566169000,61434272000,64916852000
New York,Total,2014,459266,300750,70404,41129,412283,34782,7653,454718,4548,536890,301012,70890,42411,414313,41309,19477,475099,61791,7858425,491820,459964,549049,1500833,1307583,1160066,3968482,3889943,492706483000,22208099000,18703670000,24052170000,64963939000,67063847000,68700738000,200728524000,291977959000
New York,Transportation and Warehousing,2014,56603,35377,7424,4923,47724,5011,1805,54540,2063,63090,35390,7460,4945,47795,5575,2860,56230,6860,1173438,31497,46304,61568,158391,170911,162085,511129,650228,52001078000,1858088000,1801044000,2390422000,6197172000,7118501000,6120089000,20129565000,31524347000
New York,Utilities,2014,1071,440,140,110,690,117,66,873,198,3080,470,145,115,730,145,285,1160,1920,193669,601,701,1212,2858,2514,3802,11479,169932,19035430000,49495000,56276000,69480000,185417000,224941000,409415000,1004582000,16961208000
New York,Wholesale Trade,2014,149181,91997,21923,14225,128145,13425,3925,145495,3686,162190,92130,22010,14650,128790,15055,6285,150130,12060,1832132,150647,141476,186631,483341,454214,351392,1301239,450997,127921973000,7860090000,7617345000,10827287000,26321320000,29644824000,24591750000,81292600000,43425054000
North Carolina,Accommodation and Food Services,2014,71659,25055,13254,15067,53376,15314,1528,70218,1441,99615,25060,13290,15300,53650,17855,5955,77460,22155,1840003,39376,89828,206344,336511,540203,225500,1105812,740126,28522515000,1147935000,1256135000,2919681000,5325125000,8095550000,3337926000,16830840000,11436227000
North Carolina,Administrative and Support and Waste Management and Remediation Services,2014,52360,31300,8340,4663,44303,4436,1513,50252,2108,61405,31300,8355,4730,44385,5105,2035,51525,9880,1771650,45421,54076,61015,167233,156024,190483,521371,1029951,60143622000,1634613000,1668735000,1971001000,5322325000,5341358000,5741130000,16588911000,34619835000
North Carolina,"Agriculture, Forestry, Fishing and Hunting",2014,3908,2420,820,425,3665,140,40,3845,63,3950,2420,820,435,3675,140,60,3875,75,23168,4444,5167,5024,15201,3048,1389,21025,1590,874306000,150017000,187833000,198341000,551101000,115967000,48638000,761484000,66659000
North Carolina,"Arts, Entertainment, and Recreation",2014,16833,10024,2299,1730,14053,2087,373,16513,320,17880,10035,2305,1735,14075,2255,520,16850,1030,292136,11879,14647,23216,52712,82238,46653,191707,95226,8788492000,578541000,367987000,508609000,1473741000,1764862000,1434541000,4819344000,3470399000
North Carolina,Construction,2014,103810,69130,16500,9329,94959,7117,995,103071,739,105430,69130,16515,9340,94985,7235,1400,103620,1810,839645,109667,108125,124790,344154,256844,105444,710935,111676,37644410000,3863761000,3761360000,4905600000,12541175000,11833147000,5530040000,30078410000,6662715000
North Carolina,Educational Services,2014,12611,6615,1815,1465,9895,1838,498,12231,380,13355,6620,1815,1475,9910,1905,670,12485,870,472604,9810,11980,18544,41470,76751,77641,198951,259004,18876817000,357082000,236659000,396685000,1005373000,2113595000,2577041000,5900594000,12684648000
North Carolina,Finance and Insurance,2014,32401,21815,4485,1722,28022,1526,784,30332,2069,65425,21855,4610,2150,28615,3660,3425,35700,29725,826792,31588,27177,20621,80095,45012,53749,187055,587000,71552603000,1739080000,1391771000,1418569000,4591241000,2964186000,3771168000,11691687000,58352780000
North Carolina,Health Care and Social Assistance,2014,85729,36459,19980,12962,69401,11318,3013,83732,1997,115265,36485,20100,13285,69870,15195,9945,95010,20255,2788858,60465,132422,171496,367214,440234,428277,1246218,1492423,120274949000,3154475000,5565160000,7024336000,15764818000,15549873000,15252407000,46917187000,71279092000
North Carolina,Information,2014,9238,4960,1095,775,6830,910,395,8135,1103,17345,4985,1095,800,6880,1250,790,8920,8425,399387,7176,6626,9657,24521,30602,37491,96680,299987,28361576000,359308000,308867000,469811000,1170509000,1940428000,3223280000,6540183000,21691913000
North Carolina,Management of Companies and Enterprises,2014,5027,245,110,140,495,980,1366,2841,2186,8905,245,110,140,495,990,1485,2970,5935,462517,7,329,920,1555,13030,46622,61207,400846,48103985000,37135000,21770000,62890000,121795000,892330000,2996760000,4010885000,44028160000
North Carolina,Manufacturing,2014,40113,14510,6320,5250,26080,7161,2886,36127,3986,43605,14520,6325,5265,26110,7355,3570,37035,6570,1879347,21237,36581,63489,130338,268074,273373,723755,1076212,88850165000,978697000,1328704000,2413304000,5013753000,10949500000,11658573000,29899765000,55069231000
North Carolina,"Mining, Quarrying, and Oil and Gas Extraction",2014,588,225,90,60,375,72,51,498,90,1030,225,90,60,375,95,90,560,470,15176,33,374,688,1648,1991,2988,7624,6907,826293000,12563000,12877000,32822000,77945000,92426000,181078000,422984000,350945000
North Carolina,Other,2014,437,415,16,5,436,1,0,437,0,437,415,16,5,436,1,0,437,0,0,0,90,66,0,0,0,0,0,9400000,7036000,1590000,768000,9394000,0,0,9400000,0
North Carolina,Other Services (except Public Administration),2014,105833,68715,20820,8885,98420,5752,902,105074,759,113980,68840,20985,9395,99220,7515,2700,109435,4545,741658,126368,134552,114896,379328,198199,79248,668118,50411,19247076000,3060824000,3231802000,2882993000,9186536000,4936807000,2088458000,16584766000,1962785000
North Carolina,"Professional, Scientific, and Technical Services",2014,107649,77555,12988,7168,97711,5420,1893,105024,2625,117065,77580,13075,7345,98000,6595,3185,107780,9285,1006363,103894,83687,92973,292327,169895,117257,585006,404327,70650224000,5653330000,4154435000,5054338000,14893345000,11124623000,9025155000,35418045000,34816956000
North Carolina,Real Estate and Rental and Leasing,2014,39788,31435,3645,1542,36622,1471,775,38868,920,53090,31480,3700,1760,36940,2830,3305,43075,10015,242941,30842,22664,18287,84228,42821,34119,167644,74463,10618327000,1661039000,843101000,715488000,3244375000,1792355000,1585109000,6870387000,3642305000
North Carolina,Retail Trade,2014,100040,58284,19793,9954,88031,7559,1649,97239,2801,171230,58465,20255,11380,90100,13505,7450,111055,60175,2119177,100470,127335,126132,359827,251384,129680,763709,1254784,52461165000,2636336000,3119263000,3479767000,9261414000,8471716000,4398441000,22624375000,28359617000
North Carolina,Total,2014,168472,99745,28409,17463,145617,15533,3688,164838,3634,219897,99885,28707,18333,146925,20488,10538,177951,41946,3560448,165260,186925,232432,584617,570444,438315,1593376,1967072,155372284000,6030970000,6117509000,7797440000,19945919000,20144207000,18052829000,58142955000,97229329000
North Carolina,Transportation and Warehousing,2014,23652,14275,3108,1736,19119,1786,938,21843,1809,27545,14290,3120,1770,19180,1980,1220,22380,5165,503146,17979,19365,21261,63275,55046,47382,175074,274636,21210956000,752523000,653330000,776606000,2206375000,2038436000,1909258000,6362039000,12684277000
North Carolina,Utilities,2014,768,270,135,55,460,105,113,678,90,2810,270,135,55,460,180,275,915,1895,65542,7,706,770,2055,5468,8884,16820,0,5967407000,12202000,34420000,28725000,79524000,383372000,674412000,1168443000,0
North Carolina,Wholesale Trade,2014,46737,23501,6662,4932,35095,5566,2550,43211,3526,58370,23545,6755,5220,35520,6790,4610,46920,11450,842247,36490,41534,58644,144207,160453,124976,444108,355733,54484908000,1961221000,2191762000,3188604000,7429568000,8450833000,8009260000,24300532000,28445160000
North Dakota,Accommodation and Food Services,2014,8749,3019,1700,1555,6274,1948,293,8515,234,10200,3075,1715,1585,6375,2185,765,9325,875,189615,4583,11084,21709,37791,69449,43081,151520,35722,3103287000,153897000,144041000,294901000,596284000,1101499000,748101000,2459592000,596330000
North Dakota,Administrative and Support and Waste Management and Remediation Services,2014,4912,2905,705,470,4080,401,102,4583,329,5465,2905,710,490,4105,440,150,4695,770,71648,3327,3813,5409,13865,11621,8897,38775,28111,2682477000,171716000,159396000,192794000,553468000,430491000,410998000,1533419000,853488000
North Dakota,"Agriculture, Forestry, Fishing and Hunting",2014,565,415,75,50,540,10,0,550,15,575,415,75,50,540,10,0,550,25,2440,450,422,0,1525,0,0,1825,0,118457000,28931000,21563000,0,71301000,0,0,86867000,0
North Dakota,"Arts, Entertainment, and Recreation",2014,1991,1225,260,195,1680,225,59,1964,27,2205,1225,260,210,1695,300,180,2175,30,24840,1056,1208,1950,5207,7361,7124,21042,0,368655000,48229000,18853000,37990000,118305000,117418000,72323000,325640000,0
North Dakota,Construction,2014,15235,9905,2570,1474,13949,940,175,15064,171,15435,9905,2575,1475,13955,1000,210,15165,270,119297,14032,16151,18652,50639,34672,16890,105472,10360,8196266000,957173000,818491000,1122575000,2922663000,2497997000,1391848000,6987985000,944624000
North Dakota,Educational Services,2014,745,275,105,65,445,180,55,680,65,770,275,105,65,445,190,55,690,80,23388,311,571,598,1849,7107,7087,16161,0,566171000,11150000,9988000,7897000,32411000,157038000,212057000,412677000,0
North Dakota,Finance and Insurance,2014,5464,3730,455,320,4505,360,170,5035,429,8655,3730,490,510,4730,1090,1050,6870,1785,72739,5230,2764,3799,12229,11117,14084,38649,25172,3986543000,258364000,123500000,195583000,612759000,609249000,791374000,2137244000,1500528000
North Dakota,Health Care and Social Assistance,2014,8041,3570,1470,1200,6240,977,506,7723,318,9860,3575,1480,1250,6305,1190,1115,8610,1250,294772,5167,8866,14637,30260,36449,52347,126327,142732,13442884000,243472000,366161000,568524000,1213693000,1142723000,1681348000,4370299000,7453089000
North Dakota,Information,2014,1145,320,195,165,680,197,77,954,191,1715,320,195,185,700,315,90,1105,610,31304,305,792,1777,3026,6496,3543,14424,12137,2053878000,15321000,34838000,63649000,132961000,386198000,216146000,782666000,754609000
North Dakota,Management of Companies and Enterprises,2014,490,40,10,35,85,85,100,270,220,565,40,10,35,85,85,105,275,290,21784,11,0,0,26,974,1790,2989,18623,1611865000,6724000,0,0,17852000,49567000,122710000,192175000,1399512000
North Dakota,Manufacturing,2014,3517,1360,565,445,2370,546,264,3180,337,3810,1360,565,445,2370,560,330,3260,550,88064,1307,2074,3569,9516,12062,11753,45603,24593,4090365000,72230000,84532000,145738000,404763000,561280000,526302000,2024464000,1231056000
North Dakota,"Mining, Quarrying, and Oil and Gas Extraction",2014,2440,940,340,235,1515,395,155,2065,375,2915,940,340,235,1515,455,170,2140,775,124229,1172,1914,3013,6023,16497,20305,43663,78637,12886562000,161560000,125505000,245334000,538310000,1590111000,2081295000,4235114000,8491694000
North Dakota,Other,2014,42,40,2,0,42,0,0,42,0,42,40,2,0,42,0,0,42,0,0,0,0,0,0,0,0,0,0,787000,764000,0,0,787000,0,0,787000,0
North Dakota,Other Services (except Public Administration),2014,12153,7857,2408,984,11249,644,55,11948,205,12645,7865,2430,1045,11340,825,80,12245,400,69447,12597,15000,12205,41950,16979,1016,65226,2202,1920463000,369396000,405161000,352968000,1143539000,520424000,28897000,1772886000,81583000
North Dakota,"Professional, Scientific, and Technical Services",2014,8505,5370,1215,709,7294,544,288,8126,379,9160,5370,1215,730,7315,735,450,8500,660,76040,7419,6422,8186,23816,15689,11737,54649,14094,4920442000,411910000,382200000,497656000,1339221000,1055447000,1023838000,3676566000,845120000
North Dakota,Real Estate and Rental and Leasing,2014,4618,3410,475,235,4120,186,115,4421,197,5330,3410,480,240,4130,235,285,4650,680,26412,3415,2358,2655,9146,4520,2853,19280,5577,1363527000,201054000,110563000,109873000,460080000,264909000,87532000,871714000,419822000
North Dakota,Retail Trade,2014,11681,4664,2557,1707,8928,1439,450,10817,864,16210,4705,2580,1860,9145,2065,1365,12575,3635,241183,6486,15203,19328,45759,41061,32859,128433,93992,6839633000,240491000,461131000,628240000,1383782000,1511794000,1175446000,4283612000,2041205000
North Dakota,Total,2014,20305,11243,3394,2186,16823,2037,573,19433,872,24698,11269,3426,2335,17030,2794,1547,21371,3327,360970,17993,22236,29270,69499,74778,65299,209576,151394,17362523000,797047000,828825000,1137035000,2762907000,3282896000,3017796000,9063599000,8298924000
North Dakota,Transportation and Warehousing,2014,7821,4990,1105,535,6630,550,236,7416,405,8545,4995,1105,535,6635,600,325,7560,985,95027,6681,6824,6173,20590,19118,13489,56423,31439,5935192000,392810000,368870000,361056000,1145589000,1269674000,709679000,3212682000,2360520000
North Dakota,Utilities,2014,275,75,25,20,120,80,15,215,60,695,75,25,20,120,160,25,305,390,5318,0,120,0,0,3816,0,5960,0,1078851000,4063000,9547000,0,34090000,293458000,0,499584000,0
North Dakota,Wholesale Trade,2014,5814,1960,735,605,3300,1046,524,4870,944,8525,1960,765,710,3435,1530,985,5950,2575,115449,2061,4057,6168,13191,25437,19814,66265,37743,7061337000,151018000,237155000,365371000,836928000,1619524000,1263850000,4028580000,2582638000
Ohio,Accommodation and Food Services,2014,84287,29714,16128,17124,62966,17895,1859,82720,1567,119000,29770,16175,17315,63260,21290,8900,93450,25550,2224059,48391,107979,232876,389731,646919,302729,1341665,862712,31871375000,1148795000,1300085000,2956722000,5412665000,9129747000,3843388000,18404025000,13119170000
Ohio,Administrative and Support and Waste Management and Remediation Services,2014,56394,32775,8505,5415,46695,5238,1990,53923,2471,66845,32785,8505,5450,46740,5665,2620,55025,11820,1926733,43596,55584,71464,173782,197117,267793,647071,1274480,59029863000,2041516000,1808758000,2429194000,6375557000,6811976000,7822426000,21249098000,37760028000
Ohio,"Agriculture, Forestry, Fishing and Hunting",2014,1330,975,180,85,1240,45,15,1300,30,1340,975,180,85,1240,45,15,1300,40,5715,1326,756,947,3513,409,0,4862,721,199485000,39169000,22535000,29728000,108825000,15551000,0,161705000,31076000
Ohio,"Arts, Entertainment, and Recreation",2014,17571,9725,2842,1985,14552,2186,523,17261,310,18805,9735,2860,2000,14595,2405,745,17745,1060,319447,14027,18435,25810,59772,81935,70769,216623,91776,10971860000,598596000,487964000,499175000,1615575000,1576999000,4672449000,7926662000,2618903000
Ohio,Construction,2014,96630,62846,15530,9598,87974,6974,957,95905,725,98015,62850,15530,9610,87990,7265,1335,96590,1425,858045,98604,100995,127030,328155,255159,133314,722022,114719,50024382000,4516865000,4441470000,6514846000,15480735000,15089040000,9399692000,40282445000,8554965000
Ohio,Educational Services,2014,13236,5010,2300,1872,9182,2962,636,12780,456,15150,5010,2310,1915,9235,3500,995,13730,1420,588413,7794,15158,24792,48680,124934,94751,273563,312509,16308640000,256181000,292795000,551238000,1104738000,3456226000,3147450000,7778527000,8473052000
Ohio,Finance and Insurance,2014,41414,27227,6154,2358,35739,2460,969,39168,2246,85680,27310,6400,2955,36665,5770,4610,47045,38635,1229935,46655,38519,29953,115574,87307,77081,290701,917564,88897160000,2209067000,1929490000,1927682000,6156514000,5418994000,4707765000,16628745000,70889746000
Ohio,Health Care and Social Assistance,2014,101472,40102,24078,15344,79524,13812,5033,98369,3103,142975,40255,24350,16250,80855,19560,15150,115565,27410,4102842,78060,158811,204377,444976,543567,747417,1743996,2348502,175908627000,3659056000,6178230000,8464694000,18316347000,20257972000,22115668000,61004230000,114565465000
Ohio,Information,2014,8764,3830,1204,1000,6034,1209,441,7684,1080,18985,3840,1210,1040,6090,1475,805,8370,10615,413816,4708,7191,12875,27315,42588,39851,113156,300214,26163986000,312859000,305253000,599351000,1235583000,2215080000,2412933000,6030058000,20107045000
Ohio,Management of Companies and Enterprises,2014,6473,345,145,230,720,1070,1897,3687,2786,10770,345,150,230,725,1090,1990,3805,6965,736364,529,508,1605,2566,12685,56463,71930,664434,68898035000,38200000,41610000,101125000,181745000,806586000,4058225000,5048455000,63848797000
Ohio,Manufacturing,2014,65876,20263,11130,9718,41111,13976,5380,60467,5409,71040,20265,11155,9755,41175,14635,6645,62455,8585,3106265,35335,69042,123600,238849,529996,614353,1445117,1528942,171024634000,1590142000,2688806000,5349625000,9906136000,24886596000,31260293000,68966436000,94082338000
Ohio,"Mining, Quarrying, and Oil and Gas Extraction",2014,3015,1545,480,314,2339,265,112,2716,299,3690,1545,480,315,2340,350,200,2890,800,53727,2458,2859,3583,9466,6866,8692,25714,24906,3941085000,211871000,146520000,216057000,586707000,425824000,632014000,1693073000,2037461000
Ohio,Other,2014,351,339,10,2,351,0,0,351,0,351,339,10,2,351,0,0,351,0,367,0,0,0,367,0,0,367,0,7944000,7017000,0,0,7944000,0,0,7944000,0
Ohio,Other Services (except Public Administration),2014,123291,71930,28058,13280,113268,7789,1238,122295,996,137915,72000,28375,14060,114435,10470,3430,128335,9580,1000458,143753,182523,171754,499814,261662,100890,870332,113975,26194028000,3268099000,3983536000,4074775000,11340391000,6748436000,3076366000,21328328000,4344754000
Ohio,"Professional, Scientific, and Technical Services",2014,108932,71300,15910,9565,96775,7135,2362,106272,2660,120205,71315,15955,9870,97140,8510,3690,109340,10865,1194121,108631,101897,125801,343808,235196,190638,774607,401713,78118618000,5428354000,4975359000,6848719000,17280645000,15348260000,14177220000,47191545000,30381173000
Ohio,Real Estate and Rental and Leasing,2014,35273,24806,4619,2194,31619,1798,960,34377,896,49595,24870,4735,2545,32150,3215,4115,39480,10115,301389,39052,28955,26638,96111,50848,46280,197444,98008,14084720000,1440195000,992336000,1126364000,3569818000,2240302000,2662944000,8638502000,5258881000
Ohio,Retail Trade,2014,102180,55150,21826,11189,88165,8836,2149,99150,3030,181300,55375,22465,12425,90265,13980,8665,112910,68390,2789150,85459,139408,144399,382418,316142,188147,914058,1703119,69985077000,2451314000,3230667000,3664299000,9422491000,10596559000,6619865000,26992211000,40495777000
Ohio,Total,2014,185539,99937,34371,22179,156487,20131,4935,181553,3986,250535,100121,34818,23346,158285,26473,14507,199265,51270,4636844,176000,226466,296942,699408,759001,675881,2134290,2502554,203868114000,6782650000,7414732000,10511276000,24708658000,28969261000,28604940000,82282859000,121585255000
Ohio,Transportation and Warehousing,2014,29406,15210,4087,3349,22646,3181,1238,27065,2341,35375,15215,4115,3415,22745,3595,1845,28185,7190,762098,21406,25040,41821,91143,106922,71909,278337,404890,32801430000,946877000,987682000,1659222000,3647459000,4400445000,2834016000,11087084000,18542743000
Ohio,Utilities,2014,869,285,110,70,465,230,33,728,141,3150,285,115,70,470,305,90,865,2285,73525,430,563,784,1627,8852,1368,14202,10996,6722829000,21512000,37455000,44049000,117408000,595878000,87656000,922551000,1755873000
Ohio,Wholesale Trade,2014,56006,25118,8845,6993,40956,7514,3501,51971,4035,71085,25165,8975,7415,41555,9240,6690,57485,13600,1145107,42777,56715,88323,191451,241089,216198,667445,455751,68987656000,2804878000,2976488000,4842778000,10600789000,13238634000,13010945000,38122869000,29698673000
Oklahoma,Accommodation and Food Services,2014,26711,9825,4700,4795,19320,5799,750,25869,842,38085,9825,4700,4855,19380,6860,3200,29440,8645,720136,15957,30708,65513,113624,208109,110218,435678,263866,10384746000,361505000,384419000,849838000,1600230000,2910705000,1470319000,6081087000,4077390000
Oklahoma,Administrative and Support and Waste Management and Remediation Services,2014,20120,11770,3015,1825,16610,1610,677,18897,1223,22310,11785,3025,1855,16665,1715,1000,19380,2930,499818,17099,18062,22914,59779,57895,84097,208801,268617,17669525000,658880000,531140000,735444000,1971234000,2005023000,2264462000,6454911000,10896995000
Oklahoma,"Agriculture, Forestry, Fishing and Hunting",2014,751,505,110,85,700,10,16,726,25,760,505,110,85,700,10,25,735,25,4207,318,310,926,2427,0,0,3789,107,172167000,28500000,14058000,35646000,90242000,0,0,145773000,6979000
Oklahoma,"Arts, Entertainment, and Recreation",2014,4952,2700,725,555,3980,625,220,4825,127,5405,2705,735,570,4010,665,305,4980,425,128083,3056,4499,6686,15175,23677,29706,72437,0,3510247000,126774000,88746000,122753000,355417000,446647000,887707000,1842567000,24155000
Oklahoma,Construction,2014,40640,25580,7105,4165,36850,2980,460,40290,350,40990,25580,7105,4170,36855,3025,540,40420,570,349470,40736,45952,54262,143549,108194,54207,311410,32861,16981440000,1487310000,1594075000,2214683000,5318460000,5175999000,3325297000,14081375000,2655256000
Oklahoma,Educational Services,2014,3431,1715,500,425,2640,400,199,3239,192,3665,1715,500,430,2645,410,245,3300,365,107319,2411,3245,4395,10778,13812,26735,52956,51478,3141123000,74129000,66141000,80620000,241209000,355751000,799834000,1485445000,1606265000
Oklahoma,Finance and Insurance,2014,20068,13705,2560,893,17158,1349,419,18926,1142,33800,13735,2620,1175,17530,3780,2260,23570,10230,277511,19950,15426,10484,48826,48743,42470,147244,123767,16035261000,933439000,688483000,594064000,2246961000,2460363000,2130150000,7166284000,8051244000
Oklahoma,Health Care and Social Assistance,2014,42308,20913,9175,4915,35003,4739,1449,41191,1117,53560,20940,9190,5040,35170,6450,4745,46365,7195,1076060,33336,60239,64641,161341,201885,195099,561464,474417,43831536000,2037249000,2463668000,2501760000,7015657000,6759066000,5979386000,19841957000,23247973000
Oklahoma,Information,2014,3851,1720,505,459,2684,456,166,3306,545,7175,1735,510,505,2750,600,360,3710,3465,144422,1487,3154,4490,11347,13890,4823,36572,97377,7766546000,117810000,106632000,207802000,458134000,626126000,302157000,1614119000,5787028000
Oklahoma,Management of Companies and Enterprises,2014,2293,155,55,80,290,415,683,1388,905,3060,160,55,80,295,415,770,1480,1580,186300,0,0,404,688,4117,21450,26485,159787,17093330000,3459000,1835000,38352000,81350000,250080000,1590025000,1927935000,15164324000
Oklahoma,Manufacturing,2014,16510,5945,2890,2270,11105,2799,1020,14924,1586,17770,5945,2890,2290,11125,2985,1205,15315,2455,612297,7371,15393,26211,56127,97906,79665,262216,310108,31551153000,422178000,594378000,1109617000,2314360000,4547728000,4156726000,12360710000,17139416000
Oklahoma,"Mining, Quarrying, and Oil and Gas Extraction",2014,14529,9275,1840,1169,12284,1233,394,13911,618,16335,9275,1840,1170,12285,1260,630,14175,2160,293377,8936,11512,15000,40904,43857,39357,125491,167448,27341763000,833088000,759213000,947497000,2544348000,3289741000,3549552000,9429720000,17882176000
Oklahoma,Other,2014,108,101,5,1,107,1,0,108,0,108,101,5,1,107,1,0,108,0,163,0,35,0,0,0,0,163,0,1896000,1612000,203000,0,1822000,0,0,1896000,0
Oklahoma,Other Services (except Public Administration),2014,41732,26301,8282,3620,38203,2589,430,41222,510,44680,26340,8340,3780,38460,3370,830,42660,2020,308176,49016,52798,46310,149012,87702,37160,281896,16509,7765076000,1135859000,1217634000,1174485000,3568601000,2129426000,968161000,6875766000,615329000
Oklahoma,"Professional, Scientific, and Technical Services",2014,45349,32467,6180,2888,41535,2038,723,44296,1053,48535,32515,6195,3015,41725,2380,1600,45705,2830,341297,43338,39658,35981,124895,63810,53557,250154,78681,20042500000,2195906000,1793921000,1817743000,5951134000,3757455000,3708205000,13834441000,5694161000
Oklahoma,Real Estate and Rental and Leasing,2014,16943,12814,1755,791,15360,626,330,16316,627,20525,12840,1790,940,15570,990,765,17325,3200,109464,15469,11211,9854,39922,19241,9764,73610,29861,4848569000,645721000,395206000,386655000,1440899000,706026000,557930000,3013389000,1502853000
Oklahoma,Retail Trade,2014,42246,22105,9138,4687,35930,3446,898,40274,1972,66185,22160,9350,5100,36610,5255,3190,45055,21130,794119,39630,58641,57721,159910,110158,62602,348885,414401,20462553000,1014780000,1379975000,1547049000,3986609000,3809846000,2393035000,10478746000,9255207000
Oklahoma,Total,2014,73014,42518,12568,7312,62398,6687,1740,70825,2189,92430,42587,12679,7682,62948,8937,4916,76801,15629,1359851,72417,82425,97616,252458,249731,206929,709118,650733,58150206000,2673066000,2701440000,3357281000,8731787000,9201365000,8669194000,26602346000,31547860000
Oklahoma,Transportation and Warehousing,2014,11349,6325,1475,992,8792,976,460,10228,1121,13430,6325,1495,1020,8840,1020,780,10640,2790,207429,8662,8410,12246,31451,29387,18360,82991,96552,10887415000,412766000,345353000,487641000,1276944000,1403002000,963636000,3707584000,5846393000
Oklahoma,Utilities,2014,685,240,90,20,350,135,81,566,119,1845,240,90,20,350,195,195,740,1105,36595,444,0,0,1288,7065,2533,13186,261,2925558000,31588000,9744000,0,92025000,462920000,221243000,919621000,179639000
Oklahoma,Wholesale Trade,2014,18846,8095,2791,2144,13030,2545,1233,16808,2038,23495,8105,2830,2305,13240,3295,1935,18470,5025,298105,9877,16132,24940,56815,65758,43775,181276,101817,17061761000,662088000,785581000,1268084000,2821547000,3452011000,2625621000,9604004000,6742389000
Oregon,Accommodation and Food Services,2014,43355,14310,10275,10041,34626,7178,886,42690,665,54155,14330,10300,10290,34920,9180,3440,47540,6615,807105,23803,66625,135327,225117,237617,110446,579558,220721,14372720000,547617000,959475000,2113623000,3627910000,4269552000,1984434000,9905103000,4391010000
Oregon,Administrative and Support and Waste Management and Remediation Services,2014,24513,14880,3797,2095,20772,1995,648,23415,1098,27605,14885,3805,2145,20835,2195,955,23985,3620,463278,21562,23212,26441,76150,71852,69022,228004,227661,14563412000,729337000,702271000,839626000,2306189000,2401898000,2127600000,7138710000,7183797000
Oregon,"Agriculture, Forestry, Fishing and Hunting",2014,6391,4145,755,635,5535,700,95,6330,61,6540,4145,755,635,5535,730,140,6405,135,58016,4757,4835,8764,19022,24486,7865,52347,2603,2404804000,292126000,204880000,372651000,875990000,1003678000,251423000,2180756000,148621000
Oregon,"Arts, Entertainment, and Recreation",2014,8319,4840,1145,965,6950,1065,175,8190,129,8790,4850,1155,965,6970,1215,305,8490,300,127793,5174,6174,12235,26575,39385,18712,94389,22775,3079930000,236894000,144056000,227266000,638119000,722488000,602014000,2333183000,423027000
Oregon,Construction,2014,56277,39733,8465,4460,52658,2863,391,55912,365,56805,39735,8465,4465,52665,3030,485,56180,625,384290,60146,54516,58752,176025,100368,35529,321521,49741,20587080000,2250741000,2070575000,2664145000,6992886000,5680274000,2747661000,15963828000,3690519000
Oregon,Educational Services,2014,6984,3455,1075,900,5430,1105,248,6783,201,7690,3460,1090,915,5465,1295,630,7390,300,177377,4465,6931,12265,24646,40672,34960,103134,69493,4717205000,156561000,128108000,253886000,544030000,1032787000,957059000,2604747000,1876045000
Oregon,Finance and Insurance,2014,16750,11245,2099,649,13993,765,549,15307,1443,29625,11260,2145,725,14130,1665,1960,17755,11870,295092,16231,12538,6955,38530,24622,24289,100314,173810,20697262000,789059000,812058000,520339000,2170877000,1597741000,2164533000,6475011000,12981727000
Oregon,Health Care and Social Assistance,2014,50575,27310,10545,5548,43403,4350,1713,49466,1109,64795,27315,10615,5825,43755,6145,6795,56695,8100,1130496,40867,69649,72013,190206,169901,187896,557945,541426,53862548000,2050529000,2646564000,2875134000,7587012000,6578839000,6523527000,20974085000,31489508000
Oregon,Information,2014,6573,3400,846,660,4906,685,302,5893,680,9870,3405,860,690,4955,765,615,6335,3535,171101,3920,4483,8144,18488,21294,24132,70867,95024,11591382000,235127000,221934000,416696000,884469000,1451860000,1648697000,4326116000,6830175000
Oregon,Management of Companies and Enterprises,2014,2589,130,70,115,315,545,797,1657,932,3775,130,70,115,315,555,860,1730,2045,211406,125,252,635,1025,5988,27670,34801,176605,24679800000,34023000,11895000,33865000,80180000,332780000,2173014000,2596845000,22082955000
Oregon,Manufacturing,2014,25336,10730,4395,3345,18470,4006,1329,23805,1531,26570,10735,4400,3355,18490,4175,1600,24265,2305,736919,15323,24207,38803,86945,135705,110764,389770,277245,41816845000,642838000,921451000,1586818000,3418028000,6221176000,5560818000,17607465000,20740735000
Oregon,"Mining, Quarrying, and Oil and Gas Extraction",2014,570,270,90,90,450,60,15,525,45,690,270,90,90,450,65,15,530,160,6216,280,534,901,1999,1037,0,3669,0,333631000,19035000,22134000,44362000,88674000,56161000,0,178608000,59499000
Oregon,Other,2014,347,338,8,0,346,1,0,347,0,347,338,8,0,346,1,0,347,0,345,266,51,0,317,0,0,345,0,7244000,5945000,1101000,0,7046000,0,0,7244000,0
Oregon,Other Services (except Public Administration),2014,45250,28640,9067,4202,41909,2456,413,44778,472,49345,28660,9120,4400,42180,3400,2210,47790,1555,322461,50880,58355,53306,165765,81238,30570,286560,21339,8820251000,1341947000,1437917000,1433719000,4228289000,2235605000,1011081000,7796831000,764252000
Oregon,"Professional, Scientific, and Technical Services",2014,56522,40440,7155,4022,51617,2702,793,55112,1410,59510,40445,7160,4150,51755,3125,1005,55885,3625,421575,45960,44829,50764,157285,86284,39104,288717,106393,29495295000,2940157000,2167844000,2844462000,8042076000,5797329000,3040367000,17149309000,10954091000
Oregon,Real Estate and Rental and Leasing,2014,23867,18372,2510,1101,21983,896,430,23309,558,28800,18415,2595,1240,22250,1380,1995,25625,3175,134021,26205,15461,12667,54968,24821,20561,107025,21912,4982651000,879533000,504655000,473184000,1879321000,893445000,742228000,3712317000,1048490000
Oregon,Retail Trade,2014,47143,23834,10330,5824,39988,3947,1192,45127,2016,69970,23965,10480,6470,40915,6510,4685,52110,17860,960211,38140,64753,71631,180220,127315,77637,402315,493342,26157287000,1061205000,1537666000,1926711000,4536871000,4172141000,2538282000,11524579000,13440452000
Oregon,Total,2014,89739,53085,15499,9566,78150,7520,1837,87507,2232,109875,53153,15623,10030,78806,10025,6146,94977,14898,1444041,88546,101631,127278,317455,270578,213633,801666,642375,65714985000,3124133000,3251209000,4247669000,10623011000,10399577000,9113869000,30136457000,35578528000
Oregon,Transportation and Warehousing,2014,13108,7370,1835,1165,10370,1154,543,12067,1041,14985,7370,1845,1230,10445,1245,755,12445,2540,248761,9887,11216,13262,37237,35107,22678,102478,122338,11509394000,404718000,429599000,504544000,1395753000,1508311000,1024326000,4123891000,6229422000
Oregon,Utilities,2014,631,335,60,40,435,95,30,560,71,1395,335,60,40,435,155,45,635,760,16795,459,0,440,963,3750,0,4966,14216,2208577000,16524000,5242000,39743000,73542000,321792000,13697000,429659000,1909724000
Oregon,Wholesale Trade,2014,22227,10365,3024,2320,15709,2786,1502,19997,2230,26725,10365,3065,2405,15835,3290,2235,21360,5365,363014,12199,17621,26633,63916,71807,59901,215057,130821,23108173000,816346000,912658000,1398014000,3214881000,3922971000,3474822000,11392041000,10919176000
Pennsylvania,Accommodation and Food Services,2014,113345,50020,22466,19426,91912,18228,1780,111920,1425,141855,50070,22520,19640,92230,20590,6105,118925,22930,2258040,88968,148895,263632,501294,663998,250351,1420435,835491,36087385000,1771755000,1924105000,3396496000,7094170000,9836045000,3512719000,20525000000,15527120000
Pennsylvania,Administrative and Support and Waste Management and Remediation Services,2014,65491,39495,9660,6153,55308,5722,2026,63056,2435,76895,39495,9670,6255,55420,6265,3050,64735,12160,1581986,55571,63017,81179,202794,215957,265740,691691,870651,53567780000,2884159000,2183463000,3080785000,8171337000,7963253000,7964044000,24295228000,28471495000
Pennsylvania,"Agriculture, Forestry, Fishing and Hunting",2014,2390,1795,365,100,2260,90,25,2375,15,2390,1795,365,100,2260,90,25,2375,15,12063,2485,2211,906,6231,1707,867,11733,18,423206000,88691000,63857000,40517000,202116000,79811000,34333000,416541000,1333000
Pennsylvania,"Arts, Entertainment, and Recreation",2014,21431,11947,3240,2355,17542,2897,603,21042,389,22760,11950,3240,2395,17585,3110,855,21550,1210,459825,15781,20589,31196,69144,113991,85853,276384,178471,15792905000,646286000,502252000,664223000,1824675000,2343004000,3656110000,8100544000,6803637000
Pennsylvania,Construction,2014,129864,87780,20280,11414,119474,8370,1353,129197,667,131045,87780,20280,11460,119520,8560,1595,129675,1370,1101985,138371,132065,152698,424725,303300,178641,914130,155279,65369935000,5904190000,5958515000,8026634000,19895540000,19178845000,13013803000,52378295000,11253179000
Pennsylvania,Educational Services,2014,16657,6590,2625,2145,11360,3602,940,15902,755,18730,6590,2625,2200,11415,3880,1480,16775,1955,1308775,9888,17446,28632,56933,158560,133049,362232,942659,51605695000,373920000,377713000,692257000,1442869000,4948018000,5181411000,12072665000,39363680000
Pennsylvania,Finance and Insurance,2014,46682,29468,7429,3019,39916,2856,1404,44176,2506,87785,29505,7675,3475,40655,5770,6845,53270,34515,1282567,53711,45378,39371,140256,96010,123149,374996,860258,108094196000,2747899000,2605647000,2992890000,8389282000,7421759000,8670536000,25614012000,80490790000
Pennsylvania,Health Care and Social Assistance,2014,122681,53004,27323,17480,97807,15313,5829,118949,3732,182670,53110,27645,18545,99300,23385,20570,143255,39415,4861289,105116,179763,234597,520394,579486,873152,1976421,2865377,212518779000,4306061000,6922525000,9608259000,20898394000,22981950000,28829870000,72767858000,139455901000
Pennsylvania,Information,2014,12501,5435,2005,1390,8830,1708,613,11151,1350,25510,5440,2015,1465,8920,2085,1000,12005,13505,568300,8336,12632,18000,40485,57034,54616,157275,409740,45758021000,432806000,502418000,813142000,1763945000,3192644000,3416775000,8682100000,37074340000
Pennsylvania,Management of Companies and Enterprises,2014,7134,295,130,185,610,1262,2080,3952,3182,11875,295,130,195,620,1285,2270,4175,7700,924045,0,690,1145,2280,16312,77495,96090,827955,90565530000,55215000,84295000,91645000,231155000,988106000,6384895000,7604790000,82960740000
Pennsylvania,Manufacturing,2014,64207,21538,10455,9560,41553,13262,4481,59296,4911,68420,21545,10460,9630,41635,13860,5400,60895,7525,2637891,36186,63897,122322,234855,504926,484483,1298164,1205151,144092005000,1542125000,2471220000,5203483000,9521982000,24373423000,25246552000,62518345000,74110989000
Pennsylvania,"Mining, Quarrying, and Oil and Gas Extraction",2014,4496,2030,655,515,3200,570,272,4042,454,5820,2030,655,520,3205,625,425,4255,1565,159482,2025,3951,6355,14503,20671,23565,60318,94206,13929503000,193439000,199510000,338823000,737594000,1304102000,1856446000,3991817000,9937620000
Pennsylvania,Other,2014,390,373,12,4,389,1,0,390,0,390,373,12,4,389,1,0,390,0,484,0,71,0,462,0,0,484,0,9390000,8020000,679000,0,9339000,0,0,9390000,0
Pennsylvania,Other Services (except Public Administration),2014,168138,105225,36110,15493,156828,9014,1345,167187,951,179830,105265,36345,15980,157590,11180,3755,172525,7305,1200651,204411,232363,202196,644142,310772,118005,1085252,89772,32108052000,4748595000,5179152000,4894470000,14836509000,8550441000,4278334000,27856693000,3591920000
Pennsylvania,"Professional, Scientific, and Technical Services",2014,136048,90355,18865,11657,120877,9373,2666,132916,3132,147940,90380,18955,11925,121260,11460,4170,136890,11050,1607679,139303,121049,152101,416387,320789,230310,975680,615841,122180790000,7680922000,6834965000,9690930000,24248395000,23916192000,18061240000,66439045000,54546548000
Pennsylvania,Real Estate and Rental and Leasing,2014,35369,23798,5202,2428,31428,2042,877,34347,1022,47855,23890,5365,2760,32015,2785,3585,38385,9470,297286,37853,33162,31083,103909,63778,48500,221689,64305,14970057000,1484904000,1282920000,1455159000,4228969000,3347007000,2614869000,10539960000,4335481000
Pennsylvania,Retail Trade,2014,131547,72208,26862,14312,113382,11951,2979,128312,3235,217990,72430,27375,16010,115815,18035,9425,143275,74715,3153892,111409,162681,171369,452929,418159,297914,1191930,1652447,79412032000,3237418000,3981909000,4828305000,12026399000,14509506000,9467326000,36533064000,38363125000
Pennsylvania,Total,2014,229522,129956,41543,25579,197078,22887,5417,225382,4140,298297,130120,41959,26820,198899,29559,15658,244116,54181,5255409,229833,272598,342765,845196,863644,750885,2459725,2795684,248560941000,8447275000,9202498000,12761099000,30410872000,35518559000,33429080000,99358511000,149202430000
Pennsylvania,Transportation and Warehousing,2014,35309,18975,4520,3692,27187,4320,1421,32928,2381,42015,18990,4535,3755,27280,4810,1885,33975,8040,1004901,27735,28004,48212,107110,151564,115098,383171,512784,40792246000,1057237000,1015611000,1755720000,3857810000,5378905000,4246023000,13798803000,22154410000
Pennsylvania,Utilities,2014,1042,385,130,65,580,162,55,797,245,3990,385,130,65,580,225,130,935,3055,76536,522,438,495,1552,6042,1184,11105,67058,10461334000,32080000,18869000,43194000,112773000,455355000,89930000,826460000,9676427000
Pennsylvania,Wholesale Trade,2014,60316,27764,9647,7377,44788,8147,3340,56275,4041,74160,27790,9750,7705,45245,9790,5720,60755,13405,1229458,44569,60690,94468,207293,257841,215984,697402,495537,84536671000,2660551000,3330447000,5494684000,11574770000,15096615000,12343478000,39806449000,43310086000
Rhode Island,Accommodation and Food Services,2014,13050,5155,2360,2475,9990,2515,186,12691,359,15195,5175,2365,2500,10040,2805,445,13290,1905,220718,7593,15272,33498,56486,88256,19841,165507,55717,3912324000,291736000,214105000,495565000,1005591000,1518066000,384157000,2911617000,1009295000
Rhode Island,Administrative and Support and Waste Management and Remediation Services,2014,7991,5355,850,570,6775,515,220,7510,481,8480,5355,850,575,6780,535,225,7540,940,103857,4686,4887,6500,17342,16027,20814,59990,39155,3606909000,352302000,177825000,237560000,800870000,615040000,482046000,2023586000,1415049000
Rhode Island,"Agriculture, Forestry, Fishing and Hunting",2014,195,160,15,10,185,10,0,195,0,195,160,15,10,185,10,0,195,0,526,3,17,0,364,0,0,526,0,27230000,6931000,607000,0,20018000,0,0,27230000,0
Rhode Island,"Arts, Entertainment, and Recreation",2014,2442,1305,340,320,1965,337,60,2362,80,2665,1310,340,320,1970,345,170,2485,180,44586,1065,1829,2858,6451,10814,5596,27156,0,1084303000,99935000,79755000,122459000,316763000,251659000,91237000,750237000,0
Rhode Island,Construction,2014,14752,11080,1950,970,14000,585,105,14690,62,14765,11080,1950,970,14000,585,105,14690,75,78468,15973,11923,11730,41225,16956,8296,73162,0,4928454000,795861000,587756000,683173000,2142581000,1173546000,554099000,4437435000,21268000
Rhode Island,Educational Services,2014,1993,960,270,160,1390,355,130,1875,118,2090,965,275,165,1405,405,130,1940,150,150620,1362,1794,1649,5444,13703,12732,32743,112575,5222301000,49349000,39858000,44374000,149132000,470904000,541990000,1180241000,3794861000
Rhode Island,Finance and Insurance,2014,4066,2125,550,240,2915,205,244,3364,702,6845,2125,550,250,2925,275,665,3865,2980,88374,3146,3280,2344,9427,5747,12841,32117,43663,9586734000,215292000,216398000,194768000,649642000,432208000,922651000,2322405000,4989370000
Rhode Island,Health Care and Social Assistance,2014,12282,5090,2715,1675,9480,1496,748,11724,558,16145,5100,2730,1750,9580,2090,2320,13990,2155,419992,9071,17751,21807,50033,61231,101112,220697,185643,18299256000,458358000,782028000,974389000,2248556000,2453488000,3878018000,8747332000,9128947000
Rhode Island,Information,2014,1436,610,205,150,965,145,65,1175,261,2380,610,205,160,975,190,80,1245,1135,34792,654,994,876,3088,4725,1521,12073,18317,2571605000,58398000,45417000,51504000,171099000,245483000,101354000,629878000,1582370000
Rhode Island,Management of Companies and Enterprises,2014,626,35,25,20,80,60,150,290,336,965,35,25,20,80,65,160,305,660,591,0,112,0,320,845,5445,6725,0,33282000,759000,12464000,0,27631000,69680000,300590000,403980000,0
Rhode Island,Manufacturing,2014,7058,2740,1170,1066,4976,1408,361,6745,313,7160,2740,1170,1075,4985,1435,395,6815,345,159061,3007,5526,10321,22861,44093,21417,114451,24466,8489292000,174509000,223862000,469103000,986079000,2053252000,1084880000,5354642000,1656732000
Rhode Island,"Mining, Quarrying, and Oil and Gas Extraction",2014,95,45,25,15,85,5,0,90,5,100,45,25,15,85,5,0,90,10,589,13,114,0,373,0,0,485,0,49717000,2021000,8580000,10512000,31501000,0,0,37565000,0
Rhode Island,Other,2014,53,50,3,0,53,0,0,53,0,53,50,3,0,53,0,0,53,0,0,0,19,0,0,0,0,0,0,1047000,913000,134000,0,1047000,0,0,1047000,0
Rhode Island,Other Services (except Public Administration),2014,13676,8855,2700,1141,12696,635,100,13431,245,14500,8860,2705,1160,12725,925,105,13755,745,84102,15111,16811,13882,48225,18320,2162,74590,4993,2613152000,470140000,479828000,395985000,1387667000,657588000,92967000,2315491000,194783000
Rhode Island,"Professional, Scientific, and Technical Services",2014,14331,9675,2015,965,12655,820,245,13720,611,14990,9675,2015,975,12665,855,255,13775,1215,111222,13147,12792,11126,38374,23201,10045,77502,23554,6753537000,768892000,734715000,729580000,2279125000,1652269000,690698000,4948664000,1620443000
Rhode Island,Real Estate and Rental and Leasing,2014,4429,3135,475,273,3883,248,78,4209,220,5285,3135,495,290,3920,385,205,4510,775,25891,3742,2675,3034,10316,6968,144,19715,3083,1122017000,202717000,125091000,134663000,496345000,286981000,34604000,841175000,202410000
Rhode Island,Retail Trade,2014,14128,7915,2499,1274,11688,864,309,12861,1267,18720,7940,2570,1355,11865,1005,680,13550,5170,231362,8969,11952,12825,39033,20989,9675,81257,96780,6486784000,368202000,402878000,416647000,1243562000,904271000,454387000,2803273000,2297095000
Rhode Island,Total,2014,23964,13776,3907,2433,20116,2219,576,22911,1053,28132,13794,3934,2501,20229,2622,1260,24111,4021,421578,22594,25707,32490,80791,80530,64350,225671,195907,19511135000,966035000,951868000,1220937000,3138840000,3245055000,2800701000,9184596000,10326539000
Rhode Island,Transportation and Warehousing,2014,2843,1660,390,243,2293,232,80,2605,238,3025,1660,390,255,2305,245,80,2630,395,42940,1523,2146,2157,6666,4695,3176,19302,9448,1696960000,81116000,78946000,80742000,273413000,225216000,143692000,774036000,470727000
Rhode Island,Utilities,2014,100,40,10,10,60,6,0,66,34,205,40,10,10,60,10,0,70,135,3057,52,0,0,25,0,0,49,1902,304916000,6835000,0,0,27022000,0,0,45040000,188844000
Rhode Island,Wholesale Trade,2014,6273,2705,970,645,4320,888,273,5481,792,6685,2710,970,650,4330,940,280,5550,1135,86327,3218,4421,5655,16348,20953,7873,54960,25089,6033183000,235114000,307393000,363349000,1030826000,1244474000,528440000,3424804000,2055888000
South Carolina,Accommodation and Food Services,2014,36834,12445,6555,7575,26575,8105,1120,35800,1034,50035,12470,6570,7620,26660,9090,4325,40075,9960,979661,20624,43956,103693,168578,297605,165011,633668,337228,15597023000,503225000,561252000,1432822000,2497305000,4577095000,2300530000,9442403000,6148915000
South Carolina,Administrative and Support and Waste Management and Remediation Services,2014,24578,14520,3674,2355,20549,2020,744,23313,1265,28065,14525,3690,2385,20600,2155,980,23735,4330,784151,22369,23580,30052,79061,74116,101955,265636,492858,24189909000,867332000,667172000,903796000,2771242000,2233951000,2955114000,8327734000,14832336000
South Carolina,"Agriculture, Forestry, Fishing and Hunting",2014,2480,1295,570,375,2240,175,35,2450,30,2495,1295,570,375,2240,175,45,2460,35,18247,1912,3449,4683,10629,4695,1122,17655,48,723607000,80795000,142832000,190724000,426897000,195424000,47793000,701317000,4470000
South Carolina,"Arts, Entertainment, and Recreation",2014,7272,3900,1025,848,5773,1075,280,7128,144,7860,3905,1035,870,5810,1145,535,7490,370,124721,4889,6295,10856,23111,41766,32190,101167,14244,2341700000,178397000,134003000,198335000,526752000,792698000,626455000,1985669000,244195000
South Carolina,Construction,2014,43716,27605,7765,4525,39895,3030,388,43313,403,44400,27610,7765,4535,39910,3095,550,43555,845,355475,44617,50548,59232,156174,104402,36433,303885,33250,15910050000,1572832000,1759950000,2295119000,5640135000,4781264000,2020554000,12768150000,2025935000
South Carolina,Educational Services,2014,5391,2650,815,695,4160,845,181,5186,205,5800,2650,815,720,4185,870,315,5370,430,154553,3302,3724,8954,18726,32650,29367,83679,70224,3886260000,129613000,85928000,162294000,395270000,839214000,920599000,2220085000,1649894000
South Carolina,Finance and Insurance,2014,16538,10470,2555,862,13887,711,553,15151,1387,35550,10505,2785,1135,14425,2245,2725,19395,16155,317926,15777,15329,10602,41694,23612,35158,106391,207941,19012656000,798250000,658172000,560586000,2052133000,1315280000,1805537000,5345569000,13615443000
South Carolina,Health Care and Social Assistance,2014,38087,16845,8923,5441,31209,4370,1322,36901,1186,49655,16870,8975,5630,31475,5540,3810,40825,8830,1104385,26532,58233,71456,162038,164101,173542,505394,582187,47017212000,1605861000,2340171000,2843893000,6811785000,6271565000,5216043000,18472343000,28442133000
South Carolina,Information,2014,3454,1665,365,285,2315,364,155,2834,620,6780,1665,365,300,2330,450,220,3000,3780,152029,2038,1863,2869,8189,11650,9217,33273,118445,8488040000,111977000,69218000,134205000,332498000,490745000,653601000,1682808000,6786556000
South Carolina,Management of Companies and Enterprises,2014,2141,120,45,51,216,342,626,1184,957,3185,120,45,55,220,350,640,1210,1975,126035,27,171,275,625,3745,16104,20474,105447,9446940000,25466000,10670000,7285000,45655000,226961000,1082355000,1354971000,8085831000
South Carolina,Manufacturing,2014,17547,5750,2585,2255,10590,3100,1436,15126,2421,18850,5750,2585,2255,10590,3230,1650,15470,3380,948481,7385,13310,25381,52531,105124,138652,339534,536239,49827976000,367905000,504607000,1054675000,2094661000,4546638000,6474207000,15121705000,30277824000
South Carolina,"Mining, Quarrying, and Oil and Gas Extraction",2014,284,110,40,40,190,25,15,230,54,395,110,40,40,190,25,15,230,165,4404,165,90,373,886,0,0,1718,2413,236274000,8642000,17460000,16796000,48050000,0,0,84677000,133810000
South Carolina,Other,2014,177,172,5,0,177,0,0,177,0,177,172,5,0,177,0,0,177,0,0,0,30,0,0,0,0,0,0,3169000,2870000,299000,0,3169000,0,0,3169000,0
South Carolina,Other Services (except Public Administration),2014,52588,32170,11483,4679,48332,3222,513,52067,521,56060,32175,11535,4820,48530,4125,885,53540,2520,397360,59095,73424,60905,196013,111102,40717,352378,37698,10187493000,1417708000,1628823000,1498271000,4560863000,2641424000,1095686000,8380728000,1660790000
South Carolina,"Professional, Scientific, and Technical Services",2014,45714,32192,5990,3098,41280,2289,873,44442,1272,49670,32195,6025,3200,41420,2895,1490,45805,3865,418523,43673,36976,38870,128832,71041,52904,257874,146660,26483520000,2297550000,1790931000,2192421000,6325855000,4104559000,3486270000,14160230000,11883938000
South Carolina,Real Estate and Rental and Leasing,2014,19678,15190,1783,870,17843,683,491,19017,661,24700,15205,1875,955,18035,1105,1005,20145,4555,113534,15447,10581,9613,41186,17435,23692,83628,18711,4571085000,794323000,381084000,409143000,1631140000,625849000,893873000,3200539000,1288007000
South Carolina,Retail Trade,2014,52592,31138,10085,4826,46049,3509,946,50504,2088,87835,31265,10350,5525,47140,5505,3410,56055,31780,1067748,55450,60254,54956,173955,114991,54055,353549,658221,25693920000,1389503000,1531758000,1659726000,4605703000,3989905000,1782557000,10629245000,14419963000
South Carolina,Total,2014,78484,44826,13685,8300,66811,7243,1968,76022,2462,102297,44893,13866,8692,67451,9200,5117,81768,20529,1617249,77311,89406,110122,276839,263512,217967,758318,858931,62406424000,2730078000,2733187000,3527856000,8991121000,8763534000,7883562000,25638217000,36768207000
South Carolina,Transportation and Warehousing,2014,10620,5772,1308,800,7880,901,579,9360,1260,12630,5775,1315,815,7905,990,725,9620,3010,271132,7083,7185,9330,27226,23420,26015,81521,160293,11062920000,314129000,262031000,326746000,947961000,868127000,1065542000,3039246000,6919328000
South Carolina,Utilities,2014,458,140,50,45,235,95,65,395,63,1760,140,50,45,235,140,180,555,1205,50165,176,0,314,1093,4606,6809,12689,0,4326439000,8091000,12319000,21221000,44433000,302024000,459353000,817174000,143782000
South Carolina,Wholesale Trade,2014,20029,9364,2905,2111,14380,2395,1196,17971,2058,24875,9375,2915,2180,14470,2870,2080,19420,5455,333851,12792,16439,22460,57935,63989,42522,179111,136699,18766832000,751466000,846527000,1166355000,2915927000,3300198000,2203596000,8940695000,8853654000
South Dakota,Accommodation and Food Services,2014,10322,4035,1785,1950,7770,1907,367,10044,278,12030,4040,1805,2000,7845,2175,880,10900,1130,200097,4714,11878,27022,44554,66665,43786,156653,42948,3008501000,162076000,134582000,347877000,647586000,922997000,717893000,2323581000,684494000
South Dakota,Administrative and Support and Waste Management and Remediation Services,2014,5119,3120,855,390,4365,316,100,4781,338,5420,3120,855,420,4395,345,120,4860,560,50896,3665,4979,3489,13988,9186,3951,31245,13046,1599272000,151653000,146775000,99340000,443452000,300357000,106905000,981392000,461769000
South Dakota,"Agriculture, Forestry, Fishing and Hunting",2014,670,530,85,35,650,5,10,665,5,670,530,85,35,650,5,10,665,5,1581,448,353,162,1325,0,0,1541,0,66120000,23818000,19438000,10464000,59086000,0,0,65050000,0
South Dakota,"Arts, Entertainment, and Recreation",2014,3185,1940,555,310,2805,275,60,3140,45,3415,1940,555,320,2815,380,170,3365,50,28778,2035,3354,3116,9307,8931,2996,26119,1319,553457000,83885000,52684000,54285000,206638000,177900000,45034000,521921000,15344000
South Dakota,Construction,2014,16226,11400,2630,1220,15250,804,92,16146,80,16340,11400,2630,1225,15255,820,135,16210,130,90601,16632,16335,15189,51300,27271,4280,88331,1931,4290712000,737564000,660685000,754785000,2186368000,1476987000,257514000,4158197000,115500000
South Dakota,Educational Services,2014,1110,500,150,115,765,195,95,1055,55,1155,500,150,120,770,195,105,1070,85,37324,543,622,1190,2927,7065,14111,26795,10466,936770000,17395000,9691000,11918000,51392000,145767000,412015000,668619000,265841000
South Dakota,Finance and Insurance,2014,6232,3970,782,378,5130,353,206,5689,543,9780,3975,785,595,5355,740,1175,7270,2510,124269,5983,4544,4307,15791,9456,16151,44015,68154,6406522000,270921000,203409000,187296000,673272000,451766000,902629000,2165433000,3830836000
South Dakota,Health Care and Social Assistance,2014,9151,4180,1703,1250,7133,1145,524,8802,349,11530,4195,1710,1285,7190,1805,1415,10410,1120,320873,6230,10573,15763,34026,41001,63051,144856,160914,14142011000,300737000,370645000,687882000,1391744000,1566832000,2100466000,5217528000,8395226000
South Dakota,Information,2014,1588,655,240,165,1060,213,89,1362,226,2270,655,245,165,1065,325,245,1635,635,28562,672,1286,1208,3749,5546,1501,16148,8959,1394988000,34235000,34845000,58545000,151781000,237291000,66627000,708468000,416103000
South Dakota,Management of Companies and Enterprises,2014,666,30,20,10,60,130,246,436,230,755,30,20,10,60,135,265,460,295,35125,0,128,0,205,1103,3900,5279,29846,2461559000,2484000,3395000,0,7608000,81426000,291468000,394440000,2068570000
South Dakota,Manufacturing,2014,4788,1775,820,555,3150,809,351,4310,478,5140,1775,820,560,3155,850,480,4485,655,171477,2126,3689,4761,12977,24634,22541,78381,67249,7699971000,89046000,133732000,172030000,468869000,1084334000,927720000,3221619000,3092921000
South Dakota,"Mining, Quarrying, and Oil and Gas Extraction",2014,285,135,30,25,190,32,24,246,39,335,135,30,25,190,35,50,275,60,4359,161,66,99,432,0,1036,2843,0,277651000,11518000,2187000,6818000,31099000,0,67561000,173410000,58130000
South Dakota,Other,2014,42,41,0,0,41,1,0,42,0,42,41,0,0,41,1,0,42,0,0,0,0,0,0,0,0,0,0,644000,580000,0,0,580000,0,0,644000,0
South Dakota,Other Services (except Public Administration),2014,13203,8590,2720,1075,12385,582,126,13093,110,13720,8595,2730,1140,12465,750,225,13440,280,71816,15373,16503,12487,47074,17576,2451,69870,942,1712457000,366052000,396691000,297541000,1097161000,391621000,65678000,1650359000,34571000
South Dakota,"Professional, Scientific, and Technical Services",2014,9003,5885,1395,795,8075,408,146,8629,374,9495,5885,1410,835,8130,530,210,8870,625,55655,8071,8829,9205,27011,8642,4141,44902,8165,2719536000,360553000,350266000,412675000,1168448000,545776000,234692000,2123352000,515979000
South Dakota,Real Estate and Rental and Leasing,2014,4415,3370,463,150,3983,148,105,4236,179,5135,3370,500,150,4020,195,475,4690,445,18021,1542,2722,1174,9022,3299,1770,16036,1360,606452000,128015000,94210000,52300000,297982000,104439000,60689000,510871000,75127000
South Dakota,Retail Trade,2014,14575,6579,3209,2071,11859,1332,449,13640,935,19330,6585,3255,2220,12060,1950,1545,15555,3775,232524,9393,18742,24898,57929,39781,26089,132436,84213,5758796000,299079000,485690000,602690000,1422964000,1233158000,748582000,3620113000,1729586000
South Dakota,Total,2014,21904,12530,3759,2295,18584,1910,562,21056,848,26198,12540,3798,2442,18780,2633,1720,23133,3065,347819,20742,24651,30167,75560,68778,62750,207088,140731,13161115000,693131000,720369000,929373000,2342873000,2329012000,2264519000,6936404000,6224711000
South Dakota,Transportation and Warehousing,2014,5453,3595,665,425,4685,341,154,5180,273,5850,3595,665,435,4695,370,200,5265,585,48081,4997,3848,4116,14257,8401,2044,31459,13111,1956134000,189228000,150721000,171513000,535800000,322632000,99584000,1151055000,613093000
South Dakota,Utilities,2014,357,50,55,60,165,105,20,290,67,800,50,55,60,165,180,60,405,395,10119,85,346,840,1295,2987,0,5599,55,782977000,1925000,17128000,46705000,67225000,196512000,0,360106000,3804000
South Dakota,Wholesale Trade,2014,5648,2120,680,584,3384,999,475,4858,790,7610,2120,685,610,3415,1375,835,5625,1985,88873,2630,3019,5292,12607,24705,15114,57855,20313,4592809000,140044000,145481000,245141000,588040000,1194070000,821357000,2913095000,1259827000
Tennessee,Accommodation and Food Services,2014,41727,14118,7801,8042,29961,9345,1193,40499,1228,61190,14155,7830,8235,30220,11005,4900,46125,15065,1255675,23299,52361,110765,186725,340570,169020,697366,559445,20006908000,656380000,708554000,1557324000,2926355000,5217967000,2429724000,10588555000,9209882000
Tennessee,Administrative and Support and Waste Management and Remediation Services,2014,27497,14810,4225,2726,21761,2866,1064,25691,1806,33790,14815,4250,2785,21850,3100,1505,26455,7335,1181493,22391,25911,35520,83879,110886,137808,342612,813452,33932963000,944872000,859191000,1233042000,3102854000,4036168000,3995312000,11321407000,21654581000
Tennessee,"Agriculture, Forestry, Fishing and Hunting",2014,1160,740,215,120,1075,35,30,1140,20,1170,740,215,125,1080,35,30,1145,25,7604,613,1272,1436,4221,743,0,6168,0,254139000,49941000,40089000,44866000,143875000,21707000,34904000,242673000,2669000
Tennessee,"Arts, Entertainment, and Recreation",2014,11402,6345,2085,1270,9700,1233,267,11200,202,11955,6350,2085,1275,9710,1305,370,11385,570,159469,5795,13574,16429,40835,45244,27052,119047,32768,6746932000,610660000,533006000,774244000,1931191000,1696759000,1138549000,5372327000,774431000
Tennessee,Construction,2014,45550,26235,8340,5460,40035,4410,635,45080,470,46395,26235,8345,5465,40045,4490,880,45415,980,510325,43514,54101,72064,173261,165191,72080,415615,72268,24601220000,1733305000,2032920000,3103970000,6889335000,8766888000,3966076000,19791305000,3771082000
Tennessee,Educational Services,2014,6184,2620,830,870,4320,1056,470,5846,338,6625,2625,835,910,4370,1145,525,6040,585,283544,3933,5491,11464,21760,40912,74288,138982,147206,9564107000,151321000,120582000,243379000,526940000,1162755000,2524463000,4275329000,5355982000
Tennessee,Finance and Insurance,2014,22520,13610,3178,1245,18033,1604,976,20613,1907,49450,13630,3410,1795,18835,4830,5260,28925,20525,545496,23059,18694,14482,60317,55701,73734,197141,342794,38119967000,1118197000,996448000,1223714000,3418979000,3916596000,4249844000,12634949000,24909258000
Tennessee,Health Care and Social Assistance,2014,54813,23655,13318,7819,44792,6213,2032,53037,1776,75900,23705,13370,8140,45215,8450,6600,60265,15635,1957793,47880,87101,101746,239219,235775,301733,784467,1139405,88274967000,2321813000,3443345000,4537093000,10434135000,10629852000,11828344000,33177396000,53992892000
Tennessee,Information,2014,7089,3390,1141,695,5226,743,286,6255,834,11955,3400,1145,700,5245,860,575,6680,5275,230340,3854,6947,6238,19109,21965,15129,61848,167135,12817355000,268594000,274303000,357767000,928605000,1323409000,887402000,3384856000,9371600000
Tennessee,Management of Companies and Enterprises,2014,3734,130,50,90,270,615,1086,1971,1763,7065,130,50,95,275,620,1100,1995,5070,410955,0,180,496,962,5915,36090,43085,367869,42938330000,21357000,31404000,62150000,127211000,616975000,2659316000,3415050000,39523252000
Tennessee,Manufacturing,2014,26189,8670,4025,3465,16160,4732,2141,23033,3156,28160,8670,4040,3475,16185,4925,2585,23695,4465,1362047,13689,21951,40581,84373,164977,166929,472926,781719,68329911000,622209000,818857000,1605724000,3300675000,7400829000,7929750000,20904390000,41570733000
Tennessee,"Mining, Quarrying, and Oil and Gas Extraction",2014,640,225,95,90,410,85,50,545,95,1020,225,95,90,410,90,100,600,420,8497,309,430,462,2016,1093,2541,6502,0,647209000,12178000,23032000,25162000,83005000,82022000,174573000,358726000,9567000
Tennessee,Other,2014,226,216,10,0,226,0,0,226,0,226,216,10,0,226,0,0,226,0,251,195,56,0,251,0,0,251,0,6292000,5159000,1133000,0,6292000,0,0,6292000,0
Tennessee,Other Services (except Public Administration),2014,64833,39485,13440,6102,59027,4420,737,64184,649,70315,39495,13480,6500,59475,5640,1440,66555,3760,536213,73785,86080,79622,241989,158735,62858,470423,48601,14145868000,1775631000,1995929000,2061780000,5876462000,3983936000,1652632000,11651916000,2093422000
Tennessee,"Professional, Scientific, and Technical Services",2014,50211,32605,7260,4398,44263,3207,1098,48568,1643,55330,32620,7275,4540,44435,3880,1680,49995,5335,570687,52332,46816,56147,158478,97959,73444,335756,214322,34761266000,2571871000,2151521000,3027060000,7801968000,6502365000,4811480000,19458355000,13740519000
Tennessee,Real Estate and Rental and Leasing,2014,19340,13140,2728,1147,17015,939,589,18543,797,27910,13170,2795,1230,17195,1520,2185,20900,7010,153080,21075,16511,12992,52665,26375,21299,105154,43685,6800619000,825510000,612870000,544074000,2004896000,1141605000,902344000,4341689000,2232299000
Tennessee,Retail Trade,2014,67859,38655,13709,6596,58960,5155,1225,65340,2519,112665,38745,14010,7315,60070,7965,4385,72420,40245,1465869,64759,87947,83870,244677,173885,87847,520398,868808,37745053000,1686118000,2145492000,2479064000,6344260000,6320109000,3397572000,16438885000,19945072000
Tennessee,Total,2014,96270,51545,17712,10977,80234,10071,2807,93112,3158,131504,51621,17911,11574,81106,13262,7702,102070,29434,2453470,93797,116383,146170,356350,371053,324540,1051943,1401527,103559163000,3469824000,3773363000,5306933000,12550120000,14761598000,13652824000,40964542000,62594621000
Tennessee,Transportation and Warehousing,2014,15357,7129,2237,1755,11121,1622,821,13564,1793,20475,7130,2250,1755,11135,1790,1005,13930,6545,519891,9685,13228,21946,45996,52834,44637,150911,332846,22859387000,459970000,479031000,803510000,1822137000,2116452000,2048820000,6321829000,15859834000
Tennessee,Utilities,2014,304,55,10,20,85,95,55,235,69,730,55,10,20,85,200,230,515,215,14434,18,0,217,342,4981,6313,11902,1714,951569000,6410000,0,11590000,17435000,317573000,429483000,792686000,130473000
Tennessee,Wholesale Trade,2014,27017,11116,3965,3295,18376,3708,2002,24086,2931,34290,11130,4015,3420,18565,4460,3155,26180,8110,563538,17054,24350,39351,86593,104115,92555,302512,242754,33235667000,1058227000,1300044000,2094882000,4603475000,6089657000,5727658000,17407998000,15047117000
Texas,Accommodation and Food Services,2014,175223,61521,33686,33721,128928,39739,4232,172899,2324,253775,61610,33850,34240,129700,46275,18405,194380,59395,5339699,101526,224662,458103,784463,1474518,701129,2963525,2372061,88693508000,3148910000,3161354000,6672040000,12983770000,23507188000,11191172000,47693985000,40918948000
Texas,Administrative and Support and Waste Management and Remediation Services,2014,112981,62505,17395,11737,91637,12552,4669,108858,4123,136300,62520,17430,11970,91920,13535,6295,111750,24550,4547131,97833,112921,157783,375609,487871,711500,1581543,2927514,169307135000,5094726000,4253639000,6008583000,15365670000,18967724000,24368211000,58926433000,108638575000
Texas,"Agriculture, Forestry, Fishing and Hunting",2014,4920,3315,850,385,4550,235,95,4880,40,5115,3315,850,385,4550,240,250,5040,75,36883,4831,4801,4747,15186,7043,6182,29053,0,1379347000,201337000,194617000,192016000,609682000,227116000,238129000,1126417000,0
Texas,"Arts, Entertainment, and Recreation",2014,29800,16500,4600,3890,24990,3531,854,29375,425,33515,16510,4630,3960,25100,3890,1235,30225,3290,640635,19560,26095,44548,93339,132672,131382,376926,224242,17888804000,1137474000,694647000,1068510000,2911434000,2635388000,5219400000,11055999000,4746024000
Texas,Construction,2014,198060,114918,35070,22133,172121,20441,3711,196273,1787,202625,114930,35075,22180,172185,20990,5105,198280,4345,3049200,195361,231730,300170,728970,804975,593214,2128715,869638,169364360000,9074370000,9551745000,13637890000,32264005000,41658030000,34465565000,108393960000,58090581000
Texas,Educational Services,2014,29426,14180,4895,3860,22935,4621,1186,28742,684,32800,14220,4900,3930,23050,5180,1955,30185,2615,885701,22240,31679,51892,107248,184590,165574,462958,405773,31721430000,773970000,712568000,1008820000,2507125000,5116978000,6209252000,13935295000,17031450000
Texas,Finance and Insurance,2014,98943,66717,14287,5685,86689,5900,2719,95308,3635,199165,66865,14685,6830,88380,12705,13940,115025,84140,2463689,112735,89133,71660,278440,210955,289598,790949,1581305,186586284000,5952342000,4812713000,5027490000,15867257000,16386503000,20665088000,54129352000,132274155000
Texas,Health Care and Social Assistance,2014,259269,126365,59439,35440,221244,27269,7296,255809,3460,319675,126480,59680,36545,222705,34960,18930,276595,43080,7043896,217618,394926,471889,1094521,1063042,1157187,3319624,3715557,300874047000,15026308000,17048506000,19289584000,51393269000,39559948000,36587661000,127680232000,172874109000
Texas,Information,2014,22917,11790,3045,2303,17138,2698,1167,21003,1914,45510,11820,3080,2355,17255,3255,2200,22710,22800,1153234,15491,19670,29251,67963,95170,107053,279949,864216,87228351000,1054040000,1020422000,1610280000,3717550000,6146018000,8154058000,18375309000,68411417000
Texas,Management of Companies and Enterprises,2014,12850,1090,276,485,1851,2314,3452,7617,5233,23475,1090,280,490,1860,2415,3695,7970,15505,1574245,1450,1290,3631,6371,29350,124415,160145,1414100,207459105000,210320000,115660000,291712000,617692000,2169340000,12929245000,15717255000,191741850000
Texas,Manufacturing,2014,89864,33085,15410,12714,61209,16468,5833,83510,6354,98405,33085,15415,12775,61275,17005,7005,85285,13120,3920657,54620,96701,164710,329906,634186,660335,1679188,2101422,241010823000,2912594000,3734267000,7149867000,14191702000,31472958000,33656133000,81934940000,153139856000
Texas,"Mining, Quarrying, and Oil and Gas Extraction",2014,37183,20823,4973,3643,29439,5144,1426,36009,1174,44555,20830,4980,3670,29480,5475,2250,37205,7350,1253316,32545,32627,48904,114254,205002,199515,521059,729522,134558590000,2964396000,2331593000,3564540000,8877603000,18627125000,20207219000,47851832000,86690147000
Texas,Other,2014,1057,1003,43,10,1056,0,1,1057,0,1057,1003,43,10,1056,0,1,1057,0,1321,0,278,128,0,0,0,1321,0,34661000,23285000,4088000,1484000,28857000,0,0,34661000,0
Texas,Other Services (except Public Administration),2014,225247,133170,46915,23737,203822,17362,2570,223754,1493,249495,133250,47260,24745,205255,22305,6410,233970,15525,2174406,247201,304771,312895,869235,630524,285703,1790471,334390,65326945000,6746920000,7761117000,8350604000,22864510000,16465814000,9062408000,48513885000,15538664000
Texas,"Professional, Scientific, and Technical Services",2014,303118,216102,38303,21822,276227,17300,4833,298360,4758,332380,216170,38485,22360,277015,20320,8640,305975,26405,3324975,306911,251376,286830,861117,616225,479527,1965935,1325392,270333665000,20235680000,14297255000,18694324000,53241970000,46988515000,38521927000,139004745000,130570753000
Texas,Real Estate and Rental and Leasing,2014,101777,75876,12180,5647,93703,4593,1864,100160,1617,140090,75955,12350,6395,94700,7700,8155,110555,29535,912441,113060,77222,72906,266169,153090,151568,582128,320222,48012080000,4995645000,3058803000,3361774000,11423303000,7934770000,8585197000,28481405000,18650224000
Texas,Retail Trade,2014,228617,134788,45845,23665,204298,16414,4194,224906,3711,399070,135290,46895,26200,208385,27170,17625,253180,145890,5605785,221269,288898,301825,803848,572737,457103,1898355,3453632,150967114000,6957985000,7437640000,8741211000,23176373000,20268717000,20254008000,64168490000,84987333000
Texas,Total,2014,419500,240965,73884,46433,361282,42498,9997,413777,5723,557721,241329,74634,48606,364569,54382,28091,447042,110679,9920214,411738,486100,621669,1519507,1617107,1416629,4553243,5366971,501456595000,19283191000,18188146000,24134215000,61605552000,68351580000,68046587000,198003719000,303452876000
Texas,Transportation and Warehousing,2014,70888,39525,10414,7217,57156,6867,2939,66962,3926,91220,39580,10435,7405,57420,7785,5340,70545,20675,1761968,56208,65423,93320,221591,228347,231213,703442,1060496,91616789000,2867602000,2756742000,4002243000,9717959000,11166136000,12090757000,33759642000,58206579000
Texas,Utilities,2014,5006,2640,913,335,3888,520,242,4650,356,9975,2640,920,335,3895,660,775,5330,4645,231668,5148,5488,4246,15217,20998,29519,67146,165872,23795366000,211207000,278655000,245029000,760083000,1454007000,2334353000,4766184000,16726324000
Texas,Wholesale Trade,2014,129399,65299,21392,15225,101916,15267,6123,123306,6093,166175,65470,21755,16210,103435,20045,12240,135720,30455,2555615,110696,138574,197345,450660,490865,432071,1387473,1084602,174549210000,6461850000,7383754000,11286675000,25154635000,29496614000,27863892000,82962753000,89018541000
United States,Accommodation and Food Services,2014,2548688,995130,503530,489425,1988085,500907,47507,2536499,12189,3396480,996735,505145,496720,1998600,579590,206435,2784625,611855,63959640,1670648,3363802,6675033,11713575,18397730,8445889,38563190,24334262,1142327405000,45395840000,47823400000,98244124000,191479950000,304188130000,142880417000,638714310000,503528278000
United States,Administrative and Support and Waste Management and Remediation Services,2014,1661734,1065930,242156,148975,1457061,141584,41379,1640024,21710,1990780,1066660,243060,151970,1461690,158865,70375,1690930,299850,52896620,1568472,1586066,2002000,5184170,5588575,7137753,17911465,34866506,1977440460000,69702675000,54947795000,72113095000,196763565000,207720665000,234269049000,638798095000,1337968030000
United States,"Agriculture, Forestry, Fishing and Hunting",2014,105874,73266,17120,8375,98761,5588,1055,105404,470,109220,73275,17130,8400,98805,5960,2300,107065,2155,781815,103932,111405,109983,328578,200062,137058,668520,109610,30904955000,4407830000,4143635000,4382837000,12948835000,8231803000,4664850000,25914220000,4750742000
United States,"Arts, Entertainment, and Recreation",2014,597919,379166,77926,58343,515435,64080,13950,593465,4454,649195,379395,78325,59395,517115,70765,23450,611330,37865,10850605,426173,511885,786688,1787320,2565405,2352777,6720750,4111524,361091500000,44612235000,15036285000,19247472000,78921020000,58200195000,91728280000,230085600000,130452706000
United States,Construction,2014,3276336,2214377,512334,292604,3019315,222119,28386,3269820,6516,3335495,2214560,512555,293215,3020330,229430,43235,3292995,42500,28525730,3450230,3355565,3917080,10722875,8335490,4572345,23630710,4862299,1597212760000,146586770000,141120620000,190223230000,477930620000,474129595000,296754980000,1248815195000,346735271000
United States,Educational Services,2014,440220,215808,69072,56892,341772,73227,18189,433188,7032,496885,216190,69385,58490,344065,82810,30800,457675,39210,17811820,338207,463790,774715,1576940,3071575,3175365,7823880,9985012,648331620000,11571615000,10469175000,17191985000,39232775000,91530485000,116786140000,247549400000,400723368000
United States,Finance and Insurance,2014,1189922,848896,171185,67709,1087790,66908,22260,1176958,12964,2354755,850790,176890,82725,1110405,162095,173220,1445720,909035,30389145,1333373,1085150,890779,3425074,2660753,3516838,9651290,20697205,2835239792000,75838460000,63055003000,70022585000,208915260000,229342478000,307710202000,746440860000,2087792748000
United States,Health Care and Social Assistance,2014,3301063,1689616,718749,417767,2826132,327892,105425,3259449,41614,4276260,1692040,724010,436650,2852700,458415,339925,3651040,625220,94145663,2932727,4762062,5560505,13368510,12879050,16681070,42928630,51129252,4300611040000,157616440000,197364549000,237432065000,592416420000,515454415000,582972555000,1690843390000,2608824550000
United States,Information,2014,369178,223400,50853,36675,310928,38882,11606,361416,7762,691735,224075,51285,38330,313690,51900,30675,396265,295470,16822650,317038,334907,489904,1149565,1505344,1816975,4476570,12303559,1469224640000,24143258000,17286870000,27464410000,68961120000,100008805000,149003059000,317983040000,1149762828000
United States,Management of Companies and Enterprises,2014,135274,13918,3660,5412,22990,29035,44079,96104,39170,268950,14000,3725,5545,23270,30145,48690,102105,166845,16179790,17390,17410,35525,70325,363630,1501135,1935090,14244700,1751106830000,2690490000,1557075000,2865980000,7113545000,26375260000,117814135000,151302940000,1599803890000
United States,Manufacturing,2014,1290622,519945,231708,190460,942113,240148,69991,1252252,38370,1462715,520120,232025,191665,943810,255200,105240,1304250,158465,57066328,959619,1547004,2593365,5110469,9703875,10740190,25577841,31227952,3196285501000,40816979000,57921796000,108176602000,207078955000,457531571000,542473341000,1208469594000,1977868266000
United States,"Mining, Quarrying, and Oil and Gas Extraction",2014,114879,65322,16220,12363,93905,14367,4073,112345,2534,148770,65380,16325,12700,94405,16800,8515,119720,29050,3787829,102592,107092,165136,375892,555326,609334,1543273,2241083,352681985000,7840397000,6632509000,10846454000,25351077000,43931688000,53744056000,123169725000,229278081000
United States,Other,2014,16535,15924,485,101,16510,24,1,16535,0,16535,15924,485,101,16510,24,1,16535,0,0,0,3027,1249,0,739,0,0,0,407602000,331255000,47552000,16115000,394922000,6876000,0,407602000,0
United States,Other Services (except Public Administration),2014,3381377,2164680,672298,314996,3151974,199297,22850,3374121,7256,3699725,2166520,677430,329695,3173645,260420,82855,3516920,182805,26708256,4060592,4362673,4150190,12575155,7146689,3192391,22920585,3502974,806313450000,103945670000,110431720000,114185270000,328562660000,209518152000,117678707000,655857185000,149125420000
United States,"Professional, Scientific, and Technical Services",2014,3958890,2911802,506386,279335,3697523,202105,38576,3938204,20686,4413960,2913410,509405,290985,3713800,262895,108585,4085280,328680,43097870,3950360,3309150,3722195,11342860,7568965,5966440,24878265,18035393,3325850940000,246602705000,182903520000,234750475000,664256700000,569941255000,488268735000,1722466690000,1598911240000
United States,Real Estate and Rental and Leasing,2014,1419080,1117965,156743,70677,1345385,53031,13527,1411943,7137,1835380,1120105,161070,79640,1360815,93015,100845,1554675,280705,9843871,1574101,1002043,918782,3527109,1852270,1557393,6951335,2902180,494955160000,66869795000,39557865000,40692510000,147120170000,91155555000,81369331000,319825470000,170417308000
United States,Retail Trade,2014,3273518,1959101,663993,347300,2970394,243290,44273,3257957,15561,5326840,1965470,678845,385775,3030090,390950,223475,3644515,1682325,75417493,3410096,4327829,4522279,12392737,8871835,5760196,27148528,46133064,1997705656000,94388559000,107753285000,125248110000,327625980000,305667452000,218056234000,851385828000,1128981590000
United States,Total,2014,5825458,3598185,998953,608502,5205640,513179,87563,5806382,19076,7563084,3603935,1010467,641096,5255498,690583,360894,6306975,1256109,121069944,5940248,6570776,8176519,20687543,20121588,17085461,57894592,63175352,5940186911000,251757114000,235546762000,309924445000,797228321000,838405832000,803652747000,2439286900000,3500900011000
United States,Transportation and Warehousing,2014,875568,557843,123096,82163,763102,76012,20744,859858,15710,1102825,558485,124155,84825,767465,92350,50665,910480,192345,21858287,792532,808775,1092542,2730187,2797049,2516831,8049315,11882549,1023232711000,32390979000,29989698000,42320317000,104702914000,115605768000,110255146000,330843532000,605077690000
United States,Utilities,2014,30096,15127,4988,2489,22604,4524,1638,28766,1330,89810,15215,5095,2690,23000,7370,7695,38065,51745,3189200,29312,31697,33186,94707,198082,263238,558240,2628410,307904940000,1134250000,1473483000,1998355000,4608175000,14212235000,21076718000,40119700000,267505073000
United States,Wholesale Trade,2014,1565783,885274,259419,181558,1326251,174629,44058,1544938,20845,2082965,887630,264050,195560,1347240,243820,147485,1738545,344420,29833735,1504915,1706460,2409430,5622765,6335410,5397040,17363145,12113962,2024207975000,80054275000,87959045000,132051205000,300064525000,368919440000,336446853000,1005474410000,1018229975000
Utah,Accommodation and Food Services,2014,19376,6400,3368,4050,13818,4370,588,18776,600,26795,6415,3385,4115,13915,5085,2370,21370,5425,524841,8678,22305,54393,86085,150547,89145,328286,195798,7982960000,281636000,274287000,661727000,1229955000,2130941000,1351620000,4759700000,3213388000
Utah,Administrative and Support and Waste Management and Remediation Services,2014,18885,11775,2565,1630,15970,1330,515,17815,1070,20735,11775,2565,1640,15980,1410,550,17940,2795,582218,13986,15901,19516,53032,49053,54667,167819,410204,18975569000,567190000,457666000,680414000,1749796000,1824677000,1815403000,5691600000,13176120000
Utah,"Agriculture, Forestry, Fishing and Hunting",2014,405,290,65,25,380,15,5,400,5,415,290,65,25,380,15,5,400,15,1500,73,323,120,884,0,0,1055,0,76007000,8967000,7111000,6304000,33168000,0,0,51975000,0
Utah,"Arts, Entertainment, and Recreation",2014,5030,3150,680,425,4255,535,132,4922,108,5240,3150,680,425,4255,560,180,4995,245,94175,2163,3487,4800,11636,19988,15687,54241,33277,1920299000,134994000,82509000,84254000,329607000,372676000,211567000,1033492000,601624000
Utah,Construction,2014,42727,28725,6604,3985,39314,2672,394,42380,347,42985,28725,6610,3990,39325,2715,430,42470,515,340550,41620,43063,52709,141265,96262,42631,292446,32517,15972760000,1600342000,1544600000,2095134000,5269790000,4507241000,2500573000,12916822000,2062717000
Utah,Educational Services,2014,4939,2480,710,580,3770,835,175,4780,159,5220,2480,710,580,3770,885,190,4845,375,139505,194,4525,7389,14389,34273,23474,75055,0,3924159000,118512000,85960000,158229000,384540000,882154000,689658000,2011964000,1600172000
Utah,Finance and Insurance,2014,16426,11630,1705,630,13965,805,322,15092,1334,25005,11635,1750,730,14115,1485,1360,16960,8045,286446,15094,9734,7240,34927,24379,30885,99091,169427,18159641000,712457000,457211000,404940000,1602044000,1839882000,1974119000,6371983000,10310897000
Utah,Health Care and Social Assistance,2014,32255,17245,6890,4095,28230,2749,628,31607,648,37750,17255,6900,4190,28345,3580,1940,33865,3885,535217,20439,45434,52538,124192,105126,84404,324328,195570,21141005000,1662961000,1392258000,1566178000,4650772000,3448056000,2858523000,11138394000,9612051000
Utah,Information,2014,5285,2605,590,430,3625,636,293,4554,731,7105,2605,590,450,3645,670,360,4675,2430,188631,2311,2859,3984,8951,22174,26475,66074,121981,12412293000,164211000,142013000,175271000,560741000,1393255000,2243970000,4474777000,8067375000
Utah,Management of Companies and Enterprises,2014,1785,250,25,55,330,315,370,1015,770,2300,250,25,55,330,315,370,1015,1285,102490,0,155,272,720,4589,13625,19255,83235,8726535000,12707000,20510000,14044000,48525000,285001000,760623000,1105695000,7620840000
Utah,Manufacturing,2014,15491,6024,2645,2275,10944,2453,823,14220,1271,16005,6025,2650,2275,10950,2515,880,14345,1660,490280,6591,13276,24250,49216,83345,57123,227113,195418,26506153000,365349000,486321000,912808000,1922312000,3567273000,2861678000,9863551000,12384491000
Utah,"Mining, Quarrying, and Oil and Gas Extraction",2014,2423,1335,250,235,1820,236,76,2132,291,2600,1335,250,235,1820,240,80,2140,460,48040,1616,1350,2780,6244,6519,3387,16922,23756,3820899000,106488000,97244000,187046000,406221000,466828000,226895000,1163601000,2582720000
Utah,Other,2014,71,71,0,0,71,0,0,71,0,71,71,0,0,71,0,0,71,0,0,0,0,0,0,0,0,0,0,2172000,2172000,0,0,2172000,0,0,2172000,0
Utah,Other Services (except Public Administration),2014,21777,13830,4160,1960,19950,1178,207,21335,442,24160,13835,4175,2045,20055,2085,410,22550,1610,252038,20240,26509,22425,69464,35292,7755,121605,55673,8479741000,646382000,720440000,673887000,2069607000,955003000,301964000,3724100000,2154914000
Utah,"Professional, Scientific, and Technical Services",2014,46108,34415,4645,2645,41705,2341,817,44863,1245,48715,34415,4660,2695,41770,2760,1035,45565,3150,435892,32685,29790,32606,106959,79029,57433,254800,155345,22836786000,2107682000,1391274000,1740236000,5271825000,4908915000,4210852000,14767635000,7439388000
Utah,Real Estate and Rental and Leasing,2014,21737,17855,1836,755,20446,603,243,21292,445,24335,17860,1855,825,20540,1020,675,22235,2100,95266,18706,10955,9161,40193,16419,5608,70476,10279,3827062000,771808000,370740000,354127000,1521826000,664232000,286714000,2650265000,670123000
Utah,Retail Trade,2014,30818,15693,5816,4078,25587,2719,732,29038,1780,46120,15750,5915,4355,26020,4025,2435,32480,13640,690979,20231,35631,50474,111847,89638,59955,273497,377502,18692612000,825185000,892232000,1282236000,3025286000,2567268000,2219354000,8047690000,10019698000
Utah,Total,2014,61242,37572,9148,6040,52760,5149,1320,59229,2013,73375,37605,9221,6244,53070,6518,3043,62631,10744,1148251,54726,60235,80262,195223,190371,154674,540268,607983,47913387000,2222470000,1890130000,2614837000,6727437000,7235230000,6745948000,20708615000,27204772000
Utah,Transportation and Warehousing,2014,10319,6240,1125,885,8250,807,343,9400,919,11240,6240,1125,895,8260,850,410,9520,1720,234700,5181,6343,10518,26323,25741,23141,81196,146775,11437458000,322287000,242986000,430235000,1036011000,1101361000,984059000,3224182000,7542746000
Utah,Utilities,2014,405,255,40,25,320,32,15,367,38,1080,255,40,25,320,85,25,430,650,615,382,275,130,949,1179,0,4142,0,22704000,9808000,12175000,12111000,34094000,89168000,0,342955000,0
Utah,Wholesale Trade,2014,16215,7362,2140,1619,11121,2033,1048,14202,2013,18715,7375,2155,1670,11200,2290,1510,15000,3715,272044,9432,11408,17921,43372,54806,41567,151937,94850,16161844000,512933000,543841000,967270000,2129290000,2915268000,2413718000,7886530000,6703108000
Vermont,Accommodation and Food Services,2014,8648,3500,1600,1700,6800,1465,167,8432,216,9725,3500,1605,1725,6830,1660,365,8855,870,149135,5436,10108,23341,39634,46326,16871,104413,45152,2660182000,167576000,158512000,378189000,711235000,861634000,336023000,1930335000,712017000
Vermont,Administrative and Support and Waste Management and Remediation Services,2014,5225,3620,690,285,4595,265,65,4925,300,5455,3620,690,295,4605,295,65,4965,490,35839,4353,3886,2636,11629,6502,1645,23767,11438,1172728000,193294000,127656000,79850000,453570000,198641000,38056000,794086000,295542000
Vermont,"Agriculture, Forestry, Fishing and Hunting",2014,700,585,85,15,685,5,10,700,0,700,585,85,15,685,5,10,700,0,1691,642,376,39,1445,0,0,1691,0,60327000,25663000,14210000,1607000,48967000,0,0,60327000,0
Vermont,"Arts, Entertainment, and Recreation",2014,2219,1355,385,225,1965,165,59,2189,30,2295,1355,385,230,1970,185,110,2265,30,39629,1048,2213,2348,6792,4263,6660,21616,11065,681645000,86228000,63088000,74938000,238964000,83939000,95718000,487520000,114001000
Vermont,Construction,2014,13208,9920,1855,775,12550,510,83,13143,65,13235,9920,1855,775,12550,525,95,13170,65,64650,11414,11657,9218,36199,16277,3876,61794,338,3363425000,673729000,533755000,465502000,1714026000,915321000,252930000,3174450000,15704000
Vermont,Educational Services,2014,1805,855,290,205,1350,250,130,1730,75,1935,855,290,205,1350,355,145,1850,85,77228,1032,1675,2167,5590,8798,19967,36033,40574,2262440000,41823000,47759000,43472000,149764000,263380000,676957000,1151270000,1099962000
Vermont,Finance and Insurance,2014,2561,1400,310,125,1835,165,132,2132,429,4710,1405,340,185,1930,410,855,3195,1515,38917,2081,1566,1385,5614,3249,9513,19980,10770,2741867000,137519000,104667000,83425000,369668000,264502000,474278000,1497995000,1281780000
Vermont,Health Care and Social Assistance,2014,8614,3930,1780,1160,6870,1030,379,8279,335,10450,3935,1780,1185,6900,1295,1030,9225,1225,228485,6187,10976,12186,33231,37369,31898,108349,108955,9674284000,306287000,444891000,515199000,1301013000,1202185000,1131968000,3734916000,5463349000
Vermont,Information,2014,1871,830,340,175,1345,227,75,1647,224,2405,830,340,175,1345,305,95,1745,660,29073,1232,1663,1723,5184,6604,1233,19373,5252,1702520000,52300000,59324000,78124000,223432000,329537000,81890000,1001160000,519128000
Vermont,Management of Companies and Enterprises,2014,395,30,5,25,60,70,90,220,175,450,30,5,25,60,70,90,220,230,15030,32,0,0,0,0,3099,4233,10754,873995000,2933000,0,0,14213000,0,157845000,234200000,637214000
Vermont,Manufacturing,2014,4744,2095,815,540,3450,736,300,4486,258,4945,2095,815,545,3455,760,415,4630,315,95725,1986,3201,5074,13288,19490,11448,60032,20799,4851936000,104458000,119869000,214209000,510138000,959860000,539678000,2826584000,1231257000
Vermont,"Mining, Quarrying, and Oil and Gas Extraction",2014,201,125,20,15,160,20,10,190,11,235,125,20,15,160,35,20,215,20,1695,0,0,104,312,291,0,1575,0,116497000,10853000,1222000,11336000,30782000,17346000,0,108533000,0
Vermont,Other,2014,53,48,4,1,53,0,0,53,0,53,48,4,1,53,0,0,53,0,0,0,0,0,0,0,0,0,0,1486000,1229000,0,0,1486000,0,0,1486000,0
Vermont,Other Services (except Public Administration),2014,9732,6570,1940,667,9177,330,73,9580,152,10115,6585,1955,715,9255,470,125,9850,265,45216,10878,11586,7858,32316,7024,1310,44191,453,1288513000,343311000,306770000,211291000,881318000,220540000,57782000,1246941000,21669000
Vermont,"Professional, Scientific, and Technical Services",2014,10162,7120,1440,720,9280,420,128,9828,334,10520,7120,1445,740,9305,525,155,9985,535,81011,8936,9145,8339,27252,11797,4985,48781,18460,3866334000,547708000,493580000,470590000,1540670000,833897000,405264000,3028291000,603881000
Vermont,Real Estate and Rental and Leasing,2014,3364,2460,430,150,3040,123,45,3208,156,3905,2460,430,180,3070,170,300,3540,365,14655,2935,2282,1829,7712,2235,418,11542,1595,646821000,137851000,94015000,69050000,308476000,76562000,14733000,473635000,76520000
Vermont,Retail Trade,2014,12462,5650,2539,1756,9945,1301,287,11533,929,17000,5660,2570,1890,10120,2125,1100,13345,3655,179188,8902,14427,18207,45291,33775,14778,111117,35018,5178659000,285419000,382865000,554484000,1258125000,1382640000,577652000,3480578000,860995000
Vermont,Total,2014,18097,10629,3063,1799,15491,1507,364,17362,735,21041,10638,3082,1889,15609,2008,1089,18706,2335,261058,17743,20086,23656,61485,52639,42119,156243,104815,10179794000,689233000,674751000,788871000,2152855000,2013274000,1761531000,5927660000,4252134000
Vermont,Transportation and Warehousing,2014,2273,1350,315,185,1850,200,62,2112,161,2505,1350,315,185,1850,215,90,2155,350,23190,1389,1788,1369,5344,4611,1334,14952,4512,901515000,65731000,63016000,62783000,207182000,174419000,60604000,561640000,207873000
Vermont,Utilities,2014,125,45,5,5,55,15,20,90,35,290,45,5,5,55,20,40,115,175,854,10,0,0,74,0,596,1653,0,786377000,4593000,0,0,8612000,0,54318000,167942000,0
Vermont,Wholesale Trade,2014,3618,1475,455,345,2275,538,241,3054,564,4065,1475,460,350,2285,615,340,3240,825,48163,1138,1787,2986,7437,11818,5489,33072,7121,2815943000,78471000,96028000,151090000,446873000,622671000,358896000,1824871000,591724000
Virginia,Accommodation and Food Services,2014,63211,22885,12596,12973,48454,11903,1342,61699,1512,86720,22940,12660,13205,48805,13320,5200,67325,19395,1602970,38550,83972,174769,297401,419933,189250,908427,700514,27081480000,1064395000,1286963000,2591510000,4943545000,6995569000,2839015000,14788454000,12005824000
Virginia,Administrative and Support and Waste Management and Remediation Services,2014,45178,25715,6845,4300,36860,4523,1769,43152,2026,53150,25715,6845,4345,36905,4820,2850,44575,8575,1227193,37775,44223,55924,142083,172537,220982,548262,672034,48259452000,1500357000,1483741000,2013958000,5039650000,6709436000,7962764000,20095401000,27702237000
Virginia,"Agriculture, Forestry, Fishing and Hunting",2014,3260,2250,595,235,3080,130,25,3235,25,3275,2250,595,235,3080,130,40,3250,25,18638,3560,3495,2773,10340,2374,323,15429,0,912503000,118217000,123852000,109253000,367132000,151352000,10435000,600883000,467000
Virginia,"Arts, Entertainment, and Recreation",2014,13260,7740,1685,1405,10830,1723,399,12952,308,14490,7740,1695,1420,10855,1815,640,13310,1180,257775,9555,10001,17457,40733,66791,43577,158315,85075,6368848000,425687000,218873000,362329000,1026289000,1277430000,972682000,3540864000,1899478000
Virginia,Construction,2014,94098,61740,14415,9035,85190,7064,1160,93414,684,95685,61740,14415,9045,85200,7160,1820,94180,1505,848100,102744,94669,121211,319680,259152,130970,715255,127758,42870725000,3834270000,3659460000,5408939000,12903435000,13197938000,7241739000,33666165000,8801143000
Virginia,Educational Services,2014,13625,6700,2080,1835,10615,2061,519,13195,430,14940,6705,2085,1945,10735,2195,735,13665,1275,382158,10297,13620,25269,50055,79634,75275,208499,168683,13070870000,352543000,341548000,584665000,1282603000,2528899000,3051043000,7028210000,5983193000
Virginia,Finance and Insurance,2014,28102,18468,3705,1475,23648,1534,943,26125,1977,56070,18495,3815,1750,24060,3245,4510,31815,24255,736579,29066,22645,18335,74112,49046,74147,202288,516344,60939445000,1575732000,1291663000,1398995000,4285181000,3874097000,5291177000,14066365000,44595664000
Virginia,Health Care and Social Assistance,2014,72909,32265,16896,10754,59915,8967,2097,70979,1930,96025,32355,17090,11420,60865,12440,6675,79980,16045,2112152,57426,111593,141928,315486,339025,308291,974395,1078988,98630862000,2970714000,4969658000,6301700000,14264426000,14378399000,12766417000,41691526000,54808999000
Virginia,Information,2014,10177,4685,1235,955,6875,1356,583,8814,1363,19555,4690,1240,965,6895,1715,830,9440,10115,467855,5346,7351,10801,25444,44214,49396,127396,325743,40530300000,414776000,473075000,675530000,1622559000,3500677000,4056408000,9753470000,29683893000
Virginia,Management of Companies and Enterprises,2014,4242,300,75,155,530,587,1211,2328,1914,6800,300,75,155,530,605,1280,2415,4385,325390,0,428,746,1402,7330,37512,46945,278387,30935280000,824000,56195000,62132000,221183000,548060000,2802238000,3613145000,27322135000
Virginia,Manufacturing,2014,23247,8555,3976,3034,15565,3933,1555,21053,2194,24930,8555,3980,3075,15610,4155,1980,21745,3185,905668,12386,22157,35279,77006,131354,127168,373639,460430,48551681000,546340000,819441000,1365966000,2977665000,5773300000,6071253000,16541710000,27256463000
Virginia,"Mining, Quarrying, and Oil and Gas Extraction",2014,947,305,100,115,520,171,107,798,149,1435,305,100,115,520,190,200,910,525,46671,278,537,935,2461,4746,4803,12900,30448,3084236000,21991000,26336000,67618000,154367000,267285000,252970000,727209000,2089249000
Virginia,Other,2014,456,441,13,2,456,0,0,456,0,456,441,13,2,456,0,0,456,0,422,320,81,0,422,0,0,422,0,9478000,8184000,1105000,0,9478000,0,0,9478000,0
Virginia,Other Services (except Public Administration),2014,99040,60451,20050,10020,90521,6721,918,98160,880,107160,60485,20180,10315,90980,7980,2705,101665,5495,812898,113327,129902,132638,378743,236475,80405,709212,76326,29247662000,3032120000,3531110000,4203788000,10776725000,9022242000,4215726000,24573190000,3321837000
Virginia,"Professional, Scientific, and Technical Services",2014,129119,88086,14897,9840,112823,9880,3414,126117,3002,152365,88110,14965,10090,113165,11425,4865,129455,22910,2173582,93955,95705,129123,353039,355802,352954,1074340,1058067,193864936000,8441050000,6250866000,9498957000,24248053000,29533279000,30857869000,85178932000,106148674000
Virginia,Real Estate and Rental and Leasing,2014,32640,24365,3289,1672,29326,1416,861,31603,1037,46055,24430,3430,1890,29750,2510,4080,36340,9715,252501,27259,20163,20622,77837,40759,44945,169402,71675,12951824000,1521871000,858790000,963536000,3359534000,1989009000,2244615000,7885060000,4633683000
Virginia,Retail Trade,2014,78617,42681,15708,9437,67826,5915,1890,75631,2986,135295,42865,16010,10390,69265,8880,5955,84100,51195,1964010,70460,100258,117753,292615,192631,143370,643529,1188718,52469302000,2037970000,2428821000,3037944000,7527767000,6560945000,6105804000,20375659000,31260708000
Virginia,Total,2014,149464,86942,24950,16330,128222,14198,3609,146029,3435,195639,87061,25207,17094,129362,17796,9779,156937,38702,3160539,147115,164056,217198,528369,521095,435888,1485352,1675187,159145063000,5988531000,5985756000,8426011000,20400298000,23310048000,22385728000,66096074000,93048989000
Virginia,Transportation and Warehousing,2014,20882,11861,2755,1803,16419,1899,889,19207,1675,24290,11875,2755,1860,16490,2110,1160,19760,4530,431967,15673,17339,22681,59518,58603,43589,169543,219121,18816668000,643667000,596584000,852575000,2119247000,2448497000,1981258000,7012308000,9900382000
Virginia,Utilities,2014,505,165,40,15,220,50,65,335,170,1655,165,40,15,220,55,215,490,1165,56101,112,0,64,516,1718,7387,9839,29282,7245506000,15522000,9025000,6952000,43685000,142859000,612633000,833011000,6368819000
Virginia,Wholesale Trade,2014,28156,13375,3935,3073,20383,3421,1798,25602,2554,36020,13380,3995,3225,20600,4230,3155,27985,8035,498575,19687,23501,37412,85812,94743,89818,283221,191378,31891854000,1157856000,1224367000,2126166000,4598681000,5393705000,5398804000,15961745000,15047846000
Washington,Accommodation and Food Services,2014,65559,24825,15086,12943,52854,10660,1149,64663,896,82525,24865,15130,13295,53290,12820,4835,70945,11580,1248556,41698,96982,170391,309690,358411,171221,837098,381034,25343940000,1074205000,1554950000,3016304000,5654695000,7194833000,3517734000,16393480000,8263800000
Washington,Administrative and Support and Waste Management and Remediation Services,2014,41412,26380,6195,3540,36115,2907,878,39900,1512,46580,26390,6200,3610,36200,3125,1260,40585,5995,703125,36798,39031,44907,123736,102301,97256,342546,318262,29684776000,1394431000,1331175000,1685247000,4450571000,4086901000,3698276000,12904578000,15567818000
Washington,"Agriculture, Forestry, Fishing and Hunting",2014,7020,5185,730,445,6360,460,135,6955,65,7145,5185,730,445,6360,475,155,6990,155,64189,4046,3881,5072,15877,17774,20911,56018,1871,3178068000,369753000,187817000,306983000,925432000,812984000,846412000,2650432000,122734000
Washington,"Arts, Entertainment, and Recreation",2014,13229,7495,1975,1345,10815,1705,486,13006,223,14300,7495,1980,1350,10825,1815,720,13360,940,298342,7207,11890,17268,39363,68161,76861,191672,97238,8736438000,396727000,294858000,332921000,1097663000,1339601000,1801061000,4361058000,3171650000
Washington,Construction,2014,101597,70893,15080,8140,94113,6080,790,100983,614,102365,70895,15085,8140,94120,6240,955,101315,1050,746340,104489,98018,107770,311196,223919,90551,639345,97794,44593525000,4467611000,4286675000,5603070000,14358730000,13763788000,6905174000,35875110000,8525054000
Washington,Educational Services,2014,12704,6395,2115,1760,10270,1748,355,12373,331,13545,6395,2120,1780,10295,2000,520,12815,730,273330,9012,13820,23328,47268,66629,45353,162945,108986,7812131000,315115000,318225000,495935000,1142634000,1865345000,1752228000,4870451000,2884645000
Washington,Finance and Insurance,2014,25353,17120,3270,1155,21545,1195,737,23477,1876,48835,17140,3320,1295,21755,2095,3785,27635,21200,489713,24376,20219,13961,62800,34260,66302,165580,290117,39362741000,1543460000,1145297000,1186495000,3925571000,2691297000,4047247000,10988978000,28054070000
Washington,Health Care and Social Assistance,2014,82652,43150,18830,10054,72034,6678,2343,81055,1597,100195,43185,18895,10465,72545,9415,6565,88525,11670,1917334,72090,124618,130846,334825,255788,330371,927085,967346,94905602000,3119004000,4822842000,5295438000,13250736000,9986151000,13439545000,36998715000,56989808000
Washington,Information,2014,10892,5410,1386,1165,7961,1210,543,9714,1178,16930,5440,1395,1225,8060,1360,675,10095,6835,604207,4382,8850,11777,24923,41580,45768,121614,233655,94323480000,443001000,476323000,797878000,1842991000,3013088000,6038166000,11041439000,27619110000
Washington,Management of Companies and Enterprises,2014,3693,335,105,140,580,610,1046,2236,1457,5335,335,105,140,580,615,1115,2310,3025,404905,11,448,644,1527,6999,35814,45870,359022,45282315000,37197000,51911000,44460000,138127000,501727000,2804317000,3634775000,41646761000
Washington,Manufacturing,2014,33165,14035,5795,4392,24222,5142,1810,31174,1991,34645,14040,5800,4415,24255,5250,2185,31690,2955,944873,19353,34326,50539,114466,186198,176582,517558,367247,52488010000,946012000,1344356000,2290392000,4876421000,9173083000,9773723000,25791990000,23571409000
Washington,"Mining, Quarrying, and Oil and Gas Extraction",2014,711,350,86,80,516,74,20,610,101,880,350,90,80,520,95,70,685,195,11018,488,352,827,1772,1738,0,4718,3841,747954000,32461000,18781000,42504000,107396000,120126000,0,321902000,258895000
Washington,Other,2014,559,535,19,4,558,1,0,559,0,559,535,19,4,558,1,0,559,0,600,409,118,50,577,0,0,600,0,13567000,11237000,1337000,693000,13267000,0,0,13567000,0
Washington,Other Services (except Public Administration),2014,76429,48090,15703,7044,70837,4250,705,75792,637,84045,48095,15810,7375,71280,5755,2390,79425,4620,551232,85143,100112,90477,277696,138310,53186,477320,44259,17409174000,2373831000,2704241000,2609628000,7733206000,4259394000,1798299000,13915684000,2038958000
Washington,"Professional, Scientific, and Technical Services",2014,97077,68900,11975,6735,87610,5402,1879,94891,2186,103700,68910,12010,6865,87785,6225,2580,96590,7110,974682,91661,76787,88049,263071,181370,138802,592492,288795,80108832000,5796860000,4555476000,5805068000,16221229000,14499118000,12065086000,43166043000,27017644000
Washington,Real Estate and Rental and Leasing,2014,39612,30837,4198,1758,36793,1383,672,38848,764,50320,30885,4350,1900,37135,2145,3670,42950,7370,226961,42069,26099,20940,90952,40827,32225,169515,50146,10997222000,1656093000,954565000,949685000,3573526000,1995213000,1560758000,7341488000,3552497000
Washington,Retail Trade,2014,73029,39054,15615,8214,62883,6229,1482,70594,2435,107930,39145,15865,9060,64070,9415,4865,78350,29580,1568320,54776,98462,100257,258834,211165,107404,606570,826890,46919966000,1929927000,2505580000,3025256000,7543302000,7817353000,4794785000,20693941000,23556079000
Washington,Total,2014,146727,88573,25295,14860,128728,12000,3057,143785,2942,179012,88659,25503,15520,129682,15344,8366,153392,25620,2528874,142931,165907,196380,505218,434395,360211,1299824,1229050,141277549000,5746616000,5917955000,7634750000,19299321000,19098817000,18286335000,56684473000,84593076000
Washington,Transportation and Warehousing,2014,21838,12565,2840,1802,17207,1948,1002,20157,1681,25050,12575,2880,1860,17315,2160,1525,21000,4050,444070,16654,17390,22507,57404,57632,39041,165873,239495,22938503000,750090000,700851000,1009220000,2510255000,2459867000,1935389000,7393828000,13927581000
Washington,Utilities,2014,949,550,160,50,760,57,48,865,84,1500,550,165,50,765,95,95,955,545,1841,1023,838,623,2658,0,0,4370,0,163935000,26326000,31510000,38506000,109107000,174891000,0,383099000,19293000
Washington,Wholesale Trade,2014,37770,18710,5423,3976,28109,4469,2265,34843,2927,46440,18745,5490,4230,28465,5615,3865,37945,8495,626049,28162,33274,48509,115221,136813,112260,380001,221376,40817443000,1800432000,1864920000,2863995000,6613323000,8118415000,6847025000,22147099000,16974612000
West Virginia,Accommodation and Food Services,2014,13197,4590,2745,2435,9770,2427,493,12690,507,18195,4595,2750,2455,9800,3115,2155,15070,3125,330768,7650,18149,32868,59457,89237,56052,205897,124069,5042697000,149577000,202776000,425201000,783052000,1237858000,716287000,2768092000,2259310000
West Virginia,Administrative and Support and Waste Management and Remediation Services,2014,6343,3430,960,590,4980,570,195,5745,598,7305,3435,960,595,4990,635,230,5855,1450,155850,4428,4967,6346,17950,17657,29653,67058,81036,4608863000,160732000,137947000,226339000,576496000,593456000,901355000,2174478000,2120667000
West Virginia,"Agriculture, Forestry, Fishing and Hunting",2014,1240,1010,175,25,1210,20,5,1235,5,1240,1010,175,25,1210,20,5,1235,5,4076,1730,972,251,3081,860,0,3996,0,132553000,45777000,22627000,8784000,83433000,41235000,0,126103000,0
West Virginia,"Arts, Entertainment, and Recreation",2014,3419,1805,665,475,2945,341,70,3356,63,3850,1805,675,525,3005,635,120,3760,90,35736,2320,3782,6124,13268,9723,5707,30951,1726,589088000,78018000,63961000,99589000,252258000,166783000,61232000,511658000,27757000
West Virginia,Construction,2014,16003,10400,2640,1505,14545,1045,230,15820,183,16150,10410,2640,1505,14555,1065,260,15880,270,125017,15421,16472,18788,52843,35490,17217,112491,8667,6401700000,537995000,575874000,792491000,1946760000,2051801000,1220084000,5593891000,549381000
West Virginia,Educational Services,2014,1285,590,200,160,950,215,45,1210,75,1330,590,200,160,950,230,60,1240,90,50462,834,1234,1855,4392,6896,7450,21106,28473,1303830000,22204000,20350000,38583000,85474000,175166000,180750000,488049000,800736000
West Virginia,Finance and Insurance,2014,5805,3385,835,320,4540,487,143,5170,635,10525,3390,865,430,4685,1365,670,6720,3805,86909,5968,4979,3354,15822,17263,8117,44417,17751,4090632000,222858000,171859000,178723000,608027000,685940000,342905000,1810053000,2202455000
West Virginia,Health Care and Social Assistance,2014,16924,6470,4080,2473,13023,2230,953,16206,718,24555,6500,4085,2595,13180,3150,2845,19175,5380,658033,12671,26034,31576,72213,83958,124173,288283,354836,25871225000,518373000,921601000,1250403000,2711523000,2998862000,3674496000,9597930000,15849823000
West Virginia,Information,2014,1338,435,160,195,790,167,69,1026,312,3240,435,160,195,790,230,190,1210,2030,49524,515,782,1736,3682,3570,968,10320,13698,2455359000,18720000,18643000,49414000,99243000,135647000,35218000,387002000,1848356000
West Virginia,Management of Companies and Enterprises,2014,815,50,15,20,85,175,250,510,305,1115,50,15,20,85,175,260,520,595,38750,60,0,119,34,2362,4972,7705,31037,2804701000,3200000,0,4663000,10653000,99487000,402276000,518706000,2285481000
West Virginia,Manufacturing,2014,5584,1780,925,795,3500,1022,414,4936,648,6020,1780,925,800,3505,1125,540,5170,850,183293,1675,4458,7083,17149,29025,16822,82498,80427,9998514000,81800000,130899000,280854000,585799000,1178876000,858013000,3435932000,5449684000
West Virginia,"Mining, Quarrying, and Oil and Gas Extraction",2014,2548,1060,285,325,1670,372,194,2236,312,3240,1060,285,325,1670,395,225,2290,950,145223,1644,882,4362,8048,12541,20973,43128,101309,11121238000,104198000,64971000,228846000,414448000,779044000,1505446000,2716559000,8344605000
West Virginia,Other,2014,64,61,2,1,64,0,0,64,0,64,61,2,1,64,0,0,64,0,0,0,0,0,0,0,0,0,0,1282000,903000,0,0,1282000,0,0,1282000,0
West Virginia,Other Services (except Public Administration),2014,20574,13030,4326,1805,19161,943,176,20280,294,22070,13040,4350,1880,19270,1290,235,20795,1275,122748,24287,26933,22139,75350,27626,2706,111406,8590,2962296000,494298000,548631000,535308000,1595194000,713399000,103298000,2572940000,296354000
West Virginia,"Professional, Scientific, and Technical Services",2014,13143,7890,2195,1065,11150,863,470,12483,660,14685,7895,2200,1115,11210,1070,755,13035,1650,126984,11722,13717,13356,41502,26539,17757,95093,25306,6222843000,502899000,537715000,657963000,1734511000,1439097000,876986000,4464204000,1593028000
West Virginia,Real Estate and Rental and Leasing,2014,5641,4010,760,290,5060,180,111,5351,290,6970,4020,765,295,5080,265,375,5720,1250,28221,6550,4329,3159,14522,2245,0,19593,7655,1186691000,197882000,137107000,108702000,464293000,89182000,21408000,620632000,550414000
West Virginia,Retail Trade,2014,17862,8273,3810,2311,14394,1867,369,16630,1232,31070,8295,3895,2560,14750,2915,1425,19090,11980,352655,13400,22751,26644,65290,54833,21489,152412,169846,8335253000,367209000,551050000,702780000,1652948000,1826298000,588501000,4183497000,3718326000
West Virginia,Total,2014,27902,14681,5295,3196,23172,2681,776,26629,1273,37354,14709,5343,3369,23421,3858,2266,29545,7809,575228,27145,34620,42273,104038,97933,86240,288211,287017,22100477000,782740000,941011000,1297176000,3020927000,3348496000,3102631000,9472054000,12628423000
West Virginia,Transportation and Warehousing,2014,5227,2840,845,480,4165,438,180,4783,444,6060,2840,845,485,4170,480,235,4885,1175,53969,4172,5142,4835,15078,11332,3870,32510,13480,2418243000,159379000,175226000,178282000,553896000,428242000,162620000,1202151000,711258000
West Virginia,Utilities,2014,304,95,20,55,170,30,25,225,79,1180,95,20,65,180,80,125,385,795,18371,0,72,422,827,600,1118,2273,0,1760643000,4435000,3807000,12324000,21936000,29527000,98664000,142095000,1047980000
West Virginia,Wholesale Trade,2014,5937,1990,880,745,3615,836,410,4861,1076,7650,1995,895,810,3700,1050,620,5370,2280,89604,2302,4635,7278,17231,16485,11440,53234,29909,4529996000,128902000,188805000,310815000,689773000,756735000,589123000,2433163000,1680202000
Wisconsin,Accommodation and Food Services,2014,58482,23202,11449,11024,45675,10908,994,57577,905,71625,23290,11470,11145,45905,12790,3670,62365,9260,1143820,37359,76220,151152,266148,392263,135886,796350,343087,15750895000,837810000,869227000,1727388000,3440235000,5163272000,1938420000,10562695000,5068776000
Wisconsin,Administrative and Support and Waste Management and Remediation Services,2014,28778,17550,4163,2537,24250,2251,942,27443,1335,34410,17550,4165,2575,24290,2480,1395,28165,6245,753095,22954,26195,32585,84235,81733,128902,301403,436296,22668496000,993316000,850522000,1095354000,2957992000,2458931000,3612201000,9228735000,12731728000
Wisconsin,"Agriculture, Forestry, Fishing and Hunting",2014,2590,1980,335,135,2450,85,30,2565,25,2605,1980,335,135,2450,85,35,2570,35,14532,2424,2030,1672,6673,1166,0,11977,0,643573000,88961000,57386000,71832000,221585000,53838000,0,518628000,0
Wisconsin,"Arts, Entertainment, and Recreation",2014,12650,7100,1884,1630,10614,1526,324,12464,186,13205,7100,1910,1660,10670,1765,370,12805,400,213288,9716,12086,21351,44140,57042,48665,153445,37637,5663550000,367700000,274541000,323820000,989551000,1020203000,1056467000,3583301000,693062000
Wisconsin,Construction,2014,66075,46585,10010,5107,61702,3541,500,65743,332,66895,46585,10020,5150,61755,3745,685,66185,710,492510,69628,64994,66837,202496,124659,65862,397785,88871,31904185000,3390356000,3046718000,3820738000,10283425000,8271910000,5245772000,24160695000,7224955000
Wisconsin,Educational Services,2014,7447,3045,1325,1095,5465,1455,250,7170,277,7940,3045,1325,1110,5480,1555,355,7390,550,279287,4174,8660,14432,28380,53064,31614,115678,159957,9019407000,131742000,161694000,270582000,582771000,1365873000,908256000,2876763000,5994422000
Wisconsin,Finance and Insurance,2014,23571,15275,2820,1234,19329,1902,785,22016,1555,45145,15290,2910,1490,19690,4860,4625,29175,15970,679077,23268,17228,14952,58240,69657,81339,212239,443659,47777692000,1147422000,862367000,880862000,2941619000,4114537000,4384433000,11826262000,35694666000
Wisconsin,Health Care and Social Assistance,2014,51081,21702,10728,7475,39905,6912,2407,49224,1857,74815,21760,10880,7915,40555,10815,7635,59005,15810,1925578,34369,70010,100240,208773,265202,353562,834180,1072187,84644711000,2051840000,2704145000,3798791000,8571520000,9924863000,10172525000,28808339000,54949831000
Wisconsin,Information,2014,5413,2090,865,640,3595,756,306,4657,756,11000,2090,880,680,3650,1015,625,5290,5710,271040,2651,4854,8282,17317,22607,24412,67644,156626,17194411000,152048000,231267000,356468000,770104000,1056425000,1407337000,3424515000,11301791000
Wisconsin,Management of Companies and Enterprises,2014,3486,200,50,130,380,725,1023,2128,1358,5215,200,50,130,380,740,1100,2220,2995,396565,0,284,595,1252,8455,30119,39860,356705,33823780000,39435000,21751000,36499000,98265000,475685000,2093660000,2669055000,31154725000
Wisconsin,Manufacturing,2014,40530,12489,6135,5880,24504,8998,3664,37166,3364,44290,12495,6145,5965,24605,9420,4660,38685,5605,2113240,19317,36590,72662,138057,355785,443679,998419,1000996,109955296000,870936000,1480629000,3156036000,5781114000,16944023000,22414779000,47974339000,56360025000
Wisconsin,"Mining, Quarrying, and Oil and Gas Extraction",2014,731,280,110,120,510,90,57,657,74,835,280,110,130,520,95,115,730,105,14873,354,312,1206,2278,2409,919,9270,4380,1167186000,32121000,33044000,84467000,162849000,234747000,65310000,762412000,311564000
Wisconsin,Other,2014,310,297,13,0,310,0,0,310,0,310,297,13,0,310,0,0,310,0,0,0,78,0,0,0,0,0,0,4977000,4208000,769000,0,4977000,0,0,4977000,0
Wisconsin,Other Services (except Public Administration),2014,67766,39720,15032,7395,62147,4482,549,67178,588,72925,39765,15180,7695,62640,6185,1500,70325,2600,523292,75914,96960,95514,271634,154702,41238,475950,42114,13453705000,1901687000,2178684000,2167832000,6291832000,3861402000,1354130000,11861885000,1445224000
Wisconsin,"Professional, Scientific, and Technical Services",2014,52885,34440,7680,4671,46791,3546,1076,51413,1472,57190,34475,7745,4855,47075,4395,1730,53200,3990,512936,50808,49408,59946,164330,117571,79969,368429,124201,31402049000,2423489000,2327457000,3156895000,7953836000,7078919000,6078961000,21506381000,9595092000
Wisconsin,Real Estate and Rental and Leasing,2014,18699,13670,2275,1050,16995,862,411,18268,431,22940,13690,2365,1110,17165,1360,1925,20450,2490,117334,20345,13903,12858,48311,27715,15403,98839,14196,4396497000,721201000,518405000,464059000,1725367000,1171772000,689399000,3730741000,606725000
Wisconsin,Retail Trade,2014,61722,30377,13073,7926,51376,6429,1541,59346,2376,95715,30470,13375,8830,52675,9970,5740,68385,27330,1442521,48066,84087,101631,244126,226278,135498,616027,697647,35314024000,1374322000,1996463000,2574078000,5992039000,6690199000,3979513000,16954565000,16987841000
Wisconsin,Total,2014,108061,59336,19061,12643,91040,11668,2774,105482,2579,138221,59429,19286,13297,92012,15835,8178,116025,22196,2450254,99747,125253,169938,394938,445555,389859,1230352,1219902,106791126000,3725817000,4004843000,5595122000,13325782000,16453458000,16395378000,46174618000,60616508000
Wisconsin,Transportation and Warehousing,2014,23383,13345,3240,2325,18910,2380,745,22035,1348,26315,13345,3245,2365,18955,2675,1150,22780,3535,477708,18404,19842,29425,70269,80163,57470,213244,257196,19932543000,835312000,760668000,1146149000,2813005000,3045131000,2171095000,8296452000,11299664000
Wisconsin,Utilities,2014,400,65,15,30,110,135,15,260,140,1565,65,15,40,120,260,15,395,1170,69638,0,0,317,523,4577,63,5102,64194,6436656000,1802000,0,19096000,31010000,296143000,4809000,338792000,6085632000
Wisconsin,Wholesale Trade,2014,28234,12153,4215,3357,19725,4095,2030,25850,2384,34925,12185,4240,3505,19930,4965,3560,28455,6470,572433,17848,25676,41510,90337,130539,128744,366784,179225,33492600000,1072717000,1399211000,2208219000,4746165000,7136518000,6982769000,19657958000,11833096000
Wyoming,Accommodation and Food Services,2014,7928,2945,1575,1480,6000,1405,271,7676,252,9045,2950,1580,1490,6020,1665,710,8395,650,143526,4197,10398,19786,35116,49912,31533,116789,15409,2765555000,155965000,158680000,305130000,622292000,851212000,579810000,2062801000,484045000
Wyoming,Administrative and Support and Waste Management and Remediation Services,2014,4707,3095,690,378,4163,210,55,4428,279,4960,3095,700,380,4175,235,65,4475,485,32318,3287,4051,4649,13501,5545,1370,21941,7612,1153274000,183790000,130504000,151880000,489987000,158507000,25680000,775127000,319603000
Wyoming,"Agriculture, Forestry, Fishing and Hunting",2014,435,355,65,5,425,5,0,430,5,435,355,65,5,425,5,0,430,5,1036,249,123,0,756,0,0,964,0,31420000,14858000,8493000,0,28128000,0,0,30340000,0
Wyoming,"Arts, Entertainment, and Recreation",2014,2125,1505,260,185,1950,135,30,2115,10,2140,1505,260,185,1950,140,35,2125,15,16130,1333,1482,1588,5560,4103,665,11598,0,378331000,72481000,34046000,30931000,162741000,94656000,15484000,312808000,0
Wyoming,Construction,2014,12954,8470,2245,1200,11915,773,135,12823,131,13060,8470,2245,1200,11915,820,155,12890,170,98939,12174,14192,15182,43638,24625,5616,80744,11461,5435491000,583663000,611648000,804618000,2016631000,1549998000,365827000,4343621000,681012000
Wyoming,Educational Services,2014,888,505,90,145,740,78,30,848,40,925,505,90,145,740,85,60,885,40,9361,500,499,1528,2895,3042,1048,7770,0,264085000,22387000,6218000,28005000,65477000,74064000,37942000,213277000,0
Wyoming,Finance and Insurance,2014,3262,2120,345,130,2595,261,77,2933,329,5165,2120,365,165,2650,785,210,3645,1520,30947,3115,1587,1221,6458,8989,2739,20069,9273,1746942000,145585000,72349000,50788000,296598000,463503000,159878000,996601000,686375000
Wyoming,Health Care and Social Assistance,2014,8629,4255,1865,1122,7242,831,251,8324,305,9550,4255,1875,1140,7270,1170,510,8950,600,156349,6673,11372,13904,33459,28534,31150,100673,49804,6925750000,436287000,467559000,512352000,1441915000,1254250000,1196967000,4115164000,2692983000
Wyoming,Information,2014,1125,410,180,140,730,184,40,954,171,1895,410,190,150,750,285,145,1180,715,13840,314,516,1085,3246,4248,1133,10629,162,790667000,15440000,15852000,39855000,107314000,146407000,64518000,368222000,163786000
Wyoming,Management of Companies and Enterprises,2014,365,60,0,10,70,95,60,225,140,465,60,0,10,70,95,65,230,235,5567,0,0,0,0,956,1021,2157,0,486550000,4660000,0,0,864000,45113000,102625000,157780000,327121000
Wyoming,Manufacturing,2014,2687,1325,445,305,2075,274,97,2446,241,2820,1325,445,305,2075,295,110,2480,340,35709,1141,1341,1946,6100,5945,1841,18830,8970,2395329000,58640000,48971000,101273000,248841000,310919000,111409000,952790000,775682000
Wyoming,"Mining, Quarrying, and Oil and Gas Extraction",2014,3592,1720,480,355,2555,416,150,3121,471,4230,1720,480,355,2555,490,180,3225,1005,131220,2534,2703,4876,10905,13168,7237,35631,94232,11851092000,205108000,161396000,311433000,771005000,1059329000,556027000,2806251000,8981285000
Wyoming,Other,2014,59,55,2,2,59,0,0,59,0,59,55,2,2,59,0,0,59,0,87,46,0,0,87,0,0,87,0,2319000,1583000,0,0,2319000,0,0,2319000,0
Wyoming,Other Services (except Public Administration),2014,8676,5575,1905,695,8175,265,80,8520,156,8995,5575,1910,750,8235,380,85,8700,295,40330,8561,11516,8196,30146,5323,89,38083,1334,1328711000,300986000,351072000,242504000,926897000,205736000,6398000,1184563000,93228000
Wyoming,"Professional, Scientific, and Technical Services",2014,10769,8015,1210,665,9890,395,185,10470,299,11230,8020,1210,700,9930,500,250,10680,550,47716,10682,7207,7095,27521,9441,2969,43712,3548,2857326000,634267000,342582000,408847000,1472251000,603217000,175889000,2447502000,232829000
Wyoming,Real Estate and Rental and Leasing,2014,5079,4025,405,205,4635,150,80,4865,214,5755,4025,415,205,4645,275,265,5185,570,23624,4870,2166,2001,10365,3400,922,16372,6814,1179307000,196906000,90410000,84661000,398120000,184115000,43871000,682224000,479301000
Wyoming,Retail Trade,2014,9821,4695,2120,1157,7972,831,311,9114,707,13050,4695,2165,1255,8115,1150,810,10075,2975,132489,6473,11674,11624,35261,22415,10271,73617,49434,3675918000,226912000,331638000,388756000,1001331000,788032000,418349000,2321156000,1111223000
Wyoming,Total,2014,17852,10586,3020,1736,15342,1347,388,17077,775,20807,10589,3047,1816,15452,1863,883,18198,2609,219857,17221,19882,22946,60049,45611,30717,136377,83480,10375577000,738782000,683667000,829033000,2251482000,1928772000,1329303000,5509557000,4866020000
Wyoming,Transportation and Warehousing,2014,4143,2435,705,270,3410,303,112,3825,318,5110,2435,705,270,3410,330,265,4005,1105,41402,3123,4537,2778,11446,7196,3979,25340,11590,2321477000,150700000,218815000,153771000,553183000,402844000,180898000,1277478000,833681000
Wyoming,Utilities,2014,241,70,25,15,110,45,15,170,71,685,70,25,15,110,90,50,250,435,140,6,102,0,206,1478,0,2750,52,6003000,2570000,3467000,0,9277000,107727000,0,201423000,3300000
Wyoming,Wholesale Trade,2014,3219,1080,490,318,1888,418,284,2590,629,4225,1080,500,345,1925,520,445,2890,1335,41081,1020,2441,2816,7420,5239,3831,22598,15975,2536929000,73679000,135588000,132393000,387995000,330199000,310295000,1271308000,1173228000
