state_name,industry_name,YEAR,firms_01: Total,firms_02: <5,firms_03: 5-9,firms_04: 10-19,firms_05: <20,firms_06: 20-99,firms_07: 100-499,firms_08: <500,firms_09: 500+,establishments_01: Total,establishments_02: <5,establishments_03: 5-9,establishments_04: 10-19,establishments_05: <20,establishments_06: 20-99,establishments_07: 100-499,establishments_08: <500,establishments_09: 500+,employment_01: Total,employment_02: <5,employment_03: 5-9,employment_04: 10-19,employment_05: <20,employment_06: 20-99,employment_07: 100-499,employment_08: <500,employment_09: 500+,annual_payroll_01: Total,annual_payroll_02: <5,annual_payroll_03: 5-9,annual_payroll_04: 10-19,annual_payroll_05: <20,annual_payroll_06: 20-99,annual_payroll_07: 100-499,annual_payroll_08: <500,annual_payroll_09: 500+
Alabama,Accommodation and Food Services,2015,29099,10285,5450,5588,21323,5979,869,28171,928,42755,10310,5475,5640,21425,7095,3440,31960,10795,854905,17230,36662,76935,130955,219535,126691,477400,377278,12499341000,427831000,526244000,1058086000,2013676000,3207032000,1707122000,6931236000,5564701000
Alabama,Administrative and Support and Waste Management and Remediation Services,2015,18293,9915,2795,1745,14455,1799,743,16997,1296,21520,9920,2810,1760,14490,1950,1010,17450,4070,673994,16553,18022,22655,57835,66217,102352,230249,441456,18331409000,589048000,550482000,749033000,1922043000,2152626000,2705221000,6957937000,11268805000
Alabama,"Agriculture, Forestry, Fishing and Hunting",2015,3879,1930,1135,455,3520,270,38,3828,51,3965,1930,1135,455,3520,285,45,3850,115,32733,3890,7449,5968,17463,8362,1649,28378,2387,1301211000,143495000,261091000,249229000,657524000,351625000,61318000,1090121000,134245000
Alabama,"Arts, Entertainment, and Recreation",2015,5146,2960,870,505,4335,589,124,5048,98,5485,2960,870,545,4375,605,180,5160,325,87245,4417,5610,6510,16924,22108,16304,60500,18535,1697085000,139744000,110920000,114464000,382438000,405630000,347148000,1243372000,279973000
Alabama,Construction,2015,35972,20950,6555,4162,31667,3339,527,35533,439,36585,20950,6555,4165,31670,3430,590,35690,895,396100,36755,43480,55975,136210,121830,58141,319055,76192,19300950000,1319985000,1560130000,2350470000,5230585000,5907155000,3342067000,14642590000,4600423000
Alabama,Educational Services,2015,4007,1695,680,535,2910,715,200,3825,182,4300,1695,680,540,2915,795,200,3910,390,129413,2706,4632,7157,14678,27505,29410,72492,55011,3650003000,69522000,86930000,111896000,273123000,587336000,964921000,1873409000,1722241000
Alabama,Finance and Insurance,2015,15989,9716,2344,815,12875,1116,562,14553,1436,35955,9725,2400,1035,13160,3295,3400,19855,16100,346454,18536,14362,10294,43555,40061,37951,122829,219282,24056289000,748160000,645411000,566691000,1991914000,2123714000,2035484000,6254457000,17470720000
Alabama,Health Care and Social Assistance,2015,40312,16300,10278,6329,32907,4877,1357,39141,1171,52970,16315,10380,6620,33315,6210,4355,43880,9090,1208090,32990,68962,83767,186057,183165,194766,569407,637723,55175030000,1932943000,3021570000,3754205000,8720189000,8747119000,7287066000,25261487000,29878535000
Alabama,Information,2015,3660,1450,620,390,2460,366,232,3058,602,7510,1485,630,400,2515,450,305,3270,4240,162901,2480,3725,4884,11545,10893,19044,42689,119497,9341735000,107472000,157111000,224621000,504337000,595247000,1047238000,2214189000,7080887000
Alabama,Management of Companies and Enterprises,2015,2300,135,70,35,240,460,621,1321,979,3270,135,70,35,240,460,680,1380,1890,95900,175,305,194,675,4225,14065,18965,76852,8206015000,11072000,21775000,13021000,46032000,259990000,953485000,1259515000,6943589000
Alabama,Manufacturing,2015,19220,6180,2935,2479,11594,3502,1671,16767,2453,20790,6180,2935,2495,11610,3565,1875,17050,3740,1184443,11006,18063,29930,62725,129203,181171,402862,696669,58963361000,448739000,595704000,1134622000,2318241000,5515801000,7906092000,17042114000,37926890000
Alabama,"Mining, Quarrying, and Oil and Gas Extraction",2015,870,230,105,115,450,150,60,660,210,1140,230,105,115,450,165,70,685,455,36940,389,532,1243,2434,5626,3550,12429,23799,2598987000,19786000,18405000,68468000,118406000,264782000,207341000,629891000,1930725000
Alabama,Other,2015,204,193,8,3,204,0,0,204,0,204,193,8,3,204,0,0,204,0,306,209,51,46,306,0,0,306,0,4850000,3984000,597000,269000,4850000,0,0,4850000,0
Alabama,Other Services (except Public Administration),2015,50679,31000,10771,4684,46455,3292,405,50152,527,54625,31035,10815,4890,46740,4205,805,51750,2875,403901,60054,69247,61321,190838,114411,35803,344026,44658,10261026000,1382729000,1489423000,1476308000,4353619000,2685832000,893642000,8032726000,1767636000
Alabama,"Professional, Scientific, and Technical Services",2015,41800,27575,5955,3535,37065,2615,920,40600,1200,47020,27585,5975,3625,37185,3165,1255,41605,5415,484213,45823,39110,46761,132203,89409,74574,298173,182168,32943396000,2087492000,1883348000,2495894000,6486007000,6202951000,6187395000,18977511000,13844913000
Alabama,Real Estate and Rental and Leasing,2015,14941,10705,1725,828,13258,735,398,14391,550,20355,10715,1825,915,13455,1845,1470,16770,3585,116131,16865,10933,10349,38342,21124,18290,78782,33767,4775976000,637328000,390924000,384164000,1417845000,959127000,712276000,3136055000,1525545000
Alabama,Retail Trade,2015,54985,31100,10941,5505,47546,4380,970,52896,2089,90215,31230,11175,6045,48450,7820,3310,59580,30635,1087275,60452,71137,71121,203081,152034,79531,438886,619704,27277266000,1420466000,1814612000,1981429000,5223966000,5140094000,2699213000,13182031000,13404113000
Alabama,Total,2015,73409,39724,13646,8205,61575,7358,1981,70914,2495,98540,39799,13804,8578,62181,10103,5266,77550,20990,1634391,71722,89771,109487,270980,272084,232765,775829,858562,67370353000,2590485000,2941589000,3818925000,9350999000,10394604000,9405233000,29150836000,38219517000
Alabama,Transportation and Warehousing,2015,12352,6635,1712,1094,9441,1239,553,11233,1119,14515,6635,1720,1100,9455,1365,740,11560,2955,291739,10986,11021,14106,36706,39747,34672,114891,153895,12892733000,406055000,389228000,513137000,1328183000,1503719000,1433403000,4399276000,7445213000
Alabama,Utilities,2015,559,135,155,20,310,105,47,462,97,2130,135,155,20,310,205,125,640,1490,85539,292,958,198,1474,5269,3185,10483,40316,7795891000,7708000,40066000,8377000,57049000,372265000,235142000,695021000,3768919000
Alabama,Wholesale Trade,2015,20830,8838,3215,2411,14464,2716,1322,18502,2328,26575,8860,3270,2475,14605,3605,2475,20685,5890,356277,15171,20887,30007,66904,77499,66411,216033,133498,19683364000,745233000,1007790000,1526866000,3317277000,4037609000,3371071000,10976795000,8318067000
Alaska,Accommodation and Food Services,2015,9178,4305,1866,1421,7592,1185,177,8954,224,10625,4315,1885,1435,7635,1465,760,9860,765,140560,5459,12350,18571,36619,42526,23258,104775,34032,3691735000,321811000,265625000,367461000,962136000,953682000,530505000,2550210000,1100745000
Alaska,Administrative and Support and Waste Management and Remediation Services,2015,4907,2925,800,425,4150,274,103,4527,380,5655,2925,800,455,4180,330,210,4720,935,84738,3805,5098,5126,14625,8318,7075,33795,48445,4111357000,195692000,214055000,230648000,666210000,433637000,268998000,1633970000,2345841000
Alaska,"Agriculture, Forestry, Fishing and Hunting",2015,2215,2095,45,35,2175,20,0,2195,20,2220,2095,45,35,2175,20,0,2195,25,3985,1059,183,351,1702,201,0,2670,263,274170000,122527000,5003000,24456000,154671000,14737000,0,226415000,9551000
Alaska,"Arts, Entertainment, and Recreation",2015,2667,1855,350,205,2410,215,15,2640,27,2830,1860,355,245,2460,230,30,2720,110,22972,1946,2138,2657,7053,6559,1035,15807,1433,527498000,122953000,49354000,54900000,241281000,136951000,14334000,418443000,21811000
Alaska,Construction,2015,12333,8540,1855,959,11354,626,121,12101,232,12685,8540,1855,960,11355,660,170,12185,500,92905,11965,12036,12410,37060,19212,6996,67470,23429,8185310000,894322000,842384000,1064922000,2858205000,1785327000,665709000,5693050000,2291498000
Alaska,Educational Services,2015,1203,585,240,160,985,110,50,1145,58,1460,585,240,175,1000,115,260,1375,85,15082,807,1365,2162,4558,3270,2969,13462,1449,427304000,26259000,29605000,55761000,119582000,81035000,74821000,364524000,47057000
Alaska,Finance and Insurance,2015,2170,1160,335,120,1615,125,105,1845,325,3820,1160,335,130,1625,260,410,2295,1525,36410,2091,1946,1072,5532,3055,5929,17404,16141,2388738000,104926000,100880000,81321000,322561000,180544000,339874000,1057373000,1141302000
Alaska,Health Care and Social Assistance,2015,10493,4885,2300,1565,8750,965,424,10139,354,12890,4915,2310,1595,8820,1235,915,10970,1920,244519,8938,15443,19913,44837,33800,53497,136292,97718,14319158000,618750000,788097000,1346348000,2778462000,1924240000,2596506000,7479865000,6451696000
Alaska,Information,2015,1052,440,150,135,725,110,68,903,149,2015,440,150,150,740,205,210,1155,860,33134,634,792,1396,3224,2390,2937,11909,20112,2332782000,28809000,31894000,58329000,129637000,137082000,169415000,536537000,1754036000
Alaska,Management of Companies and Enterprises,2015,676,30,30,15,75,135,181,391,285,965,30,30,15,75,135,205,415,550,39105,10,90,72,190,1585,7425,9200,29905,4004565000,3810000,6865000,3672000,15265000,87930000,497585000,600780000,3403785000
Alaska,Manufacturing,2015,2268,1180,390,240,1810,255,45,2110,158,2675,1180,395,245,1820,275,95,2190,485,58412,1664,1717,2094,6936,4915,4314,19479,37355,2714613000,88873000,62732000,129911000,348618000,239296000,291211000,1059173000,1538242000
Alaska,"Mining, Quarrying, and Oil and Gas Extraction",2015,739,310,100,80,490,55,59,604,135,900,310,100,80,490,55,60,605,295,65414,289,631,872,1967,1193,4204,9794,53079,8261032000,33338000,83721000,105182000,244960000,163694000,495244000,1284925000,6737916000
Alaska,Other,2015,44,42,1,1,44,0,0,44,0,44,42,1,1,44,0,0,44,0,76,58,0,0,76,0,0,76,0,905000,864000,0,0,905000,0,0,905000,0
Alaska,Other Services (except Public Administration),2015,8349,4960,1948,735,7643,405,100,8148,201,8975,4970,1960,805,7735,570,295,8600,375,49044,8918,12277,9218,30762,11755,1836,46267,2420,1690999000,296564000,376249000,351536000,1041419000,378962000,73204000,1561299000,113248000
Alaska,"Professional, Scientific, and Technical Services",2015,8562,5430,1035,710,7175,495,235,7905,657,9600,5430,1040,740,7210,595,335,8140,1460,92579,8565,6487,8910,24474,13288,13849,54427,35998,7105697000,532301000,437508000,645747000,1644685000,1027570000,1020630000,3882780000,3067266000
Alaska,Real Estate and Rental and Leasing,2015,4092,3040,425,185,3650,198,66,3914,178,4565,3045,460,215,3720,300,230,4250,315,22195,4393,2676,2026,9403,4515,1259,17631,3607,1094273000,180835000,107391000,82197000,384189000,225855000,57185000,783825000,267369000
Alaska,Retail Trade,2015,9509,4681,1894,1258,7833,861,199,8893,616,12570,4725,1945,1360,8030,1340,550,9920,2650,175515,7991,12146,15439,36437,22694,10925,76684,75902,5510600000,292883000,352354000,475811000,1147002000,854345000,395962000,2629757000,2188486000
Alaska,Total,2015,16952,10065,2919,1756,14740,1226,354,16320,632,20907,10101,2966,1871,14938,1717,1175,17830,3077,267999,14827,19291,23133,57251,42740,42457,142448,125551,15643303000,850971000,842641000,1156630000,2850242000,2160600000,2295488000,7306330000,8336973000
Alaska,Transportation and Warehousing,2015,4485,2743,515,310,3568,273,222,4063,422,5720,2750,515,315,3580,360,595,4535,1185,80521,3027,3192,3155,10214,6481,12436,33645,39543,5272294000,263674000,153104000,177022000,643407000,413329000,667033000,2037941000,2862313000
Alaska,Utilities,2015,302,85,50,57,192,52,40,284,18,500,85,55,85,225,55,150,430,70,9411,146,304,616,1175,1604,4032,8558,632,886442000,3821000,16032000,33730000,57305000,153466000,407986000,794174000,69908000
Alaska,Wholesale Trade,2015,2710,910,345,285,1540,293,248,2081,629,3645,935,350,310,1595,380,395,2370,1275,43764,1281,1759,2304,6736,4924,7214,22797,17659,2847093000,73233000,99797000,122616000,364766000,310737000,469088000,1384466000,1252340000
Arizona,Accommodation and Food Services,2015,42151,13009,8070,8251,29330,10259,1302,40891,1260,61035,13045,8080,8445,29570,11620,5215,46405,14630,1410600,21400,54550,113010,188975,389268,205245,784655,625847,25223560000,713895000,783725000,1617890000,3115800000,6174949000,3398599000,12714485000,12505784000
Arizona,Administrative and Support and Waste Management and Remediation Services,2015,35905,20895,5345,3315,29555,3120,1219,33894,2011,41835,20900,5380,3330,29610,3340,1410,34360,7475,1280506,32169,34697,43870,111047,119417,163630,396447,882681,43325310000,1211888000,1093170000,1425174000,3743034000,3946253000,4790069000,12554039000,30724477000
Arizona,"Agriculture, Forestry, Fishing and Hunting",2015,995,665,135,90,890,70,15,975,20,1015,665,135,90,890,80,15,985,30,7882,840,817,968,2833,2217,1144,6972,722,273961000,36660000,34611000,32492000,110359000,87070000,20332000,249011000,19314000
Arizona,"Arts, Entertainment, and Recreation",2015,8067,4260,1000,820,6080,1265,453,7798,269,9225,4265,1000,825,6090,1295,775,8160,1065,228717,5846,6334,10515,23241,48641,71017,146262,78188,7562510000,255209000,154729000,225751000,650100000,828311000,3434133000,4981695000,2244758000
Arizona,Construction,2015,57397,34650,9535,6145,50330,5238,1086,56654,743,58075,34655,9535,6145,50335,5270,1235,56840,1235,665190,55475,63130,82181,200890,207678,133676,544430,111978,32581740000,2244155000,2330809000,3400711000,7980945000,9619310000,6887833000,24639905000,7487514000
Arizona,Educational Services,2015,9164,4285,1320,1155,6760,1656,396,8812,352,10750,4290,1320,1180,6790,1820,585,9195,1555,288190,6213,8804,15436,30575,68911,47178,147439,139266,11417260000,252356000,225046000,356851000,839036000,1995108000,1599638000,4480508000,6843816000
Arizona,Finance and Insurance,2015,25737,18339,2675,918,21932,852,809,23593,2144,46370,18360,2690,970,22020,1320,2290,25630,20740,704213,29141,17348,11158,57895,28233,53113,140898,556588,49277319000,1414841000,841887000,857027000,3126506000,2000316000,3949466000,9188528000,39702990000
Arizona,Health Care and Social Assistance,2015,68515,37580,13412,7880,58872,6050,1809,66731,1784,88590,37655,13490,8240,59385,8235,5690,73310,15280,1693266,60212,90130,104823,255322,234626,287106,780974,909668,81148064000,3946217000,3881197000,4485892000,12329402000,9682572000,12277026000,34481824000,46519761000
Arizona,Information,2015,6620,3390,780,535,4705,641,360,5706,914,10605,3390,780,555,4725,775,550,6050,4555,244474,4992,4797,6709,16979,19630,26019,64954,177637,17669140000,339980000,251647000,319918000,938004000,1187083000,2197622000,4434310000,13063888000
Arizona,Management of Companies and Enterprises,2015,3364,416,45,100,561,471,838,1870,1494,4900,425,45,100,570,475,895,1940,2960,265720,564,245,815,1625,5465,33670,40760,224960,22465515000,66420000,19685000,61855000,148930000,316615000,2386165000,2851710000,19613805000
Arizona,Manufacturing,2015,20350,7975,3430,2836,14241,3413,1169,18823,1527,21340,7980,3430,2855,14265,3515,1360,19140,2200,670777,13690,21532,34354,74203,121247,89015,316131,310490,40290857000,589879000,762243000,1371266000,2926989000,5385856000,4278668000,13966907000,23674179000
Arizona,"Mining, Quarrying, and Oil and Gas Extraction",2015,923,390,159,85,634,133,32,799,124,1185,390,160,85,635,145,40,820,365,58112,604,944,830,2803,3461,284,8358,49476,4380899000,31367000,45907000,35038000,134625000,196547000,20659000,461746000,3893862000
Arizona,Other,2015,286,274,8,2,284,2,0,286,0,286,274,8,2,284,2,0,286,0,373,252,54,0,325,0,0,373,0,9419000,7567000,792000,0,8408000,0,0,9419000,0
Arizona,Other Services (except Public Administration),2015,49321,30140,9680,4896,44716,3127,771,48614,707,54890,30175,9740,5060,44975,4085,2170,51230,3660,437545,54123,63303,65558,183209,109651,73491,370307,57888,12937321000,1521944000,1682414000,1848229000,5059812000,2913015000,2139265000,10244983000,2263916000
Arizona,"Professional, Scientific, and Technical Services",2015,79269,58640,8672,4613,71925,3873,1355,77153,2116,86105,58645,8700,4670,72015,4515,2005,78535,7570,723555,78935,56127,60411,195795,122527,82406,404275,312352,50420755000,4520685000,2984735000,3455646000,10978845000,8073597000,5774231000,25021040000,25005409000
Arizona,Real Estate and Rental and Leasing,2015,35309,28560,2798,1378,32736,1069,547,34352,957,43575,28590,2875,1540,33005,1690,1795,36490,7085,225135,34334,17859,17005,69435,32703,32850,137620,87449,10965565000,1616720000,685483000,740805000,3049850000,1735253000,1566992000,6593425000,4366264000
Arizona,Retail Trade,2015,50054,27414,9661,5244,42319,3955,1249,47523,2531,90515,27540,9880,5930,43350,6515,4150,54015,36500,1572305,48580,64032,68216,180995,135471,113656,433975,1101102,43939995000,1388025000,1567591000,1905520000,4865815000,4621500000,4991379000,14591900000,28504581000
Arizona,Total,2015,105004,62665,16445,10367,89477,9652,2699,101828,3176,136352,62753,16582,10809,90144,11951,6730,108825,27527,2295186,96472,108816,138314,343602,360022,317650,1021274,1273912,102671393000,4377837000,3814812000,4950330000,13142979000,13186068000,13653744000,39982791000,62688602000
Arizona,Transportation and Warehousing,2015,14161,7815,1760,1219,10794,1369,677,12840,1321,16590,7825,1765,1245,10835,1500,910,13245,3345,435529,11099,11450,15128,38324,43672,36085,123643,303083,21085779000,440496000,399626000,572116000,1438405000,1633801000,1402760000,4655811000,15848712000
Arizona,Utilities,2015,791,420,85,50,555,42,74,671,120,1290,420,90,50,560,65,240,865,425,47843,854,476,510,1919,1435,8373,12005,20273,4441393000,28014000,20659000,26000000,79244000,100481000,640460000,835819000,2039281000
Arizona,Wholesale Trade,2015,26788,13165,3710,2601,19476,3012,1520,24008,2780,32440,13180,3775,2720,19675,3485,2320,25480,6960,461675,21230,24160,31921,78335,85244,65170,232350,222057,29279905000,1165917000,1177538000,1648061000,4034800000,4507961000,3539786000,12293465000,16623268000
Arkansas,Accommodation and Food Services,2015,21352,7185,3730,4285,15200,4850,632,20682,670,28000,7200,3760,4320,15280,5665,2520,23465,4535,504530,11120,25577,58161,94925,170917,82832,348800,155671,7203435000,303165000,324446000,797132000,1425575000,2374851000,1036986000,4839310000,2363278000
Arkansas,Administrative and Support and Waste Management and Remediation Services,2015,11599,6800,1635,980,9415,1045,307,10767,832,13195,6805,1635,995,9435,1165,450,11050,2145,303305,11314,10861,13027,35760,37351,33573,113243,183784,7124383000,387311000,338606000,400413000,1150351000,1040609000,711785000,3078846000,3842176000
Arkansas,"Agriculture, Forestry, Fishing and Hunting",2015,3096,1765,790,245,2800,195,30,3025,71,3205,1765,790,255,2810,195,30,3035,170,23795,2974,5056,3067,11335,5922,1184,20816,1360,955612000,138961000,214014000,132426000,495186000,203840000,26544000,776013000,92219000
Arkansas,"Arts, Entertainment, and Recreation",2015,3934,2345,615,455,3415,347,87,3849,85,4025,2345,615,455,3415,380,125,3920,105,45524,3903,3974,6052,14212,11356,7848,37480,3778,926553000,101077000,70471000,104834000,287209000,239635000,137362000,754901000,78875000
Arkansas,Construction,2015,25766,16165,4435,2645,23245,2033,225,25503,263,25990,16170,4435,2645,23250,2065,275,25590,400,217325,26520,29242,35953,91785,70327,24621,192300,21669,9827940000,928365000,1016517000,1449426000,3395875000,3270488000,1233118000,8222850000,1284141000
Arkansas,Educational Services,2015,2815,1355,485,285,2125,450,145,2720,95,3085,1355,485,290,2130,510,230,2870,215,78502,2211,3174,3675,9293,17499,24195,53367,24565,1758745000,69717000,53827000,81048000,219819000,410055000,605828000,1281840000,463153000
Arkansas,Finance and Insurance,2015,12394,8418,1555,482,10455,714,366,11535,859,21600,8430,1605,650,10685,2055,2200,14940,6660,180499,14307,9600,5899,30246,24078,25903,83365,95950,10419583000,540516000,421100000,291126000,1278093000,1189710000,1385801000,4072605000,6264926000
Arkansas,Health Care and Social Assistance,2015,29725,14570,6015,3710,24295,3157,1267,28719,1006,38075,14585,6040,3845,24470,4625,3430,32525,5550,842730,24624,40126,48297,113565,134649,163321,414246,426234,35004017000,1582227000,1632947000,1961376000,5196069000,4679399000,5082769000,15096021000,19828430000
Arkansas,Information,2015,2478,960,415,255,1630,309,113,2052,426,5070,960,415,260,1635,420,375,2430,2640,118473,1784,2581,3252,7935,9437,4025,25060,80219,6545484000,68206000,92091000,115357000,292673000,543723000,167070000,1245148000,4722199000
Arkansas,Management of Companies and Enterprises,2015,1593,75,35,35,145,295,472,912,681,5435,75,35,40,150,300,515,965,4470,189955,123,165,205,500,4055,12608,17250,172697,19014220000,6422000,10080000,10045000,27225000,228115000,604616000,867365000,18144825000
Arkansas,Manufacturing,2015,11819,3935,1965,1512,7412,1996,769,10177,1642,13025,3935,1965,1515,7415,2180,960,10555,2470,727027,6994,11448,17955,39516,67514,53096,187560,474418,31324232000,230620000,362748000,607026000,1329701000,2551063000,2274380000,7290236000,21072260000
Arkansas,"Mining, Quarrying, and Oil and Gas Extraction",2015,1728,775,285,165,1225,215,58,1498,230,1990,775,285,165,1225,220,75,1520,470,35329,1209,1856,2146,5345,6637,3476,16224,18944,2254158000,57565000,77963000,89181000,228137000,343356000,221601000,837039000,1408611000
Arkansas,Other,2015,144,136,7,1,144,0,0,144,0,144,136,7,1,144,0,0,144,0,197,140,47,0,197,0,0,197,0,3041000,2481000,348000,0,3041000,0,0,3041000,0
Arkansas,Other Services (except Public Administration),2015,31380,20490,6122,2540,29152,1650,247,31049,331,33040,20505,6160,2745,29410,2150,515,32075,965,203777,38472,39001,32577,110457,56398,18324,190060,11863,5014618000,878918000,903763000,823340000,2616912000,1218282000,479837000,4514947000,438466000
Arkansas,"Professional, Scientific, and Technical Services",2015,27457,19586,3690,1910,25186,1062,388,26636,821,29720,19590,3700,1995,25285,1410,915,27610,2110,184128,28546,23526,24632,77178,34615,16804,131327,50588,10207220000,1385805000,976212000,1170878000,3556505000,1929845000,1026268000,6655960000,3382327000
Arkansas,Real Estate and Rental and Leasing,2015,11664,9283,1000,397,10680,450,211,11341,323,14640,9295,1010,465,10770,890,910,12570,2070,62100,13615,6057,4708,24676,13870,5525,45740,15023,2211062000,407053000,187786000,176237000,784226000,502409000,227195000,1573641000,563940000
Arkansas,Retail Trade,2015,34574,18145,7785,3906,29836,2592,550,32978,1596,54540,18200,7835,4295,30330,4370,2510,37210,17330,661377,34630,50902,49338,135365,84492,40505,266598,373841,16424364000,813166000,1224633000,1331912000,3380725000,2890834000,1073641000,7531706000,8337812000
Arkansas,Total,2015,50451,28802,8789,5218,42809,4650,1179,48638,1813,65175,28838,8845,5500,43183,6434,3644,53261,11914,1003113,48598,57733,69257,175588,171702,132437,479727,523386,39451191000,1741734000,1776378000,2223589000,5741701000,5698094000,4646215000,16086010000,23365181000
Arkansas,Transportation and Warehousing,2015,10063,5689,1505,900,8094,803,325,9222,841,11795,5705,1505,920,8130,860,425,9415,2380,263027,8990,9663,11024,30289,29543,19268,83396,166168,11636660000,317226000,335766000,405989000,1078843000,1110397000,787979000,3113329000,7916533000
Arkansas,Utilities,2015,708,400,75,40,515,60,53,628,80,1635,400,75,40,515,135,200,850,785,35140,927,410,426,1789,2772,7520,12465,19148,2954831000,26615000,12590000,15672000,56035000,184773000,533620000,793445000,1866220000
Arkansas,Wholesale Trade,2015,13569,5415,1824,1532,8771,1996,904,11671,1898,17090,5415,1840,1600,8855,2575,1560,12990,4100,222097,9155,11532,18651,40492,53730,34498,135917,80690,12091371000,416075000,481834000,852679000,1805070000,2622497000,2026742000,6868379000,4917150000
California,Accommodation and Food Services,2015,320068,114680,65847,65722,246249,64642,6748,317639,2429,419145,114925,66105,66960,247990,76065,26680,350735,68410,8046530,183645,441810,891840,1517295,2436031,1135174,5089250,2956529,168986165000,5793216000,7030420000,15206292000,28029928000,48399748000,23264236000,99714310000,69242183000
California,Administrative and Support and Waste Management and Remediation Services,2015,184606,112227,27852,17557,157636,17566,5464,180666,3940,218155,112305,27975,17890,158170,19070,7840,185080,33075,6945925,178441,182221,235048,595745,695035,817977,2110518,4832963,329208212000,8793540000,6780443000,8961845000,24537945000,28016152000,30618141000,83305160000,245786225000
California,"Agriculture, Forestry, Fishing and Hunting",2015,9183,5735,1420,780,7935,914,235,9084,99,9405,5735,1420,785,7940,960,340,9240,165,131680,8393,9414,9983,27975,38014,31371,98290,28810,5025425000,507041000,430941000,455511000,1399340000,1678313000,949713000,4062105000,819868000
California,"Arts, Entertainment, and Recreation",2015,112262,86300,9476,6404,102180,7409,1856,111445,817,119200,86325,9495,6490,102310,8045,2875,113230,5970,1663715,81055,61835,84520,227460,303050,304658,837025,816490,82171470000,23035545000,3123400000,3501202000,29661925000,7875755000,14701465000,52290800000,29419249000
California,Construction,2015,344721,220370,57281,34319,311970,27333,3948,343251,1470,349500,220375,57300,34385,312060,27795,5260,345115,4385,3433785,345910,376645,460190,1182745,1055470,610661,2849410,582154,210060440000,16535415000,16593245000,23404570000,56533230000,63620080000,41652006000,161835040000,48072773000
California,Educational Services,2015,61666,29733,9645,8118,47496,10320,2796,60612,1054,69785,29780,9720,8330,47830,11735,4895,64460,5325,2073560,45885,64450,110250,220585,415350,449359,1085780,985682,81370325000,1877820000,1588355000,2789535000,6255710000,14127715000,18036535000,38441475000,42870496000
California,Finance and Insurance,2015,144998,104807,18478,7723,131008,7260,2847,141115,3883,251515,104935,18755,8540,132230,11145,13155,156530,94985,2948945,175463,117571,100245,393528,259335,324477,979330,1969319,325787739000,10313377000,7941007000,9732821000,28010787000,29282673000,36633229000,94175704000,231562036000
California,Health Care and Social Assistance,2015,457661,263862,98578,47907,410347,33483,9452,453282,4379,546425,264495,99215,49885,413595,46500,30060,490155,56270,9362863,460349,644254,630508,1735165,1296427,1400077,4432480,4928770,524365807000,28434798000,27415353000,27267974000,83124468000,52933496000,57388491000,193462890000,330827792000
California,Information,2015,82574,55567,8666,5730,69963,6821,2915,79699,2875,114715,55650,8745,5890,70285,7625,4585,82495,32220,3424265,64380,57053,75908,197395,255520,385372,839885,2582710,420398075000,9130090000,4348292000,6276569000,19757160000,23927680000,42756418000,86591480000,333666043000
California,Management of Companies and Enterprises,2015,16134,1366,431,585,2382,3021,4834,10237,5897,26540,1370,440,585,2395,3120,5225,10740,15800,1578020,1730,2005,3745,7480,42780,174315,224575,1353445,218704705000,401750000,144140000,342025000,887915000,3613160000,14998345000,19499420000,199205285000
California,Manufacturing,2015,183159,75552,33365,26857,135774,31799,8500,176073,7086,192660,75600,33395,26965,135960,32710,10255,178925,13735,5798329,135375,222755,362080,722843,1243082,1101076,3096048,2620577,371968390000,7174595000,8804822000,15279498000,31582964000,61409009000,61546735000,156137845000,209759755000
California,"Mining, Quarrying, and Oil and Gas Extraction",2015,3076,1315,455,414,2184,367,160,2711,365,4195,1315,455,425,2195,380,215,2790,1405,119726,2084,2777,5273,10351,12143,18845,43100,75036,10398047000,122495000,153947000,368241000,662417000,950717000,1351217000,3088238000,7182973000
California,Other,2015,3345,3211,110,19,3340,5,0,3345,0,3345,3211,110,19,3340,5,0,3345,0,4050,2983,710,238,3931,119,0,4050,0,109765000,92429000,12609000,3348000,108386000,1379000,0,109765000,0
California,Other Services (except Public Administration),2015,333131,214361,61384,30603,306348,21944,3304,331596,1535,366465,214515,61890,31785,308190,27310,9175,344675,21790,2875170,382585,397725,401469,1181790,772194,394335,2349680,514972,94852985000,11586095000,11391665000,12330258000,35308190000,24822589000,14550762000,74730840000,19318648000
California,"Professional, Scientific, and Technical Services",2015,568793,415651,70694,38305,524650,30119,7726,562495,6298,612945,415865,70995,39290,526150,35245,13450,574845,38100,6291125,593230,462790,503680,1559700,1060195,827501,3448190,2841320,570645595000,43154630000,29299745000,36721865000,109176240000,95832205000,84123561000,289203935000,281320691000
California,Real Estate and Rental and Leasing,2015,209112,163079,23321,10509,196909,8100,2334,207343,1769,261890,163390,23850,11970,199210,13450,14220,226880,35010,1433030,228910,149435,135664,514020,276070,226162,1018355,413554,84640785000,12427420000,6650820000,6886616000,25964875000,15285780000,14151425000,55616285000,28706544000
California,Retail Trade,2015,351829,206575,71246,37724,315545,26267,5957,347769,4060,542710,207330,72865,41830,322025,39115,22980,384120,158590,8279551,372453,471675,494630,1338758,952040,698167,2989771,5143124,251530051000,11392110000,12751165000,14934380000,39077655000,35033785000,31282085000,105422735000,142638422000
California,Total,2015,740303,458058,123281,75203,656542,64579,13122,734243,6060,908120,458802,124461,78428,661691,80353,38364,780408,127712,14325377,721267,810617,1002630,2534514,2467465,1994215,6996194,7329183,856954246000,41741668000,32570161000,42048399000,116360228000,115477824000,111905046000,343743098000,513211148000
California,Transportation and Warehousing,2015,95957,56071,14883,9594,80548,8645,3059,92252,3705,115765,56150,14995,9855,81000,9920,5675,96595,19170,2427952,83533,97564,124689,306050,286894,262798,860660,1560968,123980804000,3583667000,3551635000,5011522000,12159859000,12719314000,13058576000,38255846000,85511046000
California,Utilities,2015,2645,1365,510,220,2095,221,79,2395,250,6095,1365,520,240,2125,270,255,2650,3445,297242,2713,3283,2676,8914,7208,6469,24335,241189,35472154000,113821000,177054000,165551000,471102000,659862000,622785000,1943009000,30720573000
California,Wholesale Trade,2015,259899,146287,43213,28916,218416,26734,8153,253303,6596,296765,146530,43620,29945,220095,31280,14680,266055,30710,4271015,244860,283110,376410,904440,922062,754829,2581925,1676882,364581360000,13543640000,14548410000,20424599000,48518055000,56739477000,54862526000,160148570000,202584458000
Colorado,Accommodation and Food Services,2015,50188,15965,9245,10684,35894,11809,1213,48916,1272,66310,15990,9285,10795,36070,13185,5005,54260,12050,1353235,24025,61905,144955,230885,421117,191175,843455,509488,26103890000,862245000,1014145000,2399905000,4276295000,7610228000,3603685000,15497650000,10598100000
Colorado,Administrative and Support and Waste Management and Remediation Services,2015,39071,24235,5530,3220,32985,3235,1024,37244,1827,44385,24235,5530,3250,33015,3470,1350,37835,6550,1255130,33749,36334,42846,113199,119750,119148,357382,894760,56686955000,1564059000,1305584000,1623521000,4504091000,4528626000,4536603000,13802842000,42714900000
Colorado,"Agriculture, Forestry, Fishing and Hunting",2015,1645,1340,170,60,1570,40,20,1630,15,1645,1340,170,60,1570,40,20,1630,15,7575,1800,1078,610,3621,1888,518,7131,0,276786000,69765000,46045000,19259000,141170000,61671000,16332000,262575000,0
Colorado,"Arts, Entertainment, and Recreation",2015,13139,8675,1505,1237,11417,1099,322,12838,301,13880,8675,1505,1255,11435,1170,435,13040,840,275243,10505,9984,16350,37216,40470,55613,138243,132041,8749521000,596301000,229516000,368779000,1208184000,901885000,1582130000,4234136000,3927320000
Colorado,Construction,2015,84685,59425,11385,6665,77475,5564,927,83966,719,85415,59425,11385,6675,77485,5615,1135,84235,1180,725440,83540,74450,88495,246485,206932,126336,583880,138167,41570595000,3887095000,3282690000,4315445000,11485230000,11221358000,8053239000,31066925000,10316983000
Colorado,Educational Services,2015,11888,6425,1755,1440,9620,1540,385,11545,343,12565,6440,1760,1450,9650,1675,470,11795,770,251383,9271,11540,19221,40248,65744,42552,151398,98919,7923020000,465386000,312460000,451970000,1238070000,1886984000,1534622000,4784165000,3115019000
Colorado,Finance and Insurance,2015,31195,22785,3227,935,26947,1267,777,28991,2204,49840,22800,3265,1040,27105,2285,2220,31610,18230,524634,36635,20215,11772,69124,39414,41417,152892,371760,44018027000,1973344000,1203875000,1022959000,4236261000,3486697000,3412850000,11394868000,32620939000
Colorado,Health Care and Social Assistance,2015,64948,35895,12365,7390,55650,6095,1704,63449,1499,78655,35955,12405,7675,56035,7890,4755,68680,9975,1460308,57790,82625,99084,239640,233420,263152,739737,716374,70593527000,3185945000,3528700000,4346328000,11064409000,9916625000,10414495000,31596931000,38764602000
Colorado,Information,2015,9926,5380,1220,745,7345,810,544,8699,1227,16085,5380,1230,755,7365,910,685,8960,7125,404947,7826,7761,9897,25945,23643,40590,94493,308484,36159599000,469245000,419634000,556562000,1471591000,1725015000,3655215000,7128286000,28843582000
Colorado,Management of Companies and Enterprises,2015,3558,340,80,95,515,496,919,1930,1628,5235,340,80,95,515,505,970,1990,3245,285070,495,385,680,1560,5835,30750,38145,246810,33749840000,56740000,35410000,45420000,137570000,496310000,3119545000,3753425000,29988924000
Colorado,Manufacturing,2015,24415,11460,4154,3000,18614,3286,1037,22937,1478,25200,11460,4160,3030,18650,3420,1170,23240,1960,573804,18670,25761,37419,86376,111675,76347,307281,231600,33149694000,827679000,969381000,1551770000,3557753000,5320842000,4302004000,14945932000,15595951000
Colorado,"Mining, Quarrying, and Oil and Gas Extraction",2015,6062,3320,690,620,4630,664,223,5517,545,6775,3330,700,625,4655,690,285,5630,1145,148183,5035,4608,7888,17777,22064,24341,66121,80314,14497193000,364712000,395392000,647690000,1431025000,1947300000,2017314000,5536533000,8802009000
Colorado,Other,2015,318,308,6,4,318,0,0,318,0,318,308,6,4,318,0,0,318,0,368,269,38,61,368,0,0,368,0,8541000,7069000,589000,883000,8541000,0,0,8541000,0
Colorado,Other Services (except Public Administration),2015,64200,41020,11732,6043,58795,3949,695,63439,761,69960,41040,11845,6225,59110,5015,1515,65640,4320,522385,69940,77101,78193,225556,140132,57081,426615,88450,17231855000,2181886000,2303532000,2463316000,6963759000,4298266000,2161171000,13572150000,3430221000
Colorado,"Professional, Scientific, and Technical Services",2015,119621,91785,11720,6326,109831,5066,2039,116936,2685,127790,91790,11775,6410,109975,5715,2550,118240,9550,957280,118510,76506,81795,277155,159231,103762,542080,408865,84236675000,7411505000,4727676000,5438463000,17596245000,12102517000,9566566000,39412390000,44334031000
Colorado,Real Estate and Rental and Leasing,2015,45869,38337,3285,1454,43076,1322,520,44918,951,52770,38375,3345,1545,43265,2015,1165,46445,6325,216645,45390,20974,18882,85415,39795,23231,149160,66781,10315160000,2498620000,855891000,767804000,4130825000,1746450000,1061686000,6962680000,3326412000
Colorado,Retail Trade,2015,62272,33985,12743,7283,54011,4563,1214,59788,2484,93670,34100,12970,7855,54925,6660,4045,65630,28040,1362835,61902,84647,95478,242360,153939,84602,486325,845175,39766225000,1825541000,2205793000,2692858000,6730910000,5676702000,3543661000,16144140000,22849742000
Colorado,Total,2015,133930,85669,19304,12225,117198,10679,2771,130648,3282,161737,85746,19448,12625,117819,13017,6296,137132,24605,2253795,125268,127281,162850,415399,386419,293768,1095586,1158209,117539555000,6050187000,4961728000,6358177000,17370092000,16241398000,14812997000,48424487000,69115068000
Colorado,Transportation and Warehousing,2015,16558,10180,1925,1264,13369,1139,679,15187,1371,18895,10180,1925,1290,13395,1180,940,15515,3380,348237,13798,12432,16190,43006,37262,30314,114724,197597,17147748000,549058000,444901000,598502000,1636455000,1667518000,1396130000,4873375000,10890273000
Colorado,Utilities,2015,1032,560,115,65,740,125,88,953,79,1925,560,115,70,745,220,160,1125,800,52858,992,606,588,2279,6086,6498,15088,28186,4340713000,30345000,22942000,29943000,88697000,512649000,603875000,1243036000,2427918000
Colorado,Wholesale Trade,2015,30052,15754,3733,2892,22379,2831,1806,27016,3036,36095,15775,3760,3005,22540,3425,2605,28570,7525,500335,24489,24029,36019,85319,81810,77432,250260,248163,36834860000,1346473000,1355934000,2054914000,4800993000,4940847000,4943261000,15022680000,21696706000
Connecticut,Accommodation and Food Services,2015,35620,14475,6957,6395,27827,6631,525,34983,637,42295,14475,7005,6440,27920,7370,1805,37095,5200,679618,25055,46326,87415,158915,232844,71551,464420,214875,13956269000,713735000,747587000,1510414000,2979520000,4610414000,1406030000,9029575000,4917015000
Connecticut,Administrative and Support and Waste Management and Remediation Services,2015,23821,15565,3035,1790,20390,1747,586,22723,1098,26905,15565,3045,1815,20425,1835,710,22970,3935,427472,20162,19480,23625,63577,64371,67296,200459,220616,17732346000,1319743000,897659000,1170282000,3404536000,3215990000,2113080000,9011213000,8095996000
Connecticut,"Agriculture, Forestry, Fishing and Hunting",2015,360,275,55,20,350,10,0,360,0,360,275,55,20,350,10,0,360,0,1355,425,273,186,985,0,0,1355,0,57522000,21572000,6534000,5426000,37167000,0,0,57522000,0
Connecticut,"Arts, Entertainment, and Recreation",2015,7732,4180,1020,895,6095,1230,241,7566,166,8495,4180,1035,905,6120,1290,550,7960,535,138109,5784,6582,11886,24674,47302,35537,112725,22858,3680224000,394330000,231499000,352109000,1034636000,1313633000,636172000,3109898000,464105000
Connecticut,Construction,2015,39613,27990,5640,3190,36820,2175,309,39304,309,39790,27995,5640,3200,36835,2195,325,39355,435,273450,42080,36842,42071,121120,77529,30085,232905,33208,19036565000,2513955000,2157016000,2857083000,7537545000,5644867000,2337870000,15840840000,2676382000
Connecticut,Educational Services,2015,6771,3270,1085,918,5273,895,370,6538,233,7155,3270,1090,920,5280,940,445,6665,490,372922,5122,7336,12094,24616,37435,51804,117781,250966,17035062000,209522000,159256000,260112000,630053000,1440722000,2754649000,5041218000,11873289000
Connecticut,Finance and Insurance,2015,17558,10283,2510,1205,13998,1161,739,15898,1660,29975,10300,2540,1295,14135,1875,2490,18500,11475,579095,18276,15699,14990,49328,39111,61595,152084,409123,88843115000,1436103000,1394861000,2430453000,5323293000,6798381000,10798241000,23328840000,62379142000
Connecticut,Health Care and Social Assistance,2015,38042,15305,8257,5672,29234,5061,2455,36750,1292,53860,15365,8385,6170,29920,7155,7025,44100,9760,1389821,30858,55120,75941,162174,191581,354200,708593,678535,66587190000,1483298000,2454904000,3608483000,7553406000,8351808000,13283807000,29226744000,37200355000
Connecticut,Information,2015,5174,2269,675,550,3494,605,277,4376,798,8770,2270,675,555,3500,660,370,4530,4240,203081,3457,4355,6687,15014,18834,18508,55104,137057,18012695000,251487000,267827000,370500000,920550000,1246156000,1291362000,3586572000,12888405000
Connecticut,Management of Companies and Enterprises,2015,2465,190,45,125,360,300,594,1254,1211,3510,190,45,125,360,305,665,1330,2180,166635,283,265,785,1340,3920,18860,24120,142472,22944820000,89860000,43147000,87725000,221930000,296675000,1529573000,2048178000,20892548000
Connecticut,Manufacturing,2015,20023,7185,3645,2900,13730,3918,1162,18810,1213,20675,7185,3645,2905,13735,4030,1295,19060,1615,689179,13457,22085,36381,75974,146120,114454,366437,290385,49171254000,632947000,1025516000,1835822000,3739950000,8527041000,7002785000,21101738000,25848908000
Connecticut,"Mining, Quarrying, and Oil and Gas Extraction",2015,268,110,50,40,200,30,0,230,38,385,110,50,40,200,45,0,245,140,4484,144,253,390,953,561,0,1718,1854,334807000,6628000,17804000,26365000,60375000,54431000,0,140270000,137650000
Connecticut,Other,2015,199,195,2,1,198,1,0,199,0,199,195,2,1,198,1,0,199,0,248,185,0,0,214,0,0,248,0,6114000,5688000,0,0,5959000,0,0,6114000,0
Connecticut,Other Services (except Public Administration),2015,44477,27465,9565,4337,41367,2335,302,44004,473,47360,27505,9625,4445,41575,2760,605,44940,2420,295171,50679,62527,56526,170066,75015,12949,262545,25065,9742933000,1520588000,1816014000,1765944000,5118532000,2459818000,703806000,8535368000,902792000
Connecticut,"Professional, Scientific, and Technical Services",2015,43043,28405,6145,3565,38115,2516,794,41425,1618,46430,28415,6165,3605,38185,2835,1045,42065,4365,540085,44907,39979,45582,131000,81399,56264,273315,260954,46751895000,2901203000,2584036000,3370944000,8895325000,7466400000,4958355000,21767750000,24652982000
Connecticut,Real Estate and Rental and Leasing,2015,12215,8645,1665,630,10940,588,233,11761,454,16040,8665,1710,700,11075,755,1075,12905,3135,98657,13679,10433,7330,31794,16872,11690,62721,32662,5311378000,690283000,532327000,406237000,1648691000,1018667000,578997000,3439865000,1638923000
Connecticut,Retail Trade,2015,43004,24045,8416,4151,36612,3324,941,40877,2127,62620,24120,8585,4415,37120,4180,2680,43980,18640,922313,44423,54645,52973,152392,118187,68014,344192,558058,27379003000,1386912000,1644196000,1745046000,4787434000,5187245000,2964289000,13108919000,13744062000
Connecticut,Total,2015,71835,40481,12515,7780,60776,6997,1861,69634,2201,89232,40540,12637,8077,61254,8356,4621,74231,15001,1503102,68006,82063,103532,253601,255092,227095,735788,767314,92555072000,3407131000,3569320000,4924332000,11900783000,13308945000,12600548000,37810276000,54744796000
Connecticut,Transportation and Warehousing,2015,6958,3325,975,755,5055,792,352,6199,759,8540,3330,975,775,5080,845,510,6435,2105,204214,4675,6180,9548,21240,25640,23443,76912,100074,9282470000,304820000,351453000,448380000,1158369000,1565538000,782695000,3912360000,3976182000
Connecticut,Utilities,2015,329,80,25,50,155,33,30,218,111,695,85,25,60,170,40,55,265,430,36653,112,98,562,930,591,12,2988,21790,4346556000,11614000,7230000,56668000,106710000,148996000,1286000,455635000,2564928000
Connecticut,Wholesale Trade,2015,18645,8410,2875,1939,13224,2463,1109,16796,1849,21305,8425,2880,1990,13295,2650,1455,17400,3905,364968,14654,18152,24813,58446,75941,62680,205153,152162,28618197000,1047809000,1238442000,1797642000,4141055000,5685922000,4834326000,15338962000,12578677000
Delaware,Accommodation and Food Services,2015,8747,3355,1395,1535,6285,1859,208,8352,395,10430,3360,1395,1540,6295,1975,800,9070,1360,193602,4940,9578,20927,35564,69285,25256,132280,61243,3482154000,233249000,162216000,330254000,730490000,1217635000,368127000,2374887000,1106224000
Delaware,Administrative and Support and Waste Management and Remediation Services,2015,6514,3550,1020,560,5130,580,175,5885,629,7310,3550,1020,560,5130,590,190,5910,1400,140812,5120,6382,6768,19011,18722,14218,56187,83750,4731122000,255558000,225973000,292746000,808346000,679849000,444577000,2157259000,2530716000
Delaware,"Agriculture, Forestry, Fishing and Hunting",2015,190,120,45,20,185,0,0,185,5,190,120,45,20,185,0,0,185,5,590,87,214,86,555,0,0,555,0,21072000,3319000,5350000,4090000,19842000,0,0,19842000,0
Delaware,"Arts, Entertainment, and Recreation",2015,2032,1195,245,215,1655,245,55,1955,77,2155,1195,245,215,1655,275,60,1990,165,38672,1315,1536,2417,5935,8857,4322,23715,11387,1228798000,69899000,32510000,61533000,188193000,195141000,180350000,904360000,271606000
Delaware,Construction,2015,10908,7005,1670,1070,9745,840,198,10783,125,10970,7005,1670,1070,9745,850,205,10800,170,96744,11093,10886,13769,36134,32930,17175,89123,5536,5305399000,465113000,466119000,693859000,1642986000,1888345000,1109393000,4791163000,363076000
Delaware,Educational Services,2015,1505,690,245,195,1130,215,80,1425,80,1555,690,245,195,1130,230,80,1440,115,33647,1027,1588,2680,5398,9039,8554,23684,9440,1255156000,39371000,39975000,51943000,134586000,269366000,325727000,759522000,478092000
Delaware,Finance and Insurance,2015,6084,3335,633,305,4273,356,291,4920,1164,9965,3365,665,370,4400,500,535,5435,4530,212913,4892,3756,3004,12174,8614,6321,30393,181748,18961226000,308745000,241537000,223918000,818597000,589863000,401945000,2035168000,16868069000
Delaware,Health Care and Social Assistance,2015,9676,3475,2024,1831,7330,1295,406,9031,645,13220,3485,2055,1910,7450,1725,1090,10265,2955,329793,6343,13233,24561,44526,44814,44622,139191,187384,16816930000,339825000,637377000,1176458000,2168685000,2196849000,1724572000,6273775000,10377660000
Delaware,Information,2015,1731,900,190,108,1198,180,55,1433,298,2615,900,190,110,1200,195,85,1480,1135,33260,987,1106,959,3447,3880,2267,12689,19228,2099507000,119205000,71433000,79812000,288550000,259900000,191854000,993038000,1048601000
Delaware,Management of Companies and Enterprises,2015,3166,1216,40,60,1316,296,382,1994,1172,3990,1255,40,70,1365,335,420,2120,1870,61685,1365,144,384,1893,1905,2930,6740,54939,6357140000,54720000,22137000,6901000,83758000,139015000,225405000,448700000,5908209000
Delaware,Manufacturing,2015,2822,1090,470,355,1915,410,185,2510,312,2915,1090,475,360,1925,440,185,2550,365,110264,1479,2181,3622,8592,9127,8411,35804,64936,5939703000,86859000,86690000,167288000,401765000,447106000,413385000,1781111000,3413163000
Delaware,"Mining, Quarrying, and Oil and Gas Extraction",2015,52,20,0,10,30,0,10,40,12,75,20,0,10,30,0,10,40,35,392,6,0,0,105,0,0,255,0,30693000,1128000,0,0,16107000,0,0,23574000,0
Delaware,Other,2015,50,48,0,2,50,0,0,50,0,50,48,0,2,50,0,0,50,0,64,42,0,0,64,0,0,64,0,1765000,1571000,0,0,1765000,0,0,1765000,0
Delaware,Other Services (except Public Administration),2015,10326,6125,2090,1007,9222,789,95,10106,220,10870,6130,2100,1065,9295,925,110,10330,540,73942,11113,13384,12919,37820,26087,2598,68926,3467,2201782000,339154000,369942000,328089000,1054445000,774841000,78393000,2027438000,119240000
Delaware,"Professional, Scientific, and Technical Services",2015,13389,8595,1660,1034,11289,956,350,12595,794,14260,8595,1670,1085,11350,1110,430,12890,1370,155618,11920,10487,12803,36020,28191,17888,84105,65081,15869451000,854570000,852613000,904251000,2674208000,2269910000,2084341000,7152913000,8273137000
Delaware,Real Estate and Rental and Leasing,2015,4977,3445,430,265,4140,296,133,4569,408,5945,3450,435,280,4165,400,380,4945,1000,29959,4631,2503,3412,10975,7260,4611,24675,4650,1513784000,219355000,120841000,162793000,532323000,351318000,217480000,1207370000,268874000
Delaware,Retail Trade,2015,12516,6510,2134,1090,9734,866,373,10973,1543,18280,6535,2175,1180,9890,1230,795,11915,6365,269308,11427,13644,13245,39422,26779,19293,91010,174924,7200092000,356826000,347614000,389392000,1121969000,1057975000,1014255000,3341982000,3754949000
Delaware,Total,2015,20048,11045,3013,2051,16109,1960,614,18683,1365,24852,11076,3054,2142,16272,2361,1180,19813,5039,397385,17005,19804,27260,64069,67805,48305,180179,217206,21305227000,845191000,817832000,1111755000,2774778000,2896490000,2435148000,8106416000,13198811000
Delaware,Transportation and Warehousing,2015,3187,1745,378,245,2368,377,115,2860,327,3420,1745,380,245,2370,400,125,2895,525,70199,2360,2039,2659,7769,9837,3175,25667,35801,2988119000,107666000,54769000,76013000,263045000,389472000,166327000,1038235000,1543052000
Delaware,Utilities,2015,142,55,15,0,70,5,22,97,45,260,55,25,0,80,5,30,115,145,7803,37,34,0,119,0,884,1938,5488,795908000,2128000,4804000,0,11726000,0,73892000,162678000,605089000
Delaware,Wholesale Trade,2015,5029,2590,435,400,3425,549,305,4279,750,5585,2595,440,415,3450,620,370,4440,1145,61437,3775,2189,4175,11862,11931,5008,34956,25381,4347424000,248378000,138142000,220315000,708874000,676705000,259980000,1961097000,2299239000
District of Columbia,Accommodation and Food Services,2015,9654,3090,1650,1435,6175,2618,376,9169,485,12520,3095,1660,1440,6195,2740,675,9610,2910,344336,5430,11275,19316,36220,104989,46340,188135,155962,9550385000,233570000,230715000,410334000,880160000,2486695000,1290082000,4681230000,4863572000
District of Columbia,Administrative and Support and Waste Management and Remediation Services,2015,3889,1465,460,300,2225,603,421,3249,640,5570,1470,465,300,2235,630,490,3355,2215,160283,2283,2776,3671,9297,21497,39408,72203,87449,6814694000,190619000,182225000,246413000,654551000,850489000,1536841000,3157634000,3607345000
District of Columbia,"Agriculture, Forestry, Fishing and Hunting",2015,5,5,0,0,5,0,0,5,0,5,5,0,0,5,0,0,5,0,0,0,0,0,0,0,0,0,0,0,0,0,0,0,0,0,0,0
District of Columbia,"Arts, Entertainment, and Recreation",2015,1477,790,195,155,1140,168,75,1383,94,1710,790,195,155,1140,175,115,1430,280,33323,1130,1133,1968,4556,6004,9063,20321,9006,1707172000,70312000,55415000,92024000,233524000,181670000,272420000,736020000,509356000
District of Columbia,Construction,2015,2283,1100,330,310,1740,345,115,2200,83,2295,1100,330,310,1740,345,120,2205,90,45832,1655,2073,3774,7975,12543,12629,36800,3055,3148789000,162881000,124670000,232989000,557736000,762610000,901399000,2434132000,270361000
District of Columbia,Educational Services,2015,2705,970,375,270,1615,573,330,2518,187,2900,970,375,275,1620,580,415,2615,285,266231,1536,2493,3327,7551,25029,40276,74131,191680,13170011000,98196000,137203000,134950000,378166000,1257874000,2110538000,3790886000,9364175000
District of Columbia,Finance and Insurance,2015,2842,870,333,205,1408,330,219,1957,885,4870,875,335,220,1430,405,420,2255,2615,80806,1464,1937,2472,6308,7466,3988,19100,50349,14389932000,154197000,188654000,386557000,775790000,1022920000,404897000,2393974000,10212410000
District of Columbia,Health Care and Social Assistance,2015,8838,4090,1690,995,6775,1029,587,8391,447,10530,4090,1690,1140,6920,1275,1095,9290,1240,330325,7187,10923,12364,31111,34576,75227,143445,177510,19708431000,473139000,613730000,686288000,1796571000,1515398000,2988366000,6447537000,12719037000
District of Columbia,Information,2015,2713,965,350,185,1500,300,209,2009,704,3745,965,350,185,1500,305,225,2030,1715,118918,1339,2214,1811,5924,8347,15058,32869,81045,13079969000,139268000,184845000,144400000,516736000,779233000,1309838000,2948688000,9679929000
District of Columbia,Management of Companies and Enterprises,2015,816,40,15,20,75,45,145,265,551,1060,40,15,20,75,50,150,275,785,73670,64,80,240,384,734,5565,6725,66945,4846780000,7290000,7520000,36325000,51135000,79362000,318535000,452310000,4394470000
District of Columbia,Manufacturing,2015,495,260,90,55,405,45,5,455,40,505,260,90,55,405,45,5,455,50,4029,416,385,253,1355,505,0,2854,466,189380000,19310000,19774000,12043000,57980000,23703000,0,123371000,36120000
District of Columbia,"Mining, Quarrying, and Oil and Gas Extraction",2015,25,10,0,0,10,0,0,10,15,25,10,0,0,10,0,0,10,15,30,0,0,0,0,0,0,0,0,2782000,0,0,0,0,0,0,0,0
District of Columbia,Other,2015,96,95,1,0,96,0,0,96,0,96,95,1,0,96,0,0,96,0,77,71,0,0,77,0,0,77,0,1846000,1727000,0,0,1846000,0,0,1846000,0
District of Columbia,Other Services (except Public Administration),2015,18418,8063,3375,2575,14013,2843,1195,18051,367,20765,8065,3385,2625,14075,2980,1460,18515,2250,374697,15549,22213,33162,71309,99062,126473,298108,73880,29534298000,1039251000,1400255000,2358079000,4809811000,8144498000,11187992000,24179954000,5104790000
District of Columbia,"Professional, Scientific, and Technical Services",2015,23157,12345,2892,2183,17420,2430,1304,21154,2003,27660,12345,2895,2185,17425,2470,1365,21260,6400,501965,18764,18963,27163,65167,75779,87431,230157,270299,62285161000,2544791000,2055940000,3120925000,7742203000,8601541000,9736791000,26184361000,35940683000
District of Columbia,Real Estate and Rental and Leasing,2015,3965,2295,475,268,3038,352,248,3638,327,6210,2315,490,275,3080,460,595,4135,2075,54886,3443,3125,3015,9654,9719,9938,29702,25031,3803411000,253283000,188594000,251590000,697203000,710361000,768936000,2206617000,1588126000
District of Columbia,Retail Trade,2015,7065,3895,1085,568,5548,427,220,6195,870,8755,3905,1100,580,5585,525,325,6435,2320,105957,7497,6557,6538,21763,8900,2379,35871,68306,3019931000,249757000,199728000,191553000,673721000,309821000,58718000,1130818000,1848796000
District of Columbia,Total,2015,17832,8360,2727,1934,13021,2413,1044,16478,1354,22553,8370,2742,1994,13106,2639,1521,17266,5287,513002,14093,18074,25138,57305,85952,99864,243121,269881,38445917000,1172399000,1160718000,1738605000,4071722000,5520587000,6951310000,16543619000,21902298000
District of Columbia,Transportation and Warehousing,2015,765,325,75,70,470,65,45,580,185,820,325,75,70,470,65,45,580,240,11701,480,252,388,1589,1042,754,4812,4196,805384000,38931000,8979000,20711000,100965000,51020000,61607000,288513000,311544000
District of Columbia,Utilities,2015,166,30,0,5,35,0,0,35,131,245,30,0,5,35,0,0,35,210,9779,22,0,0,34,0,0,34,9743,1303328000,1497000,0,0,2369000,0,0,2369000,1300856000
District of Columbia,Wholesale Trade,2015,1718,720,250,120,1090,127,100,1317,401,2095,720,255,130,1105,145,105,1355,740,20602,1070,1088,856,3813,2140,2066,9312,8413,1836460000,69104000,57667000,46214000,218892000,116597000,247490000,725599000,826905000
Florida,Accommodation and Food Services,2015,148475,60225,26425,26165,112815,30036,3420,146271,2204,196620,60315,26475,26430,113220,32515,10400,156135,40485,4527558,96805,176570,356712,630125,1150155,566688,2347545,2179233,87952181000,3064734000,2727404000,5676788000,11470020000,19938140000,10704141000,42125985000,45815159000
Florida,Administrative and Support and Waste Management and Remediation Services,2015,154561,109635,18655,10155,138445,9510,3035,150990,3571,175020,109680,18695,10230,138605,10335,4335,153275,21745,7546460,164677,121528,137185,423570,361676,447676,1235123,6308096,310765750000,7581101000,3844744000,4622644000,16057337000,12090589000,14240941000,42515075000,268127450000
Florida,"Agriculture, Forestry, Fishing and Hunting",2015,4987,3425,700,455,4580,290,76,4946,41,5090,3425,700,455,4580,330,120,5030,60,46335,5300,4588,5740,15745,9301,9692,35765,9996,1458312000,176850000,170858000,203720000,556237000,328203000,188701000,1131742000,273504000
Florida,"Arts, Entertainment, and Recreation",2015,38543,25350,4090,3090,32530,4052,1267,37849,694,41350,25355,4110,3115,32580,4235,1805,38620,2730,963169,33994,26291,41184,101619,173861,205818,485009,468956,29115237000,1770137000,642909000,961235000,3379947000,4336756000,6416452000,14498697000,14278589000
Florida,Construction,2015,240816,169760,32935,19597,222292,15312,2172,239776,1040,243655,169760,32950,19630,222340,15550,2965,240855,2800,1818900,247300,216030,262550,725880,568680,307266,1603610,214057,83629595000,8683485000,7582840000,10649945000,26916270000,26505145000,16181106000,69671365000,13872714000
Florida,Educational Services,2015,30652,17530,3800,3300,24630,4292,1052,29974,678,33470,17550,3810,3360,24720,4835,1495,31050,2420,853350,25440,25435,44923,95840,173995,144146,414505,435456,30647220000,915890000,602605000,1023948000,2544975000,5172278000,5127658000,12867445000,17567450000
Florida,Finance and Insurance,2015,90027,64955,11688,4502,81145,3697,1962,86804,3223,156395,65035,11895,4960,81890,6435,7325,95650,60745,1722828,102002,75272,57450,234940,127588,174005,538505,1183905,132687389000,5159205000,3901243000,3655612000,12729035000,10146563000,13506934000,36588615000,95997236000
Florida,Health Care and Social Assistance,2015,236951,134333,50062,26942,211337,17461,4970,233768,3183,295260,134475,50365,27915,212755,23430,15495,251680,43580,5246520,223327,329570,354972,907907,645418,754894,2311237,2933667,253451315000,12459342000,14457540000,15543127000,42461787000,30126623000,30643574000,103366758000,150007276000
Florida,Information,2015,25078,16832,2615,1615,21062,1679,771,23512,1566,41435,16915,2665,1625,21205,1950,1160,24315,17120,828940,22834,16735,21064,61285,56883,68368,188430,638636,61182055000,1223450000,779416000,1106297000,3138820000,3308913000,4870189000,11421090000,49589327000
Florida,Management of Companies and Enterprises,2015,8188,1215,271,260,1746,1310,1932,4988,3200,13875,1215,280,260,1755,1325,2010,5090,8785,725495,1470,1395,2160,5025,19490,69855,94370,631125,62412000000,256875000,89525000,180960000,527360000,1279455000,5581960000,7388775000,55023225000
Florida,Manufacturing,2015,62442,32335,9810,7327,49472,7671,2549,59692,2750,65560,32335,9810,7345,49490,7915,2985,60390,5170,1474195,54910,62943,95736,218510,285304,249096,796722,626084,79148666000,2103221000,2220758000,3744071000,8254466000,12301279000,11770425000,34408672000,41815440000
Florida,"Mining, Quarrying, and Oil and Gas Extraction",2015,1067,575,110,100,785,141,25,951,116,1255,575,110,100,785,205,25,1015,240,18255,780,557,1212,2743,4239,374,8199,8892,1197907000,43165000,30797000,61962000,146660000,248746000,19672000,470762000,643270000
Florida,Other,2015,742,715,22,2,739,3,0,742,0,742,715,22,2,739,3,0,742,0,941,677,133,0,837,104,0,941,0,22510000,19972000,1707000,0,22025000,485000,0,22510000,0
Florida,Other Services (except Public Administration),2015,215358,151085,33907,16301,201293,11298,1607,214198,1160,232750,151195,34005,16610,201810,13455,4510,219775,12975,1577120,248576,220172,215979,684905,402020,173400,1262790,310935,44636910000,6542199000,5762473000,5753398000,18062625000,10862518000,5190540000,34195410000,10336614000
Florida,"Professional, Scientific, and Technical Services",2015,358377,282351,36862,18469,337682,13450,3631,354763,3614,382080,282425,36980,18905,338310,16235,6315,360860,21220,2439385,388295,239065,239318,866870,449262,315500,1633070,796624,161879495000,21664835000,12737220000,14058763000,48469820000,29849311000,22817531000,101236400000,60324688000
Florida,Real Estate and Rental and Leasing,2015,143033,120771,11469,4564,136804,3348,1424,141576,1457,171205,120935,11770,4985,137690,4610,5900,148200,23005,815665,151520,73625,59634,284805,109461,99198,494895,320633,36008015000,6172950000,2865430000,2531088000,11569850000,4925892000,4873271000,21437110000,14558982000
Florida,Retail Trade,2015,240222,162256,38958,19926,221140,12248,3247,236635,3587,372665,162615,39685,21615,223915,18825,9535,252275,120390,5352665,281265,254210,259764,795270,440427,344662,1582845,3651352,145827555000,7672377000,6693915000,7132040000,21498697000,15808038000,16290889000,53668892000,89442452000
Florida,Total,2015,435582,298378,61515,35401,395294,29066,6561,430921,4661,532830,298690,62001,36589,397280,35562,17040,449882,82948,7777990,451465,402356,470611,1324432,1085348,871020,3280800,4497190,337074525000,18971008000,14525431000,17271594000,50768033000,41970145000,38341857000,131080035000,205994490000
Florida,Transportation and Warehousing,2015,64024,45759,6539,3898,56196,3691,1466,61353,2671,72880,45830,6570,3980,56380,4020,2040,62440,10440,1190856,62253,42321,50188,155323,121626,92423,375206,808714,59005884000,2447762000,1514502000,1995137000,5974007000,5105754000,4227875000,15558878000,43202657000
Florida,Utilities,2015,1543,800,305,82,1187,126,107,1420,123,3770,800,305,95,1200,200,360,1760,2010,134451,1394,1992,908,4486,5423,18206,29882,103531,12828039000,45513000,81480000,45645000,181759000,329149000,1347382000,1981104000,10797455000
Florida,Wholesale Trade,2015,136380,89372,18603,10930,118905,9590,3631,132126,4254,156105,89440,18715,11320,119475,11390,6420,137285,18820,1569325,141445,120432,140229,402440,305895,243064,955105,608500,89383575000,6750060000,5816083000,7173058000,19753825000,16487060000,13919824000,50375895000,38746526000
Georgia,Accommodation and Food Services,2015,71555,25145,12795,13857,51797,16530,1775,70102,1453,98520,25210,12825,13980,52015,18290,7200,77505,21015,2019365,41120,85820,189855,316870,607087,280771,1205585,813672,32521670000,1209775000,1243710000,2737502000,5191620000,9228734000,4128681000,18568155000,13951539000
Georgia,Administrative and Support and Waste Management and Remediation Services,2015,51500,31930,6425,4235,42590,4508,1878,48976,2524,61620,31970,6440,4270,42680,4720,2485,49885,11735,1885935,48471,42865,56403,147882,171020,232192,553342,1330981,65918921000,2011369000,1502644000,2028339000,5550545000,6478989000,7900311000,20025406000,45835901000
Georgia,"Agriculture, Forestry, Fishing and Hunting",2015,4660,2430,1115,565,4110,431,55,4596,64,4760,2430,1115,565,4110,440,65,4615,145,37647,4147,7203,7199,18887,12486,3289,35182,2373,1553225000,160450000,280398000,271355000,720730000,542270000,110265000,1389280000,156341000
Georgia,"Arts, Entertainment, and Recreation",2015,14105,8965,1735,1370,12070,1404,319,13793,312,15290,8975,1745,1375,12095,1505,500,14100,1190,233325,11888,11196,17982,41293,54913,40417,140700,82468,7725611000,598420000,282377000,374343000,1265430000,1050722000,1099036000,3605716000,3873531000
Georgia,Construction,2015,83767,55000,12595,7854,75449,6394,1105,82948,819,84790,55000,12595,7860,75455,6480,1310,83245,1545,823835,83280,83550,105534,272420,240195,126221,641145,174841,43465530000,3415305000,3425250000,4742512000,11585205000,12751535000,7021222000,31515075000,11467361000
Georgia,Educational Services,2015,13700,7445,1880,1370,10695,2000,626,13321,379,15205,7450,1880,1375,10705,2440,725,13870,1335,418565,10429,12720,17816,41217,80372,95648,218420,199429,16791980000,357037000,264056000,347648000,979759000,2321541000,3502517000,6862900000,9885042000
Georgia,Finance and Insurance,2015,39880,26298,5543,1967,33808,2263,1195,37266,2614,73885,26355,5700,2325,34380,5100,4575,44055,29830,859892,44382,34343,24510,103527,77476,83758,266518,590259,70707119000,2092188000,1824805000,1657570000,5593854000,5396905000,5922148000,17091549000,53358120000
Georgia,Health Care and Social Assistance,2015,93138,46120,20217,12603,78940,9922,2081,90943,2195,121035,46140,20335,13055,79530,13010,6795,99335,21700,2389332,77205,135045,168000,380250,373205,301175,1056369,1329299,112969198000,4574856000,5653705000,7170465000,17399026000,15424155000,11563443000,44516983000,68205975000
Georgia,Information,2015,11895,6385,1410,855,8650,1205,568,10423,1472,20445,6430,1420,855,8705,1360,810,10875,9570,594311,9034,9190,11259,29826,42131,46466,122046,468661,52088146000,508465000,490487000,631982000,1648786000,2942252000,3705091000,8442956000,43327395000
Georgia,Management of Companies and Enterprises,2015,5214,395,145,101,641,695,1322,2658,2556,8665,395,145,105,645,700,1365,2710,5955,620845,455,756,743,1949,8035,40165,50165,570658,65650995000,72175000,96167000,53750000,221797000,539390000,3285095000,4052195000,61593900000
Georgia,Manufacturing,2015,33865,12430,5185,4372,21987,5559,2578,30124,3741,37160,12445,5185,4395,22025,5815,2990,30830,6330,1778141,21651,32312,55854,114668,208300,249601,616180,1088963,87175382000,896550000,1147158000,2134977000,4380547000,9109616000,11294387000,26949206000,56201859000
Georgia,"Mining, Quarrying, and Oil and Gas Extraction",2015,661,225,125,75,425,95,49,569,92,995,225,125,75,425,100,85,610,385,26129,364,773,839,2117,2922,5457,11721,11852,1594452000,15976000,24766000,37477000,84217000,207018000,372552000,739344000,724180000
Georgia,Other,2015,482,462,16,3,481,1,0,482,0,482,462,16,3,481,1,0,482,0,576,406,96,0,543,0,0,576,0,13807000,10719000,1525000,0,12940000,0,0,13807000,0
Georgia,Other Services (except Public Administration),2015,97513,63025,18265,8282,89572,5993,1053,96618,895,104970,63070,18385,8540,89995,7245,2270,99510,5460,783025,112720,118992,110078,341997,217493,95998,657720,117601,22616810000,2986385000,3052415000,3082241000,9128844000,5728615000,3281502000,18209970000,4215620000
Georgia,"Professional, Scientific, and Technical Services",2015,136345,102001,14450,7888,124339,6677,2272,133288,3057,146080,102030,14475,8025,124530,7455,2910,134895,11185,1261755,137250,93848,103647,335065,218046,178868,734315,526559,92936860000,7865910000,5191809000,6206549000,19281145000,15297371000,13231891000,47979055000,44862436000
Georgia,Real Estate and Rental and Leasing,2015,43349,34467,3499,1611,39577,1735,848,42160,1189,56295,34540,3560,1735,39835,2495,3410,45740,10555,297262,43393,22320,20327,86223,51826,49731,189873,99163,16840092000,1980330000,901150000,991949000,3877200000,2536472000,2650587000,9240710000,5916989000
Georgia,Retail Trade,2015,106446,67778,18874,8784,95436,6377,1587,103400,3046,170205,67920,19190,9620,96730,9395,4750,110875,59330,2231195,123445,121875,112904,358300,222447,122490,705585,1470966,57511512000,3129075000,2961655000,3114938000,9207790000,8206573000,5083127000,22560935000,33689120000
Georgia,Total,2015,174802,107193,27046,16578,150817,15637,4164,170618,4184,224593,107338,27274,17172,151784,19197,9812,180793,43800,3692490,167973,177766,220626,566365,572444,458128,1596937,2095553,174839354000,7057231000,6386401000,8124869000,21568501000,22414490000,20709219000,64692210000,110147144000
Georgia,Transportation and Warehousing,2015,26910,15900,2970,1865,20735,2302,1356,24393,2517,32985,15910,2980,1905,20795,2515,1800,25110,7875,882464,22368,19066,24066,66132,68060,73163,211940,666159,42461396000,886626000,717224000,927725000,2554531000,2702799000,3072526000,8515485000,33691174000
Georgia,Utilities,2015,677,210,60,30,300,150,127,577,100,3010,210,60,30,300,225,460,985,2025,114064,343,342,298,1173,7127,22559,33245,2779,10284537000,14190000,10782000,17401000,55898000,452916000,1759150000,2440185000,265686000
Georgia,Wholesale Trade,2015,54538,27620,8079,5561,41260,5915,3138,50313,4225,64640,27675,8130,5755,41560,6690,4555,52805,11835,1023345,45285,52911,69084,167870,180058,167304,519540,499549,65049495000,2398520000,2713647000,3819543000,8955050000,10274257000,10471339000,29940280000,34894533000
Hawaii,Accommodation and Food Services,2015,14359,4795,2918,2650,10363,3155,428,13946,413,18135,4795,2920,2665,10380,3595,1325,15300,2835,523715,8134,19162,35925,63357,127830,75328,267530,253956,14917150000,240686000,310573000,606502000,1160436000,2578407000,1922419000,5686950000,9187010000
Hawaii,Administrative and Support and Waste Management and Remediation Services,2015,8019,4230,1185,830,6245,900,317,7462,557,9225,4235,1190,840,6265,1000,595,7860,1365,300563,7050,7442,10457,25735,34738,40844,106166,190999,9798842000,221289000,211474000,330846000,796114000,1145924000,1014377000,3154618000,6498754000
Hawaii,"Agriculture, Forestry, Fishing and Hunting",2015,165,135,5,5,145,20,0,165,0,165,135,5,5,145,20,0,165,0,671,137,0,0,186,196,0,671,0,17948000,4886000,0,0,5589000,5082000,0,17948000,0
Hawaii,"Arts, Entertainment, and Recreation",2015,2368,1165,270,285,1720,415,154,2289,79,2545,1180,270,285,1735,440,235,2410,135,55405,1603,1569,3621,7258,16216,18974,45045,4978,1374093000,71747000,31482000,84980000,198283000,370814000,514107000,1144227000,113541000
Hawaii,Construction,2015,13680,7835,2510,1615,11960,1295,243,13498,182,13865,7835,2510,1620,11965,1350,290,13605,260,147590,12680,16078,20873,50155,42582,26594,125393,18197,10387035000,616549000,808681000,1206342000,2663197000,2938740000,2342605000,8421896000,1666212000
Hawaii,Educational Services,2015,2373,1015,405,295,1715,440,110,2265,108,2575,1015,410,295,1720,515,170,2405,170,84158,1471,2678,3513,8293,16903,18697,44603,38862,3029928000,42976000,48544000,71125000,185363000,492407000,698880000,1399068000,1621720000
Hawaii,Finance and Insurance,2015,4001,2181,445,205,2831,260,196,3287,714,7185,2185,450,245,2880,545,705,4130,3055,94672,4035,2713,2538,9590,8109,14320,34510,56244,6165057000,197940000,153733000,147604000,519410000,423707000,952099000,2070314000,3835534000
Hawaii,Health Care and Social Assistance,2015,14773,7910,3622,1359,12891,1056,474,14421,352,18255,7910,3695,1450,13055,1640,1455,16150,2105,341057,15224,23382,17398,56827,40280,66716,166963,162007,17845032000,920624000,1101601000,811960000,2858227000,1667298000,2529163000,7192709000,10019950000
Hawaii,Information,2015,1555,700,200,170,1070,125,55,1250,305,2490,700,200,175,1075,215,60,1350,1140,38803,908,1079,1661,4363,2867,402,9833,25898,2533531000,65371000,46938000,62328000,203307000,157831000,24569000,523201000,1967038000
Hawaii,Management of Companies and Enterprises,2015,964,30,20,60,110,205,256,571,393,1230,30,20,60,110,215,285,610,620,31290,20,40,220,295,2095,6609,9025,22265,2453275000,2115000,2399000,11226000,16565000,108215000,400086000,525920000,1927355000
Hawaii,Manufacturing,2015,3717,1740,760,465,2965,484,158,3607,110,3820,1740,760,465,2965,500,215,3680,140,56464,2917,4166,4966,13879,12293,8982,46571,3695,2247634000,88471000,115481000,163967000,438776000,401458000,361196000,1667170000,221102000
Hawaii,"Mining, Quarrying, and Oil and Gas Extraction",2015,45,5,15,5,25,0,15,40,5,45,5,15,5,25,0,15,40,5,649,0,20,0,35,0,132,649,0,53301000,0,1049000,0,2130000,0,11465000,53211000,0
Hawaii,Other,2015,43,39,4,0,43,0,0,43,0,43,39,4,0,43,0,0,43,0,61,38,23,0,61,0,0,61,0,1526000,1286000,240000,0,1526000,0,0,1526000,0
Hawaii,Other Services (except Public Administration),2015,15592,10215,2545,1300,14060,1073,204,15337,255,17455,10230,2550,1330,14110,1470,595,16175,1280,127274,18208,16441,16678,52075,36459,15601,110347,10991,3795888000,576967000,506584000,523042000,1630257000,1104885000,427504000,3349653000,312340000
Hawaii,"Professional, Scientific, and Technical Services",2015,14744,9890,1820,1192,12902,932,270,14104,640,16750,9890,1820,1240,12950,1065,370,14385,2365,113434,14538,11792,15111,41879,29667,9589,83903,26956,7237261000,852662000,644974000,887053000,2404071000,1997538000,677814000,5247907000,1889568000
Hawaii,Real Estate and Rental and Leasing,2015,7929,5691,935,494,7120,328,206,7654,275,9570,5740,940,510,7190,685,370,8245,1325,63640,9098,6012,5846,21290,10062,6526,39107,23853,3307635000,428822000,260593000,264695000,965702000,494565000,323816000,1854714000,1413787000
Hawaii,Retail Trade,2015,14116,6940,2835,1516,11291,1188,480,12959,1157,23010,6945,2945,1720,11610,2260,1960,15830,7180,358434,13371,18465,18658,51493,35473,39025,134523,211003,10370433000,362621000,452521000,473690000,1315272000,1019508000,1386349000,3996557000,5906057000
Hawaii,Total,2015,25110,13859,4462,2687,21008,2496,652,24156,954,31915,13888,4522,2829,21239,3455,1953,26647,5268,523677,23655,29272,35983,88910,95636,86794,271340,252337,22068393000,1018983000,1061689000,1301723000,3382395000,3522735000,3506238000,10411368000,11657025000
Hawaii,Transportation and Warehousing,2015,3593,1385,540,419,2344,573,272,3189,404,4425,1390,540,420,2350,690,450,3490,935,142864,2280,3313,4997,11481,18821,17095,53846,73424,6762415000,89580000,117095000,157905000,401582000,762802000,634168000,2031954000,3967573000
Hawaii,Utilities,2015,139,30,15,15,60,15,15,90,49,310,30,15,15,60,85,50,195,115,8141,40,44,80,331,290,678,1753,235,778299000,1728000,2488000,4438000,18067000,17978000,63888000,136675000,15344000
Hawaii,Wholesale Trade,2015,7158,3245,1285,748,5278,772,363,6413,745,8305,3255,1335,800,5390,985,620,6995,1310,94122,5598,7597,8527,23346,21543,15786,67284,22831,4781443000,256099000,319767000,352166000,1011027000,974494000,757588000,3073319000,1468989000
Idaho,Accommodation and Food Services,2015,14451,5210,2745,3111,11066,2575,379,14020,431,18025,5225,2765,3145,11135,3265,1240,15640,2385,295579,7630,18568,41767,68150,84912,43069,196990,97788,4431316000,195205000,235700000,538648000,974255000,1255324000,657914000,2905070000,1512152000
Idaho,Administrative and Support and Waste Management and Remediation Services,2015,10757,6760,1730,825,9315,667,215,10197,560,11480,6760,1745,835,9340,705,275,10320,1160,196887,9356,11287,10361,31544,20567,27580,84112,110057,5396081000,358710000,296365000,316521000,998857000,642354000,555011000,2362261000,2849093000
Idaho,"Agriculture, Forestry, Fishing and Hunting",2015,2215,1570,255,200,2025,140,30,2195,20,2215,1570,255,200,2025,140,30,2195,20,16642,2319,1593,2780,6824,5584,2828,16217,377,644869000,120393000,79261000,130346000,334018000,203402000,68654000,630144000,11416000
Idaho,"Arts, Entertainment, and Recreation",2015,3722,2345,550,340,3235,355,65,3655,67,3835,2345,550,345,3240,380,100,3720,115,44775,3190,3336,4483,11488,12193,6255,33574,5943,763653000,104249000,61282000,82177000,259486000,236599000,96578000,665659000,59917000
Idaho,Construction,2015,30773,21545,4930,2435,28910,1537,184,30631,142,30920,21545,4930,2435,28910,1595,210,30715,205,174515,33125,32260,31535,97135,51836,15247,168725,3286,7600705000,1218620000,1093837000,1222914000,3545260000,2523254000,906728000,7196755000,219801000
Idaho,Educational Services,2015,2308,1125,345,270,1740,390,70,2200,108,2445,1125,345,280,1750,395,120,2265,180,68100,1640,2150,3405,7414,14203,3223,25518,41778,1490123000,45377000,43193000,66790000,160107000,340768000,107142000,620616000,855056000
Idaho,Finance and Insurance,2015,7875,5245,850,265,6360,308,255,6923,952,14175,5250,870,305,6425,750,1190,8365,5810,105881,8891,5273,3220,17709,8402,13825,42163,62080,5861706000,344115000,196891000,149448000,703126000,456265000,715439000,2023220000,3738298000
Idaho,Health Care and Social Assistance,2015,21948,10985,4505,2919,18409,2194,690,21293,655,25385,10995,4530,3045,18570,2995,1565,23130,2255,445343,17721,30560,38346,87066,81582,78708,249575,192278,18330736000,964040000,1029995000,1405265000,3420859000,2800801000,2450675000,8761714000,9443345000
Idaho,Information,2015,2246,1045,225,215,1485,283,109,1877,369,3170,1045,230,235,1510,365,155,2030,1140,58924,1562,1273,2400,5727,8043,5509,20666,33764,2920443000,68295000,40336000,84436000,212132000,391371000,284921000,937840000,1830024000
Idaho,Management of Companies and Enterprises,2015,935,90,15,50,155,163,240,558,377,1195,90,15,50,155,175,250,580,615,41838,85,100,153,350,1729,5179,7258,34580,3138264000,7780000,7100000,10124000,25805000,76364000,380710000,482879000,2655385000
Idaho,Manufacturing,2015,8442,3530,1645,1025,6200,1285,465,7950,492,8770,3530,1650,1025,6205,1330,530,8065,705,256108,5678,9117,11443,29378,40808,29935,125173,95028,13037941000,185922000,281332000,397688000,975280000,1684955000,1293919000,4988700000,5350446000
Idaho,"Mining, Quarrying, and Oil and Gas Extraction",2015,531,240,80,55,375,62,40,477,54,565,240,80,55,375,65,45,485,80,13069,335,460,565,1580,1572,1876,6776,3941,1055768000,15468000,32700000,33707000,98416000,87265000,143500000,451958000,381238000
Idaho,Other,2015,82,78,4,0,82,0,0,82,0,82,78,4,0,82,0,0,82,0,112,81,31,0,112,0,0,112,0,1950000,1660000,290000,0,1950000,0,0,1950000,0
Idaho,Other Services (except Public Administration),2015,15962,10575,2910,1309,14794,762,125,15681,281,16950,10585,2920,1395,14900,1160,190,16250,700,97886,19172,19084,16475,55102,22931,7222,87006,6858,2542216000,489117000,496907000,437441000,1435413000,514070000,191578000,2187060000,233982000
Idaho,"Professional, Scientific, and Technical Services",2015,21179,15180,2515,1545,19240,894,296,20430,749,22755,15180,2530,1580,19290,1085,425,20800,1955,164955,22022,16548,19044,58156,24438,13097,99786,63377,8999314000,955425000,676350000,901075000,2559140000,1285924000,640468000,4650845000,4306065000
Idaho,Real Estate and Rental and Leasing,2015,10105,8280,823,385,9488,223,140,9851,254,11400,8300,855,420,9575,525,445,10545,855,35921,11087,4892,4574,20983,4743,3411,30220,5378,1223107000,388576000,147689000,153958000,706807000,165094000,88792000,1010309000,196944000
Idaho,Retail Trade,2015,20373,10200,4133,2446,16779,1736,530,19045,1328,30020,10215,4185,2760,17160,2625,2210,21995,8025,411992,17991,27399,31055,77182,53067,36101,172782,227753,11030019000,468182000,606529000,830102000,1923219000,1741239000,1341167000,5168454000,5411514000
Idaho,Total,2015,37507,22652,6089,3732,32473,2938,794,36205,1302,44757,22675,6138,3911,32724,3941,2062,38727,6030,546524,35396,40391,49215,125002,101942,77756,304700,241824,21119617000,1302657000,1194810000,1550919000,4048386000,3512525000,2797841000,10358752000,10760865000
Idaho,Transportation and Warehousing,2015,8225,5335,1110,585,7030,561,210,7801,424,8755,5335,1110,585,7030,600,275,7905,850,91567,8088,6963,7181,22782,17862,11345,56680,25551,3458122000,279450000,237293000,251096000,793775000,636107000,446619000,2049732000,1011197000
Idaho,Utilities,2015,586,350,60,45,455,60,10,525,61,995,350,60,45,455,95,30,580,415,16380,454,334,434,1362,2257,0,3799,11967,1491534000,8985000,11576000,17427000,46053000,161923000,0,222292000,1224737000
Idaho,Wholesale Trade,2015,8071,3284,1035,775,5094,1121,645,6860,1211,10320,3300,1045,815,5160,1455,1025,7640,2680,150737,5317,6279,8881,21953,30058,23957,79961,65448,9234804000,236305000,251163000,417122000,960211000,1372698000,1126675000,3648307000,5282296000
Illinois,Accommodation and Food Services,2015,107546,42426,20832,19580,82838,20809,2237,105884,1662,138655,42530,20875,19810,83215,23280,7775,114270,24385,2533735,71557,138855,265680,476200,770277,338586,1585620,947567,47833000000,1919811000,2009395000,4004133000,7939660000,13096923000,6475014000,27525935000,20290769000
Illinois,Administrative and Support and Waste Management and Remediation Services,2015,73671,47740,9115,5605,62460,6087,2318,70865,2806,85375,47760,9120,5645,62525,6515,2990,72030,13345,2592870,57561,58864,74432,190946,235607,323831,752274,1839009,86170955000,3541641000,2507382000,3173920000,9226276000,9898406000,12760634000,31996528000,54089930000
Illinois,"Agriculture, Forestry, Fishing and Hunting",2015,1530,1140,225,65,1430,40,30,1500,30,1670,1140,225,65,1430,55,75,1560,110,9880,1622,1223,703,3745,1064,938,6280,3573,437961000,54290000,42222000,39151000,142256000,37399000,38178000,239791000,196859000
Illinois,"Arts, Entertainment, and Recreation",2015,21865,12885,3015,2395,18295,2633,562,21490,375,23595,12895,3015,2435,18345,2800,870,22015,1580,395421,17413,19831,33160,70558,100126,80899,253311,126741,14141357000,758247000,470813000,647682000,1881047000,2425860000,5051487000,9425722000,3915047000
Illinois,Construction,2015,142474,104395,18540,10135,133070,7668,960,141698,776,143380,104395,18550,10145,133090,7810,1160,142060,1320,990760,145055,120290,134823,400345,286904,130166,819510,158359,70689395000,7218560000,6407845000,8623025000,22264675000,22747877000,11044497000,56216455000,13683736000
Illinois,Educational Services,2015,19574,9410,2840,2420,14670,3393,919,18982,592,21585,9410,2860,2470,14740,3685,1395,19820,1765,835479,13869,19072,32773,65804,142200,133145,341584,492783,33141798000,495658000,424567000,701964000,1624838000,4102280000,4771238000,10509353000,22615473000
Illinois,Finance and Insurance,2015,62687,41003,8537,3480,53020,4253,2195,59468,3219,108135,41040,8700,3985,53725,8020,8740,70485,37650,1666012,71355,54053,44566,170073,147449,195518,515693,1137350,166017638000,3940083000,3225013000,4080294000,11263883000,13150772000,19170103000,43881075000,120218771000
Illinois,Health Care and Social Assistance,2015,132838,68305,26883,16376,111564,13347,4945,129856,2982,169400,68510,27195,17340,113045,17755,14100,144900,24500,3979850,119525,179276,220860,519840,516089,731159,1768357,2208464,181865232000,6407435000,7831792000,10559642000,24806615000,21441701000,25020230000,71329724000,110399993000
Illinois,Information,2015,15891,8345,2005,1310,11660,1571,947,14178,1713,27195,8395,2025,1330,11750,1780,1315,14845,12350,615628,11741,12848,16660,41633,53928,80042,178049,435086,49613555000,938494000,699257000,924868000,2581480000,3645189000,6490393000,12867384000,36679381000
Illinois,Management of Companies and Enterprises,2015,7507,460,100,215,775,1276,1984,4035,3472,11730,465,100,215,780,1295,2095,4170,7560,1041290,570,384,1547,2505,14925,66210,83640,957650,120232120000,67940000,29984000,167500000,265530000,1405340000,5433305000,7104175000,113127945000
Illinois,Manufacturing,2015,63681,22675,10005,9132,41812,12596,4603,59011,4670,67350,22700,10020,9195,41915,13235,5175,60325,7025,2682018,40914,65631,121507,232281,503875,546763,1319070,1312374,156064464000,2099598000,2761529000,5550098000,10640518000,25872588000,29487079000,67910093000,85366171000
Illinois,"Mining, Quarrying, and Oil and Gas Extraction",2015,2367,1350,290,255,1895,217,94,2206,161,2730,1350,290,255,1895,275,215,2385,345,46921,2226,1854,3172,7297,6312,11611,27169,19588,3186738000,96980000,96887000,176573000,373500000,360575000,890437000,1778551000,1397677000
Illinois,Other,2015,525,506,16,3,525,0,0,525,0,525,506,16,3,525,0,0,525,0,576,435,102,39,576,0,0,576,0,12742000,11377000,1083000,282000,12742000,0,0,12742000,0
Illinois,Other Services (except Public Administration),2015,148457,92220,29548,14549,136317,9509,1595,147421,1036,160435,92300,29895,15275,137470,11850,3405,152725,7710,1248248,169973,192825,191607,554548,331148,163491,1052198,192012,43216511000,4672136000,5143200000,5728710000,15548541000,10414829000,7372801000,33475361000,9588645000
Illinois,"Professional, Scientific, and Technical Services",2015,184558,135147,20920,11849,167916,9878,3274,181068,3490,195660,135205,21040,12065,168310,11365,4285,183960,11700,2015245,180255,136885,155670,472810,335981,280771,1090775,923981,174120570000,12231380000,8150895000,10595720000,30977995000,26689167000,25207584000,82994145000,91106807000
Illinois,Real Estate and Rental and Leasing,2015,50645,37893,5400,2743,46036,2504,995,49535,1110,63405,37990,5500,3000,46490,3740,2445,52675,10730,382445,50040,34654,35118,119990,78681,58783,258810,118190,22096750000,2486625000,1611663000,1743041000,5854785000,4562422000,4013816000,14508875000,7404313000
Illinois,Retail Trade,2015,120727,71037,22414,11564,105015,9625,2764,117404,3323,195825,71275,22910,12580,106765,13670,9345,129780,66045,3134515,130435,146929,149954,427345,351165,234537,1019015,2053962,81291620000,3563025000,3781904000,4307881000,11654060000,12723643000,9217520000,33802775000,45465795000
Illinois,Total,2015,256016,157745,39533,24687,221965,23214,6145,251324,4692,318266,157974,39952,25710,223636,28803,15063,267502,50764,5427549,242072,259743,329518,831333,871792,765944,2469069,2958480,289183546000,11314870000,10237662000,14074143000,35626675000,40336251000,39940763000,115903689000,173279857000
Illinois,Transportation and Warehousing,2015,69649,51540,5934,3648,61122,4066,1762,66950,2699,77430,51540,5940,3690,61170,4425,2285,67880,9550,1211831,61017,38574,47293,147382,129526,113949,395639,800623,59044952000,2229476000,1592034000,2063867000,5908981000,6143325000,5422606000,17693732000,40583959000
Illinois,Utilities,2015,920,335,125,65,525,175,50,750,170,2455,335,130,75,540,260,75,875,1580,131058,552,760,763,2206,7090,2480,13424,102666,13901385000,25474000,34379000,70241000,142807000,525621000,215292000,993082000,11682384000
Illinois,Wholesale Trade,2015,77036,38043,11201,8675,57919,10075,4189,72183,4853,92695,38105,11290,8960,58355,12200,7570,78125,14570,1581485,61915,73050,111863,247130,333266,268939,853685,722742,119057560000,3678845000,4266849000,6931820000,14890760000,21701529000,17823063000,54683400000,64141550000
Indiana,Accommodation and Food Services,2015,46723,15501,9029,9459,33989,10175,1264,45428,1295,65615,15510,9050,9610,34170,11520,5190,50880,14735,1349495,25205,61414,130211,216855,376487,171786,766650,582686,20307960000,649355000,778298000,1715555000,3143705000,5250011000,2341166000,10764900000,9539322000
Indiana,Administrative and Support and Waste Management and Remediation Services,2015,31138,18310,4810,2800,25920,2753,892,29565,1573,36570,18345,4810,2845,26000,3070,1270,30340,6230,1034755,27946,31484,37142,96980,101947,105052,308382,724913,30632184000,1242125000,1008953000,1192656000,3460979000,3442790000,3294111000,10412308000,20149858000
Indiana,"Agriculture, Forestry, Fishing and Hunting",2015,1226,915,165,55,1135,35,31,1201,25,1320,915,165,55,1135,35,55,1225,95,7219,1269,871,506,2964,563,732,4849,948,319394000,47384000,29208000,22683000,110964000,25130000,37664000,198069000,48530000
Indiana,"Arts, Entertainment, and Recreation",2015,10040,5610,1517,1270,8397,1207,246,9850,190,10535,5610,1555,1280,8445,1345,325,10115,420,160299,7768,9790,17807,35658,47122,30472,116028,39714,4996095000,282647000,222386000,327228000,844488000,913880000,1386274000,3214291000,1368867000
Indiana,Construction,2015,64422,40825,11550,6300,58675,4514,717,63906,516,65175,40825,11555,6305,58685,4615,895,64195,980,586015,68555,75477,84354,228450,166269,87225,486540,91554,33012115000,2736340000,3098435000,3951928000,9790365000,9833981000,5729821000,25701735000,6836888000
Indiana,Educational Services,2015,7591,3425,1300,965,5690,1265,300,7255,336,8230,3425,1315,1030,5770,1380,425,7575,655,341308,5549,8551,12827,27096,52329,41350,122198,217848,9558673000,161121000,157560000,243558000,568591000,1338919000,1225900000,3213508000,6267588000
Indiana,Finance and Insurance,2015,24154,16163,2990,1168,20321,1303,823,22447,1707,47120,16185,3075,1405,20665,2955,4695,28315,18805,488960,29335,18786,14481,62972,42906,79577,187575,298144,33105648000,1259878000,915440000,798013000,3009804000,2277526000,4908975000,10389642000,22540742000
Indiana,Health Care and Social Assistance,2015,51680,22290,11590,7150,41030,6119,2551,49700,1980,81710,22330,11665,7505,41500,8610,7110,57220,24490,2093596,41552,77375,95095,214212,245805,387431,849540,1242149,90567006000,1878110000,3059742000,3995419000,8939721000,9524236000,13141258000,31741631000,58757313000
Indiana,Information,2015,5289,2410,641,535,3586,692,289,4567,722,10240,2410,650,590,3650,850,590,5090,5150,214200,3381,4139,6983,14942,22264,20136,60185,153426,12863434000,157880000,157361000,257199000,589244000,1013353000,988748000,2715765000,10102629000
Indiana,Management of Companies and Enterprises,2015,3162,110,80,65,255,560,987,1802,1360,4630,110,80,65,255,570,1090,1915,2715,256595,138,343,325,806,6285,30635,37735,218860,23311145000,13521000,26951000,42675000,83147000,381270000,1840695000,2307910000,21003235000
Indiana,Manufacturing,2015,36558,10309,5698,5504,21511,7660,3472,32643,3915,39955,10315,5710,5530,21555,8025,4045,33625,6330,2428582,19175,36993,71491,132037,303442,416105,896539,1453321,129622053000,1036160000,1294924000,2815075000,5385777000,13442847000,18590524000,39632144000,85205748000
Indiana,"Mining, Quarrying, and Oil and Gas Extraction",2015,857,280,120,135,535,112,57,704,153,1435,280,130,160,570,160,115,845,590,29957,471,765,1349,2733,2834,2030,9654,19350,1964666000,22891000,27330000,73986000,135708000,144184000,121559000,535845000,1356171000
Indiana,Other,2015,200,196,2,1,199,1,0,200,0,200,196,2,1,199,1,0,200,0,262,201,0,0,229,0,0,262,0,4668000,4304000,0,0,4565000,0,0,4668000,0
Indiana,Other Services (except Public Administration),2015,74627,44575,15685,7663,67923,5089,884,73896,731,81565,44635,15775,8065,68475,6670,2795,77940,3625,628529,86083,101576,100908,288929,174614,76259,541864,66232,16919021000,2056178000,2362679000,2517396000,6949246000,4578397000,2143625000,13746396000,2629923000
Indiana,"Professional, Scientific, and Technical Services",2015,59531,40350,8175,4875,53400,3524,1075,57999,1532,64640,40365,8200,4975,53540,4345,1515,59400,5240,559795,60765,52668,63316,176905,112332,67723,360840,190411,34848685000,2768065000,2261975000,3095227000,8132605000,6568214000,5350837000,20248955000,14143777000
Indiana,Real Estate and Rental and Leasing,2015,23032,16990,2573,1160,20723,1057,570,22350,682,31175,17010,2660,1235,20905,2265,2190,25360,5815,162989,24616,16764,14896,56500,30302,25820,114578,44190,6762771000,872707000,545974000,532918000,1958392000,1301711000,1134831000,4487712000,2144665000
Indiana,Retail Trade,2015,61708,32290,12576,7016,51882,5686,1554,59122,2586,107130,32365,12975,7820,53160,9055,6825,69040,38090,1589315,62466,82645,91449,236772,190708,132328,562607,1022925,39869185000,1502655000,1929158000,2471756000,5908005000,6476871000,4449045000,16915450000,22850509000
Indiana,Total,2015,108558,59427,19211,12323,90961,11346,3071,105378,3180,145116,59504,19421,12905,91830,14721,8785,115336,29780,2660503,101366,126592,165104,393062,422612,382679,1198353,1462150,113315432000,3783399000,4036247000,5579580000,13399226000,15689645000,15735438000,44824309000,68491123000
Indiana,Transportation and Warehousing,2015,23026,12460,3155,2235,17850,2343,936,21129,1897,26470,12465,3155,2280,17900,2530,1155,21585,4885,610647,18676,20777,29257,69405,76094,54062,204816,402109,26402833000,732928000,799188000,1202660000,2754498000,3286337000,2266026000,8524486000,17735688000
Indiana,Utilities,2015,955,330,175,105,610,185,35,830,125,2725,330,175,105,610,240,90,940,1785,77526,744,1042,1380,3248,7765,2384,14510,55845,6907497000,24423000,41872000,71315000,143026000,581307000,232319000,1036879000,5263700000
Indiana,Wholesale Trade,2015,30389,13090,4352,3465,20907,4398,2163,27468,2921,38340,13110,4395,3660,21165,5360,3550,30075,8265,646110,21291,28249,44573,94743,132331,100040,332125,306555,42188518000,1080680000,1335303000,2255256000,4699497000,7166007000,5288691000,17364643000,24404357000
Iowa,Accommodation and Food Services,2015,27800,9891,5440,5700,21031,5354,731,27116,684,34665,9900,5470,5770,21140,6270,2815,30225,4440,593665,16125,36525,78489,131270,189254,92272,413345,179922,8711990000,345865000,417626000,946511000,1712640000,2455954000,1338474000,5519105000,3186443000
Iowa,Administrative and Support and Waste Management and Remediation Services,2015,15923,9850,2300,1327,13477,1165,355,14997,926,18245,9860,2305,1355,13520,1310,495,15325,2920,356312,14157,14770,17453,46919,38457,42673,132586,217911,10715759000,555918000,495907000,580433000,1656796000,1200170000,1108159000,4122267000,6392848000
Iowa,"Agriculture, Forestry, Fishing and Hunting",2015,1515,1200,145,60,1405,40,55,1500,15,1755,1200,145,60,1405,50,205,1660,95,12864,1475,801,685,3155,923,3576,8874,0,663419000,68247000,34305000,38785000,148476000,28998000,196278000,431119000,0
Iowa,"Arts, Entertainment, and Recreation",2015,6977,4125,1145,770,6040,660,182,6882,95,7235,4125,1150,775,6050,715,265,7030,205,98956,5731,7570,10210,23919,23230,23941,73736,20234,1809068000,183179000,134062000,169113000,504197000,386009000,407863000,1391018000,309143000
Iowa,Construction,2015,42247,28440,6864,3595,38899,2659,395,41953,294,42710,28445,6870,3595,38910,2800,485,42195,515,320415,44355,44340,48015,136735,95400,43685,280310,38030,18520575000,1955600000,1940421000,2501925000,6401895000,5794634000,3200931000,15655810000,2726535000
Iowa,Educational Services,2015,3436,1445,555,495,2495,565,178,3238,198,3955,1445,555,510,2510,655,400,3565,390,185393,2415,3672,6470,12873,21617,24781,60779,118836,4614987000,55539000,66718000,90949000,224656000,470709000,654338000,1410485000,2750074000
Iowa,Finance and Insurance,2015,18106,11599,2332,1073,15004,1295,662,16961,1145,30600,11630,2395,1420,15445,3895,3290,22630,7970,465162,20475,14173,13262,48317,44509,65948,161942,297503,31749780000,828529000,633804000,697986000,2184118000,2321807000,4261474000,9023000000,22252816000
Iowa,Health Care and Social Assistance,2015,28870,12835,5055,3543,21433,4221,1929,27583,1287,42445,12865,5110,3780,21755,6240,6135,34130,8315,1097132,23168,33600,47457,104602,175063,274943,556747,539644,44473757000,1105699000,1400751000,2109404000,4639252000,5912139000,9465842000,20104430000,24336050000
Iowa,Information,2015,4305,1750,745,560,3055,485,180,3720,585,7365,1755,760,570,3085,775,435,4295,3070,151011,2996,4909,7209,15292,15404,12533,44730,102075,7916515000,124041000,157084000,263000000,550542000,675851000,598363000,1895762000,5636655000
Iowa,Management of Companies and Enterprises,2015,2020,75,30,105,210,391,656,1257,763,2525,75,30,105,210,395,695,1300,1225,120185,45,74,420,555,4945,20245,25745,94255,9334190000,4463000,3241000,15230000,23465000,288865000,1441815000,1754145000,7568734000
Iowa,Manufacturing,2015,15607,5025,2495,1990,9510,2886,1409,13805,1802,17625,5025,2495,2005,9525,3085,1855,14465,3160,991450,9009,14967,24050,50874,106046,134535,323703,582463,50138049000,318050000,517895000,905967000,1852083000,4814038000,6361811000,14513690000,30011038000
Iowa,"Mining, Quarrying, and Oil and Gas Extraction",2015,372,140,45,30,215,62,41,318,54,940,140,45,30,215,135,190,540,400,9732,181,212,253,824,2317,3178,6737,2907,584523000,9235000,8179000,11895000,37864000,137278000,176605000,375388000,201569000
Iowa,Other,2015,133,129,2,2,133,0,0,133,0,133,129,2,2,133,0,0,133,0,136,99,0,0,136,0,0,136,0,2572000,2050000,0,0,2572000,0,0,2572000,0
Iowa,Other Services (except Public Administration),2015,42539,28040,8555,3447,40042,1768,356,42166,373,45450,28110,8825,3815,40750,2475,925,44150,1300,263332,53607,54687,44280,152873,59354,21582,237792,18854,6826311000,1241004000,1251620000,1116490000,3620555000,1652580000,545525000,5931461000,685485000
Iowa,"Professional, Scientific, and Technical Services",2015,29002,18925,4575,2382,25882,1713,515,28110,892,31620,18925,4585,2455,25965,2275,870,29110,2510,275291,30006,29380,30735,90601,54450,27405,177884,92538,16095918000,1306948000,1237347000,1420807000,3983578000,3478922000,1711348000,9487765000,6248168000
Iowa,Real Estate and Rental and Leasing,2015,11649,9065,1020,472,10557,421,283,11261,388,14360,9135,1025,580,10740,755,905,12400,1960,64455,12412,6467,5703,25048,10225,11292,48889,14281,2552210000,426878000,208764000,186376000,844035000,433235000,560681000,1960097000,568319000
Iowa,Retail Trade,2015,36912,18060,7779,4906,30745,3489,930,35164,1748,58680,18120,7910,5355,31385,5670,3140,40195,18485,887182,33861,51192,62660,148086,112192,58754,322326,560840,21344258000,832874000,1180238000,1651833000,3673188000,3689337000,2165217000,9625916000,11615857000
Iowa,Total,2015,62482,35676,10691,6721,53088,5856,1622,60566,1916,80952,35745,10851,7171,53767,8571,5547,67885,13067,1338418,59702,69933,89598,219233,218445,208847,646525,691893,55079743000,2098270000,2204304000,2993060000,7295634000,8108251000,8702817000,24106702000,30973041000
Iowa,Transportation and Warehousing,2015,15911,10300,2005,1150,13455,1189,391,15035,876,17675,10300,2015,1175,13490,1410,485,15385,2290,279490,15362,12508,14284,42862,36065,20824,102165,176588,11629631000,522370000,459170000,538292000,1540591000,1493898000,965769000,4070736000,7474895000
Iowa,Utilities,2015,471,85,55,60,200,155,27,382,89,1375,85,55,60,200,320,70,590,785,38551,105,328,826,1300,5752,398,8090,20550,3159471000,2984000,16255000,48540000,69730000,379256000,29436000,529274000,1800192000
Iowa,Wholesale Trade,2015,17339,6935,2459,2287,11681,2516,1317,15514,1825,24870,6940,2500,2430,11870,3625,4075,19570,5300,339530,11661,15853,28285,57047,74726,87521,224633,107488,18010193000,547282000,721736000,1377614000,2699149000,3946670000,4811901000,11706443000,5929306000
Kansas,Accommodation and Food Services,2015,21670,7255,3915,4154,15324,4840,600,20764,906,30170,7305,3925,4280,15510,5445,1980,22935,7235,567984,11770,26385,56964,95286,177463,68394,341396,226277,8149271000,304220000,315377000,676465000,1299156000,2437793000,943266000,4686426000,3458362000
Kansas,Administrative and Support and Waste Management and Remediation Services,2015,16113,9295,2325,1510,13130,1453,500,15083,1030,18150,9295,2330,1545,13170,1510,600,15280,2870,385062,14631,15271,19713,50250,54483,59975,167150,214900,12879057000,539661000,462018000,755104000,1780303000,1842916000,1803749000,5554238000,7201630000
Kansas,"Agriculture, Forestry, Fishing and Hunting",2015,960,700,120,75,895,45,15,955,5,960,700,120,75,895,45,15,955,5,5034,1024,732,753,2789,1506,0,4814,0,179708000,37806000,26534000,33139000,106088000,48239000,0,177913000,0
Kansas,"Arts, Entertainment, and Recreation",2015,4880,2780,610,675,4065,565,130,4760,120,5155,2780,610,685,4075,635,145,4855,300,76386,4042,3919,8870,17131,21310,13014,54327,17740,1495577000,110913000,68694000,169287000,357421000,351423000,287229000,1054370000,308070000
Kansas,Construction,2015,34663,21725,6400,3390,31515,2396,400,34311,352,35070,21725,6415,3390,31530,2450,435,34415,655,317430,36420,41215,45299,123150,95732,40043,260905,53680,16354760000,1382140000,1588528000,1994656000,4974045000,5215208000,2298074000,12600025000,3591056000
Kansas,Educational Services,2015,3511,1595,530,490,2615,510,208,3333,178,3770,1600,530,495,2625,525,290,3440,330,103847,2352,3405,6677,12585,20629,33530,69290,29090,2865594000,64460000,73443000,116489000,260056000,509385000,812217000,1676743000,896727000
Kansas,Finance and Insurance,2015,18291,11865,2135,1010,15010,1213,570,16793,1498,29660,11875,2200,1355,15430,3250,2845,21525,8135,303532,20833,13203,13033,47567,43895,48872,142014,155959,20355554000,821956000,625836000,741601000,2217931000,2589988000,3256409000,8183432000,11849539000
Kansas,Health Care and Social Assistance,2015,30285,13999,5695,3898,23592,3872,1675,29139,1146,40515,14025,5740,4055,23820,5245,4600,33665,6850,968298,23169,37719,52194,113384,154739,244688,515223,444525,39840669000,1070157000,1482390000,2335957000,4896943000,6094926000,8890378000,19996112000,19490757000
Kansas,Information,2015,3677,1420,460,420,2300,500,208,3008,669,6795,1420,460,435,2315,740,600,3655,3140,173278,2297,3073,5291,10989,16044,16708,47513,124623,12026885000,100413000,105057000,213069000,435089000,821963000,668928000,2080951000,9869245000
Kansas,Management of Companies and Enterprises,2015,2325,130,30,105,265,455,577,1297,1028,3065,130,30,105,265,470,630,1365,1700,133355,155,96,550,825,6590,17420,24835,108478,12255630000,16865000,11092000,40945000,71675000,451985000,1286085000,1809745000,10438400000
Kansas,Manufacturing,2015,13109,4085,2055,1894,8034,2405,1228,11667,1442,14085,4085,2065,1905,8055,2570,1445,12070,2015,782035,7029,12121,22404,44755,84974,132216,293599,458066,41932156000,298548000,414962000,891107000,1725171000,3757556000,6258832000,13198524000,27055119000
Kansas,"Mining, Quarrying, and Oil and Gas Extraction",2015,4997,3010,795,460,4265,420,70,4755,242,5345,3010,795,485,4290,500,100,4890,455,50028,5687,5241,5957,16961,12661,4582,35060,14872,2761479000,217810000,231721000,279761000,733441000,658081000,266858000,1712639000,1042841000
Kansas,Other,2015,169,164,4,1,169,0,0,169,0,169,164,4,1,169,0,0,169,0,184,142,24,0,184,0,0,184,0,3875000,3388000,242000,0,3875000,0,0,3875000,0
Kansas,Other Services (except Public Administration),2015,37069,24000,7209,3030,34239,2080,369,36688,381,39345,24030,7255,3155,34440,2610,835,37885,1460,258315,44463,46022,38852,129700,70167,31013,234980,20169,6705297000,1025582000,1069078000,992556000,3099101000,1777613000,969686000,6060352000,577757000
Kansas,"Professional, Scientific, and Technical Services",2015,32925,22145,4545,2512,29202,1822,676,31700,1225,35920,22145,4570,2580,29295,2280,1045,32620,3300,321230,34155,29391,32704,96630,54998,54775,210650,108101,20195370000,1586565000,1307639000,1710269000,4623660000,3402472000,3224940000,11490100000,8552442000
Kansas,Real Estate and Rental and Leasing,2015,12851,9723,1280,618,11621,490,268,12379,472,15895,9805,1300,680,11785,815,1080,13680,2215,74103,13311,8034,7414,29130,11579,12723,54407,18568,2969008000,501247000,279125000,284431000,1077686000,461714000,455398000,2044116000,875429000
Kansas,Retail Trade,2015,34590,16940,7780,4151,28871,2949,855,32675,1915,51635,16975,7900,4440,29315,4260,2500,36075,15560,752162,32775,50872,52420,136542,90479,57196,290074,457598,18553704000,809102000,1132050000,1260215000,3210746000,2871596000,1957851000,8191103000,10216616000
Kansas,Total,2015,58391,32835,9898,6197,48930,5625,1653,56208,2183,74526,32896,10003,6531,49430,7660,4557,61647,12879,1189876,55269,64859,82344,202472,207752,196742,606966,582910,51259676000,1984725000,2061888000,2905927000,6952540000,7834555000,8220930000,23008025000,28251651000
Kansas,Transportation and Warehousing,2015,10696,6050,1447,959,8456,864,378,9698,998,12770,6060,1450,1005,8515,930,590,10035,2735,243674,9237,9474,12113,31366,25713,19812,82206,153921,10122003000,334118000,324968000,465345000,1142831000,1001911000,917772000,3312477000,6492985000
Kansas,Utilities,2015,362,55,20,50,125,85,41,251,111,1185,55,20,50,125,135,275,535,650,35248,107,56,630,982,3220,3968,8493,20818,3204416000,2694000,2314000,40023000,52440000,240798000,337813000,658059000,1979853000
Kansas,Wholesale Trade,2015,16331,6629,2215,1830,10674,2521,1182,14377,1954,22295,6640,2280,1930,10850,3885,2775,17510,4785,315206,11406,14332,21985,48855,69596,58019,182811,129691,18700741000,610557000,657736000,1198716000,2527933000,3717172000,3145863000,9733963000,8796038000
Kentucky,Accommodation and Food Services,2015,28171,8760,5140,5713,19613,6550,945,27108,1063,39550,8765,5140,5780,19685,7660,3360,30705,8845,851720,13490,34642,79554,127905,239213,132536,500310,351145,12530075000,359980000,443138000,1083797000,1891390000,3360229000,1767843000,7029350000,5496797000
Kentucky,Administrative and Support and Waste Management and Remediation Services,2015,16990,9665,2435,1500,13600,1520,601,15721,1269,20290,9665,2435,1515,13615,1635,805,16055,4235,597168,15036,15718,19687,50957,53451,73217,182592,413129,14752894000,564775000,532257000,636771000,1758374000,1796370000,1718164000,5458326000,9243626000
Kentucky,"Agriculture, Forestry, Fishing and Hunting",2015,1120,800,170,65,1035,35,35,1105,15,1120,800,170,65,1035,35,35,1105,15,6552,1162,1085,831,3187,975,1889,6089,0,219705000,39011000,36897000,23839000,107933000,29535000,72277000,210591000,0
Kentucky,"Arts, Entertainment, and Recreation",2015,6311,3540,1040,685,5265,778,131,6174,137,6660,3540,1055,705,5300,870,195,6365,295,84151,5035,6815,9008,21377,30927,13250,69076,11345,2289262000,178229000,144715000,175264000,511154000,659415000,359256000,1649097000,336631000
Kentucky,Construction,2015,35010,21785,6160,3390,31335,2945,424,34704,306,35540,21785,6160,3400,31345,3065,570,34980,560,329455,36655,40414,45143,122400,105955,51724,285100,36792,16990275000,1424675000,1529364000,1938296000,4900555000,6000955000,3384201000,14624255000,2012525000
Kentucky,Educational Services,2015,3909,1745,655,520,2920,557,243,3720,189,4530,1745,660,535,2940,575,395,3910,620,142995,2697,4187,6394,13438,20335,39292,74600,68137,3727295000,69248000,75262000,124501000,273988000,471769000,1207418000,2002720000,1713773000
Kentucky,Finance and Insurance,2015,15467,9400,2358,800,12558,1041,541,14140,1327,31975,9415,2430,990,12835,2800,3775,19410,12565,366198,18206,14398,9913,42902,37761,47487,130400,231151,23531459000,767619000,612920000,511642000,1917182000,1909830000,2442429000,6444130000,16902112000
Kentucky,Health Care and Social Assistance,2015,47082,25660,9035,5373,40068,4017,1501,45586,1496,64375,25690,9065,5640,40395,5430,4720,50545,13830,1265833,44180,59690,71554,175725,152593,183538,515250,748311,55153905000,1719717000,2189975000,2714789000,6631457000,6437300000,6097478000,19339630000,35747531000
Kentucky,Information,2015,3883,1615,510,535,2660,387,238,3285,598,7535,1615,510,555,2680,585,440,3705,3830,170673,2640,3201,6871,13081,11499,10144,38323,131861,6903063000,110412000,114609000,217666000,455116000,473986000,490253000,1588938000,5287721000
Kentucky,Management of Companies and Enterprises,2015,2327,130,45,71,246,416,621,1283,1044,3525,130,45,75,250,420,700,1370,2155,153355,134,220,538,905,4865,20255,26025,127291,13611415000,8638000,15970000,40365000,65775000,341600000,1362815000,1770190000,11838381000
Kentucky,Manufacturing,2015,16867,5015,2590,2030,9635,3182,1563,14380,2487,18460,5015,2590,2030,9635,3490,1925,15050,3410,1114282,9049,15989,24316,52478,111113,151343,353054,708445,58303479000,333820000,520163000,892369000,1873979000,4657741000,7298817000,15595771000,39865733000
Kentucky,"Mining, Quarrying, and Oil and Gas Extraction",2015,1986,765,290,260,1315,353,146,1814,172,2435,765,290,260,1315,380,255,1950,485,70030,1281,1781,3346,6528,12972,14204,34017,35823,4486916000,83041000,77830000,165727000,331328000,674353000,771432000,1798183000,2678647000
Kentucky,Other,2015,552,538,11,0,549,2,1,552,0,552,538,11,0,549,2,1,552,0,859,632,61,0,693,0,0,859,0,12585000,11521000,527000,0,12048000,0,0,12585000,0
Kentucky,Other Services (except Public Administration),2015,42943,27570,8340,3700,39610,2404,397,42411,532,46855,27605,8400,3950,39955,3350,1140,44445,2410,328976,53198,54023,48308,156118,80922,24086,264716,57316,8666699000,1226655000,1266290000,1241337000,3751293000,2239429000,764197000,6862684000,1689987000
Kentucky,"Professional, Scientific, and Technical Services",2015,38187,25610,5580,3020,34210,2137,751,37098,1089,41450,25620,5585,3065,34270,2640,1075,37985,3465,363579,40603,36556,39007,116595,68857,51604,242400,118098,17455966000,1668160000,1492898000,1885023000,5069669000,3820853000,2544112000,11705307000,5633436000
Kentucky,Real Estate and Rental and Leasing,2015,14416,10630,1663,643,12936,563,344,13843,573,18400,10645,1745,745,13135,1070,910,15115,3285,86060,16393,10532,7868,35252,16217,7655,60406,23892,3387171000,541179000,363021000,290218000,1216703000,630209000,358042000,2274381000,1046167000
Kentucky,Retail Trade,2015,46321,24573,9425,5319,39317,3930,963,44210,2111,75935,24635,9560,5865,40060,6280,3130,49470,26465,979428,46608,61767,68045,176844,129310,66039,377731,578367,24437605000,1049439000,1452958000,1837003000,4345852000,4358451000,2282575000,11123064000,12723410000
Kentucky,Total,2015,68816,38659,11919,7286,57864,6618,1842,66324,2492,91845,38706,12026,7677,58409,8854,5227,72490,19355,1579477,66446,78326,97049,241821,241500,212862,696183,883294,63741066000,2240975000,2405622000,3135701000,7782298000,8790475000,8373470000,24946243000,38794823000
Kentucky,Transportation and Warehousing,2015,11992,6209,1710,1105,9024,1078,470,10572,1420,14690,6210,1710,1125,9045,1150,610,10805,3885,372809,9400,10917,13475,34829,34995,25352,101451,268364,17635833000,356029000,370236000,502499000,1271968000,1405384000,1223534000,4177813000,13216603000
Kentucky,Utilities,2015,470,130,45,50,225,80,65,370,100,1675,130,45,50,225,160,295,680,995,41921,262,237,523,1161,4669,7352,14137,26112,3630565000,9340000,8889000,19595000,44253000,318696000,528816000,934854000,2552778000
Kentucky,Wholesale Trade,2015,17037,7042,2430,1870,11342,2294,1206,14842,2195,21465,7065,2480,2035,11580,2665,1795,16040,5425,361100,12115,15559,22259,51260,65293,57153,181985,170502,20555097000,567392000,639336000,1043385000,2307953000,3281605000,3026305000,9036217000,10878432000
Louisiana,Accommodation and Food Services,2015,35177,11155,6758,7210,25123,8164,945,34232,945,46950,11185,6780,7330,25295,8925,3525,37745,9205,1062035,18765,46090,99034,163965,301061,150104,615720,446315,18779365000,537205000,637812000,1413981000,2590750000,4891508000,2690136000,10180795000,8598570000
Louisiana,Administrative and Support and Waste Management and Remediation Services,2015,20567,11270,3150,2057,16477,2206,782,19465,1102,23690,11280,3160,2075,16515,2455,1055,20025,3665,522995,17930,20651,27037,65980,86790,88264,244694,274449,19566120000,700181000,713844000,978771000,2407462000,3106543000,2936238000,8589497000,10820157000
Louisiana,"Agriculture, Forestry, Fishing and Hunting",2015,2966,1691,690,345,2726,190,15,2931,35,3000,1695,690,345,2730,190,25,2945,55,20739,2661,4475,4145,11581,5200,0,18004,643,910927000,119195000,169756000,165176000,467307000,211156000,0,730237000,40816000
Louisiana,"Arts, Entertainment, and Recreation",2015,6700,3710,995,772,5477,905,175,6557,143,7135,3710,995,780,5485,1010,260,6755,380,123479,5929,6548,10028,22931,32908,19045,80060,27137,3517501000,226256000,148032000,172698000,559495000,584878000,900365000,2708366000,555482000
Louisiana,Construction,2015,39479,22700,7252,4420,34372,3710,769,38851,628,40010,22700,7255,4425,34380,3770,905,39055,955,692410,38620,47880,59782,146455,142785,103282,394065,294237,39583425000,1547210000,1853465000,2521929000,5932775000,7398267000,6328431000,19777895000,19495488000
Louisiana,Educational Services,2015,5677,2215,790,645,3650,1433,388,5471,206,6305,2255,795,680,3730,1535,520,5785,520,220126,3295,5230,8410,17261,66638,55210,141341,77757,7628773000,129357000,138542000,205440000,483678000,1944460000,1960019000,4448973000,3143395000
Louisiana,Finance and Insurance,2015,19779,11930,3595,1232,16757,1250,567,18574,1205,37475,11950,3760,1560,17270,3800,4295,25365,12110,314648,21423,22518,15421,59787,47496,52698,161757,149937,20872493000,965559000,1082439000,809592000,2892251000,2686806000,3163582000,8901596000,11766425000
Louisiana,Health Care and Social Assistance,2015,49042,22060,10880,6371,39311,6281,2286,47878,1164,60715,22095,10925,6640,39660,7955,5450,53065,7650,1447740,39052,71915,84596,195722,255362,339466,793055,653184,60560030000,2468867000,2826045000,3252898000,8551939000,8107390000,10881639000,27664877000,32852825000
Louisiana,Information,2015,3426,1530,440,358,2328,452,173,2953,473,7235,1595,445,395,2435,545,415,3395,3840,131240,2333,2583,4595,9989,15117,9032,37054,91926,6640204000,104318000,111983000,203242000,437005000,741880000,353758000,1685179000,4895605000
Louisiana,Management of Companies and Enterprises,2015,2467,145,45,95,285,541,744,1570,897,3345,145,45,95,285,550,775,1610,1735,117340,185,235,600,1025,8985,29245,39255,78037,11522960000,158145000,10656000,32110000,201180000,513700000,2135810000,2850690000,8664033000
Louisiana,Manufacturing,2015,15156,5330,2585,2180,10095,2718,842,13655,1501,16365,5335,2585,2180,10100,2880,1170,14150,2215,602273,9751,15945,26684,55802,98201,76700,255713,312325,40626154000,433092000,590008000,1084182000,2422013000,4866633000,4623217000,13315780000,25045772000
Louisiana,"Mining, Quarrying, and Oil and Gas Extraction",2015,6606,3215,820,564,4599,985,436,6020,586,8220,3215,825,575,4615,1125,580,6320,1900,272887,5227,5259,7661,18201,37286,49625,105211,167601,20740227000,299269000,309596000,434892000,1045114000,2281260000,3659171000,6991582000,13742555000
Louisiana,Other,2015,155,141,13,1,155,0,0,155,0,155,141,13,1,155,0,0,155,0,246,152,83,0,246,0,0,246,0,5429000,3590000,1721000,0,5429000,0,0,5429000,0
Louisiana,Other Services (except Public Administration),2015,45326,26895,9705,4394,40994,3167,572,44733,593,48590,26900,9765,4595,41260,4045,985,46290,2300,377990,50829,62922,56235,170345,114935,45514,333655,35467,11169940000,1342033000,1552312000,1568325000,4473545000,3132625000,1642476000,9341740000,1591823000
Louisiana,"Professional, Scientific, and Technical Services",2015,55931,38673,7616,4331,50620,3211,815,54646,1285,61315,38695,7645,4430,50770,3885,1300,55955,5360,528878,58768,49340,56806,165223,105609,74879,350123,174033,32988017000,3037175000,2403987000,3201817000,8654575000,7121585000,5712336000,21754707000,11006953000
Louisiana,Real Estate and Rental and Leasing,2015,18615,13240,2204,1022,16466,1047,508,18021,594,24685,13240,2245,1165,16650,1525,2630,20805,3880,159500,20159,13742,12671,46873,31510,31943,112420,45890,7606130000,710372000,515846000,567549000,1806215000,1559825000,1591931000,5044130000,2505947000
Louisiana,Retail Trade,2015,51810,26925,11034,6082,44041,4861,982,49884,1926,82625,27075,11240,6665,44980,7050,2980,55010,27615,1119528,52512,73063,79993,205958,176825,85080,473708,638433,28710940000,1303111000,1844717000,2236148000,5396844000,5869733000,3185404000,14645329000,13861259000
Louisiana,Total,2015,81513,44036,14861,9239,68136,8908,2170,79214,2299,105575,44127,15009,9722,68858,11395,6128,86381,19194,1724973,75509,97798,123671,296978,339483,281005,917466,807507,76684760000,3130392000,3354728000,4361229000,10846349000,12773040000,12647457000,36266846000,40417914000
Louisiana,Transportation and Warehousing,2015,15417,8050,2180,1487,11717,1594,718,14029,1388,19620,8055,2185,1535,11775,1720,990,14485,5135,360839,12714,13844,19798,46938,52906,52623,159125,183445,20758783000,554375000,575102000,873773000,2022460000,2704179000,3200310000,8202515000,11704933000
Louisiana,Utilities,2015,1060,590,220,50,860,65,43,968,92,2505,590,220,55,865,100,160,1125,1380,54017,1217,1330,484,3122,2338,4933,11726,34830,4941022000,31517000,40872000,17291000,92907000,109732000,332557000,594192000,3571145000
Louisiana,Wholesale Trade,2015,21043,8195,3380,2902,14477,3178,1331,18986,2057,27315,8215,3420,3080,14715,3910,2620,21245,6070,391121,14634,21994,37371,74640,95947,67147,245895,137586,21990199000,695974000,1106425000,1790565000,3627887000,5174527000,3655977000,12806069000,8793836000
Maine,Accommodation and Food Services,2015,18189,8840,3060,3065,14965,2626,307,17898,291,20610,8860,3060,3120,15040,3175,1110,19325,1285,256288,9240,20415,42701,72540,91485,39307,204315,51191,5358059000,653285000,465403000,855366000,1979840000,1774892000,652207000,4432365000,911781000
Maine,Administrative and Support and Waste Management and Remediation Services,2015,9917,6620,1275,680,8575,673,178,9426,491,10660,6625,1275,710,8610,790,245,9645,1015,115964,9308,7923,8836,26732,25277,17261,74120,40870,3516123000,384281000,262943000,302713000,977379000,736280000,524221000,2419946000,1047016000
Maine,"Agriculture, Forestry, Fishing and Hunting",2015,4450,3690,395,165,4250,165,20,4435,15,4495,3690,395,165,4250,180,40,4470,25,16771,4216,2519,2052,8931,5140,410,16331,440,761508000,168264000,88931000,81932000,347463000,247288000,24793000,728283000,33225000
Maine,"Arts, Entertainment, and Recreation",2015,4317,2935,545,370,3850,355,67,4272,45,4395,2935,545,370,3850,375,125,4350,45,38584,3587,3337,4713,12069,12579,7288,33699,2466,885403000,191624000,107542000,105215000,419622000,280314000,75677000,808973000,45124000
Maine,Construction,2015,24068,18305,3120,1487,22912,981,92,23985,83,24170,18305,3120,1490,22915,1020,100,24035,135,118005,26595,19908,19761,66631,32325,7108,109680,3789,6060555000,1160059000,814727000,929332000,2919620000,1815105000,515999000,5474195000,264128000
Maine,Educational Services,2015,2341,1135,358,280,1773,345,125,2243,98,2450,1135,360,280,1775,355,160,2290,160,92528,1595,2344,3578,7648,12991,16097,38213,54098,2696697000,50713000,49805000,91967000,195570000,364733000,537577000,1174732000,1514816000
Maine,Finance and Insurance,2015,4655,2460,580,260,3300,456,207,3963,692,9465,2465,595,310,3370,1280,1280,5930,3535,135230,4367,3396,3177,11181,17246,19700,50384,79940,8931868000,198851000,173429000,188426000,574816000,970600000,1202401000,2875681000,5658619000
Maine,Health Care and Social Assistance,2015,16139,7755,2950,1938,12643,1754,972,15369,770,24085,7770,2970,2040,12780,2885,3660,19325,4760,547134,13359,19490,25933,59311,71446,121172,253178,287815,23721898000,514094000,746816000,1063795000,2344676000,2357313000,3680382000,8446182000,15001378000
Maine,Information,2015,2694,1305,375,250,1930,304,114,2348,346,3955,1305,375,260,1940,360,240,2540,1415,56208,2219,2339,2880,7807,9068,3753,24774,28461,2800964000,67199000,81812000,100256000,266787000,433017000,145982000,1089598000,1582498000
Maine,Management of Companies and Enterprises,2015,833,60,35,20,115,161,281,557,276,1075,60,35,20,115,170,295,580,495,44439,45,135,45,225,1670,7349,9244,35134,3556477000,4540000,12120000,2210000,18870000,94595000,324667000,438132000,3115697000
Maine,Manufacturing,2015,8052,3559,1330,985,5874,1238,437,7549,503,8305,3565,1330,985,5880,1320,485,7685,620,220583,5687,7454,10484,26651,38237,30549,113555,76999,11113387000,215337000,259768000,405599000,994837000,1686910000,1376190000,4863351000,4485641000
Maine,"Mining, Quarrying, and Oil and Gas Extraction",2015,101,75,5,0,80,15,0,95,6,105,75,5,0,80,15,0,95,10,361,65,0,0,86,184,0,297,0,23410000,4763000,0,0,5846000,9024000,0,16741000,0
Maine,Other,2015,120,117,3,0,120,0,0,120,0,120,117,3,0,120,0,0,120,0,135,112,23,0,135,0,0,135,0,3856000,3522000,334000,0,3856000,0,0,3856000,0
Maine,Other Services (except Public Administration),2015,17138,11645,3315,1068,16028,667,163,16858,280,18170,11650,3360,1120,16130,955,400,17485,685,91835,21499,20755,13287,55963,20328,5609,84606,4553,2687682000,591134000,551411000,383748000,1540061000,603848000,160137000,2384938000,206548000
Maine,"Professional, Scientific, and Technical Services",2015,16560,11270,2438,1153,14861,817,225,15903,657,17520,11270,2450,1180,14900,1010,300,16210,1310,112781,17223,15763,14436,47877,24540,12694,88146,21388,7051754000,800687000,717559000,764187000,2303624000,1561878000,1090738000,5140501000,1733563000
Maine,Real Estate and Rental and Leasing,2015,7331,5825,673,320,6818,224,60,7102,229,8145,5825,690,355,6870,385,120,7375,770,31610,7659,4186,3900,15955,5696,1312,24940,5242,1288187000,322419000,170679000,151057000,653540000,203853000,56784000,996881000,225489000
Maine,Retail Trade,2015,22029,11352,4265,2885,18502,1852,413,20767,1262,31405,11400,4365,3060,18825,2795,1615,23235,8170,399766,19108,28150,36534,84665,57584,33533,182180,205275,10505266000,583313000,690751000,933827000,2233172000,1850534000,1292638000,5562357000,4620338000
Maine,Total,2015,33622,20864,5250,3178,29292,2600,632,32524,1098,40801,20893,5310,3322,29525,3678,2226,35429,5372,500549,31476,34331,42665,108472,95763,80423,284658,215891,20413159000,1281556000,1141630000,1445833000,3869019000,3474577000,3085101000,10428697000,9984462000
Maine,Transportation and Warehousing,2015,5543,3455,675,485,4615,424,135,5174,369,6045,3455,680,495,4630,490,190,5310,735,75453,4699,4084,5772,15377,14995,5097,39965,27838,3112793000,190912000,138858000,196587000,555872000,555767000,210275000,1462503000,1286129000
Maine,Utilities,2015,233,75,35,15,125,20,35,180,53,445,75,45,15,135,20,115,270,175,10398,113,183,94,575,549,2030,4496,3468,843133000,5605000,5286000,8964000,32925000,39810000,153248000,324422000,308506000
Maine,Wholesale Trade,2015,6946,3410,870,598,4878,700,413,5991,955,7905,3415,880,635,4930,810,650,6390,1515,86295,5375,5348,6602,18632,15774,14452,54480,28409,4545593000,243884000,217806000,306160000,826974000,776680000,759471000,2672881000,1695835000
Maryland,Accommodation and Food Services,2015,46106,18260,8310,7851,34421,9544,1040,45005,1101,58280,18285,8350,7910,34545,10400,2650,47595,10685,1100533,30509,54672,106936,192319,362696,124110,679505,419796,20682453000,1007107000,922273000,1813330000,3751592000,6539964000,2310739000,12608973000,8047382000
Maryland,Administrative and Support and Waste Management and Remediation Services,2015,36022,20555,5028,3605,29188,3839,1316,34343,1679,41640,20570,5035,3640,29245,4015,1595,34855,6785,958264,30888,33193,48422,112858,149745,164950,430131,526258,40130597000,1451580000,1261325000,1993965000,4725833000,6118543000,6207217000,17194001000,22824138000
Maryland,"Agriculture, Forestry, Fishing and Hunting",2015,973,730,145,40,915,30,10,955,18,975,730,145,40,915,30,10,955,20,6224,1038,909,339,2564,381,0,3781,970,225746000,34997000,28152000,11630000,87442000,13481000,0,134266000,36326000
Maryland,"Arts, Entertainment, and Recreation",2015,9445,5250,1310,1020,7580,1327,270,9177,268,10350,5250,1310,1030,7590,1465,455,9510,840,203231,6661,8389,13067,28615,50480,36099,120397,72359,5947662000,392329000,222497000,275805000,907997000,1243122000,860225000,3183936000,2520687000
Maryland,Construction,2015,69354,43340,11060,6845,61245,6386,1086,68717,637,69850,43340,11065,6845,61250,6440,1230,68920,930,718530,67588,72591,92515,232720,241782,136954,615515,99098,42694275000,3223424000,3216057000,4949235000,11390090000,14337393000,8827594000,34810730000,7608739000
Maryland,Educational Services,2015,9815,4580,1505,1277,7362,1588,581,9531,284,10615,4580,1510,1355,7445,1695,805,9945,670,412790,7105,10129,17226,34540,65050,81338,182670,229465,19516735000,255950000,282763000,426815000,969880000,2068725000,3452508000,6725790000,12770097000
Maryland,Finance and Insurance,2015,21161,12615,3225,1383,17223,1322,845,19390,1771,37395,12635,3260,1590,17485,2715,2965,23165,14230,496268,22295,20375,17589,60690,46950,68027,177647,310164,47580913000,1280744000,1303714000,1587356000,4221853000,4295978000,6713853000,15446517000,31536998000
Maryland,Health Care and Social Assistance,2015,62566,30495,13345,8266,52106,6434,2252,60792,1774,81745,30555,13525,8675,52755,9235,7655,69645,12100,1831779,57550,87712,110171,255636,239343,338636,835353,993259,90122144000,3020602000,4089549000,5443582000,12561965000,11160631000,12492423000,36304276000,53663836000
Maryland,Information,2015,7051,3515,765,625,4905,775,340,6020,1031,12430,3520,770,650,4940,850,430,6220,6210,254578,5354,4930,7924,18718,25826,37272,84428,169054,20477147000,304135000,326005000,560403000,1234135000,1851392000,3024468000,6274765000,14112592000
Maryland,Management of Companies and Enterprises,2015,3174,130,60,155,345,533,912,1790,1384,5690,130,60,155,345,560,960,1865,3825,255995,160,270,1060,1490,6853,31647,39990,216005,26040306000,22340000,36290000,146770000,205400000,549776000,2543275000,3298451000,22741855000
Maryland,Manufacturing,2015,14253,5750,2275,2034,10059,2244,845,13148,1105,14840,5750,2275,2040,10065,2335,1010,13410,1430,449885,10026,13230,24266,51606,76820,65083,218837,190204,28572486000,426270000,534768000,1035207000,2209852000,4023444000,3757718000,11296875000,14540223000
Maryland,"Mining, Quarrying, and Oil and Gas Extraction",2015,318,95,70,20,185,45,28,258,60,380,95,70,20,185,45,75,305,75,5161,104,393,81,757,842,905,3328,1339,316971000,9931000,15913000,3653000,38136000,41474000,58530000,182083000,98531000
Maryland,Other,2015,330,326,2,2,330,0,0,330,0,330,326,2,2,330,0,0,330,0,357,314,0,0,357,0,0,357,0,11081000,10740000,0,0,11081000,0,0,11081000,0
Maryland,Other Services (except Public Administration),2015,63990,37925,12736,6957,57618,4986,712,63316,674,68635,37940,12805,7100,57845,5625,1430,64900,3735,572612,71964,83036,91140,246391,177609,65937,492242,71174,21853931000,2299712000,2512750000,2949941000,7770103000,6544402000,3074258000,17493671000,3614454000
Maryland,"Professional, Scientific, and Technical Services",2015,91007,61196,11157,6872,79225,7186,2324,88735,2272,102515,61220,11185,7020,79425,7825,2885,90135,12380,1367970,89070,73188,89463,251970,250754,222060,728560,626433,116953650000,6151260000,4806727000,6440905000,17417230000,20954810000,19198045000,57776080000,58210850000
Maryland,Real Estate and Rental and Leasing,2015,22638,16098,2434,1224,19756,1390,636,21782,856,31555,16120,2475,1385,19980,1895,2810,24685,6870,219153,22560,15577,15833,54205,41926,40880,138020,80880,13413276000,1177880000,693864000,937550000,2820465000,3010425000,2577886000,8532695000,4866617000
Maryland,Retail Trade,2015,57384,31349,11686,6297,49332,4165,1368,54865,2519,91365,31495,11900,6765,50160,5730,4070,59960,31405,1451520,55977,77720,81948,216020,138243,114107,475075,944218,39959260000,1609221000,2012583000,2366715000,6001240000,5140485000,4827200000,16226887000,22954957000
Maryland,Total,2015,109021,62684,18065,11662,92411,10972,2811,106194,2827,137204,62764,18219,12090,93073,13216,6747,113036,24168,2239817,102231,118823,155497,376551,408370,339501,1124422,1115395,118496858000,4864440000,4817082000,6822828000,16504350000,19427927000,17957698000,53889975000,64606883000
Maryland,Transportation and Warehousing,2015,15687,8740,2064,1480,12284,1571,573,14428,1259,17495,8740,2070,1485,12295,1685,665,14645,2850,345854,12544,13441,18683,45420,49064,26259,126088,160974,16721158000,483816000,484695000,666074000,1661248000,1899657000,1137050000,4947195000,8903586000
Maryland,Utilities,2015,299,110,10,15,135,20,30,185,114,710,110,10,15,135,20,70,225,485,46612,116,0,0,268,0,1681,3021,41238,5545023000,19804000,0,0,36286000,0,174298000,316062000,4946587000
Maryland,Wholesale Trade,2015,23585,11115,3263,2613,16991,3046,1353,21390,2195,27905,11125,3265,2720,17110,3515,1965,22590,5315,438445,17246,21081,33138,72014,95916,76150,249776,184395,31138778000,1037671000,1170392000,2085413000,4324377000,6202208000,4893222000,15717765000,15113662000
Massachusetts,Accommodation and Food Services,2015,69507,27551,13800,12305,53656,13789,1060,68505,1002,86150,27625,13865,12440,53930,15410,4450,73790,12360,1440390,45600,91471,168575,305655,499385,158269,963705,476117,30888630000,1868005000,1648958000,3005175000,6522255000,10131036000,3387100000,20056900000,10824410000
Massachusetts,Administrative and Support and Waste Management and Remediation Services,2015,46707,30805,5825,3453,40083,3534,1329,44946,1761,52745,30815,5850,3490,40155,3700,1490,45345,7400,998713,37083,38149,45560,121157,138283,178124,441137,555445,49495581000,2702996000,1939931000,2358099000,7040470000,6585168000,8168801000,21973705000,27354739000
Massachusetts,"Agriculture, Forestry, Fishing and Hunting",2015,1680,1350,215,75,1640,35,0,1675,5,1680,1350,215,75,1640,35,0,1675,5,5077,1613,1316,685,3939,322,0,5041,0,191279000,68785000,27843000,16367000,125796000,15938000,0,183803000,0
Massachusetts,"Arts, Entertainment, and Recreation",2015,15489,8510,2255,1862,12627,2198,409,15234,255,16760,8510,2265,1895,12670,2450,800,15920,840,281574,11640,14856,25147,51939,85588,54060,197479,75263,10361315000,744199000,526183000,801093000,2085415000,2030244000,1627780000,6559665000,3213147000
Massachusetts,Construction,2015,89386,64105,13180,6225,83510,4721,696,88927,459,89670,64105,13180,6225,83510,4750,730,88990,680,620095,95990,85164,83365,264545,175638,97700,544870,73822,46381740000,5582270000,4912934000,5627040000,16125360000,14388381000,8759898000,39932900000,6308013000
Massachusetts,Educational Services,2015,14575,6645,2523,1760,10928,2080,1006,14014,561,15615,6655,2535,1810,11000,2205,1335,14540,1075,1082571,10455,17058,23763,51410,86337,161095,300281,781834,45671021000,397065000,470103000,628235000,1503100000,3116623000,6634821000,11293861000,34357472000
Massachusetts,Finance and Insurance,2015,26804,15030,3856,2030,20916,2209,1346,24471,2333,47885,15075,4030,2320,21425,3675,5495,30595,17290,906859,27149,24184,26920,78449,75335,119997,276636,627022,125536316000,2343337000,2300674000,3015023000,7723308000,8687701000,13070318000,30128990000,95183299000
Massachusetts,Health Care and Social Assistance,2015,66110,28521,14403,9400,52324,7889,3398,63611,2499,94125,28620,14505,9880,53005,10545,9825,73375,20750,3103538,53059,95360,125572,274127,302422,537477,1115410,1983582,158316180000,2916742000,4598406000,6404582000,13924094000,14366705000,20981412000,49335680000,108739646000
Massachusetts,Information,2015,11215,4880,1625,1055,7560,1418,786,9764,1451,18130,4895,1625,1070,7590,1550,915,10055,8075,566776,7796,10411,13439,32133,52164,77775,166786,396454,62093958000,493548000,683891000,933674000,2138350000,4858731000,9380928000,16793188000,44922841000
Massachusetts,Management of Companies and Enterprises,2015,3927,285,85,135,505,475,1037,2017,1910,6160,285,85,140,510,485,1075,2070,4090,456785,402,510,858,1770,6490,38476,46825,409960,55435710000,53578000,47890000,87376000,188844000,616130000,3272862000,4088230000,51347480000
Massachusetts,Manufacturing,2015,31775,11460,5505,4715,21680,6249,1791,29720,2055,32720,11460,5520,4725,21705,6390,1980,30075,2645,1099202,20821,35181,61594,121831,237255,185516,590142,460233,76974941000,1181378000,1656922000,3187263000,6254094000,13530200000,12473368000,34983422000,39173617000
Massachusetts,"Mining, Quarrying, and Oil and Gas Extraction",2015,318,120,45,50,215,54,24,293,25,375,120,45,50,215,70,60,345,30,4061,212,297,475,1099,1067,565,3184,207,343597000,16763000,15009000,31506000,71058000,87681000,38305000,225779000,29017000
Massachusetts,Other,2015,596,561,26,8,595,1,0,596,0,596,561,26,8,595,1,0,596,0,863,551,166,108,825,0,0,863,0,27235000,20798000,3493000,2428000,26719000,0,0,27235000,0
Massachusetts,Other Services (except Public Administration),2015,82456,50410,17893,8227,76530,4540,728,81798,658,89270,50455,18040,8575,77070,5415,2220,84705,4565,623140,94044,116773,105961,317004,148768,71135,541590,74416,21406545000,3034462000,3431182000,3207602000,9680777000,5173443000,2908970000,17977750000,3121540000
Massachusetts,"Professional, Scientific, and Technical Services",2015,101368,67625,13855,7550,89030,6956,2391,98377,2991,107560,67665,13855,7665,89185,7450,2700,99335,8225,1383560,104925,90958,98319,294465,245322,221150,765475,615594,148345375000,7643595000,6195094000,8016651000,21868915000,25877980000,24608253000,72671510000,75486792000
Massachusetts,Real Estate and Rental and Leasing,2015,26875,19763,3135,1513,24411,1276,498,26185,690,34740,19835,3280,1655,24770,1900,1630,28300,6440,233115,29797,20129,19805,70018,41367,43856,156945,70422,15811625000,1715132000,1074167000,1218319000,4033113000,2579566000,3204141000,9886440000,5105572000
Massachusetts,Retail Trade,2015,80530,46913,15974,8019,70906,5514,1533,77953,2577,120505,47090,16340,8755,72185,7760,4880,84825,35680,1830169,87529,104389,103347,295374,194397,115181,610279,1191469,52989474000,2824578000,3062516000,3484509000,9374653000,8596916000,5084289000,23254194000,29002251000
Massachusetts,Total,2015,141589,82235,24404,14765,121404,13442,3517,138363,3226,175225,82378,24661,15343,122382,16095,8590,147067,28158,3167329,134165,160372,197102,491639,504047,464854,1460540,1706789,198026611000,7242468000,7145317000,9387019000,23774804000,27128865000,28283866000,79187535000,118839076000
Massachusetts,Transportation and Warehousing,2015,16828,8955,2360,1819,13134,1780,715,15629,1199,18895,8955,2375,1835,13165,1885,890,15940,2955,409457,12506,15573,23716,52517,61958,52206,171746,232240,19242520000,595471000,634594000,930660000,2196772000,2528903000,1901496000,6837085000,12032415000
Massachusetts,Utilities,2015,479,165,40,40,245,45,52,342,137,1345,165,40,40,245,45,95,385,960,61215,143,141,376,907,2068,2532,6613,53790,6181347000,12834000,10854000,19296000,58525000,314775000,286005000,751945000,5370670000
Massachusetts,Wholesale Trade,2015,33674,15382,5500,3912,24794,4293,1870,30957,2717,38815,15405,5525,4030,24960,4750,2380,32090,6725,701921,26462,35955,51048,114001,144191,123226,385971,304982,62078953000,1834214000,2316343000,3529291000,7710084000,10682802000,9535043000,28321998000,32832001000
Michigan,Accommodation and Food Services,2015,75954,27430,13601,15479,56510,16829,1406,74745,1209,98845,27465,13660,15630,56755,19250,5795,81800,17045,1855760,41465,91335,214170,346970,610817,212178,1170349,683524,30304300000,1316650000,1206395000,2814110000,5337155000,9282363000,2956201000,17585041000,12682323000
Michigan,Administrative and Support and Waste Management and Remediation Services,2015,50600,31415,6625,4082,42122,4773,1707,48602,1998,58810,31435,6660,4145,42240,5055,2190,49485,9325,1669871,41281,43808,54937,140205,187736,269942,600560,1067899,52264856000,2411205000,1571392000,2080349000,6072630000,6861116000,8680056000,21720339000,30481371000
Michigan,"Agriculture, Forestry, Fishing and Hunting",2015,2851,1990,460,185,2635,156,40,2831,20,2860,1990,460,185,2635,160,40,2835,25,18785,2994,2758,2216,8175,4902,3113,17750,979,738678000,111761000,93026000,74916000,289702000,197815000,124079000,686093000,46213000
Michigan,"Arts, Entertainment, and Recreation",2015,15915,9455,2275,1775,13505,1814,365,15684,231,16665,9455,2290,1830,13575,1915,535,16025,640,232148,11605,14430,23936,50258,68346,51513,173915,49824,7779775000,675900000,390516000,509989000,1588498000,1517258000,3553690000,6740505000,856270000
Michigan,Construction,2015,92115,63880,14328,7540,85748,5232,720,91700,415,92830,63885,14330,7545,85760,5335,945,92040,790,661150,92815,93645,101290,287750,187865,99242,578455,79309,40949550000,4946785000,4530540000,5768275000,15245600000,12227233000,7010777000,34739995000,6010175000
Michigan,Educational Services,2015,10562,5175,1630,1340,8145,1606,479,10230,332,11855,5175,1635,1350,8160,1835,745,10740,1115,364105,7959,11011,17798,36980,65895,68893,173685,189785,10274517000,253683000,232747000,393949000,891800000,1580321000,2302648000,4844160000,5420510000
Michigan,Finance and Insurance,2015,34308,21795,5499,2119,29413,2121,1051,32585,1723,64270,21820,5555,2480,29855,4975,5235,40065,24205,755468,41385,34968,27796,104355,78194,105095,289815,459119,55746901000,1953036000,1777041000,1734156000,5478301000,4585353000,6578940000,16796238000,38426485000
Michigan,Health Care and Social Assistance,2015,100595,45240,24600,14880,84720,10528,3338,98586,2009,133185,45325,24805,15475,85605,14270,11830,111705,21480,3005450,83090,165491,197647,446347,399911,510179,1358264,1645222,137722620000,4171292000,6804055000,8937397000,19919702000,16476099000,18209833000,54699960000,82931538000
Michigan,Information,2015,11631,6713,1420,962,9095,1037,405,10537,1094,18800,6720,1420,1000,9140,1240,575,10955,7845,346555,9512,9170,12068,31170,36821,38716,108625,237241,23483675000,423803000,374513000,553333000,1370597000,1987349000,2207738000,5689549000,17747339000
Michigan,Management of Companies and Enterprises,2015,5265,235,75,125,435,1000,1564,2999,2266,8005,235,75,140,450,1015,1665,3130,4875,601575,278,415,975,1672,11370,50525,63570,537941,62790060000,43585000,38310000,85220000,167407000,800960000,3428360000,4397055000,58385129000
Michigan,Manufacturing,2015,58348,19400,9867,9156,38423,11687,4511,54621,3727,62185,19405,9875,9195,38475,12245,5605,56325,5860,2813990,34634,64568,121328,225683,464876,588162,1311519,1441952,160206119000,1773297000,2702669000,5727266000,10481704000,23585456000,30627050000,66391379000,90265667000
Michigan,"Mining, Quarrying, and Oil and Gas Extraction",2015,1555,740,255,154,1149,185,66,1400,155,1715,740,270,155,1165,205,75,1445,270,23090,1214,1507,2025,4803,5294,2553,13161,9646,1611204000,77070000,92184000,117202000,289203000,376944000,138569000,839312000,756910000
Michigan,Other,2015,963,936,22,5,963,0,0,963,0,963,936,22,5,963,0,0,963,0,922,714,148,60,922,0,0,922,0,13104000,10820000,1417000,867000,13104000,0,0,13104000,0
Michigan,Other Services (except Public Administration),2015,106709,65295,22985,10606,98886,6261,898,106045,664,115180,65340,23180,11160,99680,8490,2505,110675,4505,787685,124227,148866,137967,411270,210169,88722,714610,61470,22561879000,3188532000,3613574000,3531923000,10338749000,5949178000,3127155000,19606249000,2430091000
Michigan,"Professional, Scientific, and Technical Services",2015,99164,66558,13975,7941,88474,6307,1830,96611,2553,107400,66595,14020,8105,88720,7630,3065,99415,7985,1316190,98590,92518,104039,295315,224479,183116,706700,602221,97192700000,5397835000,5000445000,6479239000,16886875000,15902000000,13398069000,46497045000,50338866000
Michigan,Real Estate and Rental and Leasing,2015,29778,21310,3973,1684,26967,1457,645,29069,709,38880,21350,4080,1800,27230,2560,2380,32170,6710,258775,31985,24777,21569,78520,46512,44031,170715,85608,10965325000,1268405000,852480000,865834000,2998640000,1831337000,2222038000,7134420000,3797737000
Michigan,Retail Trade,2015,112880,65306,23232,11349,99887,8532,1885,110304,2576,173555,65430,23640,12510,101580,13325,8120,123025,50530,2329705,124660,153640,149199,427675,313052,208381,953705,1362828,60187250000,3221345000,3633920000,3920348000,10779035000,10829478000,7108548000,28846000000,30992082000
Michigan,Total,2015,173309,98976,30941,19275,149192,16937,3918,170047,3262,219627,99093,31233,20129,150455,21884,11425,183764,35863,3725280,162222,204532,258922,625676,643337,565265,1834278,1891002,174873962000,6914291000,7275006000,9860294000,24049591000,26154981000,25759781000,75964353000,98909609000
Michigan,Transportation and Warehousing,2015,26614,16220,3180,2299,21699,2502,914,25115,1499,31135,16230,3180,2335,21745,2685,1255,25685,5450,561148,21898,20853,30298,73511,85702,64640,229010,329435,27461230000,900511000,836671000,1254500000,3008298000,3724113000,2915283000,9906886000,17389546000
Michigan,Utilities,2015,567,210,55,50,315,55,42,412,155,1880,210,55,75,340,65,190,595,1285,109596,293,268,425,1194,1745,4105,7682,89093,11249731000,17854000,12441000,27105000,70373000,127892000,358047000,606651000,9314580000
Michigan,Wholesale Trade,2015,45554,21969,6795,5246,34010,5874,2395,42279,3275,55265,21980,6865,5505,34350,7165,4375,45890,9375,883990,37018,44835,68459,150750,195410,166507,518095,357357,59062815000,2312835000,2464369000,4114202000,8910520000,12031801000,10399065000,31659810000,26803471000
Minnesota,Accommodation and Food Services,2015,42653,14058,7248,9017,30323,10248,1088,41659,994,57410,14070,7305,9105,30480,11700,3515,45695,11715,1180385,19610,49690,125833,195195,381530,150667,727744,447713,20541140000,742200000,637645000,1667930000,3048435000,6076169000,2565523000,11698139000,8754600000
Minnesota,Administrative and Support and Waste Management and Remediation Services,2015,32847,20645,4450,2735,27830,2737,860,31427,1420,37595,20655,4470,2740,27865,2980,1145,31990,5605,818374,27480,28583,35572,92058,103548,116231,316557,499677,32278878000,1439141000,979105000,1377472000,3816642000,4033444000,3886419000,11941972000,20174878000
Minnesota,"Agriculture, Forestry, Fishing and Hunting",2015,2665,1910,405,195,2510,100,20,2630,35,2715,1910,405,195,2510,105,40,2655,60,12625,2880,2661,2299,8145,2908,162,11795,750,518357000,127862000,93895000,79975000,310197000,136557000,8978000,478567000,34014000
Minnesota,"Arts, Entertainment, and Recreation",2015,13520,8300,1973,1334,11607,1393,315,13315,205,14275,8300,2015,1340,11655,1495,370,13520,755,234910,11152,12700,17716,41828,50362,43858,140477,83396,7044692000,443084000,261283000,326124000,1034792000,932804000,988634000,3248582000,3432945000
Minnesota,Construction,2015,80712,59705,10600,5395,75700,3932,597,80229,483,81230,59705,10600,5400,75705,4045,685,80435,795,568895,81705,68438,71248,221485,146156,80295,451495,112034,40441900000,4488335000,3627179000,4477773000,12603165000,10965137000,6233645000,29975710000,10108960000
Minnesota,Educational Services,2015,9134,4025,1350,1265,6640,1847,365,8852,282,9755,4025,1350,1275,6650,1980,540,9170,585,367615,6180,9021,17203,32506,76540,55818,168010,192957,10112516000,203506000,204279000,371434000,783382000,2091685000,1948765000,4915406000,5046949000
Minnesota,Finance and Insurance,2015,30420,20050,3902,1732,25684,1939,856,28479,1941,46475,20075,4000,2095,26170,4170,3520,33860,12615,756744,34289,24543,21413,80449,67331,70697,221468,534168,66290815000,1642040000,1396180000,1521627000,4576200000,4924003000,5296008000,15011518000,51196705000
Minnesota,Health Care and Social Assistance,2015,52480,23330,9275,6906,39511,7771,3456,50738,1742,81600,23395,9350,7285,40030,10565,12440,63035,18565,2253058,39163,62447,94330,196085,317871,547939,1064620,1188294,95193115000,1738962000,2545292000,3653505000,7958590000,11130334000,17411410000,36662550000,58525536000
Minnesota,Information,2015,8211,3930,1155,810,5895,978,346,7219,992,12580,3930,1160,815,5905,1265,635,7805,4775,288519,5996,7405,10363,24206,34250,37221,98841,178428,21483249000,335787000,337883000,519173000,1211927000,2028848000,2419538000,5799190000,14620158000
Minnesota,Management of Companies and Enterprises,2015,4010,200,90,80,370,730,1176,2276,1734,6120,200,90,80,370,775,1230,2375,3745,689820,240,415,412,1075,9560,39375,50010,639810,68203380000,53545000,25290000,17666000,96715000,541425000,3029380000,3667520000,64535860000
Minnesota,Manufacturing,2015,34192,12855,5474,4419,22748,6554,2343,31645,2547,36555,12855,5475,4430,22760,6845,2875,32480,4075,1481140,21505,34534,56001,116213,256281,274804,685334,730230,84086301000,1023425000,1414968000,2520593000,5160363000,13066018000,15199203000,35500754000,44579825000
Minnesota,"Mining, Quarrying, and Oil and Gas Extraction",2015,676,325,125,55,505,65,31,601,75,785,325,125,65,515,65,40,620,165,29733,524,706,505,1994,1700,1018,5559,23334,2667045000,41354000,57204000,43473000,171041000,144676000,92672000,477676000,2122774000
Minnesota,Other,2015,346,340,5,1,346,0,0,346,0,346,340,5,1,346,0,0,346,0,314,266,32,0,314,0,0,314,0,6724000,5404000,1240000,0,6724000,0,0,6724000,0
Minnesota,Other Services (except Public Administration),2015,71899,42555,15260,7553,65368,5154,770,71292,607,77515,42595,15490,7890,65975,6555,2450,74980,2535,587187,78179,98807,99773,276989,172129,77290,530157,49104,16435069000,2058590000,2398135000,2512239000,6975667000,4656770000,2418908000,14196849000,2033215000
Minnesota,"Professional, Scientific, and Technical Services",2015,79440,58130,8600,5265,71995,4064,1407,77466,1974,83835,58135,8670,5410,72215,4695,1800,78710,5125,895980,75415,56212,69762,201700,139270,125116,469825,422359,70926485000,4451646000,3065218000,4279351000,11813670000,10939011000,10096008000,33108685000,37598363000
Minnesota,Real Estate and Rental and Leasing,2015,26618,21035,2170,1046,24251,1058,612,25921,697,32950,21055,2240,1095,24390,1565,2240,28195,4755,189573,25574,13828,12829,52359,34994,39002,127562,60727,9208599000,1175787000,566431000,531572000,2278787000,1505630000,1572867000,5419302000,3663150000
Minnesota,Retail Trade,2015,61134,30050,13326,8021,51397,5722,1553,58672,2462,94870,30080,13550,8705,52335,8665,5560,66560,28310,1500985,53750,87869,104749,246605,201225,139406,590420,905341,40433765000,1495836000,2007988000,2720654000,6228413000,6173435000,4783735000,17277005000,23038956000
Minnesota,Total,2015,118525,70335,18492,12175,101002,11769,2969,115740,2785,148666,70396,18715,12702,101813,15017,8642,125472,23194,2612314,105780,121694,163440,390914,448170,410019,1249103,1363211,133092716000,4754045000,4459960000,6141891000,15355896000,18647495000,18411937000,52415328000,80677388000
Minnesota,Transportation and Warehousing,2015,21154,12925,2400,1843,17168,2131,646,19945,1209,23495,12925,2420,1860,17205,2265,900,20370,3125,400343,17731,15489,24470,58558,74512,56149,191936,206109,18093263000,709503000,621898000,910023000,2273059000,2645969000,2142629000,7182246000,10767404000
Minnesota,Utilities,2015,634,125,35,55,215,191,70,476,158,1680,130,35,55,220,250,115,585,1095,64812,209,194,725,1281,6332,4861,12820,52046,6008453000,15841000,12213000,55225000,92115000,478509000,399978000,989035000,5022325000
Minnesota,Wholesale Trade,2015,33455,15880,4767,3504,24151,4412,1976,30539,2916,40160,15915,4800,3665,24380,5100,3110,32590,7570,672675,25358,31291,45116,102605,143938,114157,366820,299989,50718685000,1515001000,1870554000,2806929000,6232650000,9671005000,7424027000,23724590000,26579103000
Mississippi,Accommodation and Food Services,2015,19845,6660,3850,4048,14558,3965,593,19116,729,27250,6665,3855,4125,14645,4450,1935,21030,6220,619730,11145,25748,54945,92020,141500,79025,313030,306619,10076220000,262045000,312889000,711268000,1288925000,1884777000,993949000,4174075000,5901266000
Mississippi,Administrative and Support and Waste Management and Remediation Services,2015,9682,5300,1435,1011,7746,793,383,8922,760,11115,5300,1435,1015,7750,880,485,9115,2000,283536,8995,9086,12862,31488,27525,41248,102887,173748,7108204000,309675000,262146000,400685000,992356000,787787000,998997000,2853099000,4030898000
Mississippi,"Agriculture, Forestry, Fishing and Hunting",2015,3368,1805,910,380,3095,195,30,3320,48,3470,1805,910,380,3095,195,50,3340,130,24836,3274,6124,4736,14333,5586,575,21553,1324,1072993000,130147000,216162000,178966000,530683000,205189000,19975000,792383000,113120000
Mississippi,"Arts, Entertainment, and Recreation",2015,3105,1765,440,395,2600,375,60,3035,70,3275,1765,440,400,2605,390,155,3150,125,43578,2951,2753,5205,11266,12422,5701,31766,10855,901270000,74163000,88382000,86162000,272344000,205494000,92920000,637624000,240826000
Mississippi,Construction,2015,18765,11300,3450,1975,16725,1595,215,18535,230,19010,11300,3450,1975,16725,1625,245,18595,415,217655,19560,22624,26472,68845,58670,30510,160955,40856,10252730000,691720000,749396000,1069420000,2517130000,2843975000,1732875000,7234520000,2216317000
Mississippi,Educational Services,2015,2485,980,435,265,1680,520,140,2340,145,3125,980,435,265,1680,555,270,2505,620,89285,1652,2880,3461,8255,24056,14964,48524,40167,2131305000,35400000,65858000,56422000,166162000,555573000,475499000,1227795000,884723000
Mississippi,Finance and Insurance,2015,11356,7540,1330,587,9457,607,343,10407,949,23135,7585,1465,1025,10075,1975,2700,14750,8385,164380,14583,8157,7028,30066,21383,25838,79237,84844,8901504000,541505000,323946000,364719000,1245099000,1027066000,1256379000,3621538000,5247765000
Mississippi,Health Care and Social Assistance,2015,24303,10645,5835,3455,19935,2618,898,23451,852,31000,10685,5860,3630,20175,3365,2505,26045,4955,813736,19921,39174,45592,105142,100203,115649,325004,475043,36152070000,1055554000,1620803000,1878176000,4567818000,3811945000,3898059000,12429078000,23507973000
Mississippi,Information,2015,2056,785,345,230,1360,220,105,1685,371,4605,785,350,240,1375,325,185,1885,2720,68652,1326,2049,2537,6452,6097,4364,18370,50040,3221482000,45742000,61193000,70040000,197312000,232052000,194810000,701477000,2506447000
Mississippi,Management of Companies and Enterprises,2015,1306,81,25,56,162,245,386,793,513,1710,90,25,60,175,250,415,840,870,41280,115,45,263,434,1980,9160,11575,29705,3114360000,21735000,1490000,19125000,43970000,108700000,526185000,678915000,2435445000
Mississippi,Manufacturing,2015,9586,2655,1510,1220,5385,1830,948,8163,1423,10585,2655,1510,1225,5390,1895,1165,8450,2135,651904,5012,8371,13654,30195,61445,83658,203265,408803,29023745000,175940000,252745000,446272000,994550000,2370265000,3110034000,7603251000,19276584000
Mississippi,"Mining, Quarrying, and Oil and Gas Extraction",2015,1677,979,215,104,1298,160,85,1543,134,1865,980,215,105,1300,165,115,1580,285,28456,1457,1392,1201,4116,5128,7575,16819,9462,2067207000,86016000,65006000,64076000,217932000,253810000,571225000,1042967000,838216000
Mississippi,Other,2015,131,119,7,2,128,3,0,131,0,131,119,7,2,128,3,0,131,0,281,128,48,0,197,84,0,281,0,2794000,2150000,385000,0,2660000,134000,0,2794000,0
Mississippi,Other Services (except Public Administration),2015,30076,18870,6460,2685,28015,1478,236,29729,347,31770,18885,6510,2800,28195,1925,570,30690,1080,190928,37224,41058,35193,113846,49096,13151,179253,9660,4666707000,830230000,885290000,823968000,2553275000,1216502000,366591000,4227072000,381359000
Mississippi,"Professional, Scientific, and Technical Services",2015,21324,14495,3042,1530,19067,1115,387,20569,755,23705,14505,3080,1580,19165,1700,575,21440,2265,152957,23806,19595,19324,63248,32398,20364,117682,33238,7913243000,1032027000,807658000,913425000,2776830000,1737650000,1138460000,5740225000,2128908000
Mississippi,Real Estate and Rental and Leasing,2015,9392,7172,943,381,8496,379,196,9071,321,12045,7175,945,470,8590,590,670,9850,2195,51439,11254,5795,4629,21984,9300,5443,38474,11775,1738673000,333288000,161316000,152658000,656253000,334307000,204401000,1273218000,424496000
Mississippi,Retail Trade,2015,36594,20010,7461,4064,31535,2816,590,34941,1653,57935,20030,7575,4440,32045,4180,2725,38950,18985,669989,37178,49016,51393,138268,93936,49832,285363,366421,15858763000,856386000,1123913000,1428541000,3424806000,3052190000,1405318000,7986551000,7370697000
Mississippi,Total,2015,44424,24336,8206,4859,37401,4108,1134,42643,1781,58662,24375,8304,5187,37866,5466,3363,46695,11967,926391,43736,53769,64453,161958,148026,124859,434843,491548,33948151000,1436838000,1590073000,2006590000,5033501000,4895275000,4487130000,14415906000,19532245000
Mississippi,Transportation and Warehousing,2015,9000,4530,1450,875,6855,816,328,7999,1001,10325,4530,1455,875,6860,870,390,8120,2205,185482,6952,9065,10726,27384,25249,16901,74736,107542,8009702000,255030000,319969000,386333000,986336000,972569000,701505000,2884456000,4896204000
Mississippi,Utilities,2015,1801,1100,410,65,1575,95,72,1742,59,2950,1100,410,75,1585,180,305,2070,880,46007,2617,2429,768,5947,5152,9599,21498,12090,3572227000,59442000,73455000,32259000,173698000,304321000,649771000,1160955000,1122358000
Mississippi,Wholesale Trade,2015,10904,4450,1535,1145,7130,1443,782,9355,1549,13780,4460,1560,1240,7260,1800,1355,10415,3365,182734,8130,9475,13752,32638,37577,30656,107967,69552,9159391000,326411000,396675000,636256000,1415872000,1751495000,1640665000,5145911000,3738889000
Missouri,Accommodation and Food Services,2015,45209,15495,7815,8483,31793,10865,1277,43935,1274,62360,15515,7840,8565,31920,12335,4690,48945,13415,1271270,24720,52486,115955,193161,400291,173104,766891,503640,20407210000,728132000,712637000,1574720000,3015489000,5926110000,2655425000,11606149000,8788205000
Missouri,Administrative and Support and Waste Management and Remediation Services,2015,33490,20470,4900,2855,28225,2671,928,31824,1666,38145,20470,4905,2890,28265,2805,1210,32280,5865,841565,30841,32278,37900,101350,96416,110835,311279,528712,26027730000,1066909000,1031527000,1223708000,3349145000,3205862000,3515586000,10168563000,15778037000
Missouri,"Agriculture, Forestry, Fishing and Hunting",2015,1385,1020,210,50,1280,50,20,1350,35,1395,1020,210,50,1280,55,20,1355,40,8265,1650,1309,543,3795,1421,704,7065,1045,265470000,57755000,40655000,14330000,119320000,44609000,17282000,211075000,46438000
Missouri,"Arts, Entertainment, and Recreation",2015,9994,5645,1360,1227,8232,1279,232,9743,251,10620,5645,1360,1235,8240,1380,350,9970,650,202793,7784,8812,16389,33419,49214,24378,112879,84942,8127715000,302705000,156791000,292439000,761625000,992376000,1218897000,3114354000,4009006000
Missouri,Construction,2015,64584,41534,11370,5890,58794,4645,650,64089,495,65260,41535,11370,5900,58805,4760,845,64410,850,571155,69685,74838,77913,222500,168357,84314,479290,86569,32841180000,2651935000,2975140000,3747552000,9377915000,10233940000,6018261000,25882135000,6539302000
Missouri,Educational Services,2015,7350,3235,1020,1040,5295,1350,395,7040,310,8140,3235,1020,1055,5310,1420,500,7230,910,376025,5432,7041,13668,26301,56273,67956,151935,223784,14934764000,139511000,124484000,233484000,502166000,1513249000,2221618000,4273834000,10644616000
Missouri,Finance and Insurance,2015,28706,19250,3502,1265,24017,1920,775,26712,1994,53440,19270,3620,1635,24525,5395,3980,33900,19540,626189,34213,21742,16303,72528,71969,73692,221133,401216,44612453000,1446271000,1053127000,880379000,3394031000,4026803000,4641115000,12278341000,31927861000
Missouri,Health Care and Social Assistance,2015,122308,90570,12410,7540,110520,7379,2472,120371,1937,145235,90600,12475,7820,110895,9440,7560,127895,17340,2056521,107861,83101,100628,291651,308688,340908,942615,1108743,86731903000,2717169000,3121295000,3951463000,9791917000,10204159000,10792553000,30988130000,55535223000
Missouri,Information,2015,6249,2850,865,694,4409,707,304,5420,829,11960,2850,865,735,4450,925,510,5885,6075,275732,4629,5623,8671,19319,22397,16241,60586,210432,18033095000,185149000,201147000,336251000,737753000,1156712000,892690000,2882546000,14875935000
Missouri,Management of Companies and Enterprises,2015,4030,245,60,131,436,735,1194,2365,1665,6040,245,60,135,440,740,1250,2430,3610,420870,277,264,778,1330,7355,40095,48780,371932,42150545000,58370000,21360000,48009000,128465000,461220000,2908410000,3498095000,38643428000
Missouri,Manufacturing,2015,27618,10275,4490,3898,18663,4725,1856,25244,2374,29535,10275,4495,3915,18685,5040,2230,25955,3580,1243120,19443,28391,48996,101668,170418,190340,499651,619974,64941901000,720089000,938048000,1879535000,3751384000,7508928000,9586472000,22650930000,34036711000
Missouri,"Mining, Quarrying, and Oil and Gas Extraction",2015,829,270,165,95,530,132,81,743,86,1325,270,165,105,540,290,200,1030,295,15937,497,1108,1093,2892,3647,3513,11174,4131,903521000,19566000,45869000,44459000,118401000,184829000,203718000,560414000,271109000
Missouri,Other,2015,2063,2005,56,2,2063,0,0,2063,0,2063,2005,56,2,2063,0,0,2063,0,1766,1362,380,0,1766,0,0,1766,0,13737000,12088000,592000,0,13737000,0,0,13737000,0
Missouri,Other Services (except Public Administration),2015,71139,44875,13920,6388,65183,4485,750,70418,721,76785,44900,14100,6705,65705,5730,2225,73660,3125,549469,84378,89536,83069,257409,160982,56960,479294,63385,15291683000,2029888000,2204492000,2159852000,6407108000,4280749000,1932822000,12764013000,2271639000
Missouri,"Professional, Scientific, and Technical Services",2015,62597,42020,8950,4860,55830,3579,1328,60737,1860,69290,42045,8970,4990,56005,4360,1910,62275,7015,787275,63815,58081,62943,185227,116674,101152,406860,373566,55494995000,3042340000,2781626000,3338856000,9183236000,7819501000,6985125000,24221645000,30738263000
Missouri,Real Estate and Rental and Leasing,2015,24825,18567,2548,1283,22398,1081,541,24020,805,31055,18770,2585,1405,22760,1640,1515,25915,5140,180900,27660,15945,15767,59615,32529,29501,124642,53879,7787830000,920815000,598417000,588925000,2121155000,1604781000,1170746000,5001195000,2701895000
Missouri,Retail Trade,2015,63469,33219,12678,7425,53322,5953,1546,60821,2648,105885,33325,12900,8200,54425,9505,5665,69595,36290,1498749,61589,82486,95587,239920,203748,116948,564485,927364,38602835000,1493093000,1989578000,2506052000,5994120000,6792776000,4315712000,17211735000,21232586000
Missouri,Total,2015,124388,77174,18710,11619,107503,11119,2746,121368,3020,158191,77286,18889,12177,108352,14686,7882,130920,27271,2442316,118989,123138,154541,396668,418376,333295,1148339,1293977,109135528000,3950443000,4045706000,5284246000,13280395000,15499173000,14382279000,43161847000,65973681000
Missouri,Transportation and Warehousing,2015,20679,12190,2755,1830,16775,1742,731,19248,1431,23785,12195,2760,1835,16790,1870,1015,19675,4110,409255,18252,18189,23567,60707,54986,46912,166838,216154,17419271000,662648000,639709000,891868000,2225459000,2205236000,1962955000,6523907000,9773224000
Missouri,Utilities,2015,537,140,45,30,215,185,47,447,90,1860,140,45,30,215,295,285,795,1065,70449,277,220,373,969,9660,4041,15862,38476,6750686000,5936000,8614000,17780000,37296000,710510000,314576000,1132399000,3910119000
Missouri,Wholesale Trade,2015,31234,14083,4380,3489,21952,4454,1948,28354,2880,38525,14100,4420,3670,22190,5445,3450,31085,7440,628260,24434,28678,44775,98499,136376,110601,350120,266151,34951325000,1236637000,1421442000,2371447000,5056142000,7768335000,6168282000,19328875000,14640072000
Montana,Accommodation and Food Services,2015,15690,5695,3367,3190,12252,2935,263,15450,240,17400,5710,3370,3275,12355,3260,815,16430,970,248275,8701,22295,43849,75011,101859,33152,210955,35272,4119761000,278029000,294611000,645899000,1225198000,1659405000,529248000,3437091000,638438000
Montana,Administrative and Support and Waste Management and Remediation Services,2015,8319,5705,1170,610,7485,373,119,7977,342,8850,5705,1175,615,7495,415,215,8125,725,100633,7826,7479,7274,23401,11953,8817,47340,37266,3415754000,281615000,212071000,219447000,745537000,362547000,247636000,1474935000,1348173000
Montana,"Agriculture, Forestry, Fishing and Hunting",2015,1765,1465,175,60,1700,25,20,1745,20,1800,1465,175,60,1700,25,45,1770,30,5231,1764,1114,649,3694,687,134,4906,114,217716000,78833000,35153000,24842000,145068000,32016000,5732000,202961000,3932000
Montana,"Arts, Entertainment, and Recreation",2015,5348,3215,960,610,4785,424,77,5286,62,5970,3215,970,630,4815,530,115,5460,510,56697,4111,6236,8134,18937,14751,10852,46092,6108,1043726000,127197000,113515000,131227000,377661000,233958000,141257000,783981000,146227000
Montana,Construction,2015,26279,20175,3505,1515,25195,835,110,26140,139,26455,20180,3505,1515,25200,845,135,26180,275,124180,28830,22872,18830,70885,27952,9330,113645,5980,6360170000,1143605000,941103000,900391000,3000950000,1705012000,664402000,5775685000,399434000
Montana,Educational Services,2015,1885,1010,330,185,1525,230,80,1835,50,1950,1010,330,185,1525,230,125,1880,70,30191,1522,2211,2467,6375,8229,9524,25211,2031,704806000,41144000,35118000,45091000,127647000,173034000,277026000,612181000,40362000
Montana,Finance and Insurance,2015,6243,4160,765,338,5263,344,137,5744,499,9725,4170,775,410,5355,930,555,6840,2885,82576,7224,4648,4135,16394,12445,8990,39066,40905,4563911000,270156000,185952000,184427000,662642000,587983000,430914000,1753692000,2692410000
Montana,Health Care and Social Assistance,2015,15116,7870,2970,1725,12565,1381,711,14657,459,17875,7870,2970,1765,12605,1725,1955,16285,1590,337987,13640,19336,22060,55581,54997,85407,197661,133214,14315866000,521623000,684486000,869528000,2104151000,1944954000,2950292000,7052504000,6993592000
Montana,Information,2015,2082,1060,305,150,1515,133,107,1755,327,3190,1060,305,155,1520,140,410,2070,1120,43492,1731,1980,1823,5922,2531,8029,19524,23692,2087331000,60170000,59565000,63066000,197033000,120765000,447103000,874488000,1199517000
Montana,Management of Companies and Enterprises,2015,600,60,5,30,95,120,145,360,240,670,60,5,30,95,120,145,360,310,18430,64,0,73,149,895,4500,5645,12746,1413370000,3364000,0,5290000,9084000,50588000,372287000,439065000,971081000
Montana,Manufacturing,2015,6276,3170,1085,950,5205,643,210,6058,218,6380,3170,1090,950,5210,675,225,6110,270,80373,4806,6053,10777,24162,14613,9792,61179,10414,3701167000,150000000,183979000,368795000,785157000,556566000,377911000,2224069000,930385000
Montana,"Mining, Quarrying, and Oil and Gas Extraction",2015,1855,1150,200,135,1485,95,55,1635,220,1985,1150,200,135,1485,100,55,1640,345,31693,1582,1230,1650,4590,2725,2591,10178,15270,2659502000,79922000,65227000,90013000,241336000,223201000,162385000,639778000,1446880000
Montana,Other,2015,77,76,1,0,77,0,0,77,0,77,76,1,0,77,0,0,77,0,74,67,0,0,74,0,0,74,0,1169000,1167000,0,0,1169000,0,0,1169000,0
Montana,Other Services (except Public Administration),2015,15080,9885,2985,1282,14152,668,85,14905,175,15705,9890,2990,1315,14195,920,135,15250,455,81160,18228,19387,16399,54536,19590,1898,78656,1640,2211305000,468613000,487466000,424818000,1396729000,534976000,90052000,2114965000,71717000
Montana,"Professional, Scientific, and Technical Services",2015,17516,12868,2170,1047,16085,638,214,16937,579,18555,12875,2185,1070,16130,935,400,17465,1090,98967,18313,13858,12765,45511,17217,9771,75731,22112,4797944000,775690000,642098000,634039000,2074544000,1026864000,654139000,3918044000,830770000
Montana,Real Estate and Rental and Leasing,2015,8577,7215,590,345,8150,191,59,8400,177,9550,7220,605,490,8315,305,310,8930,620,28775,9118,3593,4283,17302,4160,1371,24512,3859,951406000,310429000,103219000,120452000,546281000,113064000,42494000,778576000,155959000
Montana,Retail Trade,2015,18287,9156,4013,2363,15532,1542,394,17468,819,23955,9190,4095,2520,15805,2140,1295,19240,4715,288369,16698,26493,30448,74142,46430,26688,153477,125983,7590703000,445357000,661575000,870154000,1989039000,1469951000,865935000,4545124000,2786146000
Montana,Total,2015,32222,20254,5245,3090,28589,2236,521,31346,876,37270,20279,5282,3239,28800,2963,1597,33360,3910,375041,31161,34488,41014,106663,79105,58900,244668,130373,14227065000,1093207000,1045847000,1286335000,3425389000,2630528000,2261250000,8317167000,5909898000
Montana,Transportation and Warehousing,2015,6195,4114,795,400,5309,409,160,5878,317,6905,4115,795,400,5310,435,280,6025,880,66439,6041,5012,4729,16435,12014,7526,40097,17087,2818048000,213180000,178993000,191825000,605548000,510646000,258341000,1564700000,904519000
Montana,Utilities,2015,433,170,30,70,270,85,20,375,58,1075,170,30,75,275,120,45,440,635,15356,238,95,955,1442,1998,618,4851,4478,1319379000,4639000,4834000,62510000,83464000,156239000,46006000,345684000,409359000
Montana,Wholesale Trade,2015,6085,2785,828,560,4173,711,376,5260,825,7970,2790,835,600,4225,965,725,5915,2055,81076,4210,4866,5822,16461,18288,10298,51682,25713,3997520000,174188000,204427000,269802000,718460000,814027000,538771000,2379134000,1400024000
Nebraska,Accommodation and Food Services,2015,17049,6155,3049,3253,12457,3531,484,16472,577,22130,6175,3065,3275,12515,4300,2045,18860,3270,371680,10335,20534,44378,75590,122106,61425,259450,111750,5369475000,225536000,239070000,531766000,1002295000,1730805000,878304000,3616880000,1745584000
Nebraska,Administrative and Support and Waste Management and Remediation Services,2015,11883,7390,1640,1025,10055,820,288,11163,720,13360,7390,1650,1050,10090,860,365,11315,2045,304112,11007,10796,13144,35616,27386,35479,103491,198907,10831082000,386316000,314281000,399744000,1126261000,871756000,988282000,3179461000,7595607000
Nebraska,"Agriculture, Forestry, Fishing and Hunting",2015,925,675,115,45,835,40,20,895,30,965,675,115,45,835,40,30,905,60,5995,744,782,558,2194,709,190,3430,2565,304125000,42401000,28447000,26876000,102251000,40057000,7874000,165220000,138905000
Nebraska,"Arts, Entertainment, and Recreation",2015,4194,2485,560,455,3500,480,95,4075,119,4400,2490,560,455,3505,520,120,4145,255,70760,3507,3549,5919,13421,19424,9764,46429,17847,1141380000,102861000,63595000,106982000,286851000,326609000,154314000,841935000,183205000
Nebraska,Construction,2015,30991,20760,5135,2710,28605,1889,242,30736,255,31225,20760,5135,2710,28605,1920,325,30850,375,223825,33476,33396,35522,102496,71638,18191,195810,23844,10989500000,1217247000,1239473000,1591705000,4052222000,3879068000,1146206000,9286935000,1421418000
Nebraska,Educational Services,2015,2523,1075,390,310,1775,515,125,2415,108,2830,1075,390,310,1775,595,235,2605,225,94150,1783,2547,3907,8539,21325,11828,43835,49772,2513789000,40173000,33768000,69018000,155032000,476226000,324607000,1011344000,1491237000
Nebraska,Finance and Insurance,2015,13051,8590,1499,704,10793,832,366,11991,1060,21495,8605,1555,930,11090,2245,1825,15160,6335,310671,14739,9112,8007,32252,27444,29252,90888,216036,22369932000,582228000,440472000,420959000,1475958000,1511767000,1777054000,4878116000,17194020000
Nebraska,Health Care and Social Assistance,2015,22256,10650,4095,2715,17460,2987,1028,21475,781,27645,10690,4115,2805,17610,3990,2570,24170,3475,627505,18232,27089,35920,81748,117568,128115,329972,287231,28211085000,947452000,1152363000,1566761000,3686424000,4573614000,5450995000,13805660000,14036432000
Nebraska,Information,2015,2704,1003,349,315,1667,387,173,2227,477,4425,1005,350,315,1670,540,225,2435,1990,104695,1602,2255,3795,8046,12965,10834,34068,64268,6283620000,50485000,75623000,145199000,292097000,654237000,613905000,1644609000,4265017000
Nebraska,Management of Companies and Enterprises,2015,1454,70,50,66,186,260,386,832,622,1870,70,50,75,195,265,405,865,1005,102045,105,252,300,680,2880,11115,14675,87370,8792690000,5755000,19167000,42085000,70000000,180280000,725705000,975985000,7816705000
Nebraska,Manufacturing,2015,8222,2985,1225,1110,5320,1356,604,7280,942,8925,2985,1225,1115,5325,1450,740,7515,1410,433563,5081,6938,12037,26686,44371,48206,138130,254643,19772544000,177460000,222416000,444516000,940967000,1950730000,2193809000,5945282000,11889201000
Nebraska,"Mining, Quarrying, and Oil and Gas Extraction",2015,562,335,65,65,465,25,37,527,35,640,335,65,65,465,25,40,530,110,5515,495,424,674,1769,180,1335,3921,990,319912000,24456000,23489000,33935000,94020000,7399000,84007000,215568000,64546000
Nebraska,Other,2015,119,114,5,0,119,0,0,119,0,119,114,5,0,119,0,0,119,0,145,114,31,0,145,0,0,145,0,2198000,1902000,296000,0,2198000,0,0,2198000,0
Nebraska,Other Services (except Public Administration),2015,26783,17628,4750,2259,24637,1494,303,26434,349,28925,17640,4810,2395,24845,1995,975,27815,1110,184081,31720,30519,29219,92046,50636,18542,165636,16420,4903250000,781078000,763924000,712632000,2271215000,1315845000,578840000,4286930000,573090000
Nebraska,"Professional, Scientific, and Technical Services",2015,21600,14400,2960,1762,19122,1206,394,20722,878,23145,14400,2965,1800,19165,1470,630,21265,1880,435391,21173,19078,23004,63900,37367,26382,131233,182053,22423501000,907231000,893044000,1152617000,2986790000,2237023000,1876685000,7302213000,9729176000
Nebraska,Real Estate and Rental and Leasing,2015,9222,7210,690,385,8285,313,230,8828,394,10665,7225,720,410,8355,355,625,9335,1330,53886,9339,4120,4620,18441,8798,10929,41501,11251,2258236000,328900000,143320000,147901000,632364000,368046000,489555000,1675497000,533525000
Nebraska,Retail Trade,2015,24585,11608,5327,3111,20046,2189,764,22999,1586,36760,11640,5445,3370,20455,3365,2475,26295,10465,539090,22114,34659,39727,96878,70526,52091,224245,308112,13542092000,561441000,801628000,994021000,2363993000,2198852000,1993804000,6694213000,6602612000
Nebraska,Total,2015,42993,25106,6977,4386,36469,3955,1016,41440,1553,53719,25142,7064,4626,36832,5382,3137,45351,8368,870279,41000,45808,58288,145096,145069,116580,406745,463534,36967924000,1430787000,1487901000,1943151000,4861839000,5304760000,4880985000,15047584000,21920340000
Nebraska,Transportation and Warehousing,2015,10991,7415,1349,675,9439,562,256,10257,734,11950,7415,1350,685,9450,600,370,10420,1530,146856,10433,8445,8098,27889,18196,17494,69942,60751,6672278000,356420000,310059000,306760000,1004881000,801542000,801788000,2848814000,3072859000
Nebraska,Utilities,2015,176,45,5,5,55,30,5,90,86,600,45,5,5,55,35,10,100,500,4618,42,0,0,127,491,0,789,3790,524294000,2522000,0,0,6717000,35064000,0,55596000,466065000
Nebraska,Wholesale Trade,2015,11433,4519,1684,1224,7427,1746,794,9967,1466,16045,4520,1725,1315,7560,2340,1675,11575,4470,211061,7467,10769,14226,33620,47830,31637,120111,86371,12441038000,335857000,506133000,697080000,1617975000,2382825000,1715091000,6086898000,6050879000
Nevada,Accommodation and Food Services,2015,22202,7026,4300,4360,15686,4499,921,21106,1096,31530,7045,4315,4485,15845,5330,2680,23855,7675,1590141,10635,28999,58872,98660,171070,137217,407366,1182619,46566307000,404650000,440986000,996852000,1845615000,3392802000,2918955000,8166287000,38397535000
Nevada,Administrative and Support and Waste Management and Remediation Services,2015,19560,10990,2780,1900,15670,2005,740,18415,1145,21485,10990,2785,1930,15705,2140,820,18665,2820,558546,16439,18284,25173,60227,77706,88109,229537,324013,18289012000,780712000,584674000,858280000,2239127000,2300231000,2272038000,6929264000,11007023000
Nevada,"Agriculture, Forestry, Fishing and Hunting",2015,265,220,40,0,260,5,0,265,0,265,220,40,0,260,5,0,265,0,607,226,156,0,442,0,0,607,0,28363000,10907000,5193000,0,24278000,0,0,28363000,0
Nevada,"Arts, Entertainment, and Recreation",2015,6393,3840,685,610,5135,755,304,6194,199,7305,3860,685,615,5160,820,820,6800,505,141358,4605,4293,7637,17171,30448,41783,98095,39200,4573056000,409206000,226629000,199308000,860829000,807975000,1136710000,3176627000,1185285000
Nevada,Construction,2015,23605,12015,4160,3370,19545,2857,607,23009,596,23920,12020,4160,3375,19555,2895,655,23105,815,327555,19363,27472,45335,92360,103785,64530,263237,60042,17412640000,1129181000,1156501000,2060596000,4364715000,4992522000,3185816000,12698408000,4505795000
Nevada,Educational Services,2015,3377,1760,430,375,2565,480,176,3221,156,3620,1760,435,385,2580,500,215,3295,325,56070,2360,2747,4776,10085,15953,13711,42151,13226,1945030000,95959000,75231000,100784000,278400000,441441000,513640000,1368618000,544590000
Nevada,Finance and Insurance,2015,13190,8690,1402,635,10727,578,503,11808,1382,20840,8700,1430,655,10785,875,1275,12935,7905,174048,13736,8789,7722,30732,12055,14034,58811,114218,11059291000,700669000,412715000,418484000,1569289000,756079000,1065800000,3522205000,7463611000
Nevada,Health Care and Social Assistance,2015,29004,15445,5920,3555,24920,2488,632,28040,964,34665,15450,5965,3630,25045,3245,1695,29985,4680,564558,24362,39509,46669,111005,94341,81150,291698,268182,28665066000,1903322000,1714201000,2179953000,5810251000,3930083000,3338420000,13260041000,15182432000
Nevada,Information,2015,4518,2610,580,290,3480,315,136,3931,587,6360,2615,585,300,3500,350,185,4035,2325,83192,3508,3732,3407,10985,8584,6503,28237,54538,5449312000,221442000,219830000,213068000,667934000,504209000,459485000,1765853000,3656451000
Nevada,Management of Companies and Enterprises,2015,2075,445,35,50,530,290,443,1263,812,2550,445,40,50,535,295,500,1330,1220,87673,385,167,379,954,2920,11067,14935,72738,7946521000,112676000,6596000,25423000,145590000,216030000,770382000,1131994000,6814527000
Nevada,Manufacturing,2015,8727,3540,1570,1110,6220,1316,548,8084,643,8970,3540,1570,1110,6220,1350,600,8170,800,193598,5721,8917,12815,30171,39731,29246,114585,55960,10130355000,239135000,319859000,484676000,1150382000,1721209000,1414939000,5129617000,3469496000
Nevada,"Mining, Quarrying, and Oil and Gas Extraction",2015,999,480,133,80,693,124,85,902,97,1060,480,135,80,695,125,85,905,155,62836,598,786,810,2388,4156,13154,20213,42340,6037326000,93781000,59294000,83169000,256161000,229996000,1115380000,1630147000,4383163000
Nevada,Other,2015,118,111,6,0,117,1,0,118,0,118,111,6,0,117,1,0,118,0,173,94,39,0,133,0,0,173,0,4333000,2719000,1100000,0,3819000,0,0,4333000,0
Nevada,Other Services (except Public Administration),2015,19668,12220,3790,1635,17645,1242,318,19205,463,21950,12230,3835,1710,17775,1720,845,20340,1610,161455,20656,24534,20404,65954,42628,17084,129965,27006,5002965000,661678000,711571000,612865000,1999000000,1178054000,506231000,3796770000,1041705000
Nevada,"Professional, Scientific, and Technical Services",2015,40943,30135,4365,2520,37020,2040,721,39781,1162,43790,30145,4375,2610,37130,2235,1045,40410,3380,291650,40255,28146,31743,100820,61538,31372,199740,89438,17990605000,2677080000,1511812000,1897289000,6116515000,3981576000,1845065000,12218390000,5643610000
Nevada,Real Estate and Rental and Leasing,2015,17321,13050,1783,760,15593,663,431,16687,634,21290,13100,1810,815,15725,890,1445,18060,3230,144165,18525,11663,9850,40341,17226,22187,81165,62124,6232020000,782229000,402473000,363122000,1563713000,742486000,934156000,3306990000,2850114000
Nevada,Retail Trade,2015,25870,12664,4810,3153,20627,1989,906,23522,2348,43410,12745,4885,3475,21105,2910,2215,26230,17180,695395,21712,31913,40410,94539,61299,48261,208478,483754,19256428000,690895000,827658000,1055252000,2592205000,1933127000,2002731000,6656239000,12504429000
Nevada,Total,2015,50562,29093,7831,5216,42140,4629,1588,48357,2205,63383,29141,7901,5416,42458,5591,3375,51424,11959,1129965,43717,51716,68888,164321,162979,147235,474535,655430,46595673000,2351489000,1899468000,2559075000,6810032000,6108453000,5837376000,18755861000,27839812000
Nevada,Transportation and Warehousing,2015,6847,3340,760,684,4784,672,449,5905,942,7825,3340,760,700,4800,685,515,6000,1825,253836,4401,4740,8101,17823,19696,35340,76553,171822,10383290000,187900000,167669000,269410000,643445000,774330000,1285863000,2853849000,7314193000
Nevada,Utilities,2015,281,105,30,20,155,36,36,227,54,645,110,30,20,160,55,105,320,325,19352,183,83,192,579,670,1503,3062,8026,2054718000,7341000,3831000,14104000,32201000,60269000,132605000,257170000,875758000
Nevada,Wholesale Trade,2015,13243,6355,1628,1107,9090,1405,1044,11539,1704,14845,6355,1635,1135,9125,1525,1175,11825,3020,172771,9529,9988,12727,33278,31147,22865,91358,78939,10407132000,556677000,484332000,618197000,1704151000,1642066000,1502986000,5209412000,5064942000
New Hampshire,Accommodation and Food Services,2015,15282,5820,2810,3103,11733,2852,366,14951,331,18420,5835,2825,3125,11785,3295,1010,16090,2330,278425,8308,19040,42280,69730,99165,38961,208050,70338,5381470000,345171000,328861000,713355000,1388540000,1893693000,709751000,3998610000,1378562000
New Hampshire,Administrative and Support and Waste Management and Remediation Services,2015,10609,6640,1595,835,9070,702,230,10002,607,11705,6640,1600,845,9085,785,290,10160,1545,214995,9527,10076,10605,30974,25087,16287,77188,132570,9909105000,460792000,426335000,425119000,1349070000,1211251000,706685000,3464346000,6119257000
New Hampshire,"Agriculture, Forestry, Fishing and Hunting",2015,705,510,120,50,680,20,0,700,5,710,510,120,50,680,25,0,705,5,2915,954,716,635,2424,421,0,2845,0,132024000,30983000,25134000,33994000,94698000,34624000,0,129322000,0
New Hampshire,"Arts, Entertainment, and Recreation",2015,3736,2075,575,425,3075,470,89,3634,102,3905,2075,575,425,3075,495,135,3705,200,61613,2794,3602,5689,12282,15142,11952,44003,15446,1358416000,296827000,133686000,130091000,569432000,333085000,154250000,1142536000,162385000
New Hampshire,Construction,2015,19571,13885,2815,1435,18135,1193,135,19463,108,19690,13885,2815,1435,18135,1215,205,19555,135,121776,21488,18310,19374,59421,40827,11088,116446,4247,7574394000,1053746000,929111000,1120589000,3122904000,2807645000,844471000,7212749000,287737000
New Hampshire,Educational Services,2015,2952,1310,515,376,2201,485,145,2831,121,3140,1310,520,435,2265,515,160,2940,200,123875,2090,3396,4924,10502,17238,15417,46880,75999,5111087000,63420000,82580000,120483000,270210000,493987000,579104000,1535487000,3465062000
New Hampshire,Finance and Insurance,2015,5254,2760,670,299,3729,335,321,4385,869,9700,2760,675,375,3810,555,1375,5740,3960,136371,4821,4027,3266,12594,10532,19731,44390,85640,11567772000,274517000,264125000,260709000,830105000,882046000,1169718000,3036674000,7876654000
New Hampshire,Health Care and Social Assistance,2015,13511,5300,3213,2035,10548,1578,682,12808,703,18570,5305,3225,2150,10680,2105,2010,14795,3775,447540,10466,21719,26757,59449,58692,88469,209633,232571,22322545000,450668000,906805000,1396943000,2778979000,2387363000,3370358000,8653316000,13170278000
New Hampshire,Information,2015,2301,885,350,235,1470,269,129,1868,433,3590,885,350,235,1470,350,175,1995,1595,68190,1389,2071,2822,6715,7239,8779,27158,39859,5952312000,77518000,108223000,198439000,407223000,469339000,561214000,1825685000,4087535000
New Hampshire,Management of Companies and Enterprises,2015,842,35,15,25,75,100,216,391,451,1080,35,15,25,75,105,225,405,675,45845,70,44,156,290,1582,9028,10900,34945,4534715000,6470000,2176000,14467000,24195000,132868000,496197000,653260000,3881455000
New Hampshire,Manufacturing,2015,8628,3200,1420,1214,5834,1651,421,7906,722,8940,3200,1420,1220,5840,1710,480,8030,910,299235,5620,7793,13376,30209,58172,26914,135726,136999,18848055000,236846000,359115000,684935000,1460817000,3055297000,1642516000,7210497000,9915581000
New Hampshire,"Mining, Quarrying, and Oil and Gas Extraction",2015,222,135,20,15,170,25,15,210,12,245,135,20,15,170,25,25,220,25,1029,167,150,111,506,53,168,933,0,69240000,10236000,8440000,8997000,33776000,2988000,11793000,60448000,0
New Hampshire,Other,2015,67,63,3,0,66,1,0,67,0,67,63,3,0,66,1,0,67,0,104,54,18,0,72,0,0,104,0,2479000,1909000,394000,0,2303000,0,0,2479000,0
New Hampshire,Other Services (except Public Administration),2015,17225,10790,3700,1510,16000,743,202,16945,280,18335,10800,3715,1550,16065,920,425,17410,925,111828,20770,24255,18892,64488,22262,8413,98829,10014,3377441000,631538000,642329000,527549000,1823826000,673693000,298412000,2978525000,322042000
New Hampshire,"Professional, Scientific, and Technical Services",2015,17707,11350,2495,1570,15415,1137,375,16927,780,18915,11350,2505,1605,15460,1310,480,17250,1665,152512,18236,16344,19874,54878,33361,16609,108897,42278,10261665000,1146778000,1009893000,1450822000,3648892000,2637336000,1418234000,7992400000,2224116000
New Hampshire,Real Estate and Rental and Leasing,2015,5731,4010,805,293,5108,241,132,5481,250,6995,4030,835,335,5200,395,600,6195,800,35335,6408,4999,3647,15397,7248,4841,29015,5407,1754503000,285135000,207885000,155221000,696319000,421217000,210286000,1419967000,282825000
New Hampshire,Retail Trade,2015,19640,9565,4037,2185,15787,1786,518,18091,1549,30250,9580,4110,2310,16000,2385,1450,19835,10415,493322,17833,26114,27653,72180,56409,35195,167960,311274,13736821000,549218000,711580000,928102000,2205856000,2334373000,1717669000,6374976000,7002489000
New Hampshire,Total,2015,30574,16825,5399,3321,25545,2910,784,29239,1335,37669,16851,5442,3450,25743,3535,2009,31287,6382,576424,28298,35685,44172,108155,103317,79876,291348,285076,28076320000,1312511000,1402944000,1867368000,4582823000,4676515000,3795942000,13055280000,15021040000
New Hampshire,Transportation and Warehousing,2015,3610,1940,555,377,2872,300,133,3305,305,4020,1940,555,380,2875,315,160,3350,670,63971,2842,3374,4266,11279,8427,8835,33632,24440,2627986000,135833000,126327000,159246000,453944000,331976000,310682000,1318541000,1146967000
New Hampshire,Utilities,2015,242,85,20,5,110,15,48,173,69,605,85,20,5,110,55,170,335,270,14165,170,134,0,358,228,2040,3190,7488,1346002000,10313000,5669000,0,18781000,16767000,175780000,250075000,775463000
New Hampshire,Wholesale Trade,2015,8245,3564,1295,717,5576,1016,524,7116,1129,9195,3580,1295,730,5605,1110,670,7385,1810,121999,6170,8091,8325,23784,27470,18747,76356,42851,8974646000,420030000,497561000,559314000,1548541000,1853161000,1291393000,5165305000,3648775000
New Jersey,Accommodation and Food Services,2015,89850,45891,16451,13160,75502,12411,953,88866,984,103050,45950,16460,13265,75675,13170,2520,91365,11685,1481810,77020,108432,179163,364660,453508,112464,931324,549947,29689270000,2289855000,1835607000,3026365000,7152720000,8194952000,2170416000,17529352000,12149873000
New Jersey,Administrative and Support and Waste Management and Remediation Services,2015,62059,41300,7430,4880,53610,4787,1664,60061,1998,69955,41310,7435,4925,53670,4965,2025,60660,9295,1582464,54015,49125,65148,168499,181347,241599,593911,983869,63407276000,4105910000,2142175000,3008934000,9270476000,7781722000,8206492000,25403404000,37449534000
New Jersey,"Agriculture, Forestry, Fishing and Hunting",2015,1010,755,135,50,940,50,10,1000,10,1010,755,135,50,940,50,10,1000,10,4461,1005,724,423,2443,1153,0,4432,0,185476000,42159000,27685000,12549000,97879000,44147000,0,180685000,0
New Jersey,"Arts, Entertainment, and Recreation",2015,16826,9611,2282,1890,13783,2249,512,16544,282,18015,9630,2290,1900,13820,2295,745,16860,1155,298493,12098,14914,25749,52858,91860,79654,229563,60321,9248976000,770122000,438687000,622297000,1833062000,2073237000,2884762000,6919837000,1557942000
New Jersey,Construction,2015,104933,74495,15385,8004,97884,5782,730,104396,537,105395,74495,15385,8025,97905,5810,800,104515,880,730765,115860,99450,106495,321805,214401,102865,642955,82766,50712885000,5712960000,5255320000,6586595000,17554875000,16288188000,9023469000,43179300000,7055627000
New Jersey,Educational Services,2015,17711,8030,3140,2580,13750,2850,754,17354,357,19125,8035,3140,2605,13780,3090,945,17815,1310,554670,12820,21233,34690,68795,118948,107178,297415,207167,21464200000,460145000,430132000,708830000,1599750000,3879997000,4626607000,10293515000,8879705000
New Jersey,Finance and Insurance,2015,31407,19645,4433,1871,25949,2182,1084,29215,2192,59125,19685,4575,2105,26365,3785,3975,34125,25000,955881,34304,28142,24044,86737,76169,80183,245837,706075,112523724000,2188306000,1932738000,2113585000,6254559000,6703614000,7258215000,20724051000,91211815000
New Jersey,Health Care and Social Assistance,2015,109935,52776,25415,14492,92683,11835,3248,107766,2169,137290,52930,25615,15220,93765,14735,9360,117860,19430,2841346,104574,166882,192883,464403,441624,482327,1393053,1445711,137597716000,5297896000,7401481000,9571139000,22274550000,19942142000,18747914000,61259934000,76175562000
New Jersey,Information,2015,10063,5439,1150,880,7469,1089,430,8988,1075,18575,5440,1150,910,7500,1215,495,9210,9365,438342,8028,7368,11245,27126,36976,32583,101647,333198,44510214000,555159000,460063000,774158000,1821504000,3035612000,3461896000,8743184000,35477414000
New Jersey,Management of Companies and Enterprises,2015,4662,405,151,125,681,602,1012,2295,2367,7515,405,155,130,690,615,1060,2365,5150,634490,520,815,1075,2410,9817,39450,51677,582729,83747515000,47440000,92925000,87145000,227510000,879613000,3766845000,4873968000,78866015000
New Jersey,Manufacturing,2015,35929,13655,6279,4958,24892,6825,2114,33831,2098,37065,13660,6285,4985,24930,6965,2390,34285,2780,1084725,25538,40237,64113,135204,260253,237504,676285,366698,70150443000,1244904000,1813345000,3111708000,6462919000,14281929000,13591323000,36695719000,30683781000
New Jersey,"Mining, Quarrying, and Oil and Gas Extraction",2015,330,135,30,45,210,41,31,282,48,390,135,30,45,210,50,35,295,95,5839,186,169,477,971,858,425,2578,1995,432626000,12791000,8023000,28183000,57570000,55001000,44545000,190198000,128359000
New Jersey,Other,2015,388,366,18,4,388,0,0,388,0,388,366,18,4,388,0,0,388,0,462,292,118,52,462,0,0,462,0,10353000,8765000,1399000,189000,10353000,0,0,10353000,0
New Jersey,Other Services (except Public Administration),2015,113251,75421,20352,9976,105749,5998,774,112521,730,117915,75465,20410,10230,106105,6625,1605,114335,3580,763855,138200,131005,131347,400780,210507,71131,686235,72125,23449820000,3663540000,3485355000,3890551000,11046405000,6189631000,2764863000,20191030000,3097810000
New Jersey,"Professional, Scientific, and Technical Services",2015,138730,97993,16703,9737,124433,8803,2684,135920,2810,146755,98040,16740,9880,124660,9585,3465,137710,9045,1608210,148115,107922,126949,383180,303967,245607,935775,669529,143271745000,9135260000,6690312000,9114349000,24956155000,24903308000,21764403000,71801530000,71274444000
New Jersey,Real Estate and Rental and Leasing,2015,36252,25505,5167,2519,33191,1721,508,35420,832,44300,25535,5285,2690,33510,2270,1160,36940,7360,282615,41595,33660,33136,108611,56512,27725,194140,86769,16397295000,1787161000,1463266000,1587773000,4856101000,3316624000,1587843000,9944940000,6346260000
New Jersey,Retail Trade,2015,111577,71415,19256,9709,100380,6816,1679,108875,2702,157785,71560,19675,10265,101500,8905,4220,114625,43160,2293645,129010,125985,126848,381970,248381,156493,792304,1458727,66811291000,3743415000,3510045000,3751843000,11010545000,10236255000,7037392000,28424866000,37360899000
New Jersey,Total,2015,193960,119455,31615,18942,170012,16663,3933,190608,3352,230961,119596,31874,19500,170970,19156,8119,198245,32716,3558619,198703,206897,252624,658224,619428,494380,1772032,1786587,209072015000,9245606000,8458106000,11238144000,28941856000,30290809000,27025525000,86258190000,122813825000
New Jersey,Transportation and Warehousing,2015,33444,19610,4440,2985,27035,3313,1436,31784,1660,37410,19615,4480,2995,27090,3565,1860,32515,4895,826082,28690,28843,39246,97129,115137,125760,346241,471897,42306722000,1229443000,1180992000,1535511000,3974470000,4945644000,5410939000,14760423000,26889460000
New Jersey,Utilities,2015,519,195,55,30,280,65,32,377,142,1890,195,60,30,285,70,90,445,1445,96096,359,277,296,1106,1100,1479,5602,83175,11567920000,19838000,10884000,44344000,85437000,99577000,147436000,512373000,10256435000
New Jersey,Wholesale Trade,2015,64034,33287,9919,7104,50310,7529,2862,60701,3333,70300,33310,9975,7225,50510,8015,3835,62360,7940,1276895,59403,65618,93459,218710,257671,240427,720810,553836,115507825000,3765385000,3945254000,6251992000,14025155000,17607789000,17299947000,49246330000,66091244000
New Mexico,Accommodation and Food Services,2015,15593,4795,2715,3045,10555,3845,555,14955,638,21235,4805,2725,3120,10650,4450,1650,16750,4485,432470,7785,18337,42694,68905,138010,72950,280725,151358,7375955000,209210000,255915000,635016000,1102260000,2155636000,1317332000,4598435000,2750727000
New Mexico,Administrative and Support and Waste Management and Remediation Services,2015,8293,4505,1395,785,6685,683,203,7571,722,9275,4505,1395,795,6695,750,255,7700,1575,160410,7496,8774,10069,27178,22109,23498,75161,80269,5195471000,239087000,270449000,301825000,846156000,775875000,569002000,2281530000,2674410000
New Mexico,"Agriculture, Forestry, Fishing and Hunting",2015,441,285,75,65,425,11,0,436,5,455,285,80,65,430,20,0,450,5,2026,418,398,498,1570,0,0,1731,0,71374000,22498000,12926000,17566000,62638000,0,0,67009000,0
New Mexico,"Arts, Entertainment, and Recreation",2015,3202,1880,415,360,2655,350,115,3120,82,3345,1880,420,375,2675,390,155,3220,125,64007,2575,2477,4460,10023,11919,18740,43462,17902,1476108000,104681000,46233000,98588000,262428000,231974000,442163000,1015083000,399331000
New Mexico,Construction,2015,21236,12595,4005,2305,18905,1783,306,20994,242,21410,12595,4010,2305,18910,1815,370,21095,315,191550,21405,25946,30223,77837,64555,34684,181210,8963,8431600000,702022000,892690000,1223508000,2831981000,3007181000,1832216000,7869765000,490589000
New Mexico,Educational Services,2015,2748,1395,420,315,2130,370,150,2650,98,2870,1395,420,315,2130,370,180,2680,190,44955,2290,2668,4184,9391,12958,16630,40430,3686,1347871000,75750000,53208000,90582000,226771000,348538000,570587000,1191626000,118645000
New Mexico,Finance and Insurance,2015,7286,4415,975,270,5660,485,301,6446,840,13665,4435,985,360,5780,1260,1415,8455,5210,113855,8470,5713,3203,17830,14220,22880,57320,54067,6630001000,313386000,240894000,142072000,728090000,650393000,1243010000,3259358000,3250465000
New Mexico,Health Care and Social Assistance,2015,20160,9375,3920,2839,16134,2284,895,19313,847,25400,9375,3940,2885,16200,2970,2230,21400,4000,598648,15990,26088,37451,80018,87085,129932,300305,294087,24987050000,781742000,1074532000,1536917000,3420413000,3152251000,4233846000,10946287000,13886377000
New Mexico,Information,2015,2216,1100,242,175,1517,203,92,1812,404,3635,1100,245,185,1530,280,240,2050,1585,57011,1609,1265,1882,5477,5334,6054,18731,37171,2762711000,78374000,42663000,67850000,218424000,245252000,256789000,749511000,1973868000
New Mexico,Management of Companies and Enterprises,2015,951,45,35,40,120,175,230,525,426,1130,45,35,40,120,175,245,540,590,33775,75,145,298,535,1662,5676,7965,25810,2129915000,3674000,8420000,24701000,38415000,71148000,352579000,467815000,1662100000
New Mexico,Manufacturing,2015,6619,3030,1245,920,5195,770,235,6200,419,6790,3030,1245,920,5195,805,255,6255,535,117804,4949,6805,9663,24322,20007,8358,66821,32194,6101342000,171498000,220128000,356129000,852677000,824679000,404724000,2784735000,1956769000
New Mexico,"Mining, Quarrying, and Oil and Gas Extraction",2015,3485,1365,495,399,2259,622,201,3082,403,3920,1365,495,405,2265,630,260,3155,765,111680,2409,3323,5298,11100,21161,21983,54647,55223,8130787000,133558000,162115000,318439000,616287000,1200854000,1384450000,3219850000,4773883000
New Mexico,Other,2015,68,64,4,0,68,0,0,68,0,68,64,4,0,68,0,0,68,0,78,55,23,0,78,0,0,78,0,1431000,1200000,231000,0,1431000,0,0,1431000,0
New Mexico,Other Services (except Public Administration),2015,18914,11260,4025,1935,17220,1173,197,18590,324,20240,11260,4030,2020,17310,1505,390,19205,1035,131460,20935,25905,24208,71509,37553,6588,119247,9457,3581100000,546477000,660860000,630729000,1851726000,986273000,236216000,3193830000,305260000
New Mexico,"Professional, Scientific, and Technical Services",2015,21493,14415,2867,1728,19010,1136,457,20603,890,23620,14425,2875,1780,19080,1320,630,21030,2590,100978,21737,18332,21950,62350,32115,24002,121545,30970,5333459000,1078919000,878332000,1302626000,3274840000,1958148000,1813287000,7208290000,1313456000
New Mexico,Real Estate and Rental and Leasing,2015,9303,6925,1047,380,8352,336,159,8847,456,11605,6935,1075,415,8425,570,765,9760,1845,51415,10615,6642,4417,21899,8794,5656,36889,13587,2152485000,362531000,212600000,145419000,727403000,385209000,312050000,1449623000,668475000
New Mexico,Retail Trade,2015,20146,10167,3976,2189,16332,1684,587,18603,1543,32680,10200,4055,2345,16600,2475,1870,20945,11735,454995,18522,25807,27216,72165,52496,36498,165865,276977,11925190000,514219000,672402000,772571000,1975741000,1778658000,1225733000,5112881000,6529807000
New Mexico,Total,2015,34569,18880,5946,3837,28663,3374,941,32978,1591,43793,18905,5996,3995,28896,4311,2383,35590,8203,626284,31967,38866,50843,121676,117793,100171,339640,0,25145307000,1168075000,1253415000,1756079000,4177569000,4076293000,3930996000,12184858000,0
New Mexico,Transportation and Warehousing,2015,6064,3290,795,575,4660,586,212,5458,606,7010,3290,795,580,4665,620,265,5550,1460,92189,5219,4731,6944,17653,18325,10731,50661,29268,3942192000,184350000,139798000,268464000,617278000,737133000,476351000,1950107000,1578620000
New Mexico,Utilities,2015,716,405,90,45,540,70,25,635,81,1105,405,90,45,540,130,45,715,390,20617,801,587,568,1958,2974,490,6439,14397,1745983000,20892000,12637000,27293000,61198000,194329000,27368000,335932000,1417888000
New Mexico,Wholesale Trade,2015,7667,2864,1045,959,4868,913,511,6292,1375,9235,2875,1045,1020,4940,1020,695,6655,2580,104757,5303,6266,10746,23427,19434,10563,59045,42461,5429126000,232887000,263354000,500081000,1041966000,929328000,496804000,2694364000,2521911000
New York,Accommodation and Food Services,2015,230404,111552,43728,36417,191697,33955,3127,228779,1625,260845,111590,43785,36615,191990,36175,9145,237310,23535,3803505,196115,288575,498955,983645,1246760,480525,2711245,1089194,89842695000,5434570000,5013695000,9375005000,19823270000,28207385000,12834983000,60868910000,28911450000
New York,Administrative and Support and Waste Management and Remediation Services,2015,122716,83955,14010,9225,107190,9313,3383,119886,2830,134910,83970,14015,9380,107365,9635,4385,121385,13525,2905530,108792,91336,121946,322245,359168,501450,1184764,1713429,152820015000,6388379000,4154325000,5721240000,16270842000,16245196000,18403131000,51024535000,100313909000
New York,"Agriculture, Forestry, Fishing and Hunting",2015,2955,2255,415,175,2845,70,25,2940,15,2960,2255,415,175,2845,75,25,2945,15,14419,3397,2458,2152,8189,2603,702,13279,456,542806000,107295000,85027000,84847000,283286000,112811000,27134000,497696000,18044000
New York,"Arts, Entertainment, and Recreation",2015,58457,40415,6487,4615,51517,5155,1147,57819,638,62385,40420,6500,4650,51570,5395,1585,58550,3835,880725,47480,42545,62595,152780,207977,176475,542100,332741,41792821000,7156991000,2351883000,2236794000,11749761000,7197951000,7362274000,26494521000,15051686000
New York,Construction,2015,236026,169085,32190,18359,219634,13845,1916,235395,631,237355,169085,32200,18390,219675,14000,2250,235925,1430,1663740,242630,211065,246900,700605,513545,292505,1508535,150291,114501490000,11871305000,10413351000,14530545000,36816895000,37040580000,26431339000,100435520000,13730073000
New York,Educational Services,2015,37572,18180,5480,4270,27930,6600,1987,36517,1055,40770,18205,5525,4320,28050,7080,2840,37970,2800,2135725,27887,36662,58170,122790,283780,336448,743115,1392308,88937560000,1311463000,919216000,1451827000,3689285000,10677580000,14316478000,28686500000,60236639000
New York,Finance and Insurance,2015,79534,50685,11842,5270,67797,5630,2624,76051,3483,133790,50745,12090,5915,68750,8325,8260,85335,48455,2642058,85934,75120,66932,228175,200421,287115,717176,1922242,544657871000,7363357000,7225339000,8642165000,23246839000,40737357000,67592731000,131750682000,412282003000
New York,Health Care and Social Assistance,2015,227214,124425,44210,24634,193269,19710,8478,221457,5757,286810,124640,44500,25475,194615,26350,24190,245155,41655,7494040,225917,290637,327258,843899,759381,1378834,2983633,4506406,368004035000,12081341000,13092838000,15325825000,40503202000,34775292000,50253508000,125626443000,242106516000
New York,Information,2015,39654,23796,4970,3394,32160,3752,1481,37393,2261,57365,23835,4980,3465,32280,4260,1835,38375,18990,1418685,32140,32338,44355,108960,131818,156924,400150,1008170,152804840000,2901560000,1807416000,2670660000,7392750000,9400401000,14688028000,31752890000,120196640000
New York,Management of Companies and Enterprises,2015,9369,945,245,302,1492,1598,2517,5607,3762,14575,950,245,310,1505,1635,2675,5815,8760,939770,990,1212,2235,4445,24425,99702,128575,811195,126769075000,326830000,130518000,240480000,697840000,2882180000,9787484000,13367700000,113401375000
New York,Manufacturing,2015,77349,33910,13224,11030,58164,12703,3503,74370,2979,79815,33920,13225,11100,58245,13095,4090,75430,4385,2091082,60560,85860,145318,295689,487717,428665,1253537,767731,116846395000,2400757000,3169193000,5900684000,11660982000,23052038000,22400472000,59312110000,53317996000
New York,"Mining, Quarrying, and Oil and Gas Extraction",2015,1253,605,210,135,950,105,83,1138,115,1565,605,210,135,950,125,135,1210,355,19355,959,1366,1389,3860,3016,4299,12915,6198,1341286000,59775000,73941000,80075000,220654000,271860000,321944000,944520000,380354000
New York,Other,2015,1374,1326,40,7,1373,1,0,1374,0,1374,1326,40,7,1373,1,0,1374,0,1529,1180,240,86,1506,0,0,1529,0,46957000,39544000,6085000,991000,46620000,0,0,46957000,0
New York,Other Services (except Public Administration),2015,274268,190660,45501,21855,258016,13226,1892,273134,1134,288145,190800,45700,22265,258765,15180,4715,278660,9485,1893335,338365,297237,287461,923125,459827,246352,1631530,252154,69220515000,9332045000,8846213000,9723392000,27904425000,17349547000,12401744000,57747795000,11124649000
New York,"Professional, Scientific, and Technical Services",2015,290081,210906,35926,19335,266167,15443,4359,285969,4112,306855,210980,36005,19670,266655,17190,6265,290110,16745,3219775,307500,233658,253378,794660,547008,460783,1803575,1400653,292841705000,20552965000,14878037000,18219020000,53656420000,46328807000,43313709000,143372360000,148242782000
New York,Real Estate and Rental and Leasing,2015,149686,116215,17137,8081,141433,5775,1275,148483,1203,166410,116360,17365,8630,142355,7935,3965,154255,12155,879490,175940,111609,105315,392960,195696,112162,702195,176664,53475910000,7728495000,5345054000,5571318000,18649080000,11904641000,8513391000,39258350000,14191816000
New York,Retail Trade,2015,297290,201779,49064,23215,274058,16656,3179,293893,3397,394160,202015,49675,24735,276425,21955,10230,308610,85550,4686640,362102,316435,303845,982382,600505,301339,1888118,2723034,136225715000,10124368000,9357795000,9658930000,29141093000,22601291000,12975462000,64830463000,69026345000
New York,Total,2015,462660,302430,70783,41664,414877,35402,7752,458031,4629,540298,302698,71248,42909,416855,41818,19247,477920,62378,7998994,484866,462801,556150,1503817,1334036,1178037,4015890,3983104,513083321000,23033139000,19360808000,24586201000,66980148000,69516854000,72061706000,208558708000,304524613000
New York,Transportation and Warehousing,2015,57440,36007,7507,4933,48447,5067,1914,55428,2012,64055,36015,7530,4975,48520,5590,3025,57135,6920,1192281,51356,49800,64045,165670,174316,187311,533035,650723,55763365000,1893782000,1918843000,2516882000,6355238000,7531667000,7503280000,21708417000,33331873000
New York,Utilities,2015,1093,455,140,100,695,142,62,899,194,2925,455,145,115,715,200,285,1200,1725,202161,824,824,1132,2834,4479,3857,12475,178716,20758744000,63325000,54170000,84432000,204550000,380769000,386360000,1055427000,18772133000
New York,Wholesale Trade,2015,146479,89932,21858,13808,125598,13312,3889,142799,3680,158925,90015,21930,14190,126135,14885,6335,147355,11570,1854460,149065,141896,182633,473690,455963,359502,1292505,554567,131041695000,7830830000,7834738000,10672898000,26343600000,30213975000,26168303000,82999510000,47450683000
North Carolina,Accommodation and Food Services,2015,73071,24940,13729,15162,53831,16165,1649,71645,1426,100995,24975,13795,15365,54135,18670,6450,79255,21740,1960548,38760,93130,209760,341680,574737,247753,1164500,795865,31021537000,1263860000,1342940000,3102429000,5709405000,8958622000,3788304000,18462650000,12554717000
North Carolina,Administrative and Support and Waste Management and Remediation Services,2015,53083,31620,8650,4773,45043,4497,1480,51020,2063,62110,31655,8680,4785,45120,5130,2035,52285,9825,1872453,50101,56793,63844,170848,163406,188198,525688,1346365,63014454000,2042824000,1721647000,2094277000,5864174000,5768610000,6029524000,17800304000,45193873000
North Carolina,"Agriculture, Forestry, Fishing and Hunting",2015,3923,2335,890,460,3685,135,40,3860,63,3965,2335,890,470,3695,135,60,3890,75,23544,4050,5612,5687,15679,3017,1410,21589,1601,925965000,146655000,209116000,213914000,578840000,118516000,51273000,806260000,77792000
North Carolina,"Arts, Entertainment, and Recreation",2015,17229,10274,2405,1789,14468,2032,411,16911,318,18260,10285,2405,1805,14495,2190,570,17255,1005,309912,13871,15642,24425,54097,78715,58993,196519,103057,9292865000,590273000,387225000,519207000,1502656000,1719028000,1712165000,5035640000,3766763000
North Carolina,Construction,2015,106830,70755,16960,9854,97569,7447,1046,106062,768,108490,70755,16975,9865,97595,7575,1420,106590,1900,878785,111785,110791,131406,354030,270590,117186,745130,131281,41244975000,4244810000,4006794000,5424108000,13676980000,12839720000,6509832000,33247495000,7872004000
North Carolina,Educational Services,2015,13104,6845,1895,1505,10245,1948,548,12741,363,13900,6845,1895,1515,10255,2015,775,13045,855,493405,9980,12794,20383,43232,81707,90704,216415,274412,19719625000,332975000,271145000,438225000,1044239000,2284565000,3099279000,6439430000,13086822000
North Carolina,Finance and Insurance,2015,33319,22535,4548,1763,28846,1529,853,31228,2091,65230,22560,4650,2235,29445,3515,3650,36610,28620,885768,38491,28247,21078,88362,47525,53467,191564,679614,79729528000,1812833000,1447082000,1449512000,4764025000,3293412000,4106095000,12263020000,66753167000
North Carolina,Health Care and Social Assistance,2015,85747,36483,19859,12882,69224,11445,3065,83734,2013,116415,36590,19980,13175,69745,15070,10110,94925,21490,2840783,62690,132477,172116,367340,443169,444037,1257071,1579926,127584242000,3104786000,5643073000,7015268000,15764793000,16299433000,16002249000,48165813000,79177308000
North Carolina,Information,2015,9546,5095,1200,790,7085,915,439,8439,1107,17955,5190,1220,870,7280,1190,885,9355,8600,399411,7589,7728,10342,26051,29914,41290,99691,296443,28095791000,394864000,327196000,478323000,1218721000,1836121000,2848679000,6031616000,21969628000
North Carolina,Management of Companies and Enterprises,2015,5012,225,95,145,465,900,1426,2791,2221,8805,225,95,145,465,915,1540,2920,5885,479576,330,405,805,1540,11710,46186,59436,420140,49978398000,58532000,31285000,48140000,137957000,1093595000,3089136000,4320688000,45657710000
North Carolina,Manufacturing,2015,40152,14490,6300,5180,25970,7213,2959,36142,4010,43695,14500,6305,5195,26000,7380,3670,37050,6645,2072115,25776,40563,66814,137798,284624,301422,763304,1244709,101398142000,1146886000,1434256000,2480563000,5288358000,11740921000,12873130000,31667441000,66367642000
North Carolina,"Mining, Quarrying, and Oil and Gas Extraction",2015,588,230,90,55,375,77,41,493,95,1035,230,90,55,375,100,80,555,480,13563,349,536,691,1728,2286,1762,6665,6197,758933000,17601000,19183000,29471000,76027000,103711000,117488000,338913000,371707000
North Carolina,Other,2015,579,551,24,4,579,0,0,579,0,579,551,24,4,579,0,0,579,0,701,495,152,54,701,0,0,701,0,14379000,10101000,2197000,2081000,14379000,0,0,14379000,0
North Carolina,Other Services (except Public Administration),2015,107526,70000,21040,8866,99906,5919,957,106782,744,115735,70040,21205,9395,100640,7610,2830,111080,4655,756040,129777,136614,115301,381930,202063,86620,675540,68750,20193073000,3245271000,3354820000,3003256000,9609763000,5241963000,2366884000,17416478000,2325500000
North Carolina,"Professional, Scientific, and Technical Services",2015,109576,78840,13253,7413,99506,5507,1865,106878,2698,119295,78880,13310,7640,99830,6865,2815,109510,9785,1055318,114580,86073,97589,298400,175991,120911,599350,444090,77390493000,5807025000,4398877000,5361843000,15575275000,11810492000,9271061000,36915820000,39404002000
North Carolina,Real Estate and Rental and Leasing,2015,41740,33335,3660,1542,38537,1503,749,40789,951,54945,33360,3735,1740,38835,2905,4035,45775,9170,248545,44830,23171,19075,87345,46889,37592,172685,72811,11216940000,1847100000,870484000,787121000,3513425000,2177401000,1585410000,7315915000,3806270000
North Carolina,Retail Trade,2015,100437,58333,19816,10186,88335,7553,1724,97612,2825,172635,58485,20250,11445,90180,13340,7805,111325,61310,2360527,104780,128570,130891,364440,255662,147985,772025,1582590,60284362000,2758755000,3183829000,3696285000,9645520000,8702702000,5215423000,23647415000,36417249000
North Carolina,Total,2015,171419,101516,28863,17706,148085,15885,3789,167759,3660,223209,101681,29155,18538,149374,20693,10978,181045,42164,3670284,163958,189666,236459,590083,583541,454042,1627666,2042618,164936258000,6373587000,6361505000,8124175000,20859267000,21253164000,18672273000,60784704000,104151554000
North Carolina,Transportation and Warehousing,2015,24753,15209,3092,1896,20197,1755,976,22928,1825,28830,15225,3100,1945,20270,1900,1305,23475,5355,596568,21887,19703,24683,66993,56887,53867,183260,354654,26721306000,859252000,671040000,910160000,2462823000,2204682000,2135991000,6959105000,17393911000
North Carolina,Utilities,2015,764,255,130,55,440,115,118,673,91,2845,255,130,55,440,190,275,905,1940,81909,375,799,639,1925,5460,9827,17928,32134,8019789000,12391000,25773000,26201000,67478000,382846000,764199000,1246599000,3387319000
North Carolina,Wholesale Trade,2015,46397,23193,6856,4741,34790,5500,2540,42830,3567,58010,23260,6945,4970,35175,6770,4580,46525,11485,897790,36723,44732,60436,142175,162308,146589,455270,438578,61719955000,2046086000,2306990000,3263829000,7628525000,8798313000,8565810000,25183980000,36349603000
North Dakota,Accommodation and Food Services,2015,8894,2985,1685,1595,6265,2033,347,8645,249,10385,2985,1695,1625,6305,2255,960,9520,865,198935,4575,11171,22140,38145,73247,47998,160520,37041,3327345000,143019000,146139000,310177000,606415000,1129765000,875426000,2634375000,661151000
North Dakota,Administrative and Support and Waste Management and Remediation Services,2015,5095,2995,765,490,4250,396,122,4768,327,5710,2995,770,510,4275,435,165,4875,835,73738,3977,4630,5526,14932,13689,8133,39093,30590,2697215000,163918000,167062000,213235000,588683000,525446000,269279000,1448951000,1093059000
North Dakota,"Agriculture, Forestry, Fishing and Hunting",2015,550,410,80,35,525,10,0,535,15,555,410,80,35,525,10,0,535,20,2210,432,455,370,1315,0,0,1625,468,109605000,28778000,20056000,13363000,63040000,0,0,78050000,25244000
North Dakota,"Arts, Entertainment, and Recreation",2015,2016,1280,230,205,1715,215,59,1989,27,2240,1280,230,205,1715,305,190,2210,30,27080,1587,1396,2335,5779,7148,6864,20917,1233,412703000,59336000,19571000,36206000,129288000,131335000,80429000,358362000,10911000
North Dakota,Construction,2015,15406,9970,2559,1435,13964,1075,191,15230,176,15635,9970,2565,1435,13970,1135,245,15350,285,128625,15162,16617,18424,50540,39392,20447,112500,13511,8700365000,903184000,807294000,1109206000,2879210000,2654569000,1571764000,7221210000,1198382000
North Dakota,Educational Services,2015,770,275,120,90,485,165,60,710,60,795,275,120,95,490,170,60,720,75,24026,379,741,1075,2416,6298,7512,16570,2208,601526000,11574000,15487000,13585000,46685000,153030000,226806000,438978000,52944000
North Dakota,Finance and Insurance,2015,5524,3740,470,310,4520,380,161,5061,463,8660,3740,510,455,4705,1085,1025,6815,1845,85649,6363,2864,3942,13548,11609,14117,41114,43019,4893277000,271405000,133861000,206010000,633759000,634657000,878324000,2286270000,2491755000
North Dakota,Health Care and Social Assistance,2015,8121,3595,1495,1240,6330,967,481,7778,343,9980,3600,1505,1280,6385,1180,1095,8660,1320,293403,6481,9869,16334,33356,38879,50816,126416,161056,14105691000,264743000,420974000,618035000,1339971000,1284506000,1649208000,4395280000,9302119000
North Dakota,Information,2015,1131,345,200,135,680,197,67,944,187,1645,345,200,155,700,315,80,1095,550,33672,635,1134,1410,3726,7085,3673,15699,12429,2111062000,18602000,34778000,52594000,127701000,403183000,235554000,827932000,773481000
North Dakota,Management of Companies and Enterprises,2015,511,45,5,25,75,80,105,260,251,610,45,5,25,75,80,110,265,345,23485,115,0,100,250,829,1754,2835,20650,1960525000,6765000,0,7845000,15210000,35502000,158301000,209060000,1751465000
North Dakota,Manufacturing,2015,3488,1240,600,475,2315,541,288,3144,344,3790,1240,600,475,2315,550,360,3225,565,102069,1958,3112,4661,11216,12813,15856,52942,36657,4724770000,66009000,94419000,202382000,421655000,570655000,721226000,2291526000,1866365000
North Dakota,"Mining, Quarrying, and Oil and Gas Extraction",2015,2289,795,310,245,1350,385,160,1895,394,2750,795,310,245,1350,460,175,1985,765,125089,1320,1989,3256,6641,15294,17165,39100,85503,10557451000,93457000,144003000,225307000,470411000,1225052000,1224645000,2920108000,7615799000
North Dakota,Other,2015,57,54,3,0,57,0,0,57,0,57,54,3,0,57,0,0,57,0,78,58,0,0,78,0,0,78,0,1178000,888000,0,0,1178000,0,0,1178000,0
North Dakota,Other Services (except Public Administration),2015,11983,7612,2395,1082,11089,634,75,11798,185,12430,7620,2415,1135,11170,785,120,12075,355,69976,13888,15024,13790,43169,18669,1190,65493,2938,2040377000,359989000,395011000,393753000,1162843000,523188000,43025000,1812659000,173430000
North Dakota,"Professional, Scientific, and Technical Services",2015,8771,5585,1200,739,7524,569,268,8361,410,9495,5585,1205,760,7550,780,435,8765,730,80072,8642,7921,9285,26232,17677,12019,58980,18814,4959639000,414879000,415103000,485512000,1337257000,1209256000,989231000,3737288000,1126506000
North Dakota,Real Estate and Rental and Leasing,2015,4675,3440,435,285,4160,206,100,4466,209,5395,3440,440,295,4175,255,115,4545,850,30102,4565,2663,3576,11228,5593,1420,20273,7633,1431820000,187506000,108391000,146848000,460176000,274116000,53712000,858546000,487360000
North Dakota,Retail Trade,2015,11578,4574,2567,1712,8853,1390,452,10695,883,16295,4585,2610,1880,9075,1960,1455,12490,3805,249602,8598,16885,21918,48440,41443,35233,131061,112155,7210289000,276571000,463078000,702119000,1469364000,1496474000,1267741000,4434943000,2593975000
North Dakota,Total,2015,20370,11157,3412,2251,16820,2059,581,19460,910,24848,11167,3448,2389,17004,2794,1578,21376,3472,365893,18021,22369,30060,70450,75599,64899,210948,154945,17184756000,773021000,817371000,1169761000,2760153000,3199416000,2847025000,8806594000,8378162000
North Dakota,Transportation and Warehousing,2015,7517,4645,1150,600,6395,475,235,7105,412,8255,4650,1150,610,6410,515,310,7235,1020,97815,6876,7046,7506,22183,17464,14099,56621,33238,5277677000,326191000,311995000,375059000,1036093000,1020500000,640014000,2793353000,2200058000
North Dakota,Utilities,2015,297,90,25,20,135,80,15,230,67,715,90,25,25,140,145,35,320,395,15636,103,149,116,481,3367,1869,6420,8360,1455765000,9258000,5186000,8022000,30221000,268994000,185613000,547921000,826564000
North Dakota,Wholesale Trade,2015,5818,1910,765,600,3275,1051,499,4825,993,8615,1915,790,700,3405,1550,955,5910,2705,118256,3197,4369,6393,15464,28883,20480,69415,46677,6944075000,163065000,241671000,368601000,853286000,1670836000,1214887000,3974456000,2858070000
Ohio,Accommodation and Food Services,2015,84671,29787,15840,17537,63164,18054,1873,83091,1580,118485,29825,15870,17755,63450,21395,8870,93715,24770,2303951,47250,106495,240084,393870,665653,307551,1367615,936292,34463501000,1310250000,1372200000,3163788000,5847150000,9886384000,4214235000,19953135000,14508820000
Ohio,Administrative and Support and Waste Management and Remediation Services,2015,56363,32825,8355,5490,46670,5260,1981,53911,2452,67630,32845,8360,5550,46755,5690,2610,55055,12575,1986614,46921,55105,72994,175110,200803,271129,649773,1336431,63146493000,2189007000,1929910000,2637228000,6759746000,7034715000,8037875000,21932554000,41192190000
Ohio,"Agriculture, Forestry, Fishing and Hunting",2015,1335,1000,140,110,1250,40,15,1305,30,1345,1000,140,110,1250,40,15,1305,40,5979,1492,786,1363,3766,1050,82,5174,737,197985000,45669000,22005000,39394000,110782000,40619000,3202000,166170000,29136000
Ohio,"Arts, Entertainment, and Recreation",2015,17627,9720,2677,2155,14552,2251,501,17304,323,18830,9720,2680,2190,14590,2460,720,17770,1060,325679,13956,17552,28469,60190,88678,67401,219807,95899,11782710000,624450000,487697000,558051000,1678890000,1754156000,3854405000,7357396000,4033634000
Ohio,Construction,2015,97247,62005,16165,9995,88165,7239,1109,96513,734,98655,62005,16165,10005,88175,7515,1460,97150,1505,899415,97960,106040,133287,337380,265860,160730,767710,119819,53451025000,4583310000,4858720000,7047882000,16494955000,16143020000,11323667000,44168330000,8619422000
Ohio,Educational Services,2015,13532,5225,2360,1827,9412,2972,672,13056,476,15445,5225,2370,1875,9470,3450,1210,14130,1315,604514,8587,15995,24879,49499,125322,103013,278569,322739,16844693000,272982000,356095000,528063000,1157783000,3477058000,3286467000,7946613000,8702148000
Ohio,Finance and Insurance,2015,41140,26847,6169,2463,35479,2422,1016,38917,2223,86235,26895,6365,3100,36360,5590,5095,47045,39190,1203150,48901,38813,31609,119547,86609,89997,297582,903882,91847877000,2224988000,1962340000,2064441000,6268141000,5835132000,5962851000,18173286000,73578219000
Ohio,Health Care and Social Assistance,2015,100804,39551,23336,15411,78298,14319,5057,97674,3130,144880,39710,23615,16360,79685,20070,15620,115375,29505,4122666,76584,155008,205683,437399,563914,769053,1772775,2348426,179841083000,3516706000,6109132000,8427332000,18060071000,20735482000,24138793000,63119673000,116667606000
Ohio,Information,2015,8722,3854,1160,985,5999,1199,423,7621,1101,18760,3865,1165,1025,6055,1555,635,8245,10515,422049,5690,7272,12924,26184,40750,39371,107369,314501,28851186000,266276000,313385000,593871000,1184251000,2166207000,2297228000,5700061000,23138561000
Ohio,Management of Companies and Enterprises,2015,6571,330,145,230,705,1081,1893,3679,2892,10930,335,145,230,710,1100,1985,3795,7135,750495,455,624,1445,2545,13374,59975,75900,674571,75314995000,83477000,38125000,94821000,217435000,818228000,3941315000,4977050000,70337074000
Ohio,Manufacturing,2015,65425,19659,11130,9860,40649,13816,5441,59906,5519,70695,19660,11145,9915,40720,14485,6805,62010,8685,3286569,38495,72664,130927,246423,537514,662420,1486552,1725364,179553957000,1607513000,2745228000,5630107000,10161695000,25437448000,33762617000,71397142000,104069755000
Ohio,"Mining, Quarrying, and Oil and Gas Extraction",2015,3009,1440,495,359,2294,265,137,2696,313,3715,1440,500,365,2305,345,245,2895,820,63767,2638,3255,4504,10550,8844,10814,30602,32630,3840128000,151725000,158801000,220441000,539121000,431517000,670238000,1663210000,2136810000
Ohio,Other,2015,403,380,18,5,403,0,0,403,0,403,380,18,5,403,0,0,403,0,541,358,115,68,541,0,0,541,0,9296000,7719000,1061000,516000,9296000,0,0,9296000,0
Ohio,Other Services (except Public Administration),2015,123119,71605,28275,13213,113093,7776,1221,122090,1029,137465,71720,28590,13870,114180,10465,3285,127930,9535,1010404,141220,186000,171864,499209,264001,105205,870389,127596,27280072000,3343975000,4208058000,4222399000,11777012000,7136451000,3225295000,22189322000,4758165000
Ohio,"Professional, Scientific, and Technical Services",2015,108375,70455,15845,9608,95908,7341,2287,105536,2839,120435,70480,15875,9945,96300,8750,3425,108475,11960,1250210,109530,103830,127324,340985,250632,191014,787380,452186,83576675000,5456625000,5076087000,6988144000,17533255000,16762463000,14269545000,48836560000,34253384000
Ohio,Real Estate and Rental and Leasing,2015,35772,25163,4686,2163,32012,1865,915,34792,980,50375,25240,4820,2525,32585,3030,4185,39800,10575,326620,39075,30137,27194,96705,55193,50416,204360,116366,15723690000,1504951000,1070641000,1089875000,3676395000,2547481000,2715780000,9043515000,6478237000
Ohio,Retail Trade,2015,101793,54631,21632,11356,87619,8834,2260,98713,3080,181695,54835,22270,12600,89705,13740,9380,112825,68870,2825700,106904,143061,149424,399498,316512,220681,942533,1866119,72958315000,2544275000,3284426000,3954748000,9786951000,10870937000,7822965000,28649281000,43911055000
Ohio,Total,2015,185470,99228,34293,22470,155991,20389,4999,181379,4091,251668,99419,34718,23655,157792,26584,14828,199204,52464,4719985,171189,226597,300957,698743,773875,699349,2171967,2548018,213161303000,6656801000,7659274000,10840454000,25156529000,30238255000,30093107000,85487891000,127673412000
Ohio,Transportation and Warehousing,2015,30149,15575,4252,3504,23331,3227,1265,27823,2326,37240,15585,4275,3570,23430,3615,1945,28990,8250,855594,23824,27699,45541,97661,111882,78050,291406,544207,40467032000,1027549000,1045130000,1764572000,3876287000,4821696000,3273206000,12219760000,26075720000
Ohio,Utilities,2015,901,305,110,75,490,225,38,753,148,3335,305,115,75,495,300,95,890,2445,116766,480,675,934,2149,8334,3019,14807,101435,11433752000,29858000,34398000,53738000,120518000,588399000,169381000,960894000,10434361000
Ohio,Wholesale Trade,2015,55320,24463,8928,6780,40171,7648,3417,51236,4084,70175,24505,9035,7185,40725,9325,6555,56605,13570,1177865,43596,58653,88140,190825,248630,234997,680010,490255,71670710000,2425849000,3105105000,4839336000,10392710000,13866860000,13998682000,38564020000,32812780000
Oklahoma,Accommodation and Food Services,2015,27376,10085,4685,4895,19665,6119,700,26484,892,38905,10225,4685,4985,19895,7050,3430,30375,8530,743380,16440,31836,67990,116455,222140,104415,443883,292309,11151495000,450205000,415453000,919472000,1788325000,3132773000,1360803000,6296205000,4752991000
Oklahoma,Administrative and Support and Waste Management and Remediation Services,2015,19944,11605,3100,1800,16505,1588,629,18722,1222,22485,11610,3110,1830,16550,1690,920,19160,3325,517970,18686,20349,23341,62777,58779,84071,209472,304347,18873011000,660674000,636261000,775926000,2092506000,1973032000,2559320000,6774352000,11980143000
Oklahoma,"Agriculture, Forestry, Fishing and Hunting",2015,820,550,155,65,770,15,10,795,25,820,550,155,65,770,15,10,795,25,3619,701,944,877,2737,67,0,3162,192,146197000,28090000,32140000,32635000,101294000,2888000,0,118704000,9656000
Oklahoma,"Arts, Entertainment, and Recreation",2015,5171,2845,720,610,4175,620,239,5034,137,5635,2850,745,610,4205,660,355,5220,415,140996,4023,4707,7994,17232,24567,34309,81236,58335,4332152000,151079000,90628000,131564000,383560000,509675000,1102634000,2346987000,1958241000
Oklahoma,Construction,2015,40543,25580,6900,4090,36570,3085,495,40150,393,40945,25580,6900,4095,36575,3135,575,40285,660,358735,41120,45445,54236,140825,112325,59121,316145,39528,19183195000,1536350000,1619130000,2369012000,5525975000,5311781000,4145913000,15171685000,3845926000
Oklahoma,Educational Services,2015,3558,1695,545,450,2690,420,241,3351,207,3775,1695,545,455,2695,430,290,3415,360,106785,2593,3695,5671,12355,14515,30126,57900,48638,2995606000,74899000,67974000,100743000,255015000,395489000,882229000,1574301000,1401754000
Oklahoma,Finance and Insurance,2015,20121,13710,2555,923,17188,1295,487,18970,1151,33770,13730,2605,1245,17580,3790,2180,23550,10220,291220,23812,15990,11119,51288,49782,43104,146898,141634,17284110000,984852000,690860000,660375000,2363938000,2448084000,2312394000,7317423000,9834342000
Oklahoma,Health Care and Social Assistance,2015,42707,21288,9060,5035,35383,4772,1381,41536,1171,54625,21310,9080,5175,35565,6360,4345,46270,8355,1071856,35657,60217,66459,162506,204586,193042,561238,508539,45878097000,2127718000,2483191000,2587028000,7202171000,6948545000,5991948000,20181469000,25589834000
Oklahoma,Information,2015,3817,1670,525,459,2654,426,201,3281,536,7280,1670,530,500,2700,555,470,3725,3555,146319,2410,3325,5685,11937,13438,12251,41017,104402,8026837000,106524000,113999000,220593000,461990000,601617000,453580000,1742290000,6221870000
Oklahoma,Management of Companies and Enterprises,2015,2274,160,45,70,275,426,662,1363,911,3075,165,45,70,280,430,710,1420,1655,188540,155,153,368,715,6105,18750,25570,162944,17617875000,19790000,12899000,22559000,58135000,338125000,1523900000,1920160000,15696330000
Oklahoma,Manufacturing,2015,16229,5778,2765,2245,10788,2786,1073,14647,1582,17550,5780,2765,2255,10800,2980,1340,15120,2430,674850,10340,17037,27752,58672,99054,101410,283880,349671,34117020000,411584000,590455000,1078785000,2217702000,4339119000,5009745000,12664417000,19344222000
Oklahoma,"Mining, Quarrying, and Oil and Gas Extraction",2015,14170,9090,1755,1099,11944,1243,344,13531,639,16015,9090,1755,1105,11950,1295,550,13795,2220,277804,14449,11518,14494,40605,44446,30808,116607,161022,22423532000,737850000,598481000,841682000,2185503000,2787868000,2317351000,7333917000,15079575000
Oklahoma,Other,2015,142,138,3,0,141,1,0,142,0,142,138,3,0,141,1,0,142,0,191,137,16,0,153,0,0,191,0,3021000,2261000,192000,0,2453000,0,0,3021000,0
Oklahoma,Other Services (except Public Administration),2015,41925,26606,8102,3695,38403,2559,480,41442,483,44795,26640,8165,3850,38655,3145,1330,43130,1665,312273,49884,52397,47455,150097,87310,43776,285473,19780,8029619000,1194068000,1221110000,1260281000,3687965000,2166259000,1036163000,7088424000,763028000
Oklahoma,"Professional, Scientific, and Technical Services",2015,45471,32642,6080,3020,41742,1966,683,44391,1080,48970,32650,6115,3130,41895,2325,1590,45810,3160,354386,49647,40164,39538,129781,65770,52051,253141,91947,21567952000,2234531000,1798645000,1994123000,6048623000,3904358000,3567765000,13956637000,7100249000
Oklahoma,Real Estate and Rental and Leasing,2015,17169,13083,1705,779,15567,621,331,16519,650,20850,13165,1715,965,15845,975,640,17460,3390,116765,18716,11013,9397,39493,18692,11706,71610,43101,5044260000,633318000,381541000,324963000,1353373000,729789000,554315000,2732115000,2254275000
Oklahoma,Retail Trade,2015,42024,21925,8918,4801,35644,3485,935,40064,1960,66525,22005,9145,5285,36435,5350,3795,45580,20945,858372,42063,58318,60593,161377,120032,71015,358400,482641,22240716000,1058609000,1351464000,1606255000,4025737000,4034345000,2633033000,10896930000,10924748000
Oklahoma,Total,2015,73194,42664,12368,7401,62433,6752,1762,70947,2247,93093,42763,12483,7801,63047,8905,5094,77046,16047,1370988,71167,81502,98242,250911,253445,208441,712797,658191,59124620000,2697533000,2668321000,3416835000,8782689000,9151836000,8756178000,26690703000,32433917000
Oklahoma,Transportation and Warehousing,2015,11485,6395,1430,992,8817,1044,494,10355,1130,13790,6395,1450,1005,8850,1080,775,10705,3085,229983,9972,9054,12761,32051,31807,24924,91832,107370,11839709000,364381000,311073000,475345000,1159617000,1362206000,1181184000,3859900000,6233318000
Oklahoma,Utilities,2015,649,205,80,25,310,150,66,526,123,1815,205,80,25,310,210,175,695,1120,42359,392,516,142,1267,8395,4572,14977,18687,3526234000,15672000,16734000,16872000,76432000,633625000,385431000,1186489000,1659743000
Oklahoma,Wholesale Trade,2015,18470,7788,2768,2202,12758,2383,1215,16356,2114,23130,7810,2810,2355,12975,3045,1990,18010,5120,303107,13135,17490,27799,59374,64575,52183,184089,109556,16433957000,629525000,789921000,1357060000,2817458000,3249985000,2883685000,9297138000,6656331000
Oregon,Accommodation and Food Services,2015,44306,14350,10116,10531,34997,7691,938,43626,680,55285,14425,10175,10805,35405,9555,3745,48705,6580,851900,22820,67475,142387,232710,256520,124609,614323,235455,15884870000,609730000,1000315000,2362049000,3972565000,4803049000,2245110000,11029466000,4795748000
Oregon,Administrative and Support and Waste Management and Remediation Services,2015,25315,15260,4137,2160,21557,2013,658,24228,1087,28700,15265,4140,2195,21600,2215,980,24795,3905,494080,24663,26676,27949,79694,72800,76291,233310,258956,16667365000,807904000,792413000,953673000,2571327000,2567832000,2507995000,7805723000,8790948000
Oregon,"Agriculture, Forestry, Fishing and Hunting",2015,6516,4200,780,650,5630,720,110,6460,56,6660,4200,780,650,5630,745,160,6535,125,60661,6031,5272,9196,20694,25913,9037,57856,2340,2650129000,335071000,183180000,396832000,923672000,1057726000,330334000,2376884000,211796000
Oregon,"Arts, Entertainment, and Recreation",2015,8637,4990,1280,1015,7285,1060,170,8515,122,9095,4990,1295,1015,7300,1190,325,8815,280,130856,7108,8383,13649,29415,39657,24262,98600,22795,3250116000,260328000,177418000,291815000,735858000,758080000,676441000,2575150000,445886000
Oregon,Construction,2015,58470,40635,9060,4825,54520,3149,411,58080,390,59010,40635,9060,4835,54530,3295,500,58325,685,399960,63765,58316,63245,185326,113061,42563,346250,49880,21951900000,2428228000,2323080000,2956940000,7708248000,6493401000,3088052000,17706744000,3967075000
Oregon,Educational Services,2015,7204,3655,1025,890,5570,1180,273,7023,181,7935,3655,1045,905,5605,1360,680,7645,290,190835,5595,6885,12154,24770,43302,38441,108242,77795,4936245000,169150000,143409000,256128000,571685000,1154610000,1037959000,2803939000,1886723000
Oregon,Finance and Insurance,2015,16829,11315,2054,644,14013,767,578,15358,1471,29545,11330,2105,705,14140,1585,1870,17595,11950,297444,19904,12839,7511,40625,24727,34592,102957,192334,21154318000,841291000,687649000,517637000,2070092000,1710968000,2256780000,6246264000,14792770000
Oregon,Health Care and Social Assistance,2015,51305,27730,10439,5768,43937,4486,1718,50141,1164,66820,27785,10525,5945,44255,6395,7015,57665,9155,1169019,48861,69943,75927,194819,177177,190127,566276,599591,59446276000,2153658000,2702355000,3068942000,7926863000,7117445000,6927824000,22205427000,37135968000
Oregon,Information,2015,6751,3515,851,685,5051,700,292,6043,708,10205,3525,860,715,5100,785,615,6500,3705,181860,5330,5638,8792,20139,22013,25837,73030,103172,12386296000,247361000,240590000,446447000,954479000,1446913000,1772453000,4695974000,7448834000
Oregon,Management of Companies and Enterprises,2015,2606,155,80,106,341,535,771,1647,959,3450,155,80,115,350,550,825,1725,1725,229715,201,270,605,1080,6209,27809,35105,194589,28065055000,14256000,25445000,39390000,79485000,364378000,2239247000,2683745000,25378959000
Oregon,Manufacturing,2015,25946,11084,4335,3500,18919,4130,1355,24404,1542,27160,11090,4345,3525,18960,4275,1610,24845,2315,771957,19480,27227,43384,94837,148872,126423,410674,304732,41483471000,713203000,971503000,1704383000,3603198000,6837746000,6244949000,18580052000,19445098000
Oregon,"Mining, Quarrying, and Oil and Gas Extraction",2015,589,285,105,70,460,70,10,540,49,700,285,105,70,460,75,10,545,155,6704,470,691,906,2105,1703,0,4164,2449,376744000,28593000,29646000,39349000,99243000,88859000,0,208049000,159625000
Oregon,Other,2015,370,357,11,1,369,1,0,370,0,370,357,11,1,369,1,0,370,0,438,329,65,0,410,0,0,438,0,8494000,7259000,900000,0,8294000,0,0,8494000,0
Oregon,Other Services (except Public Administration),2015,45859,28945,9365,4132,42442,2489,440,45371,488,50075,28960,9410,4320,42690,3490,1860,48040,2035,331020,52673,60931,52414,166358,85450,35669,291355,29538,9843155000,1399459000,1529910000,1508043000,4450081000,2479580000,1298447000,8359950000,1280961000
Oregon,"Professional, Scientific, and Technical Services",2015,57260,40545,7420,4167,52132,2875,778,55785,1475,60340,40550,7425,4285,52260,3330,975,56565,3775,453948,60941,47945,54243,163441,92685,36713,297549,150267,33418156000,3045149000,2351021000,2985194000,8395039000,6615648000,2834686000,18078183000,14913465000
Oregon,Real Estate and Rental and Leasing,2015,25029,19437,2635,1128,23200,835,425,24460,569,30725,19465,2745,1270,23480,1395,2620,27495,3230,139393,28017,16594,13758,58607,26499,20740,107330,31330,5571619000,1056045000,560985000,510801000,2140137000,973465000,833147000,4018191000,1529475000
Oregon,Retail Trade,2015,47768,23964,10791,5706,40461,4105,1213,45779,1989,70795,24030,11045,6280,41355,6600,4880,52835,17960,1014758,44203,71117,73998,189625,133866,86243,414535,594940,28623685000,1148335000,1700811000,2022873000,4881127000,4522900000,2782098000,12359892000,16113475000
Oregon,Total,2015,91715,54002,15896,9849,79747,7839,1883,89469,2246,112393,54069,16066,10272,80407,10321,6343,97071,15322,1498727,88250,104414,130553,323217,283171,217270,823658,675069,71006598000,3328409000,3396435000,4517318000,11242162000,11284603000,9430912000,31957677000,39048921000
Oregon,Transportation and Warehousing,2015,13409,7515,1905,1210,10630,1204,586,12420,989,15485,7515,1915,1265,10695,1295,795,12785,2700,281173,11427,12678,15013,40068,38531,29475,112926,128912,12723967000,445601000,462477000,567953000,1505383000,1686264000,1285864000,4708315000,6274191000
Oregon,Utilities,2015,628,310,70,40,420,100,25,545,83,1370,310,70,45,425,155,40,620,750,39882,653,391,421,1593,3737,165,5681,23900,3684193000,16175000,10085000,33117000,64944000,329344000,19748000,426662000,2284602000
Oregon,Wholesale Trade,2015,22336,10385,3113,2326,15824,2805,1493,20122,2214,26760,10390,3150,2410,15950,3310,2210,21470,5290,410085,16661,19491,29182,66025,80114,70489,221077,178190,30331832000,838861000,963202000,1579500000,3415474000,4403495000,4087944000,12132048000,17446633000
Pennsylvania,Accommodation and Food Services,2015,113783,49775,22421,19248,91444,19095,1833,112372,1411,139985,49850,22495,19385,91730,21350,6490,119570,20415,2289300,84885,148860,263135,496880,692651,249614,1439735,848338,37060015000,1927155000,2023005000,3553670000,7503830000,10667786000,3758541000,21943875000,15099333000
Pennsylvania,Administrative and Support and Waste Management and Remediation Services,2015,66477,39945,9955,6248,56148,5847,1934,63929,2548,78145,39945,9975,6380,56300,6370,2905,65575,12570,1660820,55268,65925,83653,204972,226456,253205,686600,971116,56224550000,2746922000,2365920000,3340424000,8457839000,8654885000,7633394000,24841835000,31266927000
Pennsylvania,"Agriculture, Forestry, Fishing and Hunting",2015,2505,1915,325,135,2375,95,20,2490,15,2505,1915,325,135,2375,95,20,2490,15,12485,3135,2006,1613,6960,3653,0,12350,27,458678000,95828000,59903000,57307000,219943000,138422000,0,448773000,1981000
Pennsylvania,"Arts, Entertainment, and Recreation",2015,21871,12187,3275,2485,17947,2899,637,21483,388,23255,12190,3285,2510,17985,3135,895,22015,1240,526335,16760,21940,33606,72510,114507,93789,284510,233107,15989245000,745290000,514063000,667476000,1932310000,2508905000,3728868000,8356945000,7377496000
Pennsylvania,Construction,2015,130861,87520,20670,11805,119995,8781,1362,130138,723,132140,87520,20670,11865,120055,8950,1625,130630,1510,1150095,137015,134520,158815,430350,325585,186006,945395,196890,69589085000,6012780000,6138930000,8698690000,20850400000,20814580000,14003321000,55866125000,13301727000
Pennsylvania,Educational Services,2015,17056,6930,2535,2270,11735,3595,980,16310,746,19085,6930,2535,2325,11790,3875,1490,17155,1930,1317385,10495,16891,30852,58415,158089,150419,367345,949316,53180435000,393416000,393785000,784640000,1579625000,5148288000,5882613000,12629405000,40519722000
Pennsylvania,Finance and Insurance,2015,46647,29297,7710,2909,39916,2811,1421,44148,2499,88075,29340,7945,3340,40625,5575,7010,53210,34865,1328502,56257,48654,37774,142993,93487,132065,370473,938883,113171743000,2870544000,2752112000,3012236000,8661509000,7482514000,9589053000,25922839000,85425908000
Pennsylvania,Health Care and Social Assistance,2015,121725,52484,26379,17726,96589,15545,5754,117888,3837,186260,52640,26755,18755,98150,23515,20120,141785,44475,4926210,103335,173994,236926,514358,598976,882573,1996486,2927845,220924939000,4376168000,6905787000,9583162000,20868639000,23787588000,30076203000,74754836000,146076560000
Pennsylvania,Information,2015,12392,5395,2005,1355,8755,1684,577,11016,1376,25235,5395,2015,1425,8835,2065,1060,11960,13275,568391,8892,13203,17032,39741,56555,54891,155087,411303,51282449000,464019000,551711000,790769000,1843902000,3145419000,3617521000,8903826000,42303573000
Pennsylvania,Management of Companies and Enterprises,2015,7117,265,155,150,570,1262,2111,3943,3174,11810,265,155,150,570,1285,2315,4170,7640,858695,360,670,930,1960,17955,85410,105330,753365,87853665000,75205000,72375000,104325000,251905000,1036079000,6889360000,8183190000,79670475000
Pennsylvania,Manufacturing,2015,64030,21063,10904,9451,41418,13146,4513,59077,4953,68330,21085,10905,9520,41510,13825,5400,60735,7595,2720577,39649,71129,126895,242044,508538,536686,1327946,1322847,151414191000,1616911000,2677172000,5335744000,9867507000,24925427000,28192056000,65183774000,82399365000
Pennsylvania,"Mining, Quarrying, and Oil and Gas Extraction",2015,4377,1920,660,525,3105,540,279,3924,453,5695,1920,660,545,3125,580,430,4135,1560,162121,3492,4256,7087,14988,20883,22938,59613,102358,12120138000,165681000,209882000,349060000,731952000,1246765000,1676635000,3703548000,8409291000
Pennsylvania,Other,2015,492,466,15,9,490,2,0,492,0,492,466,15,9,490,2,0,492,0,741,461,93,134,688,0,0,741,0,12923000,9920000,1237000,829000,11986000,0,0,12923000,0
Pennsylvania,Other Services (except Public Administration),2015,168219,105117,36043,15770,156930,9010,1312,167252,967,179865,105185,36285,16270,157740,11020,3455,172215,7650,1213570,207570,232870,206317,646955,311348,125019,1085360,108010,33778780000,4927260000,5351934000,5180808000,15465565000,8913109000,4429051000,28864915000,4371332000
Pennsylvania,"Professional, Scientific, and Technical Services",2015,136259,90280,18930,11599,120809,9559,2656,133024,3235,148960,90295,19045,11900,121240,11565,4010,136815,12145,1619130,141250,124048,150700,416230,332329,231376,982225,632022,125393415000,7933490000,7023082000,10003952000,24970800000,24999501000,18492653000,68602645000,56631820000
Pennsylvania,Real Estate and Rental and Leasing,2015,36201,24665,5095,2475,32235,2069,876,35180,1021,49065,24740,5290,2770,32800,2735,3070,38605,10460,326220,39505,32962,31779,104430,65316,50966,224560,98550,17479260000,1648665000,1489269000,1767622000,4911075000,3359695000,2910637000,11410735000,5967499000
Pennsylvania,Retail Trade,2015,131006,72479,26322,14183,112984,11800,2961,127745,3261,216995,72620,26955,15765,115340,17180,9715,142235,74760,3236164,136955,173734,186342,497115,431629,292931,1227695,1932955,84370257000,3556080000,4395079000,5121819000,13075770000,14920564000,9930858000,38073050000,44077045000
Pennsylvania,Total,2015,230057,130122,41411,25695,197228,23190,5429,225847,4210,299695,130281,41875,26880,199036,29584,15557,244177,55518,5306896,225132,272114,344472,841718,879561,754509,2475788,2831108,257626942000,8710081000,9479549000,13195424000,31385054000,36840047000,34608113000,102833214000,154793728000
Pennsylvania,Transportation and Warehousing,2015,35916,19575,4530,3557,27662,4414,1470,33546,2370,43300,19585,4540,3600,27725,4890,1965,34580,8720,1093022,29380,29855,46384,106265,157732,119928,391986,698187,46617014000,1128076000,1007736000,1715469000,3881486000,5585923000,4508424000,14373730000,32125886000
Pennsylvania,Utilities,2015,1038,340,140,105,585,152,45,782,256,4170,340,140,105,585,215,110,910,3260,142488,584,860,1287,2791,5729,1248,11140,130877,16043250000,39575000,41594000,77303000,166999000,449929000,89771000,801959000,15132129000
Pennsylvania,Wholesale Trade,2015,59222,27279,9247,7294,43820,8040,3343,55203,4019,73140,27315,9325,7610,44250,9685,5700,59635,13505,1245055,47915,60992,94966,204115,259859,223562,691585,545912,89454145000,2722225000,3243195000,5564986000,11547020000,15590611000,13327343000,40690860000,48040195000
Rhode Island,Accommodation and Food Services,2015,13165,5035,2485,2470,9990,2615,191,12796,369,15265,5055,2490,2490,10035,2885,415,13335,1930,235524,7511,16705,33007,57314,91751,19743,168969,66347,4442544000,283579000,253286000,536263000,1074284000,1656943000,400759000,3135359000,1296317000
Rhode Island,Administrative and Support and Waste Management and Remediation Services,2015,8181,5515,910,525,6950,550,190,7690,491,8765,5515,915,525,6955,570,195,7720,1045,115780,5851,5780,6621,18939,18296,21626,61775,51852,4227539000,384754000,222520000,271608000,913013000,707392000,432410000,2190298000,1952288000
Rhode Island,"Agriculture, Forestry, Fishing and Hunting",2015,190,155,15,10,180,10,0,190,0,190,155,15,10,180,10,0,190,0,607,199,16,0,392,0,0,607,0,30571000,8899000,614000,0,20950000,0,0,30571000,0
Rhode Island,"Arts, Entertainment, and Recreation",2015,2564,1410,330,340,2080,342,60,2482,82,2800,1410,330,345,2085,355,170,2610,190,45738,1818,1928,4200,8441,11357,5669,29015,11691,1199237000,123586000,83944000,142465000,366086000,282463000,87772000,824841000,281456000
Rhode Island,Construction,2015,15177,11480,1960,980,14420,595,90,15105,72,15195,11480,1960,980,14420,595,95,15110,85,82350,16800,12560,12440,42435,19164,9708,76080,2387,5232860000,854090000,626479000,750555000,2272645000,1348677000,627869000,4698470000,173070000
Rhode Island,Educational Services,2015,1950,890,280,155,1325,365,145,1835,115,2105,890,285,165,1340,410,150,1900,205,148500,1494,1808,1843,5333,13831,14466,34099,109007,5236299000,40998000,34495000,48294000,130979000,484591000,628502000,1259563000,3715860000
Rhode Island,Finance and Insurance,2015,4093,2185,520,260,2965,190,221,3376,717,6750,2185,520,270,2975,265,645,3885,2865,127260,3830,3290,2953,10380,6084,13238,33392,92392,10613424000,243547000,216535000,238417000,722694000,438471000,985684000,2555536000,7944370000
Rhode Island,Health Care and Social Assistance,2015,12302,5145,2690,1600,9435,1507,771,11713,589,16300,5155,2695,1680,9530,2010,2460,14000,2300,427908,10116,17909,20497,49023,60210,109176,222480,204718,19331670000,429591000,789874000,886366000,2124139000,2399552000,4370418000,9079697000,10217369000
Rhode Island,Information,2015,1343,520,245,125,890,120,70,1080,263,2280,520,245,135,900,165,90,1155,1125,33386,750,1440,1551,4064,3539,816,11081,19304,2269843000,36650000,60936000,60501000,174086000,170310000,39046000,522656000,1640828000
Rhode Island,Management of Companies and Enterprises,2015,636,40,20,10,70,70,150,290,346,980,40,20,10,70,75,165,310,670,57675,75,76,0,290,945,5768,7005,50670,5492725000,13975000,4064000,0,24855000,137105000,345707000,508370000,4984355000
Rhode Island,Manufacturing,2015,6868,2485,1235,1066,4786,1391,359,6536,332,6985,2485,1235,1080,4800,1415,410,6625,360,174054,4157,6702,11766,25278,49612,24699,119202,35467,9556597000,169288000,258119000,488942000,1022766000,2329554000,1324792000,5753804000,2503991000
Rhode Island,"Mining, Quarrying, and Oil and Gas Extraction",2015,90,50,10,20,80,5,0,85,5,95,50,10,20,80,5,0,85,10,692,79,0,235,400,0,0,536,0,48405000,4912000,0,17458000,29173000,0,0,36481000,0
Rhode Island,Other,2015,60,57,3,0,60,0,0,60,0,60,57,3,0,60,0,0,60,0,72,55,17,0,72,0,0,72,0,1774000,1371000,403000,0,1774000,0,0,1774000,0
Rhode Island,Other Services (except Public Administration),2015,13666,8700,2795,1170,12665,666,100,13431,235,14455,8705,2800,1175,12680,970,105,13755,700,85126,16312,17808,14417,49080,20078,3244,75768,6542,2710187000,476145000,513978000,415157000,1425337000,724696000,129154000,2403936000,205181000
Rhode Island,"Professional, Scientific, and Technical Services",2015,14560,9910,1865,1040,12815,825,243,13883,677,15270,9910,1865,1050,12825,865,250,13940,1330,114138,15402,11698,12636,40222,24283,9304,75733,37364,7295782000,822081000,665270000,825174000,2340776000,1780389000,746964000,5005917000,2229914000
Rhode Island,Real Estate and Rental and Leasing,2015,4499,3195,475,311,3981,210,78,4269,230,5390,3195,495,330,4020,340,235,4595,795,26923,4816,2986,3882,12198,5796,1373,20058,6267,1249363000,231077000,129650000,181479000,575553000,247667000,64743000,914738000,293447000
Rhode Island,Retail Trade,2015,14138,7840,2606,1260,11706,849,309,12864,1274,18740,7860,2680,1350,11890,985,655,13530,5210,241442,14077,16419,15937,47432,25175,14869,91370,146336,6785387000,389476000,443107000,463529000,1323735000,979057000,539965000,2970156000,3717680000
Rhode Island,Total,2015,24169,13874,3954,2434,20262,2231,581,23074,1095,28387,13887,3986,2496,20369,2612,1291,24272,4115,425748,22285,25865,32117,80267,80178,63809,224254,201494,19704826000,984341000,982523000,1259215000,3226079000,3300050000,2895737000,9421866000,10282960000
Rhode Island,Transportation and Warehousing,2015,3000,1810,390,200,2400,250,85,2735,265,3235,1810,390,205,2405,265,85,2755,480,51713,2240,2377,1913,7348,6548,3499,20769,23726,2068106000,94496000,87934000,75398000,293842000,267806000,171881000,885684000,850480000
Rhode Island,Utilities,2015,94,20,15,20,55,5,0,60,34,195,20,15,20,55,5,0,60,135,3065,11,80,235,383,0,0,592,2461,327543000,625000,7104000,27237000,39105000,0,0,60923000,260801000
Rhode Island,Wholesale Trade,2015,6228,2710,945,640,4295,818,308,5421,807,6640,2710,950,640,4300,870,330,5500,1140,100838,4639,5676,7267,19074,21029,9928,58372,30908,7001165000,249726000,326303000,422086000,1082236000,1312255000,597252000,3514354000,2472982000
South Carolina,Accommodation and Food Services,2015,37740,12615,6750,7690,27055,8367,1232,36654,1086,51095,12650,6770,7770,27190,9185,4590,40965,10130,1038450,20680,45584,107297,173675,308008,182623,665620,372165,16900515000,589775000,645105000,1556520000,2792880000,4905128000,2762287000,10496385000,6396489000
South Carolina,Administrative and Support and Waste Management and Remediation Services,2015,25089,14765,3804,2335,20904,2110,795,23809,1280,28920,14765,3820,2340,20925,2255,1070,24250,4670,856540,24624,24746,31289,81044,76736,104782,266384,575183,25862103000,802648000,710441000,958152000,2483422000,2381925000,2786404000,7804262000,16954808000
South Carolina,"Agriculture, Forestry, Fishing and Hunting",2015,2535,1275,620,390,2285,195,25,2505,30,2550,1275,620,390,2285,195,35,2515,35,19483,2067,4107,4856,11233,5745,180,18278,399,779812000,75323000,156664000,190250000,428929000,233848000,15250000,721942000,24432000
South Carolina,"Arts, Entertainment, and Recreation",2015,7431,3930,1030,948,5908,1060,282,7250,181,8025,3930,1045,965,5940,1165,445,7550,475,131186,5453,6836,12799,25390,43477,31762,103486,23189,2521953000,177278000,137294000,231670000,553476000,852622000,582598000,2057588000,386962000
South Carolina,Construction,2015,44694,28115,7910,4540,40565,3290,413,44268,426,45410,28120,7920,4540,40580,3335,605,44520,890,378410,46614,52055,60443,159230,115859,42058,320295,54900,17682785000,1677369000,1922149000,2409644000,6013825000,5484003000,2260781000,13935350000,3589773000
South Carolina,Educational Services,2015,5466,2615,845,640,4100,920,191,5211,255,5885,2615,845,665,4125,945,315,5385,500,161145,4040,5336,8433,18145,36117,27774,84095,76847,4073810000,117615000,100100000,163346000,390410000,930197000,810179000,2194985000,1871243000
South Carolina,Finance and Insurance,2015,16767,10660,2507,892,14059,736,558,15353,1414,35875,10685,2690,1205,14580,2170,3205,19955,15920,338724,19172,15718,11429,46659,23646,39067,110946,226279,20617103000,853803000,684042000,600067000,2171952000,1254349000,2174094000,5735413000,14801247000
South Carolina,Health Care and Social Assistance,2015,38199,16767,8803,5530,31100,4528,1335,36963,1236,50735,16815,8870,5675,31360,5695,4135,41190,9545,1121825,29670,59184,73062,162162,172235,180314,516925,602216,49275270000,1594075000,2413515000,2954344000,6965923000,6450919000,5683394000,19223303000,29960234000
South Carolina,Information,2015,3585,1805,330,295,2430,355,155,2940,645,6880,1860,330,310,2500,390,275,3165,3715,167113,2603,1884,3653,8583,11713,9469,34464,132144,10178192000,140752000,75425000,147477000,381089000,599294000,652127000,1910233000,8245177000
South Carolina,Management of Companies and Enterprises,2015,2162,135,60,51,246,327,647,1220,942,3190,135,60,55,250,335,670,1255,1935,122398,130,260,370,765,3656,18737,23158,99240,9991596000,19246000,17500000,20015000,56920000,216025000,1248426000,1521371000,8470225000
South Carolina,Manufacturing,2015,17472,5520,2570,2310,10400,3130,1499,15029,2443,18750,5520,2570,2310,10400,3235,1710,15345,3405,1058363,9350,15157,27677,56816,111589,152311,353145,651719,57332413000,368879000,524630000,1121918000,2208334000,4831402000,7128659000,15746079000,38792903000
South Carolina,"Mining, Quarrying, and Oil and Gas Extraction",2015,276,100,40,50,190,20,12,222,54,400,100,40,50,190,20,25,235,165,4520,131,186,497,927,491,0,1918,2521,259195000,12810000,21612000,21630000,61064000,31378000,0,115379000,141512000
South Carolina,Other,2015,238,224,11,3,238,0,0,238,0,238,224,11,3,238,0,0,238,0,338,243,64,31,338,0,0,338,0,5164000,4046000,815000,303000,5164000,0,0,5164000,0
South Carolina,Other Services (except Public Administration),2015,52946,32390,11443,4754,48587,3314,516,52417,529,56370,32425,11505,4905,48835,4135,950,53920,2450,396264,62209,74064,61840,198404,112223,40907,353929,36909,10603785000,1449400000,1724943000,1547278000,4728400000,2720294000,1062010000,8586935000,1866694000
South Carolina,"Professional, Scientific, and Technical Services",2015,46863,32895,6160,3288,42343,2299,878,45520,1343,51355,32895,6180,3405,42480,2930,1360,46770,4585,414205,51835,39764,42360,134560,73480,53735,264260,144970,26658665000,2441650000,1871186000,2484684000,6821560000,4259317000,3853924000,15076780000,11401417000
South Carolina,Real Estate and Rental and Leasing,2015,20658,16018,1805,884,18707,783,484,19974,684,25805,16035,1885,985,18905,1235,1225,21365,4440,124950,21488,11113,10567,43540,22543,22788,89700,32706,5122735000,851468000,436613000,456903000,1764140000,801532000,948221000,3542160000,1485376000
South Carolina,Retail Trade,2015,52561,30999,10145,4762,45906,3522,973,50401,2160,87995,31120,10445,5355,46920,5485,3490,55895,32100,1128334,56810,65724,61338,184010,120307,62313,373040,725841,28000747000,1430460000,1628458000,1733390000,4796305000,4388090000,2097239000,11462500000,15815107000
South Carolina,Total,2015,79649,45385,13783,8446,67614,7471,2020,77105,2544,103973,45472,13971,8815,68258,9321,5428,83007,20966,1662251,76778,90463,112924,280165,271986,224861,777012,885239,66120263000,2756085000,2872349000,3726072000,9354506000,9255278000,8322256000,26932040000,39188223000
South Carolina,Transportation and Warehousing,2015,10937,6000,1343,910,8253,872,564,9689,1248,13140,6015,1350,925,8290,950,715,9955,3185,288978,9248,8382,11656,29857,24648,24866,83234,203731,11970797000,351245000,297442000,401124000,1068652000,934376000,1069388000,3208204000,8685327000
South Carolina,Utilities,2015,426,130,45,45,220,85,70,375,51,1720,130,45,45,220,130,185,535,1185,50971,258,298,481,1131,4445,7139,12765,1812,4516639000,7539000,10547000,20034000,41714000,307035000,475652000,827389000,139087000
South Carolina,Wholesale Trade,2015,19790,9139,2787,2114,14040,2408,1233,17681,2109,24575,9150,2810,2165,14125,2815,2135,19075,5500,367870,15520,17913,25945,60500,70069,51666,187185,175131,20756719000,749810000,834334000,1257019000,2890330000,3723572000,2587261000,9461294000,11000071000
South Dakota,Accommodation and Food Services,2015,10355,3920,1860,1995,7775,1937,361,10073,282,12105,3920,1900,2035,7855,2195,900,10950,1155,204855,5340,12902,27318,45735,68316,44120,159430,45263,3239745000,182624000,156455000,365318000,707335000,992351000,766600000,2492525000,744094000
South Dakota,Administrative and Support and Waste Management and Remediation Services,2015,5159,3245,775,410,4430,316,85,4831,328,5470,3245,775,425,4445,365,95,4905,565,51635,4675,4902,4851,15001,10049,3820,30465,19776,1687127000,174319000,150290000,140426000,485976000,342647000,100094000,997499000,623811000
South Dakota,"Agriculture, Forestry, Fishing and Hunting",2015,740,625,65,30,720,5,10,735,5,740,625,65,30,720,5,10,735,5,1839,822,323,300,1644,0,0,1789,0,73655000,35071000,12080000,11686000,65375000,0,0,72415000,0
South Dakota,"Arts, Entertainment, and Recreation",2015,3200,1950,530,370,2850,233,67,3150,50,3450,1950,530,380,2860,315,120,3295,155,31267,2450,3280,4584,10726,7175,7493,27847,2177,597411000,86629000,55310000,76557000,230366000,146288000,127625000,545586000,37113000
South Dakota,Construction,2015,16701,11610,2790,1220,15620,870,131,16621,80,16815,11610,2790,1225,15625,870,190,16685,130,97320,18507,17837,16175,52907,28509,10650,94005,2763,4743720000,753709000,747317000,750560000,2268684000,1600132000,575287000,4538105000,168520000
South Dakota,Educational Services,2015,1150,495,160,145,800,200,95,1095,55,1185,495,160,150,805,200,105,1110,75,40125,762,915,1781,3715,7471,17196,28825,11117,960262000,19603000,13586000,22457000,61742000,163710000,454962000,691732000,263175000
South Dakota,Finance and Insurance,2015,6328,4015,807,393,5215,343,196,5754,574,9915,4020,820,605,5445,785,1125,7355,2560,129266,6637,4790,4740,16476,9959,14723,44591,75337,7088520000,273845000,221505000,218233000,732295000,511685000,878304000,2319054000,4272957000
South Dakota,Health Care and Social Assistance,2015,9169,4120,1773,1205,7098,1185,565,8848,321,11610,4130,1785,1225,7140,1740,1720,10600,1010,327205,6661,11556,15854,34539,46352,70448,156122,165420,15587475000,306202000,397617000,671721000,1387642000,1752839000,2378645000,5683084000,9068232000
South Dakota,Information,2015,1578,655,225,170,1050,223,74,1347,231,2225,655,230,170,1055,335,235,1625,600,34297,1015,1310,1823,4576,5911,4546,18326,12991,1615864000,33134000,34443000,61669000,149455000,250287000,219804000,765015000,707039000
South Dakota,Management of Companies and Enterprises,2015,661,40,10,5,55,140,241,436,225,755,40,10,5,55,145,265,465,290,34508,65,0,0,143,1210,3460,4890,29670,2537554000,4371000,0,0,7166000,95873000,283115000,392680000,2146981000
South Dakota,Manufacturing,2015,4853,1810,785,600,3195,804,351,4350,503,5190,1810,785,605,3200,845,485,4530,660,200747,2821,3951,6291,15011,25983,27985,88602,78948,8791760000,97196000,135525000,233543000,536260000,1160743000,1132765000,3639910000,3579785000
South Dakota,"Mining, Quarrying, and Oil and Gas Extraction",2015,295,135,20,40,195,32,14,241,54,345,135,20,40,195,35,40,270,75,4581,181,65,324,640,673,0,2489,1444,292558000,11713000,2352000,17284000,36195000,34845000,0,151025000,94708000
South Dakota,Other,2015,52,51,1,0,52,0,0,52,0,52,51,1,0,52,0,0,52,0,58,53,0,0,58,0,0,58,0,1596000,1582000,0,0,1596000,0,0,1596000,0
South Dakota,Other Services (except Public Administration),2015,13128,8585,2600,1080,12265,607,136,13008,120,13660,8590,2625,1115,12330,820,205,13355,305,73131,16046,16458,13310,46405,19135,2685,71090,1109,1806575000,386903000,400683000,325117000,1131585000,428899000,82089000,1743505000,36926000
South Dakota,"Professional, Scientific, and Technical Services",2015,9104,5835,1440,805,8080,448,154,8682,422,9640,5835,1455,835,8125,570,225,8920,720,59954,9083,9398,9908,28856,10510,7157,48570,9543,2919270000,393242000,382246000,439371000,1228521000,591796000,362715000,2275424000,558642000
South Dakota,Real Estate and Rental and Leasing,2015,4523,3450,430,208,4088,153,105,4346,177,5215,3450,440,210,4100,215,460,4775,440,19868,4821,2499,2137,9958,3839,2396,17279,2288,669819000,148688000,90451000,67186000,322128000,129642000,76739000,568586000,86241000
South Dakota,Retail Trade,2015,14668,6673,3204,2037,11914,1320,470,13704,964,19705,6685,3240,2180,12105,1895,1635,15635,4070,255922,12271,20835,25731,59323,40683,29867,134943,116267,6580967000,326373000,504645000,649375000,1491187000,1285376000,861337000,3792252000,2551345000
South Dakota,Total,2015,22113,12629,3778,2339,18746,1935,565,21246,867,26511,12639,3821,2464,18924,2649,1774,23347,3164,353540,20408,24780,30764,75952,69450,64292,209694,143846,13812997000,725900000,756817000,965148000,2447865000,2448544000,2331689000,7228098000,6584899000
South Dakota,Transportation and Warehousing,2015,5528,3640,720,425,4785,306,154,5245,283,5950,3640,720,430,4790,330,200,5320,630,52041,5370,4437,4898,15437,8841,4221,33055,16829,2074639000,189472000,156981000,187137000,558711000,343808000,164817000,1203546000,761279000
South Dakota,Utilities,2015,364,50,70,50,170,110,15,295,69,785,50,70,50,170,195,45,410,375,10914,100,470,725,1331,3450,0,5693,5208,920912000,3240000,21801000,43980000,71037000,237447000,0,378140000,542108000
South Dakota,Wholesale Trade,2015,5577,2055,675,579,3309,1009,450,4768,809,7535,2055,680,605,3340,1385,810,5535,2000,93631,3275,3814,6021,14101,28699,16296,64089,27383,4910933000,159300000,159579000,273685000,631759000,1317616000,896747000,3104542000,1690800000
Tennessee,Accommodation and Food Services,2015,42810,14072,7851,8405,30328,9853,1356,41537,1273,62545,14100,7910,8570,30580,11210,5165,46955,15590,1337905,22575,52715,114832,190190,359060,190703,740295,595544,22069785000,669660000,786494000,1775364000,3232645000,5802920000,2938894000,11983760000,10051226000
Tennessee,Administrative and Support and Waste Management and Remediation Services,2015,28017,14985,4355,2761,22101,2903,1179,26183,1834,34780,14995,4390,2820,22205,3125,1550,26880,7900,1222625,24085,28520,36570,89471,111834,171616,376939,844841,36612565000,1002839000,948139000,1361017000,3322546000,4240257000,4992143000,12681266000,23886146000
Tennessee,"Agriculture, Forestry, Fishing and Hunting",2015,1190,765,210,110,1085,50,30,1165,25,1200,765,210,115,1090,50,30,1170,30,9942,1476,1269,1239,4192,1182,394,6585,696,247993000,60032000,41343000,41327000,148247000,36494000,9436000,216793000,6623000
Tennessee,"Arts, Entertainment, and Recreation",2015,12069,6815,2145,1335,10295,1293,272,11860,209,12650,6820,2145,1340,10305,1390,390,12085,565,167320,10178,14537,17716,42718,48828,27932,122492,33700,7626455000,659389000,620507000,791949000,2079521000,2006814000,1216956000,5872160000,923641000
Tennessee,Construction,2015,46451,26885,8270,5575,40730,4521,670,45921,530,47320,26890,8275,5575,40740,4600,885,46225,1095,514360,46380,54845,75389,176670,166326,78210,424150,77077,26615610000,1929355000,2161080000,3423523000,7518575000,9301906000,4629565000,21598655000,4463830000
Tennessee,Educational Services,2015,6352,2675,945,805,4425,1126,480,6031,321,6825,2680,960,830,4470,1220,540,6230,595,293742,4389,6392,10997,21942,43734,72657,139332,148850,10215083000,150649000,140019000,264732000,561393000,1290458000,2649436000,4538073000,5450564000
Tennessee,Finance and Insurance,2015,22716,13680,3263,1194,18137,1531,1059,20727,1989,49615,13700,3495,1730,18925,4580,5575,29080,20535,578682,26488,19949,15052,61897,56022,84299,205186,373228,41350530000,1181029000,1032872000,1126585000,3376130000,4298488000,5628754000,13601539000,27715352000
Tennessee,Health Care and Social Assistance,2015,54221,23209,12883,7939,44031,6329,1971,52331,1890,77715,23305,12950,8250,44505,8485,6140,59130,18585,2003434,46555,85071,104866,236567,242573,294104,774658,1227305,94853791000,2357171000,3359332000,4711521000,10431250000,10729894000,11483529000,32706806000,62080297000
Tennessee,Information,2015,7230,3515,1116,730,5361,743,325,6429,801,12200,3565,1120,735,5420,880,635,6935,5265,236971,5531,6988,9216,22176,22420,19938,67026,167873,13347516000,294086000,327556000,433188000,1072720000,1261500000,1024428000,3517917000,9784272000
Tennessee,Management of Companies and Enterprises,2015,3704,130,30,105,265,575,1052,1892,1812,7070,130,30,110,270,580,1070,1920,5150,432490,199,106,540,849,7190,36295,44335,388155,47515645000,17122000,33367000,51100000,101747000,672870000,2682320000,3456990000,44058592000
Tennessee,Manufacturing,2015,26155,8445,4140,3385,15970,4719,2220,22909,3246,28225,8445,4155,3410,16010,4895,2675,23580,4645,1538116,15955,25954,42166,88239,173188,206441,505560,940133,79093425000,617275000,869326000,1776403000,3454041000,7718574000,9619542000,22614505000,51651265000
Tennessee,"Mining, Quarrying, and Oil and Gas Extraction",2015,579,185,100,75,360,80,50,490,89,960,185,100,75,360,85,105,550,410,12833,272,619,807,1889,1672,3090,6972,4960,728788000,12959000,31692000,28187000,84650000,110763000,165375000,380006000,294857000
Tennessee,Other,2015,311,296,13,2,311,0,0,311,0,311,296,13,2,311,0,0,311,0,399,287,86,0,399,0,0,399,0,8923000,6466000,2319000,0,8923000,0,0,8923000,0
Tennessee,Other Services (except Public Administration),2015,64881,39590,13415,6075,59080,4460,702,64242,639,70690,39605,13500,6465,59570,5665,1405,66640,4050,544145,75467,87342,79670,242695,161015,63313,470290,63629,15030915000,1854540000,2070795000,2155973000,6088530000,4137409000,1785964000,12158675000,2521995000
Tennessee,"Professional, Scientific, and Technical Services",2015,50491,32720,7435,4408,44563,3187,1022,48772,1719,56215,32730,7450,4545,44725,3920,1535,50180,6035,567010,53985,48585,58502,161410,102288,69637,336280,222737,37591885000,2765200000,2275502000,3081099000,8140250000,6796623000,4912434000,20007180000,17184965000
Tennessee,Real Estate and Rental and Leasing,2015,19804,13635,2635,1170,17440,974,582,18996,808,28615,13665,2710,1255,17630,1610,2480,21720,6895,166325,22165,16575,14301,53465,28009,26755,111010,53613,7724135000,890000000,644517000,620728000,2172630000,1275935000,1236474000,4904990000,2688634000
Tennessee,Retail Trade,2015,67933,38569,13619,6818,59006,5245,1141,65392,2541,113215,38690,13920,7540,60150,7915,4285,72350,40865,1505465,71458,88937,88477,249030,179640,90227,522715,947402,39705736000,1817087000,2231126000,2603519000,6655705000,6960997000,3643664000,17365057000,21445193000
Tennessee,Total,2015,97091,51884,17703,11099,80686,10268,2889,93843,3248,133344,51987,17926,11681,81594,13334,7771,102699,30645,2507205,92075,116480,147950,356505,378646,335865,1071016,1436189,110481280000,3593009000,3921547000,5531869000,13046425000,15345352000,14538506000,42930283000,67550997000
Tennessee,Transportation and Warehousing,2015,15432,7355,2117,1705,11177,1632,855,13664,1768,20730,7355,2130,1705,11190,1805,1040,14035,6695,580395,12033,13872,21772,48611,55365,52081,163588,375831,26098900000,490646000,522443000,817477000,1865569000,2375424000,2480506000,7003480000,17141627000
Tennessee,Utilities,2015,287,40,10,35,85,85,50,220,67,700,40,10,35,85,190,225,500,200,16107,64,0,429,638,4849,6415,12272,3622,1117606000,2538000,0,21966000,36854000,326763000,449975000,831874000,271165000
Tennessee,Wholesale Trade,2015,26638,10782,4064,3148,17994,3705,2022,23721,2917,33895,10790,4105,3290,18185,4465,3125,25775,8120,571835,18987,26299,39203,85544,106255,102200,302260,261305,34785580000,1101239000,1360576000,2158112000,4675982000,6378858000,6231971000,17818565000,16511635000
Texas,Accommodation and Food Services,2015,181332,63806,33830,35090,132726,41851,4398,178975,2357,260430,63940,34085,35630,133655,48090,19410,201155,59275,5552770,101885,226950,479815,808650,1566765,738868,3114725,2437782,96509491000,3248445000,3394515000,7389860000,14032820000,25836800000,12257643000,52131835000,44373574000
Texas,Administrative and Support and Waste Management and Remediation Services,2015,114542,63350,17685,11862,92897,12761,4701,110359,4183,137935,63370,17730,12060,93160,13670,6465,113295,24640,4751240,102806,115763,160013,378685,491732,735943,1607955,3141684,182091990000,5045943000,4468219000,6252059000,15771025000,20006974000,25697968000,61584710000,120414625000
Texas,"Agriculture, Forestry, Fishing and Hunting",2015,5105,3475,845,400,4720,255,85,5060,45,5290,3475,845,400,4720,260,230,5210,80,38370,5425,5428,5370,16265,7958,5952,31855,6427,1388751000,228321000,209015000,209225000,647916000,252260000,212528000,1147581000,235543000
Texas,"Arts, Entertainment, and Recreation",2015,31420,17510,4940,4011,26461,3687,832,30980,440,35200,17510,4970,4080,26560,4015,1335,31910,3290,668554,25928,31865,53689,111724,141762,135138,392914,266439,19707029000,1157557000,733342000,1184594000,3079524000,2905408000,5389615000,11475929000,7971484000
Texas,Construction,2015,205035,119035,35874,23038,177947,21186,4033,203166,1869,210150,119070,35880,23085,178035,21685,5620,205340,4810,3295895,197945,236535,311590,746070,840690,648697,2235555,1054722,186990730000,9541495000,10094400000,14592715000,34228610000,44110630000,38845783000,117191585000,69502827000
Texas,Educational Services,2015,30505,14740,5065,4058,23863,4720,1199,29782,723,34150,14755,5070,4115,23940,5185,2130,31255,2895,918085,23380,33685,54213,111320,189470,177377,479040,437891,34283130000,917390000,760325000,1086885000,2765910000,5344960000,6559292000,14687610000,19534994000
Texas,Finance and Insurance,2015,100861,68471,14358,5673,88502,5874,2706,97082,3779,199905,68560,14825,6685,90070,12540,14270,116880,83025,2537787,119788,90850,72826,283650,209688,300259,794370,1742364,200370276000,6099760000,5038215000,5169408000,16321765000,16243428000,22982873000,55633750000,144327126000
Texas,Health Care and Social Assistance,2015,264579,129784,58819,36610,225213,28190,7593,260996,3583,330760,129915,59140,37570,226625,35685,19675,281985,48775,7247141,223495,391270,487696,1102610,1097165,1214514,3414973,3832128,315252533000,15990879000,17185356000,20335571000,53517689000,41137680000,38026938000,132729697000,182522056000
Texas,Information,2015,23313,12185,3086,2254,17525,2677,1183,21385,1928,46190,12210,3125,2340,17675,3235,2305,23215,22975,1194043,19643,20051,29534,69538,97689,122741,292323,894761,93781251000,1054621000,1009597000,1614194000,3692151000,6633691000,8936097000,19416271000,73766536000
Texas,Management of Companies and Enterprises,2015,13282,1061,346,500,1907,2275,3677,7859,5423,24140,1070,350,505,1925,2395,3930,8250,15890,1634775,1300,1585,3065,5955,31270,139430,176655,1458120,213623395000,222915000,170700000,240939000,634675000,2349145000,12190715000,15174535000,198448860000
Texas,Manufacturing,2015,89937,32985,15345,12769,61099,16655,5793,83547,6390,98795,32990,15345,12855,61190,17255,7155,85600,13195,4027561,60758,100892,171364,336749,647166,704672,1730044,2237669,242045789000,3135093000,3687470000,7096797000,14086446000,30010284000,34099190000,80294202000,158785066000
Texas,"Mining, Quarrying, and Oil and Gas Extraction",2015,36572,20077,5144,3693,28914,4987,1440,35341,1231,44355,20090,5145,3725,28960,5305,2360,36625,7730,1276087,32211,34037,49888,116342,192305,204284,514279,761426,117330617000,2284836000,2205055000,3233288000,7734703000,14367791000,17465400000,39662112000,77643932000
Texas,Other,2015,1268,1205,50,11,1266,2,0,1268,0,1268,1205,50,11,1266,2,0,1268,0,1638,1109,319,150,1578,0,0,1638,0,36106000,28013000,4772000,1764000,34549000,0,0,36106000,0
Texas,Other Services (except Public Administration),2015,228422,135905,46765,24160,206830,17481,2626,226937,1485,252420,136010,47065,25215,208290,22120,6655,237065,15355,2187520,250165,304985,319842,875080,639919,293687,1810325,371321,67719505000,7122140000,8098790000,8768021000,23991510000,17261162000,9146316000,50445540000,17010299000
Texas,"Professional, Scientific, and Technical Services",2015,309605,220138,39078,22754,281970,17717,4965,304652,4953,340825,220200,39305,23295,282800,20745,8540,312085,28740,3423900,325810,255045,301270,882145,636223,490635,2010225,1412744,278908930000,20814635000,14848520000,19440749000,55105650000,47770035000,41017249000,143987440000,134865697000
Texas,Real Estate and Rental and Leasing,2015,105271,79408,12195,5464,97067,4616,1921,103604,1667,144610,79505,12380,6100,97985,7685,7875,113545,31065,953370,118695,77205,70029,265950,154956,163292,585445,365303,51804705000,5311110000,3284895000,3149340000,11746165000,7809540000,9537546000,29143290000,22555056000
Texas,Retail Trade,2015,230394,135058,46786,23897,205741,16583,4363,226687,3707,401490,135530,47980,26265,209775,26600,18275,254650,146840,6397818,257680,305415,310180,873350,583383,494131,1952450,4299727,174787978000,7204980000,7868495000,9145816000,24221600000,21303327000,22417939000,67989735000,103594913000
Texas,Total,2015,428461,246691,74514,47555,368760,43507,10308,422575,5886,569091,247071,75350,49598,372019,54934,29030,455983,113108,10239710,411495,490164,636974,1538633,1658816,1474200,4671649,5568061,521095797000,19895978000,18735812000,24960654000,63592444000,69155630000,70528736000,203276810000,317818987000
Texas,Transportation and Warehousing,2015,74424,41805,11079,7408,60292,7088,2993,70373,4051,95695,41840,11105,7560,60505,8030,5215,73750,21945,2160278,64580,72215,97260,234524,239430,251066,730384,1421398,119306913000,2853309000,2889110000,4157936000,9934151000,11166469000,12259455000,33592032000,85024170000
Texas,Utilities,2015,4933,2575,870,365,3810,505,259,4574,359,9875,2575,875,365,3815,600,840,5255,4620,267632,5449,5361,4586,15516,21436,34766,72620,194367,26211979000,534682000,238474000,262551000,1045393000,1587976000,2937874000,5649034000,20513938000
Texas,Wholesale Trade,2015,130126,66570,20905,15198,102673,15066,6184,123923,6203,166900,66715,21280,16085,104080,19560,12865,136505,30395,2618700,114655,138050,197591,450460,492694,454389,1400565,1207001,179936840000,6432700000,7382686000,11256965000,25080425000,29051942000,29800661000,84100020000,95033302000
United States,Accommodation and Food Services,2015,2593061,1001101,504064,500879,2006044,525871,48790,2580705,12356,3438095,1003080,506000,507805,2016885,601040,216030,2833955,604140,65984460,1625485,3376455,6849235,11851175,19430635,8706460,39988270,25996067,1226237780000,48921670000,50877720000,106202755000,206002145000,335526845000,154841115000,696370105000,529861496000
United States,Administrative and Support and Waste Management and Remediation Services,2015,1683396,1081657,244567,149893,1476117,143502,41677,1661296,22100,2021410,1082375,245445,152580,1480400,160120,70955,1711475,309935,55562325,1582570,1603660,2011235,5197465,5678165,7249215,18125285,37435278,2140997450000,75711480000,57658485000,76531715000,209901680000,217476570000,244998008000,672403125000,1468505239000
United States,"Agriculture, Forestry, Fishing and Hunting",2015,108440,75241,17365,8455,101061,5865,1019,107945,495,111840,75250,17375,8490,101115,6235,2220,109570,2270,800720,109465,113500,111389,334365,210067,135028,681270,114939,32654840000,4761055000,4222835000,4466717000,13450950000,8736827000,4929313000,27177985000,5341682000
United States,"Arts, Entertainment, and Recreation",2015,615578,392117,79325,60413,531855,65208,14014,611077,4501,668050,392350,79760,61465,533575,71595,23975,629145,38905,11154110,492405,522405,818065,1832875,2615530,2402565,6850970,4293244,383997375000,47238705000,16044360000,20449610000,83732675000,61224625000,92364375000,237321675000,146278790000
United States,Construction,2015,3349514,2247429,527879,303293,3078601,233639,30461,3342701,6813,3411950,2247575,528090,303890,3079555,240490,45720,3365765,46185,30041430,3460545,3456555,4058595,10975695,8803575,4941310,24720580,5320850,1742994935000,155074830000,150040240000,203858175000,508973245000,518428770000,330863390000,1358265405000,384729530000
United States,Educational Services,2015,451672,221613,71304,58175,351092,74954,18523,444569,7103,509905,221870,71705,59625,353200,83880,32480,469560,40345,18210850,339920,479740,790000,1609660,3141380,3267495,8018535,10192300,673281975000,12451430000,11050125000,17794380000,41295935000,95916485000,122514945000,259727365000,413554181000
United States,Finance and Insurance,2015,1196674,853858,173555,67884,1095297,66352,22060,1183709,12965,2350310,855635,178955,82430,1117020,158295,174600,1449915,900395,30674964,1481553,1100855,892085,3474493,2634915,3489855,9600328,21074222,2978291838000,78003567000,64843045000,71091100000,213937712000,231017750000,323212013000,768463632000,2209653992000
United States,Health Care and Social Assistance,2015,3330710,1712864,710694,422394,2845952,336539,106265,3288756,41954,4380360,1716315,716135,440925,2873375,461080,344625,3679080,701280,96109320,2982280,4715259,5625597,13323355,13220750,16893735,43437840,52671480,4526920395000,161788660000,198963288000,244024230000,604794130000,532693330000,610152285000,1747639745000,2779280650000
United States,Information,2015,374121,228297,52048,36384,316729,38053,11569,366351,7770,697540,229185,52765,38160,320110,51340,30535,401985,295555,16971585,320585,343230,486690,1150505,1484435,1851026,4486125,12470986,1546634550000,24502555000,18225895000,27390445000,70118895000,101857410000,154760724000,326744130000,1219369981000
United States,Management of Companies and Enterprises,2015,136486,13697,3819,5406,22922,28438,45037,96397,40089,269715,13815,3875,5545,23235,29490,49600,102325,167390,16543795,16830,18085,34510,69425,371940,1580565,2021930,14521865,1835197705000,2833715000,1658710000,2962820000,7455245000,27820610000,124674080000,159949935000,1675247770000
United States,Manufacturing,2015,1290038,517893,230499,191252,939644,240697,70937,1251278,38760,1464125,518140,230790,192760,941690,256045,106100,1303835,160290,58020573,944661,1539138,2604391,5088655,9724362,10960680,25775388,32235838,3283497765000,43695491000,58440619000,109550627000,211919542000,462651695000,559568408000,1234289218000,2048660472000
United States,"Mining, Quarrying, and Oil and Gas Extraction",2015,111377,62221,16633,12002,90856,14022,3864,108742,2635,146125,62295,16750,12410,91455,16375,8395,116225,29900,3718300,101043,110344,162252,373755,533291,570557,1479906,2237449,308246440000,6312219000,6343456000,9823112000,22486195000,36043973000,43712521000,102426860000,205719153000
United States,Other,2015,20361,19576,635,120,20331,29,1,20361,0,20361,19576,635,120,20331,29,1,20361,0,24155,17597,4027,1577,23201,855,0,24155,0,519982000,431947000,58556000,19845000,510348000,9413000,0,519982000,0
United States,Other Services (except Public Administration),2015,3412756,2184986,676377,318034,3179397,202845,23172,3405414,7342,3730230,2187080,681720,331995,3200795,262125,85070,3547990,182240,27006165,4015755,4394430,4182655,12592840,7271505,3268311,23134130,3839191,843630150000,108218245000,115170745000,119053510000,342442500000,219533930000,124623664000,686659415000,156182050000
United States,"Professional, Scientific, and Technical Services",2015,4007997,2944687,511464,284090,3740241,207470,39510,3987221,20776,4480130,2946580,514535,295520,3756635,268385,105765,4130785,349345,43991300,4267670,3345335,3783180,11396185,7798895,6182925,25378005,18613295,3521950550000,258165355000,189862400000,242909140000,690936895000,601350040000,525775280000,1818062215000,1703888335000
United States,Real Estate and Rental and Leasing,2015,1462079,1158705,157714,71237,1387656,53657,13619,1454932,7147,1888010,1161370,161915,79945,1403230,94085,100460,1597775,290235,10327135,1631395,1012395,927460,3571250,1888010,1592914,7052650,3268948,531597975000,71953880000,41788345000,42909850000,156652075000,95956965000,88286138000,340900200000,190449236000
United States,Retail Trade,2015,3280813,1958148,664707,351911,2974766,244954,45600,3265320,15493,5351045,1964150,679830,387835,3031815,386645,232980,3651440,1699605,78520835,3595315,4370322,4612985,12578630,8977238,6014971,27571890,50800404,2141090030000,98392115000,112000189000,130783910000,341176270000,319229290000,237769554000,898202525000,1236051348000
United States,Total,2015,5900731,3643737,1004555,617390,5265682,526106,89479,5881267,19464,7663938,3649989,1016287,648694,5314970,697870,367335,6380175,1283763,124085947,5877075,6614340,8297864,20789279,20645466,17503402,58938147,65147800,6253488252000,263152063000,243719141000,321846938000,828718142000,876330967000,846259493000,2551308602000,3702179650000
United States,Transportation and Warehousing,2015,904821,580921,125942,83326,790189,77977,21113,889279,15542,1141910,581570,126870,85885,794325,93585,51600,939510,202400,23082840,837969,829575,1108600,2776299,2870987,2599984,8249118,14828160,1110091545000,33792707000,31202665000,43887181000,108893197000,122159414000,115533565000,346720536000,762940391000
United States,Utilities,2015,29992,14912,4966,2599,22477,4540,1640,28657,1335,89950,14975,5075,2825,22875,7350,7580,37805,52145,3196170,28880,31866,34790,95575,199860,266603,562615,2632995,320976620000,1453615000,1395444000,2168368000,5019685000,15020800000,21542721000,41636860000,279275897000
United States,Wholesale Trade,2015,1551578,876075,256053,179762,1311890,174434,44221,1530545,21033,2067185,878455,260670,192780,1331905,241045,147980,1720930,346255,30380545,1462945,1688200,2387010,5538155,6366285,5529345,17434035,12934536,2115665560000,80110380000,88499290000,133238230000,301847900000,378906750000,350137670000,1030909790000,1084128512000
Utah,Accommodation and Food Services,2015,19666,6345,3578,3740,13663,4781,587,19031,635,27525,6355,3610,3800,13765,5440,2510,21715,5810,557850,8885,23925,50967,83905,168824,94328,348240,209496,8743975000,279920000,337195000,669143000,1288035000,2421751000,1522927000,5264705000,3476021000
Utah,Administrative and Support and Waste Management and Remediation Services,2015,19471,12375,2485,1635,16495,1355,550,18400,1071,21440,12375,2485,1645,16505,1430,605,18540,2900,628593,16916,16127,21707,55139,51541,63351,176048,441227,21727627000,625861000,492618000,739314000,1872387000,1926406000,1973972000,5971237000,15312167000
Utah,"Agriculture, Forestry, Fishing and Hunting",2015,455,370,45,15,430,10,10,450,5,465,370,45,15,430,10,10,450,15,1835,444,257,76,951,0,0,1720,0,85146000,14846000,6328000,1344000,25899000,0,0,79961000,0
Utah,"Arts, Entertainment, and Recreation",2015,5135,3255,555,470,4280,595,142,5017,118,5360,3255,555,475,4285,615,185,5085,275,105385,3980,3488,5847,13720,21802,19930,60669,39562,1893736000,151472000,69483000,113984000,347945000,393140000,326486000,1201643000,593028000
Utah,Construction,2015,44015,28835,7455,4065,40355,2880,396,43631,384,44275,28840,7460,4070,40370,2920,430,43720,555,364790,43500,49280,54405,147185,107610,44548,305335,53832,17945455000,1669540000,1781045000,2310000000,5760585000,5279875000,2517995000,13905660000,3705583000
Utah,Educational Services,2015,5207,2585,725,665,3975,843,230,5048,159,5505,2585,725,665,3975,895,260,5130,375,231530,3672,5097,8949,17814,35235,29842,84765,141763,6457830000,116409000,99824000,154777000,374851000,957935000,904415000,2320285000,3856538000
Utah,Finance and Insurance,2015,16808,11955,1727,643,14325,811,319,15455,1353,25480,11970,1765,705,14440,1620,1460,17520,7960,310526,18520,10466,8106,37413,28017,36075,106162,199764,20584167000,776654000,519221000,432527000,1749170000,2606899000,1913175000,6605415000,13547456000
Utah,Health Care and Social Assistance,2015,32908,17825,6630,4230,28685,2893,659,32237,671,38870,17840,6665,4295,28800,3570,2130,34500,4370,666887,27178,43725,55513,126843,111033,86689,328709,334923,28386487000,1732875000,1401395000,1677428000,4824793000,3621528000,2756913000,11364763000,16871795000
Utah,Information,2015,5442,2785,560,441,3786,648,280,4714,728,7355,2785,565,455,3805,715,335,4855,2500,214843,3445,3381,5323,12712,24083,25633,67275,146539,14193434000,216731000,152031000,227655000,612886000,1536169000,1949054000,4364681000,9789913000
Utah,Management of Companies and Enterprises,2015,1917,306,35,35,376,295,456,1127,790,2440,310,35,35,380,295,470,1145,1295,119548,345,195,198,740,4200,15613,20553,98995,10435947000,20948000,19695000,8413000,49143000,243775000,1027719000,1320637000,9115310000
Utah,Manufacturing,2015,15909,6290,2700,2260,11250,2502,839,14591,1318,16430,6290,2705,2265,11260,2555,895,14710,1720,548705,10276,16273,26887,57922,90049,72803,246803,248797,29731287000,380187000,520967000,954837000,2038615000,3853461000,3795670000,10986542000,15964875000
Utah,"Mining, Quarrying, and Oil and Gas Extraction",2015,2217,1100,290,250,1640,226,51,1917,300,2375,1100,290,250,1640,230,55,1925,450,50904,1504,1810,3301,6762,5857,2661,17356,26904,3918292000,78085000,88238000,210334000,387576000,338816000,193109000,1067721000,2325608000
Utah,Other,2015,117,115,2,0,117,0,0,117,0,117,115,2,0,117,0,0,117,0,116,101,0,0,116,0,0,116,0,2511000,2388000,0,0,2511000,0,0,2511000,0
Utah,Other Services (except Public Administration),2015,22197,14170,4170,1995,20335,1193,228,21756,441,24545,14200,4185,2080,20465,1910,610,22985,1560,244235,23055,26990,25542,75936,38917,10927,131126,54600,8667665000,669499000,771852000,705018000,2160925000,1065214000,388389000,3827075000,2306346000
Utah,"Professional, Scientific, and Technical Services",2015,47945,35680,4835,2915,43430,2347,813,46590,1355,50730,35685,4850,2995,43530,2725,990,47245,3485,458197,44670,31854,38443,115495,81659,58279,259950,194632,24047870000,2228990000,1485935000,2040655000,5778235000,5262973000,4231963000,15514280000,8399114000
Utah,Real Estate and Rental and Leasing,2015,22451,18538,1773,800,21111,633,255,21999,452,25065,18555,1795,855,21205,1085,525,22815,2250,107020,21433,10970,10215,42945,18907,11870,75720,30253,4363695000,875113000,354774000,399905000,1640680000,752777000,491438000,2977130000,1339567000
Utah,Retail Trade,2015,31945,16668,5605,4303,26576,2774,776,30126,1819,47730,16705,5710,4570,26985,4055,2540,33580,14150,751862,25370,37373,56635,119875,98787,76660,299810,431199,20792865000,853037000,921238000,1474868000,3259563000,2971715000,2660664000,9003618000,11264322000
Utah,Total,2015,62916,38706,9264,6145,54115,5379,1366,60860,2056,75463,38745,9344,6338,54427,6684,3181,64292,11171,1203954,55016,61019,82297,198332,200033,159429,557794,646160,51453266000,2322812000,1994604000,2779804000,7097220000,7764688000,6877422000,21739330000,29713936000
Utah,Transportation and Warehousing,2015,10566,6400,1190,860,8450,868,342,9660,906,11525,6400,1190,870,8460,905,415,9780,1745,291780,8758,7706,11056,28276,27577,24495,83985,184513,12873360000,319095000,277167000,444754000,1062786000,1178976000,1050062000,3375094000,8766226000
Utah,Utilities,2015,426,270,35,30,335,25,23,383,43,1105,270,35,30,335,50,65,450,655,18742,419,245,359,1047,688,2214,4214,0,1770979000,12528000,8370000,18342000,40512000,55309000,250086000,364205000,0
Utah,Wholesale Trade,2015,15996,7255,2035,1566,10856,2121,1011,13988,2008,18510,7260,2040,1615,10915,2395,1415,14725,3785,276598,11323,12432,19242,44278,62768,41708,155191,116650,16685664000,529997000,537745000,966679000,2089130000,3344670000,2510955000,8333852000,8035666000
Vermont,Accommodation and Food Services,2015,8625,3405,1585,1715,6705,1520,167,8392,233,9755,3405,1590,1740,6735,1695,355,8785,970,164925,5365,10724,23380,39585,48666,16267,106185,58740,2972050000,156480000,168122000,392913000,723635000,951886000,323711000,2025055000,946777000
Vermont,Administrative and Support and Waste Management and Remediation Services,2015,5289,3725,640,315,4680,250,58,4988,301,5555,3725,640,325,4690,280,65,5035,520,39001,4868,4055,3596,13115,6652,1489,23948,13724,1263904000,235969000,127016000,135731000,523777000,217755000,36950000,862735000,350932000
Vermont,"Agriculture, Forestry, Fishing and Hunting",2015,710,580,95,20,695,5,10,710,0,710,580,95,20,695,5,10,710,0,2508,963,496,51,1818,0,0,2508,0,91031000,27071000,14504000,1951000,54361000,0,0,91031000,0
Vermont,"Arts, Entertainment, and Recreation",2015,2289,1465,330,235,2030,170,54,2254,35,2365,1465,340,240,2045,180,105,2330,35,35680,2126,1982,2750,7219,4598,9168,23574,7258,711418000,110882000,55460000,73325000,263632000,90439000,135512000,544772000,99914000
Vermont,Construction,2015,13474,10115,1845,835,12795,520,78,13393,81,13505,10115,1845,840,12800,530,90,13420,85,69537,15370,11868,10404,38151,17104,5235,64202,1550,3710264000,737370000,519872000,534315000,1822907000,956498000,321010000,3350464000,98290000
Vermont,Educational Services,2015,1825,850,320,200,1370,265,115,1750,75,1960,850,320,200,1370,375,130,1875,85,78967,1352,2004,2402,6157,10564,17379,35737,42825,2340138000,45602000,49196000,46239000,153360000,300338000,620269000,1126308000,1202364000
Vermont,Finance and Insurance,2015,2503,1375,285,125,1785,185,120,2090,413,4695,1380,305,185,1870,460,830,3160,1535,45417,2765,1625,1250,5938,5670,12971,26807,17496,3221650000,154596000,102566000,87754000,363125000,416150000,725813000,1695839000,1452436000
Vermont,Health Care and Social Assistance,2015,8581,3740,1880,1120,6740,1103,399,8242,339,10515,3745,1880,1155,6780,1365,1035,9180,1335,237614,6930,12253,14546,34200,39534,41791,118634,112763,10231333000,307319000,472119000,512970000,1315356000,1294713000,1700919000,4421156000,5614405000
Vermont,Information,2015,1886,820,345,195,1360,212,80,1652,234,2425,820,345,195,1360,285,100,1745,680,34122,1439,2163,2199,6137,6949,1335,19903,13927,2080992000,57049000,69774000,79839000,218732000,369121000,93461000,1053477000,1013503000
Vermont,Management of Companies and Enterprises,2015,385,20,10,30,60,65,90,215,170,440,20,10,30,60,65,90,215,225,14125,19,0,71,135,974,3350,4465,9660,905940000,2496000,0,4214000,15270000,64685000,166210000,246895000,659045000
Vermont,Manufacturing,2015,4793,2160,780,575,3515,716,290,4521,272,5000,2160,785,580,3525,735,405,4665,335,123106,3225,3958,5762,15251,23402,13083,70188,30081,6247876000,117028000,155743000,222636000,584664000,1065759000,633918000,3230116000,1743491000
Vermont,"Mining, Quarrying, and Oil and Gas Extraction",2015,191,110,10,30,150,20,5,175,16,225,110,10,30,150,35,15,200,25,2257,125,0,260,497,282,0,1087,741,152222000,11600000,0,21048000,39474000,16416000,0,77699000,46665000
Vermont,Other,2015,53,53,0,0,53,0,0,53,0,53,53,0,0,53,0,0,53,0,56,56,0,0,56,0,0,56,0,1611000,1611000,0,0,1611000,0,0,1611000,0
Vermont,Other Services (except Public Administration),2015,9722,6415,2020,742,9177,315,68,9560,162,10105,6425,2030,800,9255,455,115,9825,280,46457,11978,12621,9189,34227,7674,887,44904,814,1372574000,356907000,324509000,252589000,947862000,248325000,41861000,1317308000,35006000
Vermont,"Professional, Scientific, and Technical Services",2015,10224,7075,1520,710,9305,415,103,9823,401,10625,7075,1525,730,9330,520,130,9980,645,94178,10879,10011,8780,30299,12082,5255,50570,22535,4610940000,549777000,535879000,518069000,1636140000,875147000,435148000,3176082000,1103048000
Vermont,Real Estate and Rental and Leasing,2015,3339,2500,360,150,3010,153,25,3188,151,3865,2500,370,170,3040,225,245,3510,355,16226,3821,2192,1770,8095,3221,131,12171,3036,705377000,149496000,80409000,63916000,317716000,147010000,5500000,511364000,149285000
Vermont,Retail Trade,2015,12244,5475,2609,1697,9781,1266,270,11317,927,16755,5485,2675,1800,9960,2070,1045,13075,3680,199013,10429,16917,20476,48817,40251,19496,112044,82752,5459575000,292420000,433434000,579007000,1337767000,1477479000,712932000,3648022000,1701908000
Vermont,Total,2015,18126,10598,3070,1822,15490,1528,353,17371,755,21121,10606,3102,1905,15613,2033,1056,18702,2419,266363,17491,20192,23876,61559,53877,42662,158098,108265,10615093000,715073000,691213000,816350000,2222636000,2096797000,1872010000,6191443000,4423650000
Vermont,Transportation and Warehousing,2015,2192,1285,300,150,1735,217,85,2037,155,2425,1285,300,150,1735,235,120,2090,335,27189,1995,1740,1506,5870,5949,1906,16692,4237,1064677000,75434000,67214000,59218000,218687000,241716000,78417000,636672000,193488000
Vermont,Utilities,2015,140,50,10,10,70,10,25,105,35,295,50,10,10,70,15,45,130,165,8338,44,0,0,147,0,1194,1964,4234,724668000,2218000,0,0,11206000,0,109454000,171625000,366490000
Vermont,Wholesale Trade,2015,3664,1570,425,325,2320,548,236,3104,560,4120,1570,435,325,2330,635,350,3315,805,56671,2493,2184,3004,9218,14307,10469,41086,14443,3054322000,115173000,104415000,148743000,434419000,709671000,546829000,2061731000,928077000
Virginia,Accommodation and Food Services,2015,63993,22780,12531,13042,48353,12698,1414,62465,1528,86990,22830,12610,13180,48620,14055,5715,68390,18600,1700610,37745,83623,175584,297040,454426,204068,955895,743996,29761915000,1176835000,1327349000,2699640000,5205290000,7813263000,3213432000,16250015000,13503533000
Virginia,Administrative and Support and Waste Management and Remediation Services,2015,45032,25875,6565,4280,36720,4510,1780,43010,2022,53210,25895,6565,4320,36780,4855,2815,44450,8760,1226124,41032,42643,56876,140835,173976,231375,548928,674082,48941934000,1527229000,1417734000,2145034000,5105060000,6941230000,8609397000,20780289000,28011051000
Virginia,"Agriculture, Forestry, Fishing and Hunting",2015,3360,2270,635,255,3160,145,30,3335,25,3380,2270,635,255,3160,145,35,3340,40,20841,3947,3894,2973,11154,3490,444,17346,0,1017843000,123411000,138862000,110400000,388041000,156098000,24119000,692083000,0
Virginia,"Arts, Entertainment, and Recreation",2015,13407,7740,1920,1370,11030,1692,377,13099,308,14680,7750,1930,1380,11060,1790,585,13435,1245,282305,10936,12652,18343,42248,67252,42685,157858,98746,7071111000,419894000,262272000,396192000,1087046000,1327757000,1007380000,3683470000,2252443000
Virginia,Construction,2015,95269,62115,15100,8865,86080,7374,1102,94556,713,96945,62115,15115,8870,86100,7495,1690,95285,1660,863265,99965,99425,118395,317785,275640,124205,719330,140830,45376100000,3931665000,3870680000,5495520000,13297865000,14840285000,7210220000,35443005000,9681124000
Virginia,Educational Services,2015,13891,6710,2300,1850,10860,2069,515,13444,447,15210,6715,2310,1915,10940,2195,705,13840,1370,395990,10496,15131,25390,51065,81618,73065,208350,187066,13378720000,358785000,381607000,601200000,1342955000,2634017000,2944212000,7121345000,6233728000
Virginia,Finance and Insurance,2015,28283,18488,3810,1495,23793,1511,981,26285,1998,56015,18515,3915,1735,24165,3220,4880,32265,23750,770914,33285,23638,18632,75736,50690,80996,209589,559075,65081856000,1621902000,1320036000,1525804000,4478692000,4053851000,6777450000,15568647000,49431691000
Virginia,Health Care and Social Assistance,2015,73597,32655,16746,11011,60412,9136,2049,71597,2000,98230,32700,16940,11670,61310,12495,6360,80165,18065,2176203,61196,111744,145895,318931,351550,303551,978165,1192725,104314699000,3048839000,4926218000,6609172000,14587069000,14938856000,12483988000,42168532000,61911636000
Virginia,Information,2015,10218,4760,1235,995,6990,1282,591,8863,1355,19350,4790,1235,1005,7030,1500,805,9335,10015,473147,7101,8087,12458,28150,43500,53427,128345,339104,42804857000,445485000,442313000,783798000,1703351000,3490929000,4363661000,9792226000,32365957000
Virginia,Management of Companies and Enterprises,2015,4239,275,90,130,495,636,1208,2339,1900,6815,275,90,130,495,650,1280,2425,4390,338665,390,545,785,1720,7880,39143,48745,289894,33334320000,40246000,78145000,78680000,197071000,610515000,3161294000,3969740000,29361817000
Virginia,Manufacturing,2015,23208,8425,3995,3089,15509,3977,1521,21007,2201,24920,8425,3995,3105,15525,4215,1975,21715,3205,1137713,15136,24596,38048,82053,140928,136688,400252,654476,61924891000,602475000,857146000,1493614000,3144133000,6249412000,6577174000,17990244000,38795678000
Virginia,"Mining, Quarrying, and Oil and Gas Extraction",2015,971,315,75,135,525,181,112,818,153,1495,315,75,135,525,200,205,930,565,42375,542,387,1597,2859,6029,5107,16102,24893,2930745000,33359000,18383000,83368000,154285000,346258000,251951000,875750000,1911099000
Virginia,Other,2015,533,520,12,1,533,0,0,533,0,533,520,12,1,533,0,0,533,0,565,481,73,0,565,0,0,565,0,12345000,10772000,1486000,0,12345000,0,0,12345000,0
Virginia,Other Services (except Public Administration),2015,100233,61336,20180,10055,91571,6901,920,99392,841,108345,61370,20300,10355,92025,8150,2650,102825,5520,814260,114450,131281,132417,378365,242063,93232,716240,85334,30267670000,3142885000,3652230000,4246881000,11048735000,9407501000,5259221000,25827955000,3663109000
Virginia,"Professional, Scientific, and Technical Services",2015,131571,89891,15526,9623,115040,10046,3431,128517,3054,154295,89930,15585,9890,115405,11755,4650,131810,22485,2187740,128875,101756,128121,358980,359545,378137,1100000,1075733,202468265000,9097145000,6731196000,9644390000,25485070000,30923688000,33901547000,90534710000,111000971000
Virginia,Real Estate and Rental and Leasing,2015,33280,24961,3248,1750,29959,1449,820,32228,1052,46960,25020,3350,1955,30325,2725,4095,37145,9815,267275,35838,20159,21530,77685,43048,41315,162925,101077,13848570000,1579399000,864098000,1060192000,3510250000,2094225000,2330636000,7973395000,5551536000
Virginia,Retail Trade,2015,78664,42488,15819,9413,67720,6039,1936,75695,2969,135940,42615,16240,10230,69085,9275,6425,84785,51155,2119320,79510,103918,120229,303800,199879,156191,662115,1408645,55909510000,2055906000,2559509000,3127152000,7746676000,6804149000,6740067000,21364356000,33384549000
Virginia,Total,2015,150984,87735,25262,16348,129345,14552,3619,147516,3468,197384,87855,25538,17036,130429,18204,9869,158502,38882,3198718,144493,166034,217153,527680,536990,439162,1503832,1694886,165788897000,6224838000,6185102000,8676615000,21086555000,24516646000,23489484000,69092685000,96696212000
Virginia,Transportation and Warehousing,2015,21011,11949,2780,1900,16629,1861,882,19372,1639,24440,11955,2790,1950,16695,2050,1165,19910,4530,507560,18049,17943,24688,61281,61620,45392,174211,295878,23208724000,629464000,636903000,940226000,2236440000,2679190000,2040913000,7237506000,14072272000
Virginia,Utilities,2015,485,130,60,15,205,45,70,320,165,1670,140,60,15,215,50,200,465,1205,71355,191,323,82,744,1593,7344,10347,60886,7480336000,9367000,13406000,11078000,52021000,112856000,622909000,823226000,6645953000
Virginia,Wholesale Trade,2015,27615,13040,3830,2923,19793,3452,1784,25029,2586,35365,13050,3890,3080,20020,4200,3110,27330,8035,515890,20678,24528,37121,82861,99483,97911,284715,224793,33718955000,1179398000,1252633000,2027890000,4482597000,5869144000,5780150000,16372475000,16836796000
Washington,Accommodation and Food Services,2015,66521,24376,15368,13255,52999,11366,1211,65576,945,83520,24420,15430,13575,53425,13460,4805,71690,11830,1342410,40760,102520,178430,321710,385064,172976,880310,450234,28045460000,1162820000,1669045000,3267540000,6099405000,8041789000,3672861000,17828249000,9979021000
Washington,Administrative and Support and Waste Management and Remediation Services,2015,42500,26605,6660,3770,37035,3044,890,40969,1531,48210,26620,6680,3820,37120,3255,1250,41625,6585,756475,40083,42604,49265,132249,109086,108714,355636,398689,33267756000,1506457000,1416477000,1900780000,4836248000,4393955000,4280795000,13777605000,19379641000
Washington,"Agriculture, Forestry, Fishing and Hunting",2015,6950,5140,685,450,6275,475,130,6880,70,7070,5140,685,450,6275,490,150,6915,155,69197,5747,4336,5974,16179,19229,22777,59324,3685,3455647000,395127000,190585000,286976000,877556000,963349000,920574000,2807596000,299566000
Washington,"Arts, Entertainment, and Recreation",2015,13626,7815,1855,1460,11130,1783,471,13384,242,14670,7820,1855,1475,11150,1880,660,13690,980,298710,11216,12461,19516,43567,71394,76143,194850,100901,9043229000,425152000,300572000,393789000,1130664000,1476801000,1955414000,4682419000,4322048000
Washington,Construction,2015,105977,72943,16085,8655,97683,6750,915,105348,629,106870,72945,16090,8655,97690,6870,1120,105680,1190,821110,110075,105062,114330,329495,245748,117132,696105,122885,50407540000,4855585000,4576575000,6042115000,15475215000,15526040000,8713463000,39970455000,10318225000
Washington,Educational Services,2015,13298,6710,2245,1875,10830,1718,375,12923,375,14205,6715,2250,1890,10855,1900,620,13375,830,275523,9967,15190,25469,50642,65133,45742,163488,111101,7909764000,340156000,353150000,588546000,1283841000,1818479000,1607640000,4806154000,3077822000
Washington,Finance and Insurance,2015,25463,17190,3310,1169,21669,1166,730,23565,1898,48645,17210,3365,1255,21830,1885,3520,27235,21410,481555,29824,20598,14403,65178,34165,65259,166487,314682,40410524000,1590203000,1193822000,1184438000,3998996000,2844759000,4412096000,11498356000,28873413000
Washington,Health Care and Social Assistance,2015,83225,43213,18878,10293,72384,6893,2328,81605,1620,102670,43280,18985,10630,72895,9420,6585,88900,13770,1959767,75907,125278,134735,336061,265182,332063,934530,1013669,102778005000,3200684000,4995988000,5697030000,13898382000,10234751000,14385241000,38562215000,63995952000
Washington,Information,2015,10741,5305,1331,1125,7761,1225,593,9579,1162,16935,5310,1340,1160,7810,1430,705,9945,6990,636210,7616,8659,14425,31110,42508,47015,123775,509636,98144335000,525309000,483196000,893996000,1921090000,3041688000,6322247000,11506048000,86423045000
Washington,Management of Companies and Enterprises,2015,3784,360,125,150,635,591,976,2202,1582,5450,360,125,150,635,600,1000,2235,3215,436480,369,495,810,1674,7575,38198,47455,389018,51641060000,68372000,54880000,62795000,186047000,575415000,2898896000,3660660000,47979967000
Washington,Manufacturing,2015,33589,14325,5829,4365,24519,5210,1770,31499,2090,35105,14335,5830,4410,24575,5295,2165,32035,3070,1242196,23975,36869,55075,120938,193793,202943,555563,640790,78649165000,1039389000,1441523000,2427000000,5135302000,9516567000,11436494000,28011561000,47749727000
Washington,"Mining, Quarrying, and Oil and Gas Extraction",2015,698,340,106,60,506,64,25,595,103,915,340,110,60,510,85,75,670,245,11713,480,544,741,1908,1739,477,5218,4788,737951000,28579000,25963000,37517000,100532000,117447000,37023000,331998000,303478000
Washington,Other,2015,675,653,17,5,675,0,0,675,0,675,653,17,5,675,0,0,675,0,733,572,96,65,733,0,0,733,0,16725000,14536000,1547000,642000,16725000,0,0,16725000,0
Washington,Other Services (except Public Administration),2015,77680,48540,16281,7176,71997,4330,696,77023,657,85775,48545,16380,7520,72445,5820,2340,80605,5170,564581,88532,105230,93515,287443,142976,55374,488146,63635,18449939000,2458271000,2924515000,2758819000,8147253000,4538925000,1891683000,14679004000,3129905000
Washington,"Professional, Scientific, and Technical Services",2015,99477,70575,12060,6975,89610,5591,1944,97145,2332,106335,70590,12085,7130,89805,6350,2590,98745,7590,965325,99790,77887,91543,269740,185688,160749,621350,339730,80587155000,6322060000,4642298000,6167964000,17157970000,15369695000,14852860000,47800545000,32607291000
Washington,Real Estate and Rental and Leasing,2015,41324,32272,4411,1785,38468,1405,697,40570,754,52140,32315,4515,1970,38800,2315,3745,44860,7280,230190,44714,28096,22124,95190,40305,36595,173926,55355,11387320000,1879907000,1050037000,1053202000,3992480000,2020157000,1812029000,7940702000,3406625000
Washington,Retail Trade,2015,73512,38540,15874,8726,63140,6417,1566,71123,2389,108890,38635,16140,9520,64295,9485,5245,79025,29865,1653227,72220,105549,114362,292470,223155,122830,644015,976062,50349986000,2049725000,2687489000,3384852000,8130505000,8464686000,5325969000,22096975000,27400774000
Washington,Total,2015,149765,89919,25864,15359,131142,12513,3118,146773,2992,182913,90011,26081,15966,132058,15754,8386,156198,26715,2602408,142791,169751,203204,515746,452931,370406,1339083,1263325,149258789000,6129749000,6161181000,8107566000,20398496000,20411540000,19714912000,60524948000,88733841000
Washington,Transportation and Warehousing,2015,22428,12945,2840,2008,17793,1982,951,20726,1702,25885,12945,2870,2075,17890,2200,1425,21515,4370,485222,17727,18299,25598,62204,63035,37725,169400,302614,25972870000,837823000,709350000,1151704000,2740181000,2734540000,2030383000,7831939000,16914676000
Washington,Utilities,2015,936,520,155,60,735,65,45,845,91,1485,520,160,60,740,130,55,925,560,41515,992,911,840,2820,2538,1306,6886,32019,4554797000,23999000,29164000,56699000,116497000,234298000,131770000,495314000,3697288000
Washington,Wholesale Trade,2015,37758,18715,5348,3820,27883,4660,2276,34819,2939,46415,18745,5425,4000,28170,5900,3875,37945,8470,653990,30449,34314,47951,113042,145802,131131,394235,253345,43178760000,1819859000,1901585000,2849608000,6591176000,9138073000,7599320000,23547515000,18958993000
West Virginia,Accommodation and Food Services,2015,13041,4465,2665,2518,9648,2422,479,12549,492,17775,4470,2670,2560,9700,3020,1945,14665,3110,336270,7703,17743,34377,60038,89882,52467,203458,132717,5243670000,170424000,226533000,467655000,867824000,1317082000,693703000,2907739000,2326159000
West Virginia,Administrative and Support and Waste Management and Remediation Services,2015,6432,3530,950,565,5045,570,228,5843,589,7395,3530,950,570,5050,625,305,5980,1415,160754,5226,5927,7135,18934,17534,35676,74300,79702,4677321000,173710000,172738000,232585000,603001000,602117000,1064967000,2369540000,2103685000
West Virginia,"Agriculture, Forestry, Fishing and Hunting",2015,1360,1095,200,45,1340,5,10,1355,5,1360,1095,200,45,1340,5,10,1355,5,4666,1831,1290,511,3691,0,0,4601,0,154367000,51412000,32190000,16316000,101892000,0,0,148277000,0
West Virginia,"Arts, Entertainment, and Recreation",2015,3365,1750,680,465,2895,331,80,3306,59,3790,1750,680,575,3005,570,135,3710,80,36472,3159,4319,5786,13789,9378,5770,31918,1263,632938000,87081000,68028000,90151000,255904000,174709000,66346000,542193000,28047000
West Virginia,Construction,2015,15640,9915,2765,1640,14320,947,193,15460,180,15770,9915,2765,1640,14320,965,215,15500,270,120915,16250,17996,21313,55945,32640,15582,107640,11291,6214160000,531095000,639226000,908622000,2095140000,1942656000,1116027000,5345125000,762833000
West Virginia,Educational Services,2015,1290,555,215,180,950,220,50,1220,70,1340,555,215,180,950,235,65,1250,90,49985,1012,1331,2208,4741,7555,7561,21600,27842,1319358000,24982000,21519000,45005000,96021000,208422000,184936000,533623000,776009000
West Virginia,Finance and Insurance,2015,5805,3315,890,300,4505,452,185,5142,663,10540,3325,925,395,4645,1325,795,6765,3775,87168,6660,5418,3469,16018,17835,9889,46303,40114,4336693000,228838000,202477000,165397000,628572000,753935000,441252000,2011476000,2282755000
West Virginia,Health Care and Social Assistance,2015,16504,6140,4083,2401,12624,2224,931,15779,725,24390,6140,4100,2525,12765,3145,2800,18710,5680,654280,12379,26845,31648,71212,85008,126337,284126,364518,27590429000,542940000,949200000,1237677000,2740331000,3061243000,3988874000,9831226000,17491837000
West Virginia,Information,2015,1328,445,180,160,785,147,64,996,332,3300,445,180,160,785,210,140,1135,2165,52523,770,1032,1856,4031,4172,3542,13043,39322,2522072000,19904000,28428000,49175000,110687000,134057000,117721000,405800000,2109605000
West Virginia,Management of Companies and Enterprises,2015,806,35,15,30,80,150,236,466,340,1135,35,15,30,80,150,245,475,660,27410,64,80,149,315,2200,4790,7335,19991,2120090000,3376000,2928000,7529000,14610000,87565000,367300000,473200000,1630227000
West Virginia,Manufacturing,2015,5535,1830,875,722,3427,1057,393,4877,658,5980,1830,875,725,3430,1160,495,5085,895,200033,3226,5088,7602,18030,30564,18232,83867,92058,11073067000,87303000,149853000,246602000,558430000,1181549000,915261000,3413652000,6257700000
West Virginia,"Mining, Quarrying, and Oil and Gas Extraction",2015,2431,1070,310,285,1665,332,119,2116,315,3115,1070,310,290,1670,355,140,2165,950,125537,1808,1971,3717,7547,11492,9550,29842,95379,9132370000,195239000,71378000,168922000,439678000,630820000,636449000,1795156000,7319030000
West Virginia,Other,2015,78,72,6,0,78,0,0,78,0,78,72,6,0,78,0,0,78,0,108,72,36,0,108,0,0,108,0,1664000,1075000,589000,0,1664000,0,0,1664000,0
West Virginia,Other Services (except Public Administration),2015,20359,13090,4160,1801,19051,838,166,20055,304,21770,13110,4185,1875,19170,1125,240,20535,1235,121489,25417,26408,23260,75477,25393,3644,107899,10650,3054398000,520306000,553619000,539844000,1626245000,681142000,137267000,2560550000,408638000
West Virginia,"Professional, Scientific, and Technical Services",2015,13001,7745,2125,1085,10955,919,450,12324,677,14605,7750,2130,1130,11010,1135,700,12845,1760,133400,13585,13548,13503,41170,27301,23030,93652,36973,6537757000,502486000,541335000,620558000,1690202000,1483302000,1196507000,4497468000,1970410000
West Virginia,Real Estate and Rental and Leasing,2015,5636,3965,795,265,5025,170,126,5321,315,6960,3970,800,275,5045,255,410,5710,1250,29448,6592,4865,3044,14972,3152,1605,20647,8286,1090226000,197014000,155542000,108901000,483045000,101948000,79389000,702375000,369137000
West Virginia,Retail Trade,2015,17566,8238,3639,2286,14163,1800,414,16377,1189,30750,8270,3715,2510,14495,2750,1675,18920,11830,403569,15724,24075,28949,69367,60545,26815,161206,232138,9693693000,343348000,561421000,748143000,1665155000,1926759000,698431000,4416545000,4992985000
West Virginia,Total,2015,27535,14464,5233,3161,22858,2638,759,26255,1280,36993,14486,5281,3352,23119,3731,2256,29106,7887,565435,26217,34281,41988,102486,96237,81490,280213,285222,22159084000,803503000,971453000,1293591000,3068547000,3341265000,2910718000,9320530000,12838554000
West Virginia,Transportation and Warehousing,2015,5116,2755,845,465,4065,449,179,4693,423,5980,2755,845,470,4070,480,245,4795,1185,68847,4395,5358,5392,15835,11496,4874,33840,24187,3091710000,147087000,182260000,194416000,547389000,470169000,166339000,1241392000,1372245000
West Virginia,Utilities,2015,304,95,25,45,165,30,15,210,94,1190,95,25,55,175,80,120,375,815,31794,250,89,373,884,582,0,4044,26714,3215382000,8160000,3368000,11139000,29094000,29273000,0,243839000,2895791000
West Virginia,Wholesale Trade,2015,5730,1955,775,690,3420,856,389,4665,1065,7430,1960,790,750,3500,1065,600,5165,2265,110212,3581,4499,7489,17076,19646,12210,56373,51429,5524465000,134534000,170551000,314213000,682448000,911451000,590064000,2485284000,2919151000
Wisconsin,Accommodation and Food Services,2015,59110,23432,11369,11065,45866,11276,1054,58196,914,72310,23525,11375,11175,46075,13130,3780,62985,9325,1167660,37500,76190,150857,264625,411717,141367,817855,345261,16894020000,918210000,901120000,1811140000,3630985000,5659122000,2129175000,11421475000,5348436000
Wisconsin,Administrative and Support and Waste Management and Remediation Services,2015,29024,17855,4180,2402,24437,2291,945,27673,1351,35345,17855,4180,2440,24475,2500,1580,28555,6790,790388,25699,27214,31443,84674,84416,129369,301848,485993,23530728000,1136964000,911355000,1082824000,3144677000,2811293000,3543388000,9652998000,13780342000
Wisconsin,"Agriculture, Forestry, Fishing and Hunting",2015,2740,2130,330,135,2595,85,35,2715,25,2765,2130,330,135,2595,85,45,2725,40,15895,2959,2016,1735,6890,1721,4015,12860,231,729065000,111610000,63679000,76052000,260141000,70787000,250995000,586740000,7593000
Wisconsin,"Arts, Entertainment, and Recreation",2015,12962,7370,1832,1634,10836,1616,339,12791,171,13575,7370,1845,1680,10895,1885,445,13225,350,213906,10160,12281,21892,44785,61956,49288,160661,36809,5827026000,386613000,283086000,357855000,1042430000,1133617000,1072980000,3999017000,741964000
Wisconsin,Construction,2015,66759,46090,10510,5455,62055,3810,535,66400,359,67605,46095,10520,5490,62105,3995,735,66835,770,508305,70275,68090,72252,210680,136554,64437,416680,90062,33728865000,3501405000,3214763000,4082557000,10802350000,9183590000,5081309000,25407455000,8214216000
Wisconsin,Educational Services,2015,7686,3205,1275,1180,5660,1495,255,7410,276,8175,3205,1275,1195,5675,1590,320,7585,590,277780,5208,8704,15616,29710,55815,33083,119768,156082,9500085000,142677000,161546000,296752000,607645000,1428617000,993056000,3073850000,6337272000
Wisconsin,Finance and Insurance,2015,23789,15305,3050,1154,19509,1827,827,22163,1626,45160,15325,3125,1415,19865,4675,4825,29365,15795,685460,26888,19056,14709,61150,68236,85955,217444,464222,49813153000,1212381000,953716000,920446000,3130593000,4079959000,5143371000,12556832000,37016980000
Wisconsin,Health Care and Social Assistance,2015,51518,21980,10378,7698,40056,7161,2399,49616,1902,76265,22060,10465,8160,40685,11140,7405,59230,17035,1971289,39398,69426,103315,212169,277552,342623,836050,1134254,89072240000,2083140000,2623151000,4091208000,8798133000,10334324000,10497953000,29808723000,59224478000
Wisconsin,Information,2015,5437,2180,790,635,3605,783,316,4704,733,10930,2190,805,675,3670,1115,590,5375,5555,283244,3414,4946,7966,16864,24257,26457,71263,211207,19593746000,153412000,221347000,320578000,718603000,1210651000,1577488000,3705731000,15839780000
Wisconsin,Management of Companies and Enterprises,2015,3565,235,40,120,395,725,1007,2127,1438,5280,235,40,120,395,745,1080,2220,3060,419015,266,268,589,1150,9240,30740,41130,377885,35388285000,63761000,19460000,97434000,182940000,498905000,2209405000,2891250000,32497035000
Wisconsin,Manufacturing,2015,40292,12229,6060,5755,24044,9085,3748,36877,3415,44105,12235,6065,5845,24145,9490,4765,38400,5705,2218899,22212,39061,75289,141014,371764,473043,1031505,1101102,117770091000,1066904000,1466922000,3254622000,6034741000,17841588000,23834795000,50074271000,62849221000
Wisconsin,"Mining, Quarrying, and Oil and Gas Extraction",2015,761,305,115,110,530,100,57,687,74,885,320,115,125,560,100,105,765,120,15730,460,643,1356,2550,2650,4424,9833,5708,1089832000,121561000,33138000,98751000,257986000,185021000,242515000,697705000,376752000
Wisconsin,Other,2015,325,316,7,1,324,1,0,325,0,325,316,7,1,324,1,0,325,0,350,275,44,0,329,0,0,350,0,4503000,3892000,442000,0,4345000,0,0,4503000,0
Wisconsin,Other Services (except Public Administration),2015,67690,39625,14957,7370,61952,4582,574,67108,582,72830,39705,15070,7670,62445,6170,1640,70255,2575,534294,77114,96574,95582,269592,157007,44745,475854,54523,14116288000,1951614000,2225866000,2271591000,6459856000,4092153000,1507843000,12320833000,1686765000
Wisconsin,"Professional, Scientific, and Technical Services",2015,53281,34855,7670,4639,47164,3501,1044,51709,1572,57905,34885,7730,4795,47410,4355,1675,53440,4465,539553,53111,49631,61221,164261,116654,93941,377322,158326,34580285000,2574231000,2430251000,3259637000,8277921000,7116280000,7550176000,23071608000,11376752000
Wisconsin,Real Estate and Rental and Leasing,2015,19124,13910,2370,1105,17385,889,408,18682,442,23630,13935,2440,1160,17535,1255,1870,20660,2970,125750,20411,15120,14145,49862,29660,21875,103220,21031,4737505000,766525000,518763000,596643000,1888091000,1099705000,786428000,3906750000,798153000
Wisconsin,Retail Trade,2015,61046,29574,13130,7822,50526,6525,1578,58629,2417,95570,29670,13495,8595,51760,9865,5730,67355,28215,1546830,55362,86951,103332,245900,236364,140347,628450,909640,39670315000,1493253000,2090116000,2570136000,6160205000,7226627000,4257658000,17826655000,21625140000
Wisconsin,Total,2015,108745,59550,19103,12708,91361,11906,2830,106097,2648,139500,59663,19306,13315,92284,15955,8286,116525,22975,2503532,98585,125802,170417,394804,456321,394362,1245487,1258045,112406494000,3980514000,4099481000,5811847000,13891842000,17152826000,17152072000,48196740000,64209754000
Wisconsin,Transportation and Warehousing,2015,23949,13800,3370,2280,19450,2391,752,22593,1356,27075,13810,3375,2315,19500,2650,1240,23390,3685,506922,20003,21944,29732,72347,81040,62589,218464,280269,21402502000,834324000,837369000,1146849000,2852430000,3235986000,2417287000,8622855000,12372220000
Wisconsin,Utilities,2015,390,70,25,25,120,130,5,255,135,1530,70,25,35,130,245,5,380,1150,67803,84,113,291,638,4627,0,5370,62423,6814129000,3602000,1608000,18846000,33468000,294379000,0,335958000,6477561000
Wisconsin,Wholesale Trade,2015,28145,12083,4190,3422,19695,3956,2003,25654,2491,34935,12115,4220,3545,19880,4780,3595,28255,6680,585265,20178,27052,43728,91812,130282,138666,369770,212253,34750590000,1251895000,1398169000,2374300000,5061870000,7262824000,7609927000,20441589000,14130927000
Wyoming,Accommodation and Food Services,2015,8056,3070,1485,1470,6025,1475,301,7801,255,9205,3075,1490,1490,6055,1755,775,8585,620,145798,4671,10147,19554,34428,51980,34076,120722,23783,2851500000,178124000,154914000,309261000,643163000,913564000,630597000,2200331000,616988000
Wyoming,Administrative and Support and Waste Management and Remediation Services,2015,4874,3265,700,353,4318,230,55,4603,271,5160,3265,705,360,4330,250,65,4645,515,32095,4602,4408,4338,13891,7140,1425,23297,8271,1073064000,188254000,133463000,143038000,478958000,220146000,27490000,756558000,285650000
Wyoming,"Agriculture, Forestry, Fishing and Hunting",2015,450,360,55,15,430,5,5,440,10,450,360,55,15,430,5,5,440,10,1140,431,218,35,898,0,0,1018,0,35140000,14164000,7509000,1212000,29461000,0,0,32405000,0
Wyoming,"Arts, Entertainment, and Recreation",2015,2150,1465,300,175,1940,170,30,2140,10,2165,1465,300,175,1940,180,35,2155,10,18545,1801,1823,2002,6012,5376,814,13718,0,409349000,73018000,38195000,33287000,157167000,123590000,17177000,340578000,0
Wyoming,Construction,2015,13211,8490,2315,1325,12130,793,137,13060,151,13325,8490,2315,1325,12130,840,160,13130,195,101230,13840,15048,17623,46767,24499,7207,82100,16416,5286040000,608540000,644817000,857276000,2126248000,1485082000,440336000,4260470000,899404000
Wyoming,Educational Services,2015,903,515,100,148,763,65,35,863,40,940,515,100,155,770,65,65,900,40,10441,839,666,1827,3519,2758,1118,9039,559,267561000,23366000,5932000,28666000,68100000,77214000,41214000,247170000,6342000
Wyoming,Finance and Insurance,2015,3409,2270,330,125,2725,256,87,3068,341,5280,2270,350,160,2780,780,230,3790,1490,33156,3562,1922,1272,7093,9308,3345,21206,11461,1809820000,164924000,74344000,53604000,313611000,496411000,193692000,1101026000,678244000
Wyoming,Health Care and Social Assistance,2015,8845,4485,1775,1148,7408,840,269,8517,328,9780,4490,1785,1160,7435,1155,550,9140,640,160315,7671,11802,14980,34892,31804,30824,103596,52807,7180050000,433059000,438625000,575172000,1463713000,1346536000,1267801000,4279970000,2819758000
Wyoming,Information,2015,1100,380,185,160,725,149,50,924,176,1755,380,195,170,745,255,150,1150,605,20073,528,969,1802,3893,3994,3040,12444,6407,987401000,34424000,31012000,51841000,144963000,150032000,144474000,530092000,390746000
Wyoming,Management of Companies and Enterprises,2015,390,75,0,20,95,90,80,265,125,460,75,0,20,95,90,85,270,190,5369,113,0,50,165,1023,1135,2414,2949,495513000,3724000,0,3845000,7640000,53381000,102634000,168863000,326269000
Wyoming,Manufacturing,2015,2761,1395,480,270,2145,285,102,2532,229,2875,1395,480,270,2145,310,115,2570,305,39233,1913,2347,1985,7711,6041,2224,21712,10683,2408875000,68370000,73056000,73809000,262361000,291403000,122420000,991679000,885676000
Wyoming,"Mining, Quarrying, and Oil and Gas Extraction",2015,3454,1615,490,300,2405,416,165,2986,468,4060,1615,495,300,2410,485,200,3095,965,122908,2731,3235,3952,9951,14358,9956,35843,82940,10398097000,137840000,164224000,223188000,527627000,987014000,872748000,2527304000,7468585000
Wyoming,Other,2015,79,74,4,1,79,0,0,79,0,79,74,4,1,79,0,0,79,0,117,80,20,0,117,0,0,117,0,2408000,2072000,262000,0,2408000,0,0,2408000,0
Wyoming,Other Services (except Public Administration),2015,8726,5775,1730,720,8225,270,75,8570,156,9045,5775,1735,770,8280,380,85,8745,300,41221,10815,11213,8831,31377,5774,149,38452,1918,1321088000,314680000,323740000,257815000,915207000,203252000,8693000,1165848000,118424000
Wyoming,"Professional, Scientific, and Technical Services",2015,11069,8260,1175,730,10165,400,160,10725,344,11575,8265,1175,770,10210,495,260,10965,610,50477,11586,7421,9032,28644,10646,3561,45436,4265,2791554000,615376000,328527000,523153000,1504920000,638303000,214469000,2498054000,247653000
Wyoming,Real Estate and Rental and Leasing,2015,5137,4100,395,200,4695,165,75,4935,202,5835,4100,400,205,4705,300,270,5275,560,24273,6006,2516,2316,11122,4160,982,17186,6663,1159468000,230691000,81519000,93916000,415712000,205605000,27207000,684597000,462693000
Wyoming,Retail Trade,2015,9839,4710,2040,1193,7943,863,316,9122,717,13200,4720,2075,1280,8075,1155,840,10070,3130,153010,8441,13131,14323,36755,24030,11701,74813,73523,4236534000,239363000,354107000,399086000,1018420000,872392000,385911000,2351481000,1716665000
Wyoming,Total,2015,18111,10816,2939,1786,15541,1377,404,17322,789,21040,10822,2962,1867,15651,1890,916,18457,2583,219881,17302,19441,23538,60281,46758,30626,137665,82216,10094010000,721821000,657380000,839699000,2218900000,1905803000,1375012000,5499715000,4594295000
Wyoming,Transportation and Warehousing,2015,3998,2305,660,285,3250,317,121,3688,310,4820,2305,660,285,3250,345,215,3810,1010,51979,3671,4187,3382,11723,8352,5036,26771,20179,2576360000,136919000,175433000,147211000,474232000,381749000,225837000,1146815000,1228515000
Wyoming,Utilities,2015,237,65,20,25,110,45,15,170,67,655,65,20,25,110,90,60,260,395,13352,85,50,89,360,1573,0,3041,9005,1220249000,1589000,2494000,5197000,15480000,114338000,0,232709000,884057000
Wyoming,Wholesale Trade,2015,3230,1115,445,368,1928,402,267,2597,633,4220,1115,455,395,1965,515,415,2895,1325,41970,1802,2414,3708,9138,6093,4592,23913,17274,2474461000,88267000,111966000,154078000,409437000,340755000,294023000,1228638000,1205532000
