state_name,industry_name,YEAR,firms_01: Total,firms_02: <5,firms_03: 5-9,firms_04: 10-19,firms_05: <20,firms_06: 20-99,firms_07: 100-499,firms_08: <500,firms_09: 500+,establishments_01: Total,establishments_02: <5,establishments_03: 5-9,establishments_04: 10-19,establishments_05: <20,establishments_06: 20-99,establishments_07: 100-499,establishments_08: <500,establishments_09: 500+,employment_01: Total,employment_02: <5,employment_03: 5-9,employment_04: 10-19,employment_05: <20,employment_06: 20-99,employment_07: 100-499,employment_08: <500,employment_09: 500+,annual_payroll_01: Total,annual_payroll_02: <5,annual_payroll_03: 5-9,annual_payroll_04: 10-19,annual_payroll_05: <20,annual_payroll_06: 20-99,annual_payroll_07: 100-499,annual_payroll_08: <500,annual_payroll_09: 500+
Alabama,Accommodation and Food Services,2012,28358,10445,5445,5391,21281,5401,813,27495,863,41655,10470,5455,5460,21385,6760,3380,31525,10130,763504,17441,36697,73370,128237,194173,110948,434278,324893,10564261000,382756000,449443000,908878000,1752221000,2587024000,1405261000,5752701000,4534633000
Alabama,Administrative and Support and Waste Management and Remediation Services,2012,17996,9415,2945,1728,14088,1846,728,16662,1334,20730,9415,2945,1770,14130,2025,940,17095,3635,691273,15119,18733,21485,58107,67243,90774,223725,447396,18204230000,478179000,548568000,674309000,1738122000,2050589000,2330610000,6278567000,11670771000
Alabama,"Agriculture, Forestry, Fishing and Hunting",2012,3854,1925,1110,490,3525,235,33,3793,61,3925,1925,1110,490,3525,240,45,3810,115,29309,3205,6982,6098,16912,6967,1137,26943,1192,1043050000,123613000,225396000,218395000,575360000,267944000,25309000,922484000,63540000
Alabama,"Arts, Entertainment, and Recreation",2012,5106,2900,740,615,4255,624,139,5018,88,5455,2900,745,640,4285,660,200,5145,310,77229,3903,4040,7477,16908,23721,10389,58031,15116,1467654000,123753000,84321000,131145000,355624000,424913000,255175000,1141141000,280341000
Alabama,Construction,2012,36787,21805,6585,4225,32615,3261,464,36340,447,37405,21805,6585,4225,32615,3370,515,36500,905,389505,36632,42751,56252,137525,118771,56681,319010,60458,16681475000,1206335000,1323760000,2077280000,4607375000,5214646000,2800063000,12840990000,3355214000
Alabama,Educational Services,2012,3902,1735,630,520,2885,650,190,3725,177,4210,1735,630,535,2900,720,255,3875,335,141009,2290,3653,6619,13975,24437,27249,66437,70783,4164005000,70376000,49711000,114705000,256418000,551255000,753671000,1563112000,2323891000
Alabama,Finance and Insurance,2012,15989,10073,2013,894,12980,1259,579,14818,1171,36785,10080,2075,1330,13485,4005,3530,21020,15765,348221,17240,11786,10020,41038,43098,36233,125460,125815,21869057000,736308000,516147000,497838000,1848894000,2056683000,1868419000,6028834000,12103546000
Alabama,Health Care and Social Assistance,2012,40511,16295,10663,6391,33349,4637,1426,39412,1099,51340,16320,10745,6715,33780,6185,5125,45090,6250,1186221,33075,70694,83556,188845,169891,201415,571349,594137,51161371000,1800578000,3005503000,3742358000,8569261000,8111933000,6958360000,23873633000,26415049000
Alabama,Information,2012,3822,1595,605,381,2581,440,217,3238,584,7755,1595,615,400,2610,550,270,3430,4325,143979,1760,3372,4188,10335,12692,14237,44287,94157,7707797000,108718000,114671000,173578000,417942000,695252000,793784000,2127274000,5397354000
Alabama,Management of Companies and Enterprises,2012,2266,90,55,30,175,480,661,1316,950,3045,90,55,30,175,490,730,1395,1650,98780,0,212,105,372,5258,14475,20410,78370,8066655000,0,14925000,4205000,49418000,297081000,864400000,1232235000,6834420000
Alabama,Manufacturing,2012,19806,6575,3054,2590,12219,3699,1512,17430,2376,21440,6575,3055,2610,12240,3760,1765,17765,3675,1062403,8883,17472,28830,62431,130611,144495,371942,598587,49878536000,408328000,566230000,1092841000,2246336000,5311175000,6037551000,14949559000,30744384000
Alabama,"Mining, Quarrying, and Oil and Gas Extraction",2012,1039,335,90,110,535,210,67,812,227,1315,335,90,110,535,225,85,845,470,42878,309,527,889,2244,7940,2424,14189,21564,2998928000,20999000,16462000,46388000,107468000,380057000,155718000,718222000,1959365000
Alabama,Other,2012,68,65,2,1,68,0,0,68,0,68,65,2,1,68,0,0,68,0,0,0,0,0,0,0,0,0,0,1309000,1107000,0,0,1309000,0,0,1309000,0
Alabama,Other Services (except Public Administration),2012,50954,31225,10755,4836,46816,3203,422,50441,513,54965,31225,10785,5085,47095,4145,1085,52325,2640,393493,61897,68542,62495,195463,107915,34419,346902,37494,8940548000,1310385000,1390823000,1381164000,4108256000,2255730000,734109000,7388820000,1305668000
Alabama,"Professional, Scientific, and Technical Services",2012,41542,27238,6175,3505,36918,2564,845,40327,1215,45690,27255,6195,3610,37060,3150,1100,41310,4380,449172,43981,39374,44031,129139,83211,58066,276745,158266,29015267000,1871052000,1718839000,2378536000,6027559000,5370077000,4975874000,16530465000,11830021000
Alabama,Real Estate and Rental and Leasing,2012,14489,10345,1730,829,12904,721,356,13981,508,19100,10350,1815,1010,13175,1365,1055,15595,3505,109224,15690,10516,9754,37431,19670,17451,77902,25234,4003061000,535192000,343125000,345389000,1239974000,823476000,598913000,2786491000,1143307000
Alabama,Retail Trade,2012,56255,31985,11222,5498,48705,4530,991,54226,2029,91150,32040,11520,6130,49690,8245,3780,61715,29435,1013680,54262,70106,69233,201291,147030,70087,434763,546996,24303719000,1348908000,1686964000,1877029000,4954289000,4495381000,2419396000,12148783000,11536923000
Alabama,Total,2012,73661,39993,13803,8277,62073,7280,1926,71279,2382,97938,40032,13953,8777,62762,10250,5428,78440,19498,1585761,74303,90612,110083,274998,265844,223365,764207,821554,61284931000,2376948000,2726168000,3612533000,8715649000,9568508000,8415964000,26700121000,34584810000
Alabama,Transportation and Warehousing,2012,12135,6425,1704,1067,9196,1252,584,11032,1103,14165,6425,1710,1085,9220,1335,860,11415,2750,262116,9618,10162,12779,34993,36437,38158,114452,138717,11401372000,358827000,330931000,429663000,1169493000,1313595000,1503690000,4213094000,6742505000
Alabama,Utilities,2012,569,150,140,35,325,100,35,460,109,2110,150,140,35,325,200,85,610,1500,34583,327,880,350,1557,5205,2959,10155,168,2909380000,7578000,30405000,14849000,52832000,333216000,189870000,597517000,19120000
Alabama,Wholesale Trade,2012,21618,9125,3453,2486,15064,2870,1376,19310,2308,27110,9145,3485,2610,15240,3820,2335,21395,5715,349259,13735,20677,28387,67278,74835,57592,214371,118604,17997555000,715381000,972093000,1406667000,3174369000,3686906000,3125321000,10507652000,6755733000
Alaska,Accommodation and Food Services,2012,8975,4510,1670,1315,7495,1087,197,8779,196,10570,4525,1695,1340,7560,1370,745,9675,895,130480,5854,10785,17413,34314,37904,23859,97219,31943,3115156000,265592000,202764000,316947000,791942000,771104000,467941000,2048063000,1045112000
Alaska,Administrative and Support and Waste Management and Remediation Services,2012,4938,2930,740,445,4115,358,129,4602,336,5680,2930,740,470,4140,430,225,4795,885,83469,2948,4113,5024,14114,7758,8444,37176,42500,4313873000,180945000,155931000,180089000,547376000,301388000,362589000,1648541000,2388236000
Alaska,"Agriculture, Forestry, Fishing and Hunting",2012,1985,1850,80,15,1945,15,10,1970,15,1990,1850,80,15,1945,15,10,1970,20,5055,695,0,0,1550,0,0,3880,0,270231000,94409000,0,0,123670000,0,0,227016000,0
Alaska,"Arts, Entertainment, and Recreation",2012,2610,1770,350,240,2360,215,15,2590,20,2790,1770,355,285,2410,235,30,2675,115,21727,1534,1643,2936,6580,6008,972,15478,0,457127000,95091000,45550000,57381000,210955000,124567000,13200000,369957000,0
Alaska,Construction,2012,11837,8320,1650,1015,10985,535,98,11618,219,12065,8320,1650,1020,10990,570,105,11665,400,84088,9850,10392,12633,35535,16384,3435,59360,22245,7289485000,815632000,706600000,964949000,2542796000,1500010000,573968000,4908387000,2110003000
Alaska,Educational Services,2012,1143,585,225,150,960,105,45,1110,33,1310,585,225,165,975,105,175,1255,55,14380,545,1361,1881,4214,2261,3325,12201,858,401908000,24615000,30404000,46640000,114418000,60412000,74532000,325449000,24801000
Alaska,Finance and Insurance,2012,2074,1055,330,130,1515,130,99,1744,330,3810,1055,340,135,1530,275,390,2195,1615,34751,1943,1821,934,5115,2832,388,11871,16219,2153894000,98983000,97812000,53800000,279410000,159194000,173974000,798875000,1110021000
Alaska,Health Care and Social Assistance,2012,10099,4720,2315,1455,8490,876,411,9777,322,12200,4720,2315,1510,8545,1195,985,10725,1475,222520,7233,15088,18138,42139,31394,53966,134718,79357,12057088000,519527000,781245000,1183070000,2513393000,1670453000,2410008000,6777915000,4675848000
Alaska,Information,2012,1018,433,155,110,698,112,63,873,145,1975,435,155,125,715,205,200,1120,855,32345,261,638,420,2246,2855,2373,6073,9064,2007715000,21158000,29795000,20375000,97487000,132545000,135963000,485055000,1240698000
Alaska,Management of Companies and Enterprises,2012,547,25,10,20,55,116,151,322,225,795,25,10,20,55,120,180,355,440,31027,5,0,0,0,1200,4367,5815,25259,3334533000,4194000,0,0,19397000,58160000,284939000,364330000,2974436000
Alaska,Manufacturing,2012,2313,1250,390,265,1905,215,30,2150,163,2620,1250,395,265,1910,240,65,2215,405,53715,807,1147,1744,5464,4156,3778,15417,37490,2328119000,94626000,66438000,104077000,364673000,216882000,159163000,844181000,1422681000
Alaska,"Mining, Quarrying, and Oil and Gas Extraction",2012,782,380,65,60,505,55,74,634,148,915,380,65,60,505,55,80,640,275,50609,26,262,54,438,1768,4086,7632,39707,5603859000,84073000,37882000,10279000,220615000,181571000,489459000,1250178000,3928029000
Alaska,Other,2012,16,16,0,0,16,0,0,16,0,16,16,0,0,16,0,0,16,0,0,0,0,0,0,0,0,0,0,392000,392000,0,0,392000,0,0,392000,0
Alaska,Other Services (except Public Administration),2012,8484,5145,1870,793,7808,425,70,8303,181,9170,5155,1900,855,7910,600,280,8790,380,47772,8382,11623,9200,30999,10842,63,44485,1253,1589629000,281614000,344797000,309390000,967039000,374940000,15365000,1460618000,73942000
Alaska,"Professional, Scientific, and Technical Services",2012,8658,5490,1075,760,7325,525,220,8070,588,9540,5490,1075,790,7355,670,285,8310,1230,86260,7253,6071,8760,24100,14680,7068,49133,32665,6120089000,547523000,489518000,638499000,1754638000,1085138000,603876000,3616197000,2260872000
Alaska,Real Estate and Rental and Leasing,2012,3952,2800,485,230,3515,177,73,3765,187,4420,2805,490,270,3565,290,255,4110,310,21813,2901,2518,2561,8070,3654,1113,16634,3094,1013253000,143002000,103244000,94247000,360839000,194303000,57374000,709462000,209159000
Alaska,Retail Trade,2012,9523,4754,1924,1221,7899,870,196,8965,558,12515,4800,1985,1340,8125,1405,540,10070,2445,155976,6099,10747,12848,34547,20754,7629,72197,50123,4800981000,264523000,344619000,382542000,1067509000,807030000,344366000,2430397000,1508824000
Alaska,Total,2012,16656,9979,2826,1732,14537,1192,334,16063,593,20427,10005,2872,1872,14749,1752,1109,17610,2817,258219,15036,18657,23049,56742,41453,40183,138378,119841,13986403000,809344000,791222000,1049710000,2650276000,1976375000,2011768000,6638419000,7347984000
Alaska,Transportation and Warehousing,2012,4356,2685,473,297,3455,274,224,3953,403,5490,2695,475,315,3485,395,510,4390,1100,63568,2100,2390,1906,8783,5209,13064,31767,26833,4022490000,225900000,133888000,113768000,542068000,296160000,595256000,1739054000,1909876000
Alaska,Utilities,2012,295,95,40,47,182,70,38,290,5,470,95,40,90,225,95,135,455,15,9154,72,106,476,669,2137,4231,8750,0,818853000,5409000,7239000,21952000,40496000,179663000,419834000,777269000,0
Alaska,Wholesale Trade,2012,2823,1050,355,260,1665,361,231,2257,566,3730,1060,370,290,1720,490,350,2560,1170,37130,813,1244,1984,5540,6009,3893,19965,11661,2386593000,97861000,87478000,112451000,374949000,335415000,230759000,1199959000,917284000
Arizona,Accommodation and Food Services,2012,39726,13049,8100,7619,28768,8498,1282,38548,1178,58365,13060,8130,7770,28960,10065,5435,44460,13905,1238062,22033,54522,103581,181590,312004,191728,688970,551943,20604453000,540370000,699486000,1339093000,2585453000,4599636000,2830726000,10057686000,10342343000
Arizona,Administrative and Support and Waste Management and Remediation Services,2012,35381,20740,5240,3180,29160,3107,1270,33537,1844,40365,20755,5270,3220,29245,3335,1555,34135,6230,1117447,28833,33605,40645,104648,114110,168070,398217,702820,37312805000,1071109000,971186000,1252281000,3316701000,3403117000,5001593000,11934278000,24169541000
Arizona,"Agriculture, Forestry, Fishing and Hunting",2012,955,665,115,60,840,75,20,935,20,975,665,115,60,840,85,30,955,20,7069,849,463,38,1779,2494,1324,6664,0,202452000,40687000,22844000,1122000,95914000,48883000,36729000,187602000,0
Arizona,"Arts, Entertainment, and Recreation",2012,7701,4398,840,745,5983,1055,431,7469,232,8720,4410,850,750,6010,1095,715,7820,900,184330,3562,3884,9283,16774,42059,59409,128758,41828,5682294000,234201000,142876000,186578000,612141000,697917000,2939581000,4354550000,907298000
Arizona,Construction,2012,54961,34385,9110,5250,48745,4703,854,54302,659,55595,34385,9110,5255,48750,4740,1010,54500,1095,591924,53036,58921,68137,184297,179028,96135,466631,98960,27789427000,1947705000,1960894000,2629367000,6581549000,7719456000,4649155000,19314619000,6959337000
Arizona,Educational Services,2012,8730,3905,1465,1110,6480,1536,382,8398,332,10310,3915,1465,1125,6505,1695,610,8810,1500,389185,4634,9298,14534,28983,62208,43195,135862,241766,11100365000,202501000,235132000,348430000,788580000,1801327000,1346819000,4067364000,6731307000
Arizona,Finance and Insurance,2012,24742,17870,2428,869,21167,919,735,22821,1921,46505,17950,2465,1020,21435,1450,2010,24895,21610,651095,22452,14267,10199,50685,26055,36872,119329,461756,39946909000,1219957000,715606000,706290000,2678259000,1839725000,2512576000,7443472000,31224858000
Arizona,Health Care and Social Assistance,2012,66590,36775,13905,7174,57854,5247,1865,64966,1624,84335,36790,14020,7495,58305,7935,5815,72055,12280,1581256,55434,91494,91783,238861,200086,279877,736184,804897,76419040000,3826942000,3912183000,3969057000,11763540000,8381961000,11098496000,31623670000,42984650000
Arizona,Information,2012,6355,3300,780,450,4530,654,307,5491,864,10135,3300,785,450,4535,770,395,5700,4435,207845,3907,4319,4901,15221,20371,17956,56714,140507,13278746000,284667000,206333000,274145000,789058000,1174508000,1213742000,3348646000,9410853000
Arizona,Management of Companies and Enterprises,2012,3035,285,35,45,365,455,857,1677,1358,4540,285,35,45,365,460,930,1755,2785,230584,3,156,26,673,5392,26398,32990,198121,21578667000,48960000,9269000,1145000,85030000,300452000,1738817000,2149130000,19468752000
Arizona,Manufacturing,2012,20404,8280,3475,2830,14585,3175,1178,18938,1466,21345,8280,3485,2840,14605,3250,1385,19240,2105,609662,11406,19161,31068,69273,104133,80099,292324,268054,36562310000,478494000,721631000,1252360000,2708309000,4508251000,3361503000,12379312000,21747654000
Arizona,"Mining, Quarrying, and Oil and Gas Extraction",2012,958,415,145,85,645,142,43,830,128,1215,415,145,85,645,155,65,865,350,27987,291,637,636,2270,3404,957,10005,1627,2055856000,31713000,44402000,22075000,127372000,172547000,65617000,574554000,1482659000
Arizona,Other,2012,97,93,4,0,97,0,0,97,0,97,93,4,0,97,0,0,97,0,0,0,22,0,0,0,0,0,0,2325000,2163000,162000,0,2325000,0,0,2325000,0
Arizona,Other Services (except Public Administration),2012,48136,29350,9740,4517,43607,3065,788,47460,676,54060,29385,9815,4780,43980,4160,2365,50505,3555,416505,51212,62576,53892,172631,105900,66092,351340,41739,11785791000,1362460000,1555694000,1682679000,4882202000,2607126000,1883448000,9551880000,1568762000
Arizona,"Professional, Scientific, and Technical Services",2012,75745,55760,8524,4426,68710,3655,1466,73831,1914,81580,55775,8545,4545,68865,4265,2400,75530,6050,618495,66113,53047,54922,183992,109413,85086,392829,207167,38292111000,4032188000,2717370000,3104979000,9920685000,6936376000,5589856000,22997320000,14400745000
Arizona,Real Estate and Rental and Leasing,2012,32493,25835,2801,1320,29956,1087,630,31673,820,40260,25940,2890,1470,30300,1605,1875,33780,6480,201824,29434,16760,15448,65169,29099,26863,130177,68978,9114315000,1385561000,584965000,556842000,2568464000,1278374000,1182375000,5595399000,3326193000
Arizona,Retail Trade,2012,49014,27123,9708,4919,41750,3666,1250,46666,2348,87770,27175,10035,5695,42905,6350,4290,53545,34225,1389628,39755,51541,53463,148765,113729,89332,362103,891640,36824547000,1131488000,1435768000,1565941000,4234585000,3840188000,3996504000,12462098000,22191929000
Arizona,Total,2012,101205,60802,16360,9669,86831,8755,2671,98257,2948,131375,60900,16543,10153,87596,11300,6915,105811,25564,2134252,96077,107797,128201,332075,320841,302278,955194,1179058,90838616000,3935712000,3535204000,4544676000,12015592000,11348611000,11988940000,35353143000,55485473000
Arizona,Transportation and Warehousing,2012,13336,7200,1670,1197,10067,1246,715,12028,1308,15630,7210,1685,1205,10100,1430,985,12515,3115,316988,7864,8885,13866,33817,35612,34042,111149,199990,12571710000,350291000,337117000,478448000,1218995000,1275600000,1272021000,3940119000,8552139000
Arizona,Utilities,2012,788,420,85,80,585,44,52,681,107,1340,420,85,85,590,70,170,830,510,32017,758,0,925,2115,1680,6923,11050,1036,2753984000,22349000,0,41919000,84151000,119753000,511791000,725107000,119825000
Arizona,Wholesale Trade,2012,27692,13895,3713,2688,20296,3044,1662,25002,2690,33345,13920,3765,2870,20555,3585,2535,26675,6670,459674,18429,22066,28402,73820,80164,54975,227416,222983,28482589000,1064947000,1068937000,1585941000,3820332000,4034729000,2926012000,11307586000,16795527000
Arkansas,Accommodation and Food Services,2012,20930,7165,3890,4310,15365,4409,592,20366,564,27400,7170,3920,4360,15450,5280,2330,23060,4340,466605,11619,25705,58141,96760,152639,75390,325038,140941,5987555000,239351000,307384000,702421000,1252255000,1918363000,865579000,4053515000,1874905000
Arkansas,Administrative and Support and Waste Management and Remediation Services,2012,11581,6685,1730,1015,9430,1043,309,10782,799,13080,6690,1730,1045,9465,1165,510,11140,1940,266150,9036,10553,12230,34353,34943,31538,110713,142486,7615491000,311588000,312622000,347413000,1013279000,895881000,610673000,2832889000,4515856000
Arkansas,"Agriculture, Forestry, Fishing and Hunting",2012,3098,1725,810,305,2840,155,50,3045,53,3225,1725,810,305,2840,175,65,3080,145,21254,2945,5097,3521,12275,4214,2473,20012,720,726844000,120182000,221322000,125977000,473081000,127047000,45897000,660671000,43649000
Arkansas,"Arts, Entertainment, and Recreation",2012,3864,2305,615,432,3352,345,102,3799,65,3930,2305,615,440,3360,375,130,3865,65,42896,3089,3254,5378,13444,11519,7030,36183,2351,801326000,88918000,52521000,84785000,237802000,209051000,145979000,669792000,45106000
Arkansas,Construction,2012,26000,16565,4345,2670,23580,2008,197,25785,215,26240,16565,4345,2675,23585,2045,275,25905,335,211489,26370,27524,35331,90406,70635,18527,187478,13418,8441248000,819621000,866554000,1285793000,2996710000,2887243000,929761000,7183590000,851990000
Arkansas,Educational Services,2012,2630,1255,400,290,1945,410,165,2520,110,2945,1255,400,320,1975,450,365,2790,155,78834,1679,2454,3666,8089,15566,24730,51276,27307,1602511000,44579000,41295000,61327000,149491000,338829000,548446000,1083477000,473660000
Arkansas,Finance and Insurance,2012,12146,8413,1425,397,10235,739,363,11337,809,21920,8415,1450,585,10450,2210,2580,15240,6680,171528,13472,8569,4444,27420,22623,25953,83191,87193,9555412000,475734000,366246000,222502000,1092412000,1092062000,1172106000,3802452000,5673965000
Arkansas,Health Care and Social Assistance,2012,29605,14015,6630,3645,24290,3071,1261,28622,983,37415,14025,6645,3770,24440,4710,3485,32635,4780,825290,22954,43825,46119,115690,129217,152057,408104,411807,31695547000,1469607000,1645700000,1778462000,4967352000,4260977000,4410896000,14014940000,17487975000
Arkansas,Information,2012,2536,1015,415,275,1705,299,115,2119,417,5030,1015,415,280,1710,390,250,2350,2680,97096,1088,1698,2814,6713,7675,5763,24005,50082,6087883000,46685000,55209000,87524000,216712000,422587000,297650000,1041249000,2843779000
Arkansas,Management of Companies and Enterprises,2012,1578,75,30,40,145,320,422,887,691,6075,75,30,40,145,330,475,950,5125,195951,0,23,170,440,3903,9433,13854,181707,15116455000,6136000,2072000,3865000,30195000,187883000,521945000,753595000,14372759000
Arkansas,Manufacturing,2012,12181,4215,2035,1535,7785,1892,874,10551,1630,13410,4215,2035,1535,7785,2090,1085,10960,2450,679936,6059,10106,16626,37317,58076,63420,188649,431662,27352701000,230182000,330993000,583282000,1254682000,2074402000,2512611000,6931864000,17500210000
Arkansas,"Mining, Quarrying, and Oil and Gas Extraction",2012,1783,775,220,185,1180,247,108,1535,248,2030,775,220,185,1180,250,135,1565,465,47121,804,1336,2102,5455,7962,7015,21469,25331,3115332000,61771000,58577000,89187000,238270000,359249000,411985000,1063073000,2038867000
Arkansas,Other,2012,56,52,3,1,56,0,0,56,0,56,52,3,1,56,0,0,56,0,0,0,0,0,0,0,0,0,0,1055000,763000,0,0,1055000,0,0,1055000,0
Arkansas,Other Services (except Public Administration),2012,31643,20175,6566,2592,29333,1746,230,31309,334,33235,20185,6615,2725,29525,2380,460,32365,870,210429,37081,41188,32600,113630,56893,17291,196197,10780,4639435000,783761000,857799000,748076000,2425946000,1075756000,370514000,4121579000,422854000
Arkansas,"Professional, Scientific, and Technical Services",2012,26596,18930,3811,1675,24416,1082,375,25873,723,28500,18930,3825,1760,24515,1405,910,26830,1670,160388,27125,23965,21032,74229,31479,17142,126004,28516,7902020000,1277553000,948263000,947174000,3211591000,1683206000,832747000,5879152000,1800092000
Arkansas,Real Estate and Rental and Leasing,2012,11384,8910,1053,372,10335,495,230,11060,324,13775,8910,1070,460,10440,975,555,11970,1805,62813,10990,6337,3629,23108,11915,4295,43529,18127,1943900000,382296000,157156000,122906000,705427000,433831000,147320000,1349365000,581650000
Arkansas,Retail Trade,2012,35487,18340,8311,4156,30807,2500,609,33916,1571,54700,18370,8435,4625,31430,4245,2785,38460,16240,540998,33182,53137,51711,142618,74713,41141,270872,242877,12821651000,761850000,1178697000,1338219000,3303825000,2361156000,1118239000,7053555000,5571679000
Arkansas,Total,2012,50412,28542,9178,5280,43000,4535,1181,48716,1696,64815,28562,9253,5593,43408,6435,3688,53531,11284,978519,49598,60169,69889,179656,164710,132680,477046,501473,35633588000,1604222000,1689732000,2054164000,5348118000,5080139000,4371209000,14799466000,20834122000
Arkansas,Transportation and Warehousing,2012,10198,5719,1535,935,8189,909,320,9418,780,11825,5735,1550,970,8255,950,440,9645,2180,235567,8496,9478,10476,30677,29521,18950,81766,124091,9918336000,295269000,291631000,375668000,990093000,1106204000,779630000,2961467000,5590002000
Arkansas,Utilities,2012,714,435,80,30,545,55,44,644,70,1645,435,80,30,545,130,165,840,805,32823,1028,505,180,1805,2749,6862,11762,18448,2469699000,27623000,15195000,8615000,55837000,155129000,432314000,657852000,1571420000
Arkansas,Wholesale Trade,2012,14127,5755,2041,1716,9512,1998,851,12361,1766,17415,5755,2060,1850,9665,2620,1440,13725,3690,212521,9044,10715,17702,42492,50072,24751,131241,69142,10959071000,400299000,485730000,835882000,1805887000,2374473000,1430833000,6310778000,4231615000
California,Accommodation and Food Services,2012,295156,114027,62585,57640,234252,52863,5825,292940,2216,392705,114285,62855,59030,236170,66130,24295,326595,66110,6992545,193642,409512,769774,1372928,1986793,961964,4347180,2602434,131376455000,4535274000,5750240000,11802005000,22251220000,35257271000,17502026000,75038480000,56315465000
California,Administrative and Support and Waste Management and Remediation Services,2012,179951,110148,26872,17067,154087,17021,5120,176228,3723,209765,110265,26965,17550,154780,19090,7675,181545,28220,5836745,176686,175671,226348,574800,630093,749078,1999196,3745946,235031655000,7982105000,6074249000,7987489000,22065104000,24526349000,25787533000,72703715000,160121121000
California,"Agriculture, Forestry, Fishing and Hunting",2012,9484,6085,1450,705,8240,899,250,9389,95,9725,6085,1450,715,8250,950,370,9570,155,138248,8829,9008,8830,27407,37796,37234,103558,31028,4808714000,474049000,405230000,432764000,1323154000,1665576000,911938000,3927479000,776447000
California,"Arts, Entertainment, and Recreation",2012,99286,75285,8686,5627,89598,7067,1822,98487,799,105700,75315,8715,5730,89760,7765,2895,100420,5280,1465160,53485,55926,73920,206437,288246,287338,794227,651042,70323465000,22133922000,2634311000,2882886000,27709493000,7290535000,12927090000,48925980000,20774302000
California,Construction,2012,324392,214120,51892,30809,296821,23108,3188,323117,1275,328675,214135,51905,30835,296875,23675,4595,325145,3530,2830655,335082,340495,413419,1090730,868125,459524,2418605,395569,155755630000,13730485000,13785360000,19171333000,46706900000,47947950000,29119083000,123785145000,31427475000
California,Educational Services,2012,56320,27190,8848,7225,43263,9647,2393,55303,1017,63705,27225,8900,7490,43615,11080,4075,58770,4935,1908180,42817,57880,98210,199428,386344,379255,969820,928659,69248790000,1614690000,1346881000,2351285000,5314140000,12129682000,14254123000,31796110000,37318136000
California,Finance and Insurance,2012,138839,100341,16909,7539,124789,7462,2978,135229,3610,249780,100455,17320,8580,126355,12295,14830,153480,96300,2876637,158820,106720,95784,371234,252155,341103,969508,1831647,280456795000,9032052000,6861199000,8559253000,24502798000,27192675000,33228723000,85295943000,186115436000
California,Health Care and Social Assistance,2012,440078,255178,96345,44534,396057,31190,8761,436008,4070,516515,255495,96900,47195,399590,45600,28155,473345,43170,8707840,459737,629830,581411,1668620,1195389,1237556,4111888,4518400,458421583000,26562076000,25683702000,24303532000,76573033000,48282191000,47098306000,172089392000,282524800000
California,Information,2012,76183,50252,7925,5870,64047,6797,2615,73459,2724,106930,50285,7975,6025,64285,7680,4230,76195,30735,2609776,53916,51657,76136,190971,244181,308136,750230,1690891,301363041000,8954700000,3960157000,6060729000,19013279000,21190794000,29971636000,70847752000,183759792000
California,Management of Companies and Enterprises,2012,15818,1220,405,551,2176,3236,4961,10373,5445,25065,1220,405,560,2185,3310,5350,10845,14220,1429140,26,1975,3112,5797,39262,176955,222664,1199954,158810475000,10964000,142380000,294445000,3419016000,3006195000,13673440000,20898055000,137855335000
California,Manufacturing,2012,184261,75868,33450,27268,136586,32145,8525,177256,7005,193945,75900,33475,27355,136730,33245,10390,180365,13580,5615758,129714,213601,364369,726687,1253186,1047024,3096613,2403410,337768051000,5802944000,8198000000,14846212000,29106719000,58102222000,55120018000,145483571000,185803976000
California,"Mining, Quarrying, and Oil and Gas Extraction",2012,3236,1475,410,384,2269,432,205,2906,330,4140,1475,410,390,2275,455,265,2995,1145,119811,2135,2546,4672,10013,14241,25368,50814,46291,10880857000,192925000,149033000,353558000,706067000,1149253000,2204751000,4152578000,6443011000
California,Other,2012,1045,1001,34,8,1043,2,0,1045,0,1045,1001,34,8,1043,2,0,1045,0,1029,0,202,99,0,0,0,1029,0,26134000,20102000,4157000,1510000,25769000,0,0,26134000,0
California,Other Services (except Public Administration),2012,318022,205630,58294,28637,292561,20793,3145,316499,1523,353100,205790,58785,29995,294570,26900,9190,330660,22440,2743487,369081,375890,374132,1125102,722157,360132,2212928,478612,82795645000,10002751000,10004736000,10686687000,30701012000,21975286000,12541200000,65394425000,16263827000
California,"Professional, Scientific, and Technical Services",2012,535790,392444,66225,35938,494607,27923,7052,529582,6208,575090,392590,66510,37055,496155,33825,12640,542620,32470,5644560,563173,431625,470291,1480880,959790,728624,3175895,2363857,467821465000,37536330000,26143830000,32303215000,95989495000,80704015000,67612485000,244619115000,221521418000
California,Real Estate and Rental and Leasing,2012,193285,148670,22361,10059,181090,8111,2353,191554,1731,243355,148930,23150,11575,183655,14200,12610,210465,32890,1340623,215649,141084,128391,483890,271172,214994,977324,341622,68706914000,10034863000,5752980000,5983295000,21797620000,13501871000,11707902000,47154167000,21289491000
California,Retail Trade,2012,343316,205177,68284,35936,309397,24532,5478,339407,3909,532125,205735,70360,41525,317620,38565,23225,379410,152715,7313644,332300,430460,454619,1194692,867465,593007,2710104,4149574,207224319000,9876855000,10912137000,12741670000,33714375000,30085737000,23739198000,88633328000,116554506000
California,Total,2012,701899,436757,117715,70246,624718,59465,12056,696239,5660,864913,437318,119064,74204,630586,77440,37047,745073,119840,12952818,712850,773052,936632,2422534,2255052,1794022,6471608,6481210,700102379000,37841519000,29215350000,37030332000,104087201000,99988496000,92596897000,296672594000,403429785000
California,Transportation and Warehousing,2012,87331,49019,14004,9294,72317,8554,2798,83669,3662,106315,49045,14135,9565,72745,10160,5395,88300,18015,2173885,76293,90326,116490,284686,280073,224845,794843,1277828,99192738000,2985145000,3202720000,4350828000,10573788000,11634290000,10361187000,32936930000,61492626000
California,Utilities,2012,2641,1350,510,255,2115,195,84,2394,247,5845,1350,520,275,2145,220,200,2565,3280,24606,2192,3014,3061,8588,4982,6608,21011,14845,2149575000,110969000,163378000,208231000,509171000,435502000,656312000,1639813000,1445953000
California,Wholesale Trade,2012,259250,145740,43959,28203,217902,26822,8024,252748,6502,296860,146005,44415,29535,219955,32045,14850,266850,30010,4034205,244731,287398,365273,902230,900433,679861,2499690,1463717,302652855000,13228975000,14161993000,19013282000,46426150000,52089950000,47455721000,146621765000,152227616000
Colorado,Accommodation and Food Services,2012,48099,16372,9905,9830,36107,9818,1041,46966,1133,64085,16400,9930,9955,36285,11775,4705,52765,11320,1223265,25394,64277,130462,220798,348704,164186,738670,457785,21316230000,704518000,930666000,1936574000,3581935000,5790750000,2838815000,12221110000,8969047000
Colorado,Administrative and Support and Waste Management and Remediation Services,2012,37553,23525,5410,3050,31985,2800,1024,35809,1744,41830,23530,5420,3100,32050,2995,1320,36365,5465,1032365,26388,34519,38264,106280,101916,119046,335858,691392,43965992000,1392943000,1149333000,1393630000,3991078000,3583475000,4213509000,12011750000,31822446000
Colorado,"Agriculture, Forestry, Fishing and Hunting",2012,1570,1240,190,75,1505,45,10,1560,10,1570,1240,190,75,1505,45,10,1560,10,7070,1344,1047,605,3109,1440,0,6830,0,258685000,48279000,45210000,20119000,123970000,63400000,0,253100000,0
Colorado,"Arts, Entertainment, and Recreation",2012,11739,7620,1400,1075,10095,1061,312,11468,271,12370,7620,1400,1085,10105,1145,405,11655,715,235952,9133,8885,13733,32845,39741,46509,124727,103518,6477671000,404503000,188401000,270188000,897458000,802241000,1093392000,3075132000,2524487000
Colorado,Construction,2012,77707,56725,9725,5573,72023,4255,786,77064,643,78365,56725,9730,5575,72030,4340,960,77330,1035,579540,77840,62113,73542,215822,153055,90646,465470,84460,30189760000,3142825000,2581329000,3348325000,9084840000,7915584000,5336119000,22571805000,6148666000
Colorado,Educational Services,2012,11041,6450,1470,1135,9055,1380,300,10735,306,11635,6450,1470,1160,9080,1485,425,10990,645,227066,8428,9747,14216,33990,57859,30992,125671,94647,6958610000,337415000,248175000,317224000,928360000,1656913000,1040928000,3722795000,3037691000
Colorado,Finance and Insurance,2012,30486,22695,2732,980,26407,1296,817,28520,1966,49850,22715,2795,1125,26635,2540,2750,31925,17925,466122,28344,16164,10781,51554,37567,46965,152018,283542,35645541000,1654516000,984107000,830951000,3575971000,3094643000,3442512000,10415042000,24231849000
Colorado,Health Care and Social Assistance,2012,62745,35085,12660,6802,54547,5199,1656,61402,1343,75150,35095,12705,7085,54885,7160,4895,66940,8210,1310393,53830,83168,90498,232066,195021,244488,679364,608366,59786837000,2896498000,3453499000,3707965000,10084358000,8065835000,9124695000,27483423000,31438423000
Colorado,Information,2012,9532,5125,1115,775,7015,786,530,8331,1201,14665,5125,1115,790,7030,905,670,8605,6060,377132,5498,6751,9687,24493,21109,32140,85627,290195,28490816000,409468000,363908000,543369000,1341662000,1548748000,2318767000,5633451000,22717556000
Colorado,Management of Companies and Enterprises,2012,3469,340,60,80,480,547,945,1972,1497,4910,340,60,85,485,570,990,2045,2865,247312,438,0,524,1323,6761,31411,39575,208542,28610965000,44245000,675000,77580000,200295000,562255000,2765077000,3539505000,24791027000
Colorado,Manufacturing,2012,23763,11330,3965,2953,18248,3034,1022,22304,1459,24620,11330,3975,2995,18300,3155,1150,22605,2015,491120,14936,21443,31730,77230,94838,54876,274397,176421,26397508000,683125000,801727000,1309985000,3090760000,4523143000,2965874000,12851358000,11219821000
Colorado,"Mining, Quarrying, and Oil and Gas Extraction",2012,6144,3475,695,635,4805,601,220,5626,518,6820,3480,710,640,4830,625,245,5700,1120,139064,2524,4414,8282,18284,18729,20847,60499,77858,14363306000,466355000,353019000,805787000,1666131000,1609724000,2200603000,5677131000,8417944000
Colorado,Other,2012,101,96,5,0,101,0,0,101,0,101,96,5,0,101,0,0,101,0,0,0,32,0,0,0,0,0,0,2585000,2142000,443000,0,2585000,0,0,2585000,0
Colorado,Other Services (except Public Administration),2012,59686,38060,11188,5380,54628,3681,653,58962,724,65375,38080,11270,5595,54945,5040,1335,61320,4055,486565,64587,72182,68939,208346,128410,52124,396182,67434,14716310000,1858162000,1955069000,1955175000,5791686000,3677483000,2008487000,11752397000,2559239000
Colorado,"Professional, Scientific, and Technical Services",2012,113386,87725,10640,5908,104273,4720,1995,110988,2398,119900,87745,10670,6065,104480,5490,2540,112510,7390,881605,95979,68118,74351,259488,142816,99275,510424,362158,67327473000,6310815000,3986667000,4863611000,15217040000,10610004000,8502931000,34659421000,32108280000
Colorado,Real Estate and Rental and Leasing,2012,39347,31910,3312,1464,36686,1249,514,38449,898,46085,32035,3400,1610,37045,1725,1325,40095,5990,194776,28511,20472,18007,76391,36363,15077,132872,54910,8033316000,1678763000,740995000,669706000,3109068000,1466095000,603764000,5287420000,2446484000
Colorado,Retail Trade,2012,61208,34584,12347,6616,53547,4119,1074,58740,2468,92440,34705,12605,7265,54575,6565,3970,65110,27330,1102807,51440,74364,69373,197899,120809,64505,428852,579457,32568819000,1626086000,1903212000,2153167000,5770570000,4574727000,2627131000,13242481000,17944033000
Colorado,Total,2012,126478,81649,18581,11166,111396,9427,2612,123435,3043,153112,81741,18749,11632,112122,12147,6216,130485,22627,2035803,122976,121836,147517,392329,336966,262247,991542,1044261,97691175000,5115870000,4380515000,5441010000,14937395000,13618345000,12372998000,40928738000,56762437000
Colorado,Transportation and Warehousing,2012,14967,9035,1825,999,11859,1140,651,13650,1317,17225,9040,1830,1005,11875,1240,855,13970,3255,287393,11389,11315,12370,36222,33226,18621,97379,155714,13013714000,441992000,403176000,439122000,1318487000,1576848000,859190000,4065855000,7613698000
Colorado,Utilities,2012,1047,575,135,45,755,142,65,962,85,1875,575,135,45,755,235,130,1120,755,30122,394,0,287,2197,5464,4910,13084,0,3191065000,30013000,24681000,21336000,110020000,452769000,395357000,957382000,0
Colorado,Wholesale Trade,2012,30697,15950,4251,2779,22980,2935,1775,27690,3007,36285,15995,4310,2905,23210,3700,2400,29310,6975,449090,22054,26409,32371,84585,79096,50634,234214,190136,30330341000,1243416000,1387800000,1787621000,4528095000,4509945000,3106215000,13014023000,15485947000
Connecticut,Accommodation and Food Services,2012,34422,14705,6630,6200,27535,5798,481,33814,608,41435,14735,6655,6290,27680,6680,1855,36215,5220,621775,25534,43198,83066,154166,202803,64856,426770,187692,12331399000,677058000,681201000,1358500000,2720741000,3626075000,1081841000,7517188000,4199473000
Connecticut,Administrative and Support and Waste Management and Remediation Services,2012,23827,14875,3480,1905,20260,1769,664,22693,1134,26050,14875,3490,1925,20290,1860,805,22955,3095,439359,20699,21364,23642,66970,59665,73976,211094,217988,16011412000,1109152000,839340000,1010031000,3006638000,2758225000,2182874000,8331453000,7130998000
Connecticut,"Agriculture, Forestry, Fishing and Hunting",2012,425,305,70,40,415,10,0,425,0,425,305,70,40,415,10,0,425,0,1452,393,82,273,1177,0,0,1452,0,45638000,13290000,4718000,5579000,33313000,0,0,45638000,0
Connecticut,"Arts, Entertainment, and Recreation",2012,7442,3920,1095,834,5849,1235,204,7288,154,8025,3920,1095,850,5865,1325,345,7535,490,121661,3576,7052,9929,22829,48333,23299,101419,19785,3281567000,410830000,236930000,285441000,1002278000,1287047000,457539000,2853114000,358116000
Connecticut,Construction,2012,39175,27925,5590,3050,36565,2107,244,38916,259,39300,27930,5590,3055,36575,2130,260,38965,335,239584,40273,36107,39094,119519,74694,16911,218848,9582,14421200000,2003300000,1756769000,2273567000,6140538000,4831163000,1296350000,12685035000,1150659000
Connecticut,Educational Services,2012,6387,3025,1085,885,4995,818,370,6183,204,6770,3025,1095,885,5005,855,475,6335,435,329340,4808,6621,11648,23850,35020,55327,120024,199198,14993737000,165350000,150642000,238237000,558634000,1232518000,2713106000,4659704000,9998028000
Connecticut,Finance and Insurance,2012,17913,10585,2465,1238,14288,1339,730,16357,1556,30795,10600,2545,1330,14475,2160,2580,19215,11580,554770,17526,15260,14407,49292,42391,55122,152754,394486,76539427000,1612062000,1711146000,2186893000,5580351000,6832346000,8520968000,21965790000,52905676000
Connecticut,Health Care and Social Assistance,2012,38305,15355,8903,5730,29988,4827,2245,37060,1245,51575,15410,9040,6185,30635,7135,6670,44440,7135,1340062,31241,57783,75643,167568,183364,302356,670038,645940,62553594000,1498971000,2541727000,3684930000,7791599000,8434189000,11158094000,27789322000,33944272000
Connecticut,Information,2012,5036,2125,725,575,3425,600,284,4309,727,8155,2125,725,575,3425,655,415,4495,3660,158427,1755,4386,7051,15070,16734,13607,58506,96972,11333791000,209554000,232435000,416543000,919346000,1107075000,828003000,3741430000,7370724000
Connecticut,Management of Companies and Enterprises,2012,2560,165,80,110,355,320,632,1307,1253,3715,165,80,110,355,325,695,1375,2340,180053,227,417,725,1373,4485,21068,27113,152940,23607513000,23790000,80576000,57215000,161933000,411730000,1914549000,2530353000,21077160000
Connecticut,Manufacturing,2012,21088,7649,3945,2930,14524,4095,1217,19836,1252,21785,7650,3945,2935,14530,4225,1350,20105,1680,564314,11509,21925,34050,73158,146032,108973,360401,176493,35994894000,611264000,1012918000,1765712000,3698606000,8075400000,6664310000,20445145000,13639080000
Connecticut,"Mining, Quarrying, and Oil and Gas Extraction",2012,263,125,35,40,200,30,5,235,28,370,125,35,40,200,40,5,245,125,2925,134,205,269,713,119,0,1572,189,317583000,11182000,14483000,18391000,44728000,11493000,0,134499000,126442000
Connecticut,Other,2012,66,65,1,0,66,0,0,66,0,66,65,1,0,66,0,0,66,0,55,46,0,0,55,0,0,55,0,1720000,1609000,0,0,1720000,0,0,1720000,0
Connecticut,Other Services (except Public Administration),2012,43654,26540,9890,4177,40607,2285,310,43202,452,46610,26575,9940,4320,40835,2720,650,44205,2405,297640,50383,63828,52210,169955,73829,13874,264754,22558,9084213000,1418725000,1723659000,1589321000,4762974000,2226405000,572284000,7893890000,769936000
Connecticut,"Professional, Scientific, and Technical Services",2012,43242,28880,6075,3560,38515,2531,757,41803,1439,46225,28890,6105,3620,38615,2825,1030,42470,3755,501834,43395,38003,44478,130245,80949,41626,260952,226843,42605168000,2764936000,2365695000,3232066000,8444627000,6882000000,3716508000,19534213000,21934854000
Connecticut,Real Estate and Rental and Leasing,2012,12096,8680,1495,676,10851,510,255,11616,480,15710,8700,1530,810,11040,655,1165,12860,2850,88945,13591,8884,7864,30951,14385,10806,58107,22678,5290671000,648539000,501434000,414991000,1580611000,812173000,582325000,3293569000,1773785000
Connecticut,Retail Trade,2012,43675,24578,8265,4373,37216,3454,892,41562,2113,63115,24630,8475,4705,37810,4350,2670,44830,18285,895224,38271,48828,47459,140924,97177,54291,309503,382575,25178336000,1231348000,1484582000,1600176000,4424184000,4671247000,2149909000,11941642000,9228125000
Connecticut,Total,2012,71584,40289,12731,7837,60857,6808,1799,69464,2120,88210,40343,12867,8168,61378,8299,4582,74259,13951,1463732,70728,83679,103669,258076,248434,213894,720404,743328,84561759000,3210799000,3455712000,4680357000,11346868000,12484633000,11259773000,35091274000,49470485000
Connecticut,Transportation and Warehousing,2012,6683,3030,950,865,4845,789,336,5970,713,8005,3030,950,875,4855,855,460,6170,1835,190999,3502,4983,9844,19788,21761,17311,68694,73624,8104025000,247489000,228739000,516793000,1048753000,1203042000,654114000,3263168000,3345620000
Connecticut,Utilities,2012,367,70,30,60,160,48,35,243,124,785,75,30,65,170,55,75,300,485,932,76,0,633,786,1589,270,4797,339,1818667000,9276000,0,39956000,58166000,357664000,99235000,605488000,51253000
Connecticut,Wholesale Trade,2012,19127,8620,2925,2158,13703,2432,1131,17266,1861,21870,8625,2935,2225,13785,2635,1405,17825,4045,354273,13595,16282,23906,58750,71274,44124,197647,144710,25692996000,1132411000,1142830000,1771128000,4206374000,5008940000,3003952000,13583124000,11431049000
Delaware,Accommodation and Food Services,2012,8143,3125,1320,1539,5984,1550,234,7768,375,10080,3125,1320,1550,5995,1695,755,8445,1635,170101,4404,8299,19834,32821,54592,24574,115591,51437,2894472000,173156000,133715000,304183000,613048000,885827000,348374000,1900128000,943426000
Delaware,Administrative and Support and Waste Management and Remediation Services,2012,6380,3425,1010,570,5005,580,170,5755,625,6940,3435,1010,570,5015,600,180,5795,1145,125502,4727,5791,6541,17868,18434,13305,53686,57988,4882961000,213953000,187924000,225563000,676145000,796845000,293429000,1932764000,2496806000
Delaware,"Agriculture, Forestry, Fishing and Hunting",2012,220,175,30,15,220,0,0,220,0,220,175,30,15,220,0,0,220,0,269,73,0,0,269,0,0,269,0,20247000,5764000,0,0,20247000,0,0,20247000,0
Delaware,"Arts, Entertainment, and Recreation",2012,1912,1130,210,185,1525,255,55,1835,77,2025,1130,210,185,1525,290,65,1880,145,33506,796,813,1801,3555,7416,2005,20806,9173,998225000,72673000,19075000,43936000,187506000,189858000,132146000,762457000,181145000
Delaware,Construction,2012,10669,6955,1685,1000,9640,755,155,10550,119,10715,6955,1685,1000,9640,765,160,10565,150,84941,10688,10689,12542,35374,27885,11808,78517,2298,4281037000,417312000,437085000,573671000,1473054000,1595076000,737732000,3920516000,180275000
Delaware,Educational Services,2012,1355,590,215,170,975,210,80,1265,90,1400,590,215,170,975,235,80,1290,110,31120,710,1137,2096,3933,8754,9802,23833,6404,1178554000,37969000,29552000,40626000,110679000,232779000,366479000,753356000,372654000
Delaware,Finance and Insurance,2012,5835,3185,533,288,4006,328,334,4668,1167,9995,3215,575,350,4140,565,530,5235,4760,177686,3132,2765,2648,9892,7113,3680,22740,147289,15066120000,185085000,133157000,175491000,529529000,514974000,222329000,1374416000,12786164000
Delaware,Health Care and Social Assistance,2012,9427,3365,2180,1706,7251,1193,384,8828,599,12590,3380,2185,1775,7340,1665,1210,10215,2375,294870,6327,14211,22273,43449,39303,38839,130052,154091,14550607000,323938000,694599000,1102343000,2139955000,1883718000,1749425000,6100063000,8176029000
Delaware,Information,2012,1201,525,140,108,773,125,45,943,258,1960,525,140,110,775,130,80,985,975,29128,9,476,280,1949,2682,0,9178,17502,1546836000,27266000,40761000,17546000,143229000,172804000,0,614370000,885889000
Delaware,Management of Companies and Enterprises,2012,3848,1436,85,50,1571,281,534,2386,1462,4975,1470,105,55,1630,325,650,2605,2370,53022,0,0,0,0,2015,2604,7340,45698,5552680000,46903000,0,0,101706000,111416000,185885000,421560000,5130997000
Delaware,Manufacturing,2012,2742,1020,435,335,1790,429,180,2399,343,2875,1020,435,350,1805,440,205,2450,425,96663,908,1512,2360,5739,8166,6648,30242,60150,4647999000,68659000,76421000,120423000,327696000,380996000,344733000,1490593000,2744981000
Delaware,"Mining, Quarrying, and Oil and Gas Extraction",2012,57,30,0,5,35,5,5,45,12,70,30,0,5,35,5,5,45,25,114,0,0,0,0,0,0,97,0,10778000,4244000,0,0,4748000,0,0,9981000,0
Delaware,Other,2012,26,24,1,1,26,0,0,26,0,26,24,1,1,26,0,0,26,0,0,0,0,0,0,0,0,0,0,863000,453000,0,0,863000,0,0,863000,0
Delaware,Other Services (except Public Administration),2012,10091,6010,1990,1107,9107,675,109,9891,200,10570,6010,2025,1130,9165,770,160,10095,475,69884,10200,12174,13184,37199,21253,1227,64341,3464,1906432000,295895000,301861000,340865000,984733000,531647000,45297000,1731227000,121944000
Delaware,"Professional, Scientific, and Technical Services",2012,12000,7830,1380,839,10049,881,340,11270,730,12785,7835,1385,890,10110,1080,410,11600,1185,125968,8355,7874,9685,29885,24586,15193,74297,38934,11201872000,717963000,534238000,672580000,2003599000,1944020000,1937891000,6159980000,3553360000
Delaware,Real Estate and Rental and Leasing,2012,4472,3005,390,220,3615,248,148,4011,461,5335,3005,405,240,3650,385,325,4360,975,25151,2983,2074,2111,8339,5615,4655,19765,2430,1194614000,166218000,93731000,99113000,381334000,239004000,218846000,923246000,150484000
Delaware,Retail Trade,2012,12573,6375,2209,1125,9709,947,362,11018,1555,18100,6400,2275,1245,9920,1295,720,11935,6165,240857,8321,11878,11750,34694,25030,15479,82334,141372,6325864000,274910000,313738000,311520000,964223000,989651000,635232000,2724813000,3237317000
Delaware,Total,2012,19111,10421,2933,1938,15292,1817,639,17748,1363,23861,10457,2982,2037,15476,2260,1207,18943,4918,363688,16956,19309,25720,61985,60681,45669,168335,195353,18315395000,699473000,705774000,950299000,2355546000,2506999000,2227841000,7090386000,11225009000
Delaware,Transportation and Warehousing,2012,2992,1605,418,185,2208,357,113,2678,314,3140,1605,420,185,2210,390,115,2715,425,54739,1320,1952,1726,5764,7754,5192,23341,17316,2015342000,75648000,65183000,57286000,219714000,281353000,179611000,829017000,789498000
Delaware,Utilities,2012,110,25,0,5,30,0,27,57,53,230,25,0,15,40,0,35,75,155,6146,0,0,0,0,0,0,0,0,562460000,0,0,0,0,0,0,0,0
Delaware,Wholesale Trade,2012,4642,2235,480,327,3042,584,294,3920,722,5170,2235,485,340,3060,665,350,4075,1095,60301,1672,1916,2526,7662,8159,4290,26224,24622,4613653000,155097000,101500000,130625000,499220000,456086000,234589000,1504298000,2401572000
District of Columbia,Accommodation and Food Services,2012,8916,3020,1425,1375,5820,2261,371,8452,464,11850,3025,1425,1405,5855,2380,665,8900,2950,290600,5534,9143,18012,32696,87507,36388,157093,122750,7779254000,169324000,195517000,346122000,758961000,1942324000,741672000,3409339000,3776668000
District of Columbia,Administrative and Support and Waste Management and Remediation Services,2012,4013,1545,425,325,2295,650,459,3404,609,5690,1550,435,330,2315,675,560,3550,2140,161356,1434,2357,3314,8821,20395,45309,78246,61229,7306803000,153664000,240799000,203436000,638700000,884115000,1683044000,3430315000,3035277000
District of Columbia,"Arts, Entertainment, and Recreation",2012,1392,755,150,155,1060,148,85,1293,99,1525,755,150,155,1060,155,120,1335,190,34438,1009,767,1340,3525,3839,11027,20214,5244,2021939000,58870000,48056000,70833000,194560000,168518000,301683000,696802000,597400000
District of Columbia,Construction,2012,2113,965,380,290,1635,335,60,2030,83,2130,965,380,290,1635,335,60,2030,100,31122,1066,2166,3348,7260,10854,3475,24299,221,1935343000,79817000,113102000,172013000,392238000,671584000,235110000,1442454000,80982000
District of Columbia,Educational Services,2012,2424,820,370,265,1455,511,288,2254,170,2690,820,375,265,1460,590,365,2415,275,264287,118,1807,2938,6627,20235,36460,66363,195425,11818675000,79382000,109019000,130858000,330348000,987432000,1809576000,3244444000,8439272000
District of Columbia,Finance and Insurance,2012,2857,930,270,225,1425,370,196,1991,866,5085,935,270,245,1450,475,395,2320,2765,56427,610,1045,2290,4253,5190,1360,15455,36589,8451127000,131856000,124118000,311034000,621622000,803712000,193688000,1986930000,6120305000
District of Columbia,Health Care and Social Assistance,2012,8780,4025,1600,1074,6699,1126,548,8373,407,10365,4030,1600,1160,6790,1410,1110,9310,1055,309997,6284,9729,12917,29976,37006,69973,140832,155034,17562597000,456765000,584215000,692133000,1766156000,1489594000,2402715000,5733740000,11033360000
District of Columbia,Information,2012,2583,925,215,195,1335,385,202,1922,661,3575,925,220,195,1340,385,220,1945,1630,94102,761,583,1499,3321,10239,9433,26871,52945,10105662000,111668000,85317000,150501000,416628000,977235000,824431000,2601978000,6696012000
District of Columbia,Management of Companies and Enterprises,2012,751,40,5,10,55,60,115,230,521,945,40,5,10,55,60,120,235,710,46391,36,0,0,143,57,3921,4628,41660,4563745000,4856000,0,0,16387000,40153000,172560000,233170000,4330575000
District of Columbia,Manufacturing,2012,560,305,85,50,440,65,10,515,45,570,305,85,50,440,65,10,515,55,3255,336,296,126,1031,893,0,2324,0,171144000,14652000,16388000,6328000,46921000,31677000,0,104064000,18104000
District of Columbia,"Mining, Quarrying, and Oil and Gas Extraction",2012,15,5,0,0,5,0,0,5,10,15,5,0,0,5,0,0,5,10,0,0,0,0,0,0,0,0,0,0,0,0,0,0,0,0,0,0
District of Columbia,Other,2012,38,38,0,0,38,0,0,38,0,38,38,0,0,38,0,0,38,0,22,22,0,0,22,0,0,22,0,773000,773000,0,0,773000,0,0,773000,0
District of Columbia,Other Services (except Public Administration),2012,18248,7868,3550,2450,13868,2944,1073,17885,363,20480,7870,3565,2470,13905,3175,1425,18505,1975,363796,13342,22887,30682,70070,101406,114674,290794,51779,26216613000,973920000,1357255000,2108070000,4484050000,7573200000,9291985000,21416746000,3809930000
District of Columbia,"Professional, Scientific, and Technical Services",2012,21595,11265,2827,1998,16090,2329,1181,19600,1995,25200,11265,2830,2010,16105,2365,1350,19820,5380,467006,14877,17198,23853,57329,63846,68878,200999,263821,54905756000,2442731000,1947344000,2770106000,7240108000,7390283000,7022816000,22302841000,32472060000
District of Columbia,Real Estate and Rental and Leasing,2012,3765,2095,463,298,2856,344,242,3442,323,5540,2100,490,305,2895,460,490,3845,1695,45889,1236,2602,3382,8793,7744,9855,29268,14385,3220868000,202839000,157234000,208554000,582324000,578749000,696678000,1902378000,1157054000
District of Columbia,Retail Trade,2012,7083,3875,1090,532,5497,444,243,6184,899,8720,3885,1100,550,5535,535,340,6410,2310,91382,4624,5218,4371,17002,6421,2589,32126,51623,2983632000,206196000,146014000,133516000,546702000,231293000,51641000,981590000,1698286000
District of Columbia,Total,2012,17123,7931,2629,1874,12434,2392,959,15785,1338,21592,7941,2648,1924,12513,2668,1479,16660,4932,482838,14068,17372,24207,55647,82030,91748,229425,253413,33863527000,1077570000,1098417000,1569008000,3744995000,5081694000,5610696000,14437385000,19426142000
District of Columbia,Transportation and Warehousing,2012,863,350,65,50,465,80,59,604,259,970,350,65,50,465,85,65,615,355,17726,389,174,184,837,1093,393,2825,15155,658213000,30654000,8109000,10051000,68589000,41322000,19944000,179842000,446215000
District of Columbia,Utilities,2012,170,15,0,5,20,0,0,20,150,240,15,0,5,20,0,0,20,220,0,0,0,0,23,0,0,23,0,0,692000,0,0,1435000,0,0,1435000,0
District of Columbia,Wholesale Trade,2012,1686,675,240,115,1030,172,95,1297,389,2180,675,245,125,1045,190,100,1335,845,15702,588,871,749,3340,1946,56,7272,8258,1236883000,52634000,46262000,37843000,211241000,125058000,4230000,560347000,652538000
Florida,Accommodation and Food Services,2012,138713,58956,26197,23419,108572,25053,3094,136719,1994,185625,59520,26305,23695,109520,28005,9805,147330,38295,3948843,95599,173852,314910,587195,941055,485145,2013990,1839922,70266461000,2657240000,2406161000,4365460000,9429720000,14831955000,8462149000,32733920000,37476339000
Florida,Administrative and Support and Waste Management and Remediation Services,2012,148542,106440,17065,9870,133375,8595,3219,145189,3353,165735,106515,17110,10010,133635,9500,4720,147855,17880,6120384,143533,109252,130368,397071,333961,463268,1213754,4831561,235354895000,5055915000,3194306000,4227706000,12652698000,10114308000,13640169000,36708345000,195487398000
Florida,"Agriculture, Forestry, Fishing and Hunting",2012,4878,3190,715,505,4410,306,101,4817,61,4995,3190,715,515,4420,345,130,4895,100,59262,4346,4461,5863,15448,9927,14670,41356,17766,1614791000,150495000,144775000,214989000,517510000,270903000,315829000,1141860000,453616000
Florida,"Arts, Entertainment, and Recreation",2012,35379,22990,3860,2750,29600,3849,1275,34724,655,38075,22990,3860,2785,29635,3995,1775,35405,2670,878645,27467,25031,35203,87567,158525,190080,454870,405795,25395714000,1466558000,581155000,698881000,2778702000,3508948000,8629622000,15397785000,9274264000
Florida,Construction,2012,216440,157655,28150,16242,202047,11928,1500,215475,965,218960,157655,28150,16305,202110,12340,2085,216535,2425,1448920,223082,185310,214837,631701,437106,193360,1268955,165885,59200515000,6799770000,5895335000,7923893000,20623000000,18499980000,9406497000,48759045000,9671257000
Florida,Educational Services,2012,28436,16435,3642,2825,22902,3856,1031,27789,647,31775,16470,3670,2850,22990,4430,1770,29190,2585,762480,19653,24480,39056,86269,155285,139657,388040,370691,26682855000,745306000,552350000,870252000,2169410000,4347765000,4662539000,11433390000,15067861000
Florida,Finance and Insurance,2012,87517,63786,10746,4341,78873,3739,1954,84566,2951,155470,63890,10855,5075,79820,6815,7680,94315,61155,1667933,81114,68641,54704,214208,122039,160173,504229,1076122,112807696000,4652406000,3386896000,3316236000,11384285000,8626411000,11026340000,31223663000,81202426000
Florida,Health Care and Social Assistance,2012,234252,132213,52691,25399,210303,15955,4928,231186,3066,283705,132345,52995,26595,211935,22570,15930,250435,33270,4996189,211751,345446,335963,908632,596729,710236,2233213,2698641,230279508000,11987158000,14652270000,14240925000,40892692000,28286275000,27020320000,96570918000,131704292000
Florida,Information,2012,24312,16137,2569,1575,20281,1756,775,22812,1500,39320,16150,2595,1585,20330,2115,1240,23685,15635,743180,14655,16069,19429,59386,60527,49869,176854,560448,51254139000,1185513000,708644000,962871000,2903964000,3571577000,3106778000,9957324000,40716424000
Florida,Management of Companies and Enterprises,2012,7874,1020,200,230,1450,1416,1884,4750,3124,13385,1020,200,235,1455,1455,1990,4900,8485,656780,1108,1065,1630,4067,18710,63702,86456,570117,54703120000,168915000,60200000,101031000,330560000,1229765000,4627395000,6187720000,48487171000
Florida,Manufacturing,2012,61416,32105,9815,6995,48915,7344,2417,58676,2740,64360,32105,9815,7035,48955,7550,2815,59320,5040,1306390,49835,58736,84840,207969,259167,205450,732831,499623,64287960000,1794286000,2003486000,3204780000,7304898000,10778198000,9678361000,29982255000,31242842000
Florida,"Mining, Quarrying, and Oil and Gas Extraction",2012,1081,610,110,90,810,127,34,971,110,1260,610,110,90,810,170,35,1015,245,14667,601,380,813,2248,3082,216,6793,5369,957311000,38688000,21890000,41716000,113191000,135075000,23586000,328010000,580593000
Florida,Other,2012,280,272,6,2,280,0,0,280,0,280,272,6,2,280,0,0,280,0,250,0,0,0,250,0,0,250,0,5945000,5492000,0,0,5945000,0,0,5945000,0
Florida,Other Services (except Public Administration),2012,203904,141965,32578,15880,190423,10713,1603,202739,1165,220705,142005,32705,16300,191010,13350,4610,208970,11735,1502704,238663,211389,210477,663956,380220,169054,1222605,263190,38715828000,5829840000,5022054000,5185519000,16054365000,9555238000,4288976000,30225068000,8341836000
Florida,"Professional, Scientific, and Technical Services",2012,333380,263777,33809,17064,314650,12004,3245,329899,3481,354820,263830,33995,17620,315445,15080,6030,336555,18265,2205133,295082,217501,222798,803667,390511,247663,1450734,711313,135285760000,18918715000,11075729000,12922191000,42944825000,25882820000,17137250000,86148215000,48350931000
Florida,Real Estate and Rental and Leasing,2012,121124,100599,10409,4327,115335,3010,1390,119735,1389,147110,100725,10705,4865,116295,4180,5950,126425,20685,707745,127720,65718,54240,249370,95510,91301,439840,221271,27868368000,4722679000,2324833000,2065557000,9123151000,3881966000,3831279000,16946699000,10685523000
Florida,Retail Trade,2012,225638,154060,36560,17520,208140,11125,2823,222088,3550,356460,154365,37460,19830,211655,18045,9305,239005,117455,4367325,228311,218423,213936,675350,366884,249377,1303074,2123028,112200667000,6562404000,5717084000,5704846000,17957358000,13168121000,10555474000,41814077000,51925481000
Florida,Total,2012,409368,281327,58997,32450,372774,26030,6147,404951,4417,502414,281673,59528,34020,375221,33251,16985,425457,76957,6932382,438796,385591,430638,1255025,962602,782540,3000167,3932215,280304784000,16350692000,13041846000,14924667000,44317205000,35724746000,31665936000,111707887000,168596897000
Florida,Transportation and Warehousing,2012,58671,41452,6159,3516,51127,3553,1468,56148,2523,66675,41465,6210,3625,51300,3970,2205,57475,9200,1017826,49237,38718,43748,139752,103100,93537,354916,550049,43544588000,2027659000,1385533000,1525327000,4984282000,4141520000,3954459000,13356832000,27905564000
Florida,Utilities,2012,1472,805,235,72,1112,126,110,1348,124,3585,805,235,85,1125,205,355,1685,1900,130856,1387,1371,866,3916,4783,17912,30100,99391,11838078000,48595000,56963000,35632000,147990000,317394000,1185617000,1837304000,9983944000
Florida,Wholesale Trade,2012,139122,91267,19807,10465,121539,9841,3569,134949,4173,158650,91350,19920,10990,122260,12135,6495,140890,17760,1443553,120671,126315,132610,402939,299515,204065,928400,477876,77898096000,6407999000,5754329000,6395114000,18592209000,15497364000,11011104000,45759498000,30107522000
Georgia,Accommodation and Food Services,2012,67563,25070,12350,12716,50136,14466,1656,66258,1305,94325,25155,12375,12930,50460,16655,6915,74030,20295,1793993,40462,82474,173242,297752,524902,251475,1075743,718088,26859612000,975607000,1055065000,2246295000,4277817000,7306420000,3520258000,15132857000,11720902000
Georgia,Administrative and Support and Waste Management and Remediation Services,2012,50295,30955,6630,4200,41785,4304,1734,47823,2472,58740,30960,6645,4260,41865,4485,2335,48685,10055,1619275,42269,41502,55615,142772,160925,206099,522386,1090251,52484501000,1653471000,1381522000,2033840000,5083962000,5604344000,6408312000,17359027000,34781266000
Georgia,"Agriculture, Forestry, Fishing and Hunting",2012,4630,2475,1085,565,4125,391,60,4576,54,4740,2480,1085,565,4130,395,100,4625,115,37150,4368,6871,6954,18752,12041,0,34932,1041,1352638000,144337000,251319000,261127000,676177000,446099000,0,1259693000,43305000
Georgia,"Arts, Entertainment, and Recreation",2012,12718,7835,1645,1255,10735,1386,328,12449,269,13785,7835,1650,1260,10745,1515,545,12805,980,207546,9008,10306,15776,37604,50794,36398,129953,59211,6452888000,497659000,253587000,311033000,1090201000,872845000,997943000,3105738000,2940768000
Georgia,Construction,2012,78711,52040,12350,7084,71474,5615,919,78008,703,79695,52040,12350,7090,71480,5760,1125,78365,1330,686946,77559,81272,93994,254985,203473,103519,569243,102601,31691058000,2724940000,2813168000,3738560000,9283670000,9597762000,5166552000,24217723000,6785801000
Georgia,Educational Services,2012,12973,7085,1770,1420,10275,1768,558,12601,372,14385,7090,1770,1420,10280,2200,630,13110,1275,399994,8984,11119,18729,38607,72016,69844,188962,198517,14847397000,305735000,253640000,346186000,921620000,1922444000,2512088000,5471508000,9074605000
Georgia,Finance and Insurance,2012,38184,25689,4828,1744,32261,2337,1262,35860,2324,72520,25735,5045,2210,32990,5350,4835,43175,29345,803667,37903,29630,19258,86629,73391,81758,256216,396839,60415220000,1849467000,1501690000,1347269000,4741352000,4610825000,5766752000,15408272000,42432670000
Georgia,Health Care and Social Assistance,2012,91161,44400,21074,12172,77646,9462,1962,89070,2091,114075,44450,21195,12770,78415,12710,6305,97430,16645,2260970,74133,139272,163036,377732,347017,270876,1004325,1216144,100221746000,4250235000,5796978000,6728435000,16785712000,14480775000,10053976000,41538953000,57932228000
Georgia,Information,2012,11200,5870,1285,855,8010,1244,519,9773,1427,20175,5875,1285,895,8055,1395,930,10380,9795,502658,6017,7719,10350,27230,40983,40016,119067,359554,43744386000,463010000,374356000,587547000,1447999000,2851493000,3089658000,7917683000,30745125000
Georgia,Management of Companies and Enterprises,2012,5303,365,135,120,620,860,1330,2810,2493,8870,365,135,120,620,870,1350,2840,6030,583925,0,572,755,110,10695,40159,53235,530690,57400270000,50955000,44677000,65692000,166845000,701770000,2988431000,3888670000,53511600000
Georgia,Manufacturing,2012,34003,12810,5315,4272,22397,5426,2473,30296,3707,37190,12815,5330,4300,22445,5775,2895,31115,6075,1588459,20594,30002,50585,108753,194498,199269,548487,940604,71871724000,810770000,1097654000,1892191000,4089480000,8186071000,8558832000,22732602000,45267873000
Georgia,"Mining, Quarrying, and Oil and Gas Extraction",2012,591,185,105,85,375,80,40,495,96,945,185,105,85,375,85,65,525,420,20263,235,363,815,1798,1636,0,9780,10346,1104907000,10424000,20551000,28460000,64961000,95441000,0,530363000,566785000
Georgia,Other,2012,172,164,5,2,171,1,0,172,0,172,164,5,2,171,1,0,172,0,216,0,29,0,183,0,0,216,0,4373000,3238000,879000,0,4307000,0,0,4373000,0
Georgia,Other Services (except Public Administration),2012,95349,61500,17800,8327,87627,5813,1078,94518,831,102320,61525,17895,8685,88105,7280,1860,97245,5075,753598,109938,114070,108778,335103,207839,94393,644284,87457,19697156000,2658078000,2683635000,2672204000,8027226000,5167511000,2820957000,16174196000,2800854000
Georgia,"Professional, Scientific, and Technical Services",2012,132515,99961,13735,7523,121219,6195,2235,129649,2866,140765,99965,13785,7680,121430,7080,2840,131350,9415,1135590,106206,88948,97267,321939,194126,149823,678478,421599,76530212000,7196035000,4559487000,5731554000,17520378000,13231131000,10182741000,41515461000,33645441000
Georgia,Real Estate and Rental and Leasing,2012,38691,30248,3429,1603,35280,1482,846,37608,1083,51810,30315,3615,1715,35645,2245,3530,41420,10390,256048,35684,21714,19481,81046,44455,44520,178304,66578,11967534000,1518006000,759866000,841758000,3123566000,2143040000,2156688000,7751830000,4567360000
Georgia,Retail Trade,2012,105152,67503,18411,8751,94665,6017,1565,102247,2905,167365,67665,18835,9745,96245,9470,5440,111155,56210,1955241,110894,117668,110069,341876,203325,106257,678205,1159496,47244939000,2810965000,2684914000,2915867000,8439121000,7038229000,3866037000,19607305000,26092490000
Georgia,Total,2012,168614,103541,26590,15977,146108,14590,3983,164681,3933,216308,103676,26886,16724,147286,18548,9690,175524,40784,3390540,167207,174440,211955,553602,525656,421252,1500510,1890030,149290810000,6254445000,5783818000,7324002000,19362265000,19595071000,17639366000,56596702000,92694108000
Georgia,Transportation and Warehousing,2012,24859,14165,2885,1815,18865,2175,1360,22400,2459,30135,14175,2915,1860,18950,2430,1740,23120,7015,705184,19088,17106,22754,62099,60813,59280,188931,497817,31400056000,690053000,604479000,830732000,2166833000,2354525000,2363701000,7057707000,23731630000
Georgia,Utilities,2012,684,200,60,30,290,145,128,563,121,3025,200,60,30,290,215,440,945,2080,105266,330,315,0,1115,6826,22463,31486,367,9065539000,15704000,13260000,10556000,53225000,408523000,1550162000,2079557000,16657000
Georgia,Wholesale Trade,2012,56151,28680,8261,5759,42700,5993,3254,51947,4204,65815,28730,8330,5990,43050,6820,4570,54440,11375,926538,43677,51125,68743,169283,168588,149504,512043,391829,57493553000,2446038000,2494981000,3571255000,8552548000,9256126000,8938624000,27510324000,28890425000
Hawaii,Accommodation and Food Services,2012,13863,4935,2863,2440,10238,2871,358,13467,396,17720,4940,2875,2455,10270,3425,1080,14775,2945,485030,8520,18100,32120,59717,114536,61507,238500,245958,12799787000,232202000,283176000,484483000,992866000,2216204000,1371262000,4620145000,8099426000
Hawaii,Administrative and Support and Waste Management and Remediation Services,2012,7839,4140,1230,670,6040,955,324,7319,520,9080,4145,1255,680,6080,1060,600,7740,1340,172801,6132,7195,7679,23226,34502,34033,99674,80938,5210586000,232064000,221996000,224215000,724144000,1020690000,806730000,2844791000,2563845000
Hawaii,"Agriculture, Forestry, Fishing and Hunting",2012,170,120,25,0,145,20,5,170,0,170,120,25,0,145,20,5,170,0,1218,29,0,0,147,374,0,1218,0,15551000,3695000,0,0,5817000,5458000,0,15551000,0
Hawaii,"Arts, Entertainment, and Recreation",2012,2317,1055,335,245,1635,417,171,2223,94,2495,1055,335,250,1640,445,270,2355,140,50534,641,1977,2365,5924,14537,15974,41207,5654,1220253000,48459000,43832000,64519000,176908000,303847000,425847000,1019094000,119890000
Hawaii,Construction,2012,13019,7780,2300,1460,11540,1116,184,12840,179,13175,7780,2300,1465,11545,1170,230,12945,230,122905,9453,13982,18524,45725,36452,17185,106209,10346,7752935000,590593000,667383000,1037559000,2332905000,2345434000,1501928000,6531462000,820009000
Hawaii,Educational Services,2012,2376,1015,340,360,1715,445,108,2268,108,2545,1015,340,365,1720,500,175,2395,150,89971,1229,2083,3717,8335,16376,13655,41489,47198,2881250000,41826000,40295000,82161000,186276000,422959000,491095000,1202375000,1641760000
Hawaii,Finance and Insurance,2012,4054,2291,445,215,2951,277,206,3434,620,7080,2300,455,275,3030,580,690,4300,2780,90165,3417,2366,2402,8739,8766,11975,33207,54595,5366961000,206396000,121411000,121677000,490789000,412707000,860859000,1972700000,3207893000
Hawaii,Health Care and Social Assistance,2012,14728,7710,3725,1504,12939,1005,468,14412,316,17870,7710,3760,1600,13070,1625,1495,16190,1680,313814,14699,23582,18068,56031,36066,48234,162611,128793,15445148000,859972000,1071059000,832283000,2791934000,1484267000,1951490000,6832873000,7718540000
Hawaii,Information,2012,1603,758,230,115,1103,130,35,1268,335,2630,760,230,130,1120,210,45,1375,1255,39582,617,884,901,3329,2624,210,8338,26451,2329305000,45930000,48829000,38007000,173409000,117448000,12364000,408754000,1819958000
Hawaii,Management of Companies and Enterprises,2012,932,15,15,40,70,235,265,570,362,1210,15,15,40,70,240,300,610,600,43610,0,0,0,42,2355,6915,9555,33980,2726800000,0,0,6706000,15100000,126405000,382917000,524700000,2189745000
Hawaii,Manufacturing,2012,3839,1890,665,530,3085,479,139,3703,136,3970,1890,665,530,3085,510,195,3790,180,47122,1696,2237,4865,11513,9820,4360,39762,4897,1572699000,80237000,76202000,156289000,376807000,278270000,141290000,1249115000,259542000
Hawaii,"Mining, Quarrying, and Oil and Gas Extraction",2012,35,5,5,10,20,0,10,30,5,35,5,5,10,20,0,10,30,5,338,0,0,0,0,0,0,0,0,31181000,0,0,0,1770000,0,0,0,0
Hawaii,Other,2012,16,16,0,0,16,0,0,16,0,16,16,0,0,16,0,0,16,0,0,0,0,0,0,0,0,0,0,285000,285000,0,0,285000,0,0,285000,0
Hawaii,Other Services (except Public Administration),2012,15259,9890,2500,1415,13805,1011,212,15028,231,17170,9920,2505,1510,13935,1345,710,15990,1180,121366,16773,15254,17461,51184,30909,10856,100828,8201,3408662000,509421000,446409000,552846000,1533146000,914591000,302047000,2991915000,237005000
Hawaii,"Professional, Scientific, and Technical Services",2012,14617,9630,2010,1081,12721,956,296,13973,644,16265,9630,2020,1115,12765,1145,385,14295,1970,115144,3751,12600,12909,38794,29884,10725,83440,25916,6843648000,793402000,653638000,753262000,2236309000,1938996000,630115000,4948825000,1697071000
Hawaii,Real Estate and Rental and Leasing,2012,8030,5665,1016,511,7192,322,225,7739,291,9615,5685,1045,540,7270,595,395,8260,1355,48397,8661,5612,5653,21237,7658,5067,38752,5266,2334374000,379137000,232172000,234477000,863750000,340770000,241353000,1681464000,472690000
Hawaii,Retail Trade,2012,14722,7400,2918,1572,11890,1268,442,13600,1122,23155,7415,3015,1805,12235,2440,1830,16505,6650,311759,7762,15409,16711,42089,35485,27330,113385,159805,8599952000,322098000,397206000,433203000,1200172000,1056661000,995997000,3594770000,4469882000
Hawaii,Total,2012,24923,13843,4475,2653,20971,2415,604,23990,933,31496,13868,4542,2819,21229,3416,1922,26567,4929,492089,24403,29541,35233,89177,91959,77209,258345,233744,19078553000,957934000,992538000,1204379000,3154851000,3186860000,2902178000,9243889000,9834664000
Hawaii,Transportation and Warehousing,2012,3429,1290,535,404,2229,532,279,3040,389,4225,1295,535,415,2245,620,545,3410,815,119371,1469,2116,3961,9494,14360,14553,45920,51805,5141572000,71524000,90234000,121958000,318725000,562129000,551880000,1703310000,2640060000
Hawaii,Utilities,2012,117,25,25,5,55,10,10,75,42,275,25,25,5,55,65,45,165,110,7621,0,78,0,46,0,0,1339,0,649949000,896000,6969000,0,13979000,0,0,94879000,20543000
Hawaii,Wholesale Trade,2012,7593,3545,1250,851,5646,860,356,6862,731,8715,3555,1305,905,5765,1085,605,7455,1260,87652,5038,5734,8463,22196,19253,12212,64097,16732,4038984000,225000000,277669000,405907000,977272000,863265000,566118000,2781754000,1012816000
Idaho,Accommodation and Food Services,2012,14322,5140,3095,3120,11355,2250,355,13960,362,17915,5140,3120,3175,11435,3065,1335,15835,2080,261654,7812,20523,41765,70670,75022,37922,184889,77263,3604411000,178389000,215528000,508378000,906432000,995322000,510206000,2432105000,1156042000
Idaho,Administrative and Support and Waste Management and Remediation Services,2012,10342,6865,1390,725,8980,622,210,9812,530,10950,6865,1390,750,9005,690,265,9960,990,162849,7778,8047,8400,26798,18716,19927,68269,89146,4200888000,289324000,210916000,244275000,783261000,520977000,374218000,1779883000,2280981000
Idaho,"Agriculture, Forestry, Fishing and Hunting",2012,2205,1600,310,135,2045,110,25,2180,25,2215,1600,310,135,2045,110,25,2180,35,15790,2319,1847,1533,6149,4792,0,15300,418,545183000,116288000,86856000,64965000,276376000,158802000,0,524453000,16023000
Idaho,"Arts, Entertainment, and Recreation",2012,3527,2265,450,345,3060,335,80,3475,52,3645,2270,450,355,3075,360,115,3550,95,44429,1989,2649,3801,9228,10727,9185,31811,5735,733952000,89980000,45398000,65475000,216070000,181394000,178597000,622095000,48437000
Idaho,Construction,2012,28144,21065,3895,1800,26760,1141,130,28031,113,28265,21065,3895,1800,26760,1200,150,28110,155,134186,30122,24816,22419,78557,36619,6144,129779,2999,5527103000,994414000,851004000,873947000,2735465000,1781440000,325259000,5207490000,224063000
Idaho,Educational Services,2012,2099,1040,315,250,1605,350,50,2005,94,2220,1040,315,260,1615,370,105,2090,130,57520,951,1724,2928,6504,12865,3325,23040,14006,1188574000,40174000,30547000,55286000,129518000,273237000,73577000,480580000,306832000
Idaho,Finance and Insurance,2012,7762,5245,840,310,6395,295,275,6965,797,14150,5245,865,405,6515,770,1450,8735,5415,98189,7645,4771,3183,17066,3484,2774,42093,53629,5004389000,289892000,167164000,149417000,649532000,354206000,749877000,1848129000,2960311000
Idaho,Health Care and Social Assistance,2012,21265,10705,4615,2665,17985,2064,605,20654,611,24405,10725,4625,2770,18120,2890,1705,22715,1690,412179,16666,30048,34412,83389,78292,70678,237551,166958,15778789000,873601000,987512000,1205945000,3106627000,2487368000,1958966000,7680196000,7789972000
Idaho,Information,2012,2205,990,246,225,1461,286,106,1853,352,3205,990,255,245,1490,380,135,2005,1200,51064,837,880,1986,4808,7076,999,16550,29376,2302755000,47534000,37312000,59713000,168121000,276584000,68139000,726917000,1313906000
Idaho,Management of Companies and Enterprises,2012,918,75,15,25,115,227,250,592,326,1190,75,15,25,115,240,260,615,575,32723,0,48,14,240,2261,6015,8584,24284,2612335000,4037000,2864000,6991000,13336000,105944000,361014000,483390000,2125790000
Idaho,Manufacturing,2012,8518,3975,1470,1065,6510,1123,430,8063,455,8840,3975,1475,1065,6515,1165,505,8185,655,201761,4550,6760,10352,27108,32068,24966,101026,80765,9102527000,177272000,240245000,358742000,905733000,1282951000,967522000,3801549000,4359917000
Idaho,"Mining, Quarrying, and Oil and Gas Extraction",2012,595,265,90,65,420,70,51,541,54,630,265,90,65,420,75,55,550,80,9000,293,448,564,1510,1403,973,6193,896,635192000,19721000,26215000,31893000,90426000,75568000,71953000,411944000,59592000
Idaho,Other,2012,37,35,2,0,37,0,0,37,0,37,35,2,0,37,0,0,37,0,0,0,0,0,0,0,0,0,0,720000,702000,0,0,720000,0,0,720000,0
Idaho,Other Services (except Public Administration),2012,15328,10285,2805,1217,14307,647,135,15089,239,16370,10285,2815,1335,14435,1045,250,15730,640,88442,17146,17774,14260,51135,16246,6558,78813,4124,2092977000,433436000,436625000,365924000,1265234000,373068000,156966000,1830487000,158179000
Idaho,"Professional, Scientific, and Technical Services",2012,20034,14210,2695,1275,18180,921,266,19367,667,21215,14210,2710,1300,18220,1140,370,19730,1485,135809,18753,17369,15144,52712,22681,5732,85861,43006,7412849000,798048000,721183000,672237000,2238209000,1179940000,332496000,3868925000,3299434000
Idaho,Real Estate and Rental and Leasing,2012,9010,7325,810,346,8481,208,108,8797,213,10085,7330,855,370,8555,390,475,9420,665,29571,7319,4230,3550,15740,2879,512,26493,2532,893506000,289919000,110189000,98401000,530384000,124625000,54027000,763003000,116322000
Idaho,Retail Trade,2012,20023,9920,4244,2253,16417,1812,488,18717,1306,29115,9925,4340,2535,16800,2905,2380,22085,7030,358010,14304,26504,25961,71524,49241,15693,155594,177767,9014338000,414162000,577153000,694880000,1724638000,1482087000,511414000,4246613000,4241734000
Idaho,Total,2012,35966,22041,5891,3403,31335,2697,737,34769,1197,42899,22051,5951,3596,31598,3831,2147,37576,5323,493786,34658,38853,44560,118071,92911,67118,278100,215686,17605429000,1124111000,1097252000,1303661000,3525024000,2942612000,2171373000,8639009000,8966420000
Idaho,Transportation and Warehousing,2012,8128,5325,1105,530,6960,567,198,7725,403,8725,5325,1105,535,6965,605,255,7825,900,81934,5605,6133,6072,20767,16176,10060,51461,16937,2880308000,237220000,208055000,219663000,695401000,573814000,344505000,1736427000,806715000
Idaho,Utilities,2012,573,355,70,40,465,55,5,525,48,1005,355,70,40,465,95,30,590,415,1179,417,253,237,1405,1882,0,3611,0,39489000,8126000,11826000,9732000,39345000,132646000,0,187978000,0
Idaho,Wholesale Trade,2012,8110,3395,1029,760,5184,1173,616,6973,1137,10165,3395,1045,815,5255,1660,870,7785,2380,122144,3266,5096,7492,18946,28399,12826,71168,43011,5809187000,212926000,243274000,367529000,903295000,1167313000,620998000,3029401000,2458187000
Illinois,Accommodation and Food Services,2012,103854,42641,20263,18669,81573,18657,2076,102306,1548,135425,42675,20295,18840,81810,21290,7370,110470,24955,2335760,75391,133804,254010,464570,683189,299720,1448869,797164,40256285000,1658456000,1789913000,3416245000,6872839000,10543809000,5176557000,22585059000,17461003000
Illinois,Administrative and Support and Waste Management and Remediation Services,2012,74111,47615,9360,5622,62597,6366,2450,71413,2698,84065,47635,9380,5685,62700,6800,3200,72700,11365,2351369,60106,59279,73009,197804,243519,336658,783006,1544249,74009553000,3097670000,2285457000,2933237000,8356253000,9098903000,10597242000,28297573000,44622193000
Illinois,"Agriculture, Forestry, Fishing and Hunting",2012,1565,1190,230,45,1465,35,35,1535,30,1700,1190,230,45,1465,45,80,1590,110,8911,1559,927,471,3288,857,1674,6226,0,435583000,46622000,54779000,17507000,126250000,29547000,99034000,281655000,0
Illinois,"Arts, Entertainment, and Recreation",2012,21011,12285,3015,2275,17575,2545,538,20658,353,22690,12320,3065,2285,17670,2645,865,21180,1510,386276,13869,18833,30677,66253,103198,77541,252974,117346,11866936000,735676000,405680000,591433000,1757414000,2232308000,4251931000,8345232000,2926037000
Illinois,Construction,2012,139605,102920,18640,9468,131028,7046,891,138965,640,140435,102920,18645,9490,131055,7180,1065,139300,1135,898940,143493,120765,124075,389207,252042,115566,766555,114711,58232575000,6178050000,5801430000,7139399000,19134835000,17895799000,9255392000,47083275000,9667694000
Illinois,Educational Services,2012,18541,8900,2725,2120,13745,3303,832,17880,661,20310,8900,2730,2165,13795,3615,1210,18620,1690,797041,10676,17869,28971,60570,136742,116469,316596,479936,30757407000,461579000,406100000,584810000,1453192000,3670411000,4161342000,9384592000,21360825000
Illinois,Finance and Insurance,2012,63884,42435,8080,3514,54029,4639,2167,60835,3049,111860,42480,8245,4060,54785,8840,8915,72540,39320,1443207,72212,49393,42884,167665,163005,179578,519696,916393,140890904000,3616610000,3020817000,3452072000,10214576000,14067570000,16335363000,42373982000,98303649000
Illinois,Health Care and Social Assistance,2012,133679,68115,27820,16643,112578,13532,4782,130892,2787,165670,68175,28010,17650,113835,18745,14575,147155,18515,3845912,115111,183048,221291,530313,516115,677692,1736647,2077883,165460870000,6359419000,8056250000,10467942000,24943363000,21454814000,22266471000,69178744000,95286035000
Illinois,Information,2012,15268,7655,1940,1371,10966,1670,936,13572,1696,26430,7655,1980,1415,11050,1845,1255,14150,12280,589975,5405,11239,16591,35856,56779,70993,172189,412965,43821550000,639379000,619008000,874629000,2186282000,3807569000,4690870000,10817103000,32682939000
Illinois,Management of Companies and Enterprises,2012,7300,455,100,200,755,1316,1939,4010,3290,11205,455,100,200,755,1345,2045,4145,7060,914680,9,376,1353,2375,15325,74285,91985,822489,108357850000,993000,28542000,105979000,254445000,1301050000,6546115000,8101610000,100243442000
Illinois,Manufacturing,2012,65788,23155,10832,9474,43461,13175,4463,61099,4689,69450,23170,10860,9525,43555,13810,5025,62390,7060,2624185,34974,66284,120314,233555,511782,494435,1306314,1142645,146511176000,2187634000,2684508000,5237960000,10339362000,25206069000,26186871000,64960535000,67405915000
Illinois,"Mining, Quarrying, and Oil and Gas Extraction",2012,2448,1360,375,257,1992,210,80,2282,166,2815,1360,375,265,2000,265,205,2470,345,43187,2218,2228,3336,8017,6200,5324,24707,13680,2864482000,108792000,114070000,162674000,387680000,356159000,458275000,1519296000,1171945000
Illinois,Other,2012,157,150,4,3,157,0,0,157,0,157,150,4,3,157,0,0,157,0,0,0,25,0,0,0,0,0,0,3519000,2552000,466000,0,3519000,0,0,3519000,0
Illinois,Other Services (except Public Administration),2012,147027,90950,29582,14607,135139,9331,1537,146007,1020,159125,91100,29860,15420,136380,12140,3170,151690,7435,1216420,168672,193489,190966,556425,321515,145767,1031385,169265,38686040000,4272239000,4864179000,5201326000,14350209000,9479620000,6529246000,30732381000,7404693000
Illinois,"Professional, Scientific, and Technical Services",2012,183557,135153,20727,11630,167510,9690,3052,180252,3305,194035,135200,20790,11940,167930,11365,3990,183285,10750,1841688,155171,132116,150802,459316,319138,239288,1032768,763935,147642385000,11548038000,7517534000,9914098000,29011074000,24507340000,19321178000,73055285000,72399215000
Illinois,Real Estate and Rental and Leasing,2012,47957,35470,5611,2624,43705,2203,990,46898,1059,59575,35530,5745,2945,44220,3180,3040,50440,9135,351309,41905,35854,33190,116938,68330,57898,248725,97048,18375260000,2109714000,1499153000,1590266000,5210210000,3506306000,3241690000,12080200000,5927263000
Illinois,Retail Trade,2012,124509,72642,23685,12249,108576,9957,2673,121206,3303,200155,72795,24140,13680,110615,15310,10325,136250,63905,2981746,118049,146780,147724,406141,354142,225404,1024082,1726224,74552418000,3192096000,3517708000,4141060000,10974512000,12154790000,7988762000,31462486000,39194423000
Illinois,Total,2012,253146,155238,40130,24563,219931,22844,5914,248689,4457,314199,155402,40514,25780,221696,29163,15310,266169,48030,5119826,246620,263015,327198,836833,850612,729929,2417374,2702452,255694139000,10779777000,9758161000,13023031000,33560969000,37370500000,35393378000,106324847000,149369292000
Illinois,Transportation and Warehousing,2012,59520,41610,5779,3868,51257,3814,1775,56846,2674,66355,41610,5790,3920,51320,4175,2300,57795,8560,1028625,11416,37038,47322,135445,114901,109331,378864,539705,43199697000,1751285000,1397533000,1907982000,5129209000,4974456000,4940383000,15631159000,23326665000
Illinois,Utilities,2012,866,340,110,55,505,180,41,726,140,2445,340,110,65,515,275,70,860,1585,110215,505,672,363,1937,7321,4416,14177,89348,11747299000,37574000,26112000,31425000,113387000,513727000,404043000,1071990000,9671647000
Illinois,Wholesale Trade,2012,81209,40700,12080,8831,61611,10550,4320,76481,4728,96465,40750,12200,9290,62240,12945,7845,83030,13435,1533459,61089,77591,111808,257909,331225,255488,859132,609825,103183442000,3929126000,4360409000,6595440000,14989100000,20227780000,15994223000,51763333000,47312610000
Indiana,Accommodation and Food Services,2012,46437,16345,8825,9316,34486,9468,1254,45208,1229,65250,16360,8845,9470,34675,11135,5040,50850,14400,1252411,27019,59197,128584,216043,344955,162943,727063,529603,17391341000,599035000,666419000,1496454000,2765165000,4264030000,2029411000,9099785000,8159031000
Indiana,Administrative and Support and Waste Management and Remediation Services,2012,31165,18280,4830,3005,26115,2655,877,29647,1518,35570,18280,4840,3070,26190,2900,1300,30390,5180,876330,25350,31040,38651,96994,95261,104426,305023,561026,25054600000,941269000,840402000,1130893000,2930433000,2979903000,2846578000,9067300000,15821061000
Indiana,"Agriculture, Forestry, Fishing and Hunting",2012,1271,960,145,75,1180,35,26,1241,30,1360,960,145,75,1180,35,45,1260,100,7023,1346,0,859,3188,740,0,5181,0,309355000,36845000,21618000,31567000,93182000,31236000,0,198402000,0
Indiana,"Arts, Entertainment, and Recreation",2012,9977,5405,1582,1265,8252,1280,248,9780,197,10435,5425,1605,1285,8315,1390,345,10050,385,143676,5955,10008,16485,34162,45235,24735,114384,28211,4244382000,255616000,183163000,277524000,746003000,833606000,629884000,2969898000,580485000
Indiana,Construction,2012,64598,41905,11620,5890,59415,4012,661,64088,510,65320,41910,11620,5895,59425,4105,810,64340,980,564025,69995,75001,77461,223290,142828,69859,444820,88400,30662520000,2451508000,2837038000,3364558000,8655530000,7715545000,4360464000,21243245000,7198763000
Indiana,Educational Services,2012,7284,3230,1320,878,5428,1262,263,6953,331,7970,3230,1335,910,5475,1420,395,7290,680,331314,4248,8569,11315,25140,49010,31547,108738,220243,8825707000,142332000,161415000,198531000,511337000,1151890000,870528000,2653720000,6053947000
Indiana,Finance and Insurance,2012,24381,16354,3021,1123,20498,1385,897,22780,1601,48890,16370,3145,1415,20930,3330,4880,29140,19750,474969,27787,17928,13337,61216,45384,78945,190304,269204,28980333000,1134095000,810293000,679559000,2642513000,2262003000,4324992000,9517602000,19224137000
Indiana,Health Care and Social Assistance,2012,52879,23080,12480,6934,42494,6077,2462,51033,1846,76235,23130,12550,7415,43095,8700,7255,59050,17185,1963846,40436,83291,91031,217634,239468,375915,843118,1106458,80308908000,1926378000,3227325000,3751038000,8933724000,9282664000,12685019000,31266772000,48008943000
Indiana,Information,2012,5358,2355,711,575,3641,684,278,4603,755,10790,2355,720,590,3665,820,570,5055,5735,197950,2458,4100,7437,16052,20383,18353,60256,138125,10061995000,126128000,144860000,285623000,584865000,900302000,924851000,2567130000,7512871000
Indiana,Management of Companies and Enterprises,2012,3177,105,45,95,245,566,1062,1873,1304,4445,105,45,95,245,575,1165,1985,2460,277195,114,194,393,719,6007,39780,46535,230506,26478550000,15448000,15233000,21651000,52938000,335279000,2045250000,2435995000,24042555000
Indiana,Manufacturing,2012,37494,10759,5950,5786,22495,7875,3282,33652,3842,40710,10760,5950,5820,22530,8355,3865,34750,5960,2196474,16462,35676,71346,132666,303145,355948,845185,1226753,111768179000,745087000,1256248000,2767263000,4980181000,13208532000,15432361000,35599085000,70557429000
Indiana,"Mining, Quarrying, and Oil and Gas Extraction",2012,996,415,125,122,662,117,72,851,145,1515,415,135,125,675,170,155,1000,515,29479,471,471,1118,2328,2127,0,9725,13756,1975360000,30851000,23818000,64628000,136549000,110603000,20628000,589695000,974945000
Indiana,Other,2012,61,60,0,1,61,0,0,61,0,61,60,0,1,61,0,0,61,0,0,0,0,0,0,0,0,0,0,974000,970000,0,0,974000,0,0,974000,0
Indiana,Other Services (except Public Administration),2012,75845,45391,16401,7593,69385,4933,847,75165,680,82760,45415,16510,8010,69935,6845,2210,78990,3770,620308,88441,105227,98831,294830,165491,63590,534358,58636,15216291000,1919895000,2231471000,2275352000,6454534000,3968788000,1751470000,12492879000,2260372000
Indiana,"Professional, Scientific, and Technical Services",2012,59667,40710,8155,4866,53731,3423,1116,58270,1397,64400,40725,8205,4960,53890,4260,1695,59845,4555,519137,59464,53153,62047,178494,105703,65915,358529,141014,29445721000,2549058000,2144193000,2767280000,7488624000,5848418000,4339255000,17930550000,10655599000
Indiana,Real Estate and Rental and Leasing,2012,21393,15655,2323,1143,19121,1059,590,20770,623,28255,15665,2405,1240,19310,2160,2545,24015,4240,155928,18097,14434,14313,53443,31462,18584,111668,32507,5983754000,750295000,428518000,484986000,1680354000,1194829000,976973000,3995245000,1647118000
Indiana,Retail Trade,2012,63152,32616,13527,7187,53330,5878,1463,60671,2481,108395,32685,13910,8305,54900,9620,6800,71320,37075,1535392,51861,77144,91574,216059,188018,103567,553206,890894,35861656000,1400589000,1888283000,2249091000,5572065000,5898569000,3252181000,15154916000,19535475000
Indiana,Total,2012,109104,59981,19826,12250,92057,11083,2957,106097,3007,143974,60045,20047,12943,93035,14823,8764,116622,27352,2512908,105109,130583,163160,398852,408082,366692,1173626,1339282,99677281000,3377169000,3845351000,5174565000,12397085000,14223863000,14137083000,40758031000,58919250000
Indiana,Transportation and Warehousing,2012,22371,12025,3225,2164,17414,2155,944,20513,1858,25480,12035,3240,2205,17480,2360,1205,21045,4435,535579,14298,20668,25822,68076,69393,59229,205014,269572,20994147000,639804000,735800000,1011599000,2410303000,2705284000,2346855000,7720904000,11411574000
Indiana,Utilities,2012,967,320,220,80,620,195,21,836,131,2715,320,220,95,635,245,80,960,1755,64735,698,1428,218,2797,7649,0,12775,40006,6121933000,24750000,51912000,51965000,135772000,526189000,0,828217000,4217742000
Indiana,Wholesale Trade,2012,31460,13755,4757,3519,22031,4556,2090,28677,2783,39070,13780,4810,3730,22320,5690,3460,31470,7600,549830,20190,29578,41896,96507,128414,82613,327061,208246,29565137000,1027344000,1367504000,2210232000,4646370000,6348793000,4315862000,16213625000,12847661000
Iowa,Accommodation and Food Services,2012,28151,10773,5335,5421,21529,5247,704,27480,671,35315,10780,5355,5480,21615,6385,2635,30635,4680,562513,17927,35718,74743,128653,183724,76972,389961,173260,7376111000,333788000,359157000,787550000,1486280000,2146152000,906867000,4547240000,2761954000
Iowa,Administrative and Support and Waste Management and Remediation Services,2012,15820,9960,2195,1205,13360,1177,383,14920,900,17760,9975,2195,1215,13385,1410,510,15305,2455,336995,13495,13887,15382,45202,38922,37467,127469,206819,9800515000,472699000,430708000,486103000,1412657000,1165566000,1056400000,3789920000,5861400000
Iowa,"Agriculture, Forestry, Fishing and Hunting",2012,1405,1110,140,55,1305,40,50,1395,10,1655,1110,140,55,1305,50,240,1595,60,10535,1165,729,154,3024,1013,3064,7851,0,548703000,64956000,38522000,15602000,134110000,38440000,152945000,390923000,0
Iowa,"Arts, Entertainment, and Recreation",2012,7063,4155,1195,788,6138,685,130,6953,110,7285,4155,1205,790,6150,720,200,7070,215,96230,5272,7058,9230,23594,24818,14029,66301,20583,1752551000,159171000,117892000,148199000,446148000,374513000,207922000,1123888000,404900000
Iowa,Construction,2012,42052,28555,7160,3434,39149,2314,353,41816,236,42480,28555,7170,3440,39165,2445,450,42060,420,283340,45078,46151,44120,137654,82464,33686,258355,21095,14636830000,1690888000,1767150000,2080641000,5567615000,4581295000,2185378000,12647905000,1804648000
Iowa,Educational Services,2012,3232,1375,545,440,2360,528,165,3053,179,3825,1375,545,450,2370,595,450,3415,410,227695,1656,3227,5610,11579,18745,24439,57813,158659,5798189000,47928000,54895000,77880000,196539000,401870000,682524000,1351829000,3821294000
Iowa,Finance and Insurance,2012,18069,11680,2187,1138,15005,1342,632,16979,1090,30605,11700,2240,1605,15545,3895,3485,22925,7680,423887,19789,12499,13603,47763,44339,61150,157091,237119,26520349000,714341000,549568000,655604000,1966410000,2248899000,3372976000,7890075000,16704742000
Iowa,Health Care and Social Assistance,2012,29048,12910,5110,3718,21738,4172,1991,27901,1147,40570,12925,5140,4025,22090,6520,5845,34455,6115,1053927,22174,32867,48098,106183,170084,273859,556314,459650,39330906000,1086536000,1227452000,1959438000,4346915000,5456792000,8664605000,18597728000,20637974000
Iowa,Information,2012,4405,1710,840,603,3153,487,243,3883,522,7620,1710,855,610,3175,815,520,4510,3110,142155,2815,4977,5333,15968,13326,17022,51298,90099,6486125000,90585000,170880000,220485000,527282000,583881000,811792000,2063638000,4364057000
Iowa,Management of Companies and Enterprises,2012,1961,65,20,90,175,476,597,1248,713,2365,65,20,90,175,485,655,1315,1050,83240,0,0,297,461,4900,16570,21950,61129,6324610000,6037000,0,18208000,35640000,269140000,1196750000,1501530000,4814718000
Iowa,Manufacturing,2012,15957,5270,2570,1945,9785,2912,1488,14185,1772,18015,5275,2575,1970,9820,3105,1990,14915,3100,844261,7280,13851,21075,47778,99671,130004,309754,466271,40233831000,290434000,479566000,791824000,1675770000,4376903000,5863563000,13420130000,22778724000
Iowa,"Mining, Quarrying, and Oil and Gas Extraction",2012,349,110,40,45,195,74,41,310,39,950,110,40,45,195,180,185,560,390,9976,44,0,551,885,2556,3016,6734,3065,496780000,5002000,3453000,25885000,38760000,134611000,154080000,336651000,147436000
Iowa,Other,2012,71,68,2,1,71,0,0,71,0,71,68,2,1,71,0,0,71,0,66,41,0,0,66,0,0,66,0,1065000,859000,0,0,1065000,0,0,1065000,0
Iowa,Other Services (except Public Administration),2012,42572,27995,8730,3431,40156,1776,305,42237,335,45375,28030,8935,3820,40785,2575,745,44105,1270,248931,53204,55338,43461,153835,56005,12102,230584,12649,5887946000,1108037000,1155569000,986010000,3255119000,1434754000,305700000,5239231000,487738000
Iowa,"Professional, Scientific, and Technical Services",2012,28963,19070,4630,2262,25962,1759,469,28190,773,31250,19070,4645,2325,26040,2430,705,29175,2075,246564,27320,28554,26937,85360,52710,22806,169833,60715,12751624000,1196807000,1130905000,1246246000,3619383000,3143950000,1286332000,8334755000,4140511000
Iowa,Real Estate and Rental and Leasing,2012,11084,8468,1033,547,10048,423,266,10737,347,13555,8470,1040,665,10175,925,620,11720,1835,59982,6821,5574,5969,24998,12265,3868,45596,9945,2500156000,366107000,172845000,181469000,787104000,451460000,166785000,1610099000,516015000
Iowa,Retail Trade,2012,38717,18725,8489,5162,32376,3650,968,36994,1723,60545,18740,8620,5750,33110,6125,3360,42595,17950,811860,32345,50420,64603,152552,106737,50813,326914,396289,18421752000,773071000,1203883000,1546135000,3548014000,3313671000,1908857000,8953561000,8004421000
Iowa,Total,2012,62724,35874,10935,6694,53503,5821,1592,60916,1808,80649,35907,11069,7223,54199,8864,5493,68556,12093,1293694,62072,71506,88787,222365,214754,200718,637837,655857,48946464000,1898057000,2036296000,2732890000,6667243000,7404702000,7872524000,21944469000,27001995000
Iowa,Transportation and Warehousing,2012,15759,10110,2050,1160,13320,1155,437,14912,847,17585,10115,2060,1190,13365,1320,685,15370,2215,271672,10424,13007,13702,42397,31636,25998,105643,160881,10436239000,467951000,416107000,488521000,1397136000,1191147000,1169088000,3904447000,6307527000
Iowa,Utilities,2012,474,85,50,70,205,152,27,384,90,1365,95,50,70,215,310,65,590,775,37309,68,267,970,1412,5985,0,8281,19743,2785643000,3065000,15686000,52250000,75108000,369033000,0,508447000,1576461000
Iowa,Wholesale Trade,2012,17598,6930,2463,2348,11741,2712,1399,15852,1746,24770,6940,2505,2515,11960,4030,4120,20110,4660,327102,10343,14699,27621,55908,73553,73985,217553,92387,16313729000,476951000,668759000,1304737000,2547736000,3727530000,4008184000,10791911000,4879396000
Kansas,Accommodation and Food Services,2012,21471,7275,3970,4145,15390,4659,636,20685,786,29755,7375,3980,4185,15540,5525,2105,23170,6585,531386,11856,26239,56904,95869,165624,64610,327671,193370,6887707000,259174000,274893000,610885000,1150252000,2031967000,836901000,4029622000,2840407000
Kansas,Administrative and Support and Waste Management and Remediation Services,2012,15750,9120,2345,1370,12835,1388,463,14686,1064,17310,9125,2355,1415,12895,1435,540,14870,2440,356570,12104,14943,17334,47776,51522,45452,152902,180063,11103253000,477065000,403287000,509652000,1450279000,1648879000,1214958000,4531288000,5846799000
Kansas,"Agriculture, Forestry, Fishing and Hunting",2012,1020,770,135,75,980,30,5,1015,5,1020,770,135,75,980,30,5,1015,5,3730,838,699,829,2503,474,0,3680,0,136533000,42416000,26792000,36357000,112173000,13772000,0,135378000,0
Kansas,"Arts, Entertainment, and Recreation",2012,4770,2705,655,605,3965,560,130,4655,115,5000,2705,655,620,3980,625,200,4805,195,70310,3007,4190,7541,15966,21342,16154,56091,10407,1264349000,93800000,70771000,110690000,290559000,354691000,319130000,1016834000,171552000
Kansas,Construction,2012,33305,21465,5803,3130,30398,2260,360,33018,287,33705,21465,5810,3145,30420,2315,395,33130,575,279807,35857,37572,41183,116348,84634,31215,236635,29080,13666420000,1222412000,1334592000,1778900000,4363865000,4304306000,1763586000,10630705000,2132002000
Kansas,Educational Services,2012,3361,1535,550,420,2505,480,208,3193,168,3620,1535,550,430,2515,510,300,3325,295,99871,2014,3503,4912,11210,18457,31908,64465,30560,2505530000,61227000,57191000,117728000,244903000,424453000,694845000,1500667000,818840000
Kansas,Finance and Insurance,2012,18242,11915,2040,1083,15038,1307,526,16871,1371,29965,11940,2110,1475,15525,3500,2655,21680,8285,281378,19245,11959,13463,45937,41746,41193,131512,133615,17547130000,744910000,552502000,759574000,2095657000,2403273000,2537381000,7274894000,9105143000
Kansas,Health Care and Social Assistance,2012,29879,13355,6035,3826,23216,3917,1669,28802,1077,39865,13370,6065,3990,23425,5305,5030,33760,6105,961077,23141,39563,48733,113889,157712,249526,527162,413419,37951712000,1071181000,1581700000,2167185000,4863604000,6337335000,8063665000,19370950000,18094339000
Kansas,Information,2012,3682,1485,485,375,2345,499,220,3064,618,6935,1485,485,400,2370,660,585,3615,3320,189235,2108,2619,3404,10397,14895,8080,36362,142754,12550265000,90789000,92778000,134136000,383855000,776295000,499184000,1859534000,10590874000
Kansas,Management of Companies and Enterprises,2012,2303,155,40,65,260,495,575,1330,973,2965,155,40,65,260,515,630,1405,1560,102215,29,0,0,0,5885,16821,23655,78508,9172150000,15717000,15919000,1648000,53587000,408185000,1069440000,1561140000,7606841000
Kansas,Manufacturing,2012,13505,4240,2375,1945,8560,2286,1207,12053,1452,14445,4240,2385,1970,8595,2450,1445,12490,1955,696176,5527,12315,20049,43135,73122,116160,264793,379254,34592931000,237160000,461992000,829158000,1669787000,3101711000,5207472000,11369746000,20928719000
Kansas,"Mining, Quarrying, and Oil and Gas Extraction",2012,4892,2875,740,515,4130,417,127,4674,218,5240,2875,745,540,4160,495,165,4820,420,50719,4887,4726,6551,16460,12752,8216,38121,11148,2956390000,202176000,227153000,368067000,803094000,755417000,484632000,2084733000,811727000
Kansas,Other,2012,64,63,1,0,64,0,0,64,0,64,63,1,0,64,0,0,64,0,56,49,0,0,56,0,0,56,0,860000,802000,0,0,860000,0,0,860000,0
Kansas,Other Services (except Public Administration),2012,37223,24185,7133,3135,34453,2015,404,36872,351,39565,24195,7180,3265,34640,2640,905,38185,1380,249102,42635,44367,39192,129743,65421,27530,233387,12090,6079838000,987195000,944996000,952021000,2898824000,1601075000,746092000,5628548000,356137000
Kansas,"Professional, Scientific, and Technical Services",2012,33091,22420,4605,2527,29552,1747,644,31943,1148,35610,22420,4620,2610,29650,2125,1130,32905,2705,292553,30139,27782,31425,91173,52886,44625,199624,66281,17250795000,1516130000,1239668000,1548363000,4332657000,3014799000,2903233000,10529560000,5008648000
Kansas,Real Estate and Rental and Leasing,2012,11950,9033,1220,545,10798,497,216,11511,439,14905,9055,1260,605,10920,855,900,12675,2230,70411,12386,7418,6408,26710,9855,10485,50694,14904,2501059000,428155000,260300000,240422000,941616000,362629000,358112000,1705718000,675532000
Kansas,Retail Trade,2012,36243,17769,8146,4315,30230,3264,805,34299,1944,52925,17810,8255,4770,30835,4870,2275,37980,14945,669478,31658,49902,53499,140275,94884,49806,291756,336110,15651462000,748435000,1128078000,1261881000,3160451000,2826590000,1612871000,7797636000,7337397000
Kansas,Total,2012,58159,32744,10018,6169,48931,5565,1609,56105,2054,73944,32798,10120,6551,49469,7841,4594,61904,12040,1134216,56817,65757,81736,204310,202931,187807,595048,539168,45608072000,1856582000,1992698000,2712884000,6562164000,7305438000,7256457000,21124059000,24484013000
Kansas,Transportation and Warehousing,2012,10655,6130,1455,972,8557,835,349,9741,914,12595,6130,1455,985,8570,1000,615,10185,2410,190577,7960,8543,11170,30929,20788,14915,71754,100895,8139403000,313109000,294591000,430447000,1091750000,780996000,730889000,2867878000,4907072000
Kansas,Utilities,2012,360,65,20,40,125,100,38,263,97,1160,65,20,40,125,150,265,540,620,35441,0,62,566,849,3784,546,8384,19441,2951486000,0,2966000,32826000,44078000,251875000,291229000,618822000,1669430000
Kansas,Wholesale Trade,2012,17109,6944,2440,2007,11391,2675,1235,15301,1808,22815,6960,2490,2170,11620,4200,2825,18645,4170,299703,9979,14742,21529,49718,70067,43425,178227,105136,16254249000,595401000,741562000,1096858000,2564860000,3494445000,2356723000,9052520000,6190614000
Kentucky,Accommodation and Food Services,2012,27229,8740,4845,5750,19335,5874,999,26208,1021,38485,8740,4855,5800,19395,7095,3675,30165,8320,761469,13677,32871,78151,125485,213484,121773,461405,295557,10428615000,317059000,388693000,978389000,1689750000,2654680000,1608668000,5962155000,4365567000
Kentucky,Administrative and Support and Waste Management and Remediation Services,2012,16827,9320,2590,1535,13445,1540,658,15643,1184,19870,9325,2595,1550,13470,1660,890,16020,3850,452895,12780,16294,20160,52407,52939,63573,175057,277485,12198175000,436534000,486317000,600053000,1556620000,1629482000,1676226000,5013821000,6685912000
Kentucky,"Agriculture, Forestry, Fishing and Hunting",2012,1080,735,175,80,990,40,35,1065,15,1080,735,175,80,990,40,35,1065,15,7807,1131,1030,742,3253,1171,0,7553,61,258765000,31220000,27863000,19257000,86895000,37934000,0,254665000,971000
Kentucky,"Arts, Entertainment, and Recreation",2012,5987,3065,1040,839,4944,799,104,5847,140,6285,3065,1050,850,4965,875,175,6015,270,78210,3079,6060,10415,21574,30103,6866,64738,9943,1658193000,127717000,107035000,206737000,463067000,620153000,123239000,1349961000,163131000
Kentucky,Construction,2012,35759,22510,6160,3624,32294,2788,426,35508,251,36210,22510,6160,3625,32295,2905,580,35780,430,303186,36431,39579,47131,125883,100024,45804,279005,11935,13701015000,1214375000,1344045000,1878488000,4462790000,4884498000,2651588000,12325950000,777714000
Kentucky,Educational Services,2012,3849,1690,715,465,2870,547,243,3660,189,4520,1690,720,475,2885,570,445,3900,620,145263,2043,4517,5998,13652,16374,43240,76398,61572,3555503000,58003000,93941000,103042000,263920000,389804000,1175827000,1912548000,1449791000
Kentucky,Finance and Insurance,2012,15457,9480,2308,795,12583,1109,500,14192,1265,31905,9495,2380,1060,12935,3040,3480,19455,12450,316252,14973,13674,9349,40731,39236,41965,125264,185143,19140714000,642788000,585037000,480169000,1742579000,1834203000,1945810000,5754771000,12967095000
Kentucky,Health Care and Social Assistance,2012,42853,19800,9780,5892,35472,4430,1537,41439,1414,57300,19845,9815,6130,35790,5945,4530,46265,11035,1257212,34814,64058,77938,179645,158045,199455,545058,706923,50756713000,1660619000,2327678000,2882390000,6879706000,6563972000,5986263000,19669961000,30970694000
Kentucky,Information,2012,3895,1635,500,430,2565,477,242,3284,611,7685,1635,500,440,2575,695,445,3715,3970,137801,2366,2694,4813,10912,14047,8109,41507,73777,6001168000,102477000,102352000,147459000,374298000,629044000,372258000,1556881000,4365536000
Kentucky,Management of Companies and Enterprises,2012,2274,140,25,61,226,415,640,1281,993,3295,140,25,65,230,415,700,1345,1950,138575,0,68,524,87,5595,15047,21610,116783,12028890000,9528000,5598000,36013000,52529000,355840000,987270000,1395835000,10619879000
Kentucky,Manufacturing,2012,17316,5280,2680,2280,10240,3077,1545,14862,2454,18880,5285,2680,2290,10255,3400,1895,15550,3330,945504,7744,15352,25392,53284,100466,128448,316837,565017,45292722000,285990000,486427000,949966000,1859196000,4122827000,5732234000,13259358000,29045236000
Kentucky,"Mining, Quarrying, and Oil and Gas Extraction",2012,2270,810,325,310,1445,457,173,2075,195,2895,810,325,310,1445,485,360,2290,605,104175,1247,1859,4232,7787,15280,18959,42561,61286,6444311000,75268000,82206000,189961000,355812000,789938000,1006369000,2174702000,4262198000
Kentucky,Other,2012,277,276,1,0,277,0,0,277,0,277,276,1,0,277,0,0,277,0,272,267,0,0,272,0,0,272,0,4513000,4507000,0,0,4513000,0,0,4513000,0
Kentucky,Other Services (except Public Administration),2012,43133,27460,8440,3797,39697,2488,419,42604,529,46835,27475,8520,4030,40025,3390,1215,44630,2205,323353,51747,53421,48726,156493,77971,18711,262059,32774,7873482000,1171560000,1147308000,1102769000,3445205000,1947809000,542258000,6155265000,1547934000
Kentucky,"Professional, Scientific, and Technical Services",2012,37568,25435,5323,3065,33823,2072,653,36548,1020,40555,25445,5340,3105,33890,2600,975,37465,3090,319895,38274,33888,39054,115068,63913,36250,225089,81806,14632066000,1523679000,1281571000,1745940000,4584729000,3317687000,1777048000,9948387000,4519615000
Kentucky,Real Estate and Rental and Leasing,2012,13809,10045,1593,690,12328,589,352,13269,540,17495,10045,1685,790,12520,1080,830,14430,3065,88619,15313,9803,7202,33645,15830,6915,60701,20807,3229787000,453762000,308370000,271673000,1058627000,551280000,174497000,1891689000,1071693000
Kentucky,Retail Trade,2012,47535,24629,10187,5610,40426,4133,937,45496,2039,76255,24670,10405,6225,41300,6535,3310,51145,25110,928373,37668,63025,69950,179585,131317,51640,379898,403427,21779291000,978511000,1485247000,1744479000,4222060000,4075672000,1665694000,10188140000,9108556000
Kentucky,Total,2012,67898,37246,12212,7639,57097,6621,1798,65516,2382,89795,37280,12346,8043,57669,9007,5234,71910,17885,1481323,65877,80160,101294,247331,236647,202539,686517,794806,56039216000,2027112000,2292921000,3051284000,7371317000,8077905000,7285738000,22734960000,33304256000
Kentucky,Transportation and Warehousing,2012,12325,6515,1810,1130,9455,1027,470,10952,1373,14610,6515,1815,1150,9480,1110,580,11170,3440,311776,9422,10714,13103,34266,29055,23556,94571,179772,14266788000,328050000,344779000,440942000,1131627000,1140198000,1058510000,3526098000,10294433000
Kentucky,Utilities,2012,475,150,50,55,255,80,60,395,80,1670,150,50,55,255,160,245,660,1010,41418,235,280,596,1225,4715,6280,12667,17794,3343395000,9310000,9165000,19773000,42817000,297979000,383378000,740942000,1533569000
Kentucky,Wholesale Trade,2012,17722,7435,2607,2019,12061,2477,1133,15671,2051,21760,7445,2630,2185,12260,3035,1805,17100,4660,315566,11155,13110,23047,52766,61973,44951,178358,118825,17236518000,562312000,610172000,984505000,2276366000,3091642000,2367963000,8546036000,7821171000
Louisiana,Accommodation and Food Services,2012,33706,11200,6563,6870,24633,7422,828,32883,823,45230,11205,6590,6965,24760,8370,3445,36575,8655,963618,19752,44359,92959,156905,275078,127203,562920,373005,15988925000,454370000,549202000,1192675000,2198677000,4108558000,2194889000,8518872000,7400695000
Louisiana,Administrative and Support and Waste Management and Remediation Services,2012,20044,10645,3180,2105,15930,2210,769,18909,1135,22830,10660,3195,2145,16000,2470,1090,19560,3270,518349,16159,19930,27355,65940,84796,84004,241149,263327,17075743000,637953000,591109000,898199000,2141388000,2675758000,2567090000,7668740000,9030604000
Louisiana,"Agriculture, Forestry, Fishing and Hunting",2012,2931,1636,710,340,2686,195,20,2901,30,2980,1640,710,340,2690,195,20,2905,75,17853,1726,4447,3746,11406,5229,0,16811,322,751810000,103030000,176318000,145346000,441905000,214987000,0,680156000,19216000
Louisiana,"Arts, Entertainment, and Recreation",2012,6503,3545,1065,757,5367,840,170,6377,126,6965,3545,1065,800,5410,975,295,6680,285,100094,4492,6632,9706,22586,30098,11079,69867,29346,2705689000,162408000,143129000,188586000,506417000,549666000,217221000,1623400000,704636000
Louisiana,Construction,2012,39071,22595,7430,4312,34337,3486,735,38558,513,39630,22595,7430,4320,34345,3545,875,38765,865,565481,39302,48732,56406,146625,133371,104590,387898,143125,28555543000,1358945000,1631720000,2250024000,5263900000,6386557000,6354278000,18127990000,8832722000
Louisiana,Educational Services,2012,5209,2065,725,605,3395,1253,385,5033,176,5730,2065,725,630,3420,1390,545,5355,375,188766,2883,4467,7995,16012,54562,49815,124484,55064,6418488000,101403000,125857000,147500000,386960000,1591381000,1641123000,3678269000,2472458000
Louisiana,Finance and Insurance,2012,19595,12075,3484,1106,16665,1258,557,18480,1115,38670,12080,3715,1475,17270,4215,4080,25565,13105,319093,18990,21217,13515,58191,48497,49158,162439,148993,17987338000,886564000,974474000,713474000,2603046000,2516436000,2789876000,8131686000,9512739000
Louisiana,Health Care and Social Assistance,2012,49419,22075,11250,6585,39910,6046,2282,48238,1181,60205,22105,11335,6740,40180,7910,5355,53445,6760,1427623,40540,73810,86297,201907,248122,334913,791407,584697,54606323000,2317682000,2792983000,3071073000,8202692000,7585581000,9812585000,25756375000,28493409000
Louisiana,Information,2012,3313,1425,490,310,2225,425,192,2842,471,6965,1425,495,315,2235,550,535,3320,3645,111327,1400,2735,3818,9275,10815,4401,35737,69069,6263671000,116592000,90469000,169370000,405541000,510697000,178258000,1550765000,4133164000
Louisiana,Management of Companies and Enterprises,2012,2355,155,55,75,285,535,683,1503,852,3080,155,55,75,285,540,715,1540,1540,114725,0,224,0,0,6925,25620,33770,79697,10930620000,128043000,10073000,23605000,158831000,416885000,1719655000,2309365000,8538821000
Louisiana,Manufacturing,2012,15238,5500,2615,2145,10260,2663,873,13796,1442,16535,5500,2615,2145,10260,2810,1290,14360,2175,526932,7437,14343,25099,52743,89763,63281,233025,259094,31962473000,380369000,533651000,1067630000,2137481000,4367714000,3599769000,11419281000,18787669000
Louisiana,"Mining, Quarrying, and Oil and Gas Extraction",2012,6849,3485,795,624,4904,975,384,6263,586,8455,3485,805,625,4915,1130,505,6550,1905,271065,5259,4985,8450,19096,36716,47917,103967,167098,21336189000,434100000,287128000,549223000,1274047000,2471922000,3559318000,7320044000,14016145000
Louisiana,Other,2012,77,73,3,1,77,0,0,77,0,77,73,3,1,77,0,0,77,0,95,0,19,0,95,0,0,95,0,1945000,1241000,77000,0,1945000,0,0,1945000,0
Louisiana,Other Services (except Public Administration),2012,44718,26525,9647,4365,40537,3077,527,44141,577,47875,26535,9685,4660,40880,3915,965,45760,2115,376164,50404,62545,56009,171035,108799,40334,327068,22184,10390669000,1209599000,1399521000,1473340000,4105911000,2793325000,1218931000,8316569000,944596000
Louisiana,"Professional, Scientific, and Technical Services",2012,55004,38243,7555,4038,49836,3207,827,53870,1134,58835,38295,7565,4165,50025,3920,1310,55255,3580,433935,58821,48969,51679,159765,102189,67781,337432,88182,25818524000,3099738000,2225434000,2748343000,8109292000,6714751000,4805661000,19983050000,5501082000
Louisiana,Real Estate and Rental and Leasing,2012,17709,12450,2264,978,15692,986,480,17158,551,22330,12455,2310,1150,15915,1535,1270,18720,3610,152524,18127,13632,11704,45123,30667,27152,105664,38723,7489143000,647373000,488275000,470944000,1619950000,1370987000,1366590000,4443761000,2463944000
Louisiana,Retail Trade,2012,53709,28495,11461,6303,46259,4670,902,51831,1878,83870,28555,11735,6960,47250,7320,2960,57530,26340,925067,50999,73670,79340,212019,166833,62166,451373,395709,23237141000,1268197000,1755922000,2109406000,5185799000,5215189000,2369234000,12962606000,9623382000
Louisiana,Total,2012,80893,43874,15076,9151,68101,8521,2098,78720,2173,104059,43924,15259,9653,68836,11380,5746,85962,18097,1644282,78597,99479,121892,299968,325173,266984,892125,752157,68864331000,2964240000,3131848000,4072272000,10168360000,11723183000,11451551000,33343094000,35521237000
Louisiana,Transportation and Warehousing,2012,14998,7780,2075,1519,11374,1612,684,13670,1328,18930,7785,2075,1540,11400,1790,980,14170,4760,324433,9758,12484,17410,45297,48923,47437,159445,143195,17510330000,562659000,487936000,854097000,1943072000,2440812000,3244661000,8467564000,8292741000
Louisiana,Utilities,2012,1130,615,255,50,920,80,38,1038,92,2610,615,260,50,925,115,155,1195,1415,4253,1264,1497,594,3509,2367,4993,12241,206,331086000,29359000,40491000,17731000,90172000,102562000,296139000,541968000,9807000
Louisiana,Wholesale Trade,2012,21927,8540,3870,2931,15341,3301,1282,19924,2003,28185,8555,3915,3160,15630,4205,2340,22175,6010,367409,13733,23929,35780,77236,96745,49638,238917,119528,20138009000,753900000,1144946000,1788612000,3764642000,4897798000,2828826000,12154324000,7167667000
Maine,Accommodation and Food Services,2012,17511,8690,2955,2830,14475,2513,258,17246,265,19825,8690,2970,2855,14515,3065,995,18575,1250,230276,8328,19832,38342,68235,86172,31815,187687,38537,4266964000,565602000,409158000,676750000,1661375000,1466329000,511458000,3671050000,599230000
Maine,Administrative and Support and Waste Management and Remediation Services,2012,9191,6090,1190,650,7930,623,205,8758,433,9795,6095,1190,675,7960,745,265,8970,825,110851,7524,7313,7792,23862,19952,13055,64365,33332,3632872000,304362000,207987000,228447000,784989000,641860000,294517000,1951319000,1034844000
Maine,"Agriculture, Forestry, Fishing and Hunting",2012,3940,3135,410,165,3710,200,20,3930,10,3985,3135,410,165,3710,215,40,3965,20,15706,752,2426,2090,8345,5706,0,15396,0,685934000,126126000,80028000,82773000,293021000,240039000,0,661344000,0
Maine,"Arts, Entertainment, and Recreation",2012,4219,2850,540,380,3770,337,67,4174,45,4310,2850,540,380,3770,355,130,4255,55,33165,598,3297,4306,11017,10799,5630,30975,2538,752456000,165696000,89687000,125342000,403379000,201728000,55191000,705877000,42212000
Maine,Construction,2012,23664,18345,2915,1327,22587,899,84,23570,94,23745,18345,2915,1330,22590,930,90,23610,135,108792,23768,17942,17148,63157,29008,4024,101860,3425,4854074000,951552000,679753000,745062000,2405615000,1487237000,238266000,4465733000,202297000
Maine,Educational Services,2012,2309,1110,390,290,1790,313,110,2213,96,2425,1110,390,290,1790,365,135,2290,135,81389,1425,2335,3146,7884,12361,13529,36645,43454,2422021000,47885000,58988000,109222000,259915000,341496000,442275000,1148403000,1233200000
Maine,Finance and Insurance,2012,4645,2465,575,325,3365,477,221,4063,582,9590,2470,600,395,3465,1305,1440,6210,3380,128516,3312,3157,3816,11469,16925,18168,51941,67431,7832999000,169870000,154091000,215329000,558569000,899332000,1075443000,2723824000,4644518000
Maine,Health Care and Social Assistance,2012,16211,7703,3210,1805,12718,1749,1025,15492,719,23695,7710,3240,1875,12825,2950,3920,19695,4000,537691,12669,20888,23630,58434,70259,127544,259795,269557,21593887000,483975000,824201000,968958000,2317080000,2280413000,4098670000,8781697000,12476936000
Maine,Information,2012,2582,1240,390,220,1850,289,133,2272,310,4120,1250,390,225,1865,335,265,2465,1655,41737,757,1841,1799,5587,7546,6876,27017,14542,2457452000,51019000,54828000,52656000,204145000,345520000,284497000,1078742000,793466000
Maine,Management of Companies and Enterprises,2012,837,45,5,45,95,155,281,531,306,1040,45,5,45,95,155,295,545,495,38246,0,0,0,208,1949,6911,9097,28881,3186821000,2403000,0,9851000,14037000,110157000,318114000,442546000,2739156000
Maine,Manufacturing,2012,7931,3455,1424,910,5789,1233,394,7416,515,8275,3460,1430,915,5805,1315,475,7595,680,188816,3789,6814,8420,22378,37122,21347,101344,62203,9138907000,174048000,248752000,303392000,820462000,1570884000,1080174000,4157220000,3522693000
Maine,"Mining, Quarrying, and Oil and Gas Extraction",2012,121,95,5,0,100,15,0,115,6,125,95,5,0,100,15,0,115,10,34,82,0,0,34,0,0,34,0,1620000,5094000,0,0,5880000,0,0,11586000,0
Maine,Other,2012,24,22,1,1,24,0,0,24,0,24,22,1,1,24,0,0,24,0,35,0,0,0,35,0,0,35,0,678000,517000,0,0,678000,0,0,678000,0
Maine,Other Services (except Public Administration),2012,17113,11740,3220,1148,16108,654,146,16908,205,18130,11745,3260,1210,16215,1045,380,17640,490,91033,20220,19837,14034,56548,17398,5087,85135,3276,2322749000,525129000,492629000,358508000,1399140000,516272000,106102000,2143763000,117231000
Maine,"Professional, Scientific, and Technical Services",2012,16676,11530,2428,1120,15078,812,200,16090,586,17535,11530,2455,1155,15140,1020,255,16415,1120,108683,13693,15292,13537,46841,23312,7894,80405,13746,6026336000,731062000,704339000,656494000,2122630000,1433102000,612438000,4393909000,1198700000
Maine,Real Estate and Rental and Leasing,2012,7155,5675,595,358,6628,209,85,6922,233,7915,5675,610,445,6730,335,150,7215,700,28408,7162,3440,3594,15342,4467,1040,23180,3855,1086529000,275631000,136000000,130656000,559294000,153797000,40460000,854558000,184450000
Maine,Retail Trade,2012,22765,11617,4647,2989,19253,1876,402,21531,1234,31795,11670,4705,3295,19670,2810,1565,24045,7750,361106,16286,26842,33515,81097,53325,30521,178340,97128,8855065000,506313000,659354000,846237000,2066840000,1638699000,1151146000,5110513000,2435775000
Maine,Total,2012,33078,20534,5277,3102,28913,2535,621,32069,1009,40120,20563,5338,3285,29186,3657,2262,35105,5015,486838,32186,34638,41298,108122,92581,78254,278957,207881,18486234000,1120613000,1071532000,1312278000,3504423000,3166846000,2893826000,9565095000,8921139000
Maine,Transportation and Warehousing,2012,5420,3420,644,445,4509,400,134,5043,377,5920,3420,665,450,4535,460,185,5180,740,54549,4311,3696,4381,12989,10986,4660,31899,12161,2209183000,167092000,129487000,141615000,508938000,400195000,219678000,1313756000,549000000
Maine,Utilities,2012,242,98,25,10,133,15,35,183,59,495,100,25,20,145,15,100,260,235,7433,40,24,0,364,0,0,2043,4063,793498000,9458000,2680000,0,19506000,0,0,215170000,316643000
Maine,Wholesale Trade,2012,6840,3305,873,660,4838,719,389,5946,894,7760,3310,880,695,4885,850,625,6360,1400,74329,3659,4290,5812,15892,14448,10560,49781,17737,3771449000,214519000,181234000,288786000,775745000,714937000,546219000,2402795000,1066613000
Maryland,Accommodation and Food Services,2012,44517,18425,8350,7336,34111,8448,1010,43569,948,56790,18425,8375,7405,34205,9360,2855,46420,10370,1013914,32022,55490,99054,186982,318653,123102,629569,356880,18071274000,911864000,858213000,1495870000,3271249000,5366611000,2032242000,10675694000,6957439000
Maryland,Administrative and Support and Waste Management and Remediation Services,2012,35576,19610,5475,3563,28648,3996,1284,33928,1648,40165,19625,5485,3600,28710,4140,1615,34465,5700,927192,29091,35377,46598,114932,149850,146700,421014,485523,35376185000,1253906000,1240297000,1816831000,4357682000,5550297000,5172863000,15432986000,19225336000
Maryland,"Agriculture, Forestry, Fishing and Hunting",2012,913,700,125,35,860,25,10,895,18,925,700,125,35,860,25,10,895,30,4675,721,580,346,2115,452,0,2995,636,154434000,26302000,19054000,12523000,65248000,18575000,0,98093000,22408000
Maryland,"Arts, Entertainment, and Recreation",2012,9155,5088,1170,1117,7375,1235,290,8900,255,9925,5090,1185,1125,7400,1325,380,9105,820,173388,5662,6982,14437,28156,46935,36296,117265,32287,4975812000,411174000,192761000,313607000,934865000,1081134000,1139617000,3249519000,476133000
Maryland,Construction,2012,68383,43500,10765,6630,60895,5875,998,67768,615,68885,43500,10765,6635,60900,5920,1105,67925,960,693285,70134,70412,89237,231497,220763,142746,600022,63813,37330815000,2831530000,2872384000,4338989000,10051555000,12050362000,8379663000,30726345000,4537250000
Maryland,Educational Services,2012,9462,4410,1380,1260,7050,1470,611,9131,331,10175,4410,1385,1315,7110,1710,710,9530,645,403786,5829,8439,16372,32318,61152,77899,176746,214997,16970370000,244057000,216927000,362173000,843778000,1824058000,3238190000,5973384000,10423829000
Maryland,Finance and Insurance,2012,20488,12253,3190,1323,16766,1359,781,18906,1582,38285,12285,3235,1505,17025,2945,2715,22685,15600,472285,21649,19460,16441,59268,46669,52412,169043,269741,41518896000,1137405000,1229901000,1445080000,3838084000,3632640000,5135720000,13091495000,26265279000
Maryland,Health Care and Social Assistance,2012,62485,30416,13845,8088,52349,6296,2259,60904,1581,80020,30470,13985,8675,53130,9510,7910,70550,9470,1748194,56582,90578,105372,255499,233855,310418,807173,912410,80272239000,2830133000,4212290000,4861644000,11954353000,10917783000,10870708000,34025503000,44888646000
Maryland,Information,2012,6788,3255,745,605,4605,855,365,5825,963,11560,3260,745,620,4625,955,495,6075,5485,254896,4821,4085,6186,15899,26454,25321,75962,175466,19548539000,281325000,313163000,457871000,1122097000,1726148000,2113058000,5422209000,13835134000
Maryland,Management of Companies and Enterprises,2012,3094,170,55,110,335,597,811,1743,1351,6050,170,55,110,335,620,850,1805,4245,241875,173,225,692,1240,8338,29455,39033,202337,22637821000,33290000,13210000,81690000,128190000,617617000,2114725000,2860532000,19777289000
Maryland,Manufacturing,2012,14878,5980,2434,1880,10294,2525,806,13625,1253,15475,5980,2435,1880,10295,2625,950,13870,1605,443678,8193,12339,20780,47016,78637,47951,204299,165541,26396960000,388328000,505570000,862841000,1939654000,3803126000,2501282000,9768900000,11101982000
Maryland,"Mining, Quarrying, and Oil and Gas Extraction",2012,310,75,70,20,165,80,15,260,50,375,75,70,20,165,80,35,280,95,6294,12,289,140,506,1715,0,3064,2204,378519000,7430000,10948000,5318000,27542000,137479000,0,190498000,132993000
Maryland,Other,2012,79,76,1,2,79,0,0,79,0,79,76,1,2,79,0,0,79,0,92,62,0,0,92,0,0,92,0,2169000,1933000,0,0,2169000,0,0,2169000,0
Maryland,Other Services (except Public Administration),2012,63057,37145,12629,7034,56808,4892,701,62401,656,67245,37170,12660,7210,57040,5730,1315,64085,3160,557382,70311,81588,92141,246257,171676,56492,482432,54756,19554079000,2069062000,2278035000,2750084000,7130477000,5769651000,2628007000,15714434000,2832796000
Maryland,"Professional, Scientific, and Technical Services",2012,89690,60713,10920,6896,78529,6742,2133,87404,2286,98550,60735,10935,7070,78740,7340,2605,88685,9865,1223735,74082,70301,90258,252968,236787,182805,681174,515234,100646553000,5870443000,4390359000,6185687000,16461146000,19051742000,15196054000,51287958000,47422763000
Maryland,Real Estate and Rental and Leasing,2012,21542,15160,2348,1228,18736,1392,617,20745,797,29575,15195,2360,1385,18940,1980,2430,23350,6225,208256,15577,14438,16040,52643,42343,34499,132689,73610,11329452000,990041000,675088000,775226000,2454396000,2466052000,2268033000,7487265000,3819531000
Maryland,Retail Trade,2012,57527,30744,12272,6234,49250,4410,1322,54982,2545,90930,30825,12495,6815,50135,6325,3785,60245,30685,1372287,48143,76417,73269,202059,138032,94530,469326,803816,35565384000,1511971000,1916686000,2121352000,5610398000,4774756000,3983727000,14933189000,19632410000
Maryland,Total,2012,107324,61518,18270,11427,91215,10677,2711,104603,2721,134305,61585,18408,11915,91908,13241,6529,111678,22627,2152458,104930,120138,152081,377149,395709,318598,1091456,1061002,105889051000,4500711000,4585276000,6183127000,15269114000,17708872000,15773833000,48751819000,57137232000
Maryland,Transportation and Warehousing,2012,15144,8070,2260,1444,11774,1535,539,13848,1296,16690,8070,2260,1455,11785,1645,705,14135,2555,296478,8680,13730,17931,45198,47312,24430,123585,122381,12071406000,432962000,445701000,591773000,1499626000,1839390000,963817000,4511430000,5378013000
Maryland,Utilities,2012,331,115,25,20,160,25,25,210,121,715,115,25,25,165,25,60,250,465,58670,118,72,94,528,0,0,1494,52229,6727632000,11795000,4328000,5106000,32675000,0,73332000,160879000,6080523000
Maryland,Wholesale Trade,2012,24443,11440,3428,2603,17471,3378,1395,22244,2199,28795,11445,3455,2680,17580,3945,2115,23640,5155,411287,13025,20011,30796,72386,100146,71155,260555,131104,27109126000,1036186000,1179491000,1841386000,4168702000,6007226000,5002126000,15908847000,9704849000
Massachusetts,Accommodation and Food Services,2012,66850,27579,13710,11669,52958,11946,1061,65965,885,84300,27625,13740,11795,53160,13785,4080,71025,13275,1310397,45310,90315,160396,297193,430194,144267,871138,418995,26192791000,1581086000,1469225000,2617465000,5674990000,7749555000,2813741000,16250781000,9890107000
Massachusetts,Administrative and Support and Waste Management and Remediation Services,2012,45093,28995,5960,3658,38613,3453,1369,43435,1658,50185,29000,5970,3710,38680,3645,1560,43885,6300,1020176,37395,38493,47436,124614,134646,170608,444906,570454,41719791000,2188554000,1646484000,2064777000,5943913000,5923668000,6197431000,18610696000,22684227000
Massachusetts,"Agriculture, Forestry, Fishing and Hunting",2012,1750,1410,200,105,1715,30,0,1745,5,1750,1410,200,105,1715,30,0,1745,5,4803,763,1261,1133,4271,207,0,4771,0,156381000,67938000,24867000,28621000,130547000,10573000,0,153953000,0
Massachusetts,"Arts, Entertainment, and Recreation",2012,14377,7675,2210,1807,11692,2039,385,14116,261,15570,7675,2220,1835,11730,2285,775,14790,780,255216,10737,13777,23939,49519,77351,49094,183685,57956,8904312000,592614000,453829000,723780000,1800658000,1705385000,1304642000,5336812000,1206180000
Massachusetts,Construction,2012,83170,60200,12235,5769,78204,4053,539,82796,374,83440,60200,12245,5775,78220,4075,590,82885,555,519250,92634,78805,77069,250800,150823,58865,470950,36784,34363040000,4496256000,4030870000,4738491000,13271355000,11470337000,4653789000,30457225000,3056911000
Massachusetts,Educational Services,2012,13349,5925,2295,1638,9858,2060,904,12822,527,14375,5925,2300,1760,9985,2155,1305,13445,930,1023403,8629,15099,21188,45779,83454,143882,275929,741150,41847134000,340381000,422014000,563510000,1346756000,2873524000,5547333000,9953289000,31874841000
Massachusetts,Finance and Insurance,2012,26784,14729,4067,2047,20843,2542,1372,24757,2027,47415,14740,4250,2345,21335,4615,5625,31575,15840,987262,25263,25801,24383,77827,83724,115626,284286,676024,113886932000,2312614000,2165939000,2510116000,7078322000,9362275000,10706150000,27441605000,84605898000
Massachusetts,Health Care and Social Assistance,2012,66374,29140,14822,8945,52907,7675,3468,64050,2324,92250,29175,14920,9395,53490,10745,11275,75510,16740,2901462,54556,98541,119495,275271,291846,501034,1072910,1667908,141541106000,2855293000,4662724000,6041475000,13580262000,13454406000,18357180000,45510086000,92896425000
Massachusetts,Information,2012,11203,4930,1585,1175,7690,1481,686,9857,1346,17815,4930,1590,1180,7700,1555,795,10050,7765,511004,6769,9363,14404,32621,54920,60161,153620,345587,48725801000,546384000,572023000,1060888000,2230306000,4965975000,5685217000,13514456000,34502527000
Massachusetts,Management of Companies and Enterprises,2012,4000,260,110,110,480,606,1082,2168,1832,5955,260,110,115,485,625,1115,2225,3730,452885,484,571,48,1715,8256,43576,53785,399062,49852280000,48346000,45570000,37185000,131405000,650628000,3459567000,4250550000,45588264000
Massachusetts,Manufacturing,2012,33108,11900,5905,4874,22679,6482,1883,31044,2064,34075,11900,5910,4890,22700,6640,2045,31385,2690,1070699,15435,33962,59235,120379,232584,176282,581854,421494,71043619000,1096414000,1643646000,2964463000,6021692000,12671551000,11042634000,32511388000,34549992000
Massachusetts,"Mining, Quarrying, and Oil and Gas Extraction",2012,346,130,60,50,240,64,22,326,20,400,130,60,50,240,80,55,375,25,3544,214,310,185,1096,1097,0,2981,0,238340000,19861000,16974000,18711000,61238000,77830000,0,190219000,0
Massachusetts,Other,2012,218,199,14,2,215,3,0,218,0,218,199,14,2,215,3,0,218,0,364,0,90,0,271,93,0,364,0,10636000,6298000,2991000,0,9606000,1030000,0,10636000,0
Massachusetts,Other Services (except Public Administration),2012,79667,49000,17035,8128,74163,4144,707,79014,653,87005,49010,17195,8550,74755,5110,2105,81970,5035,594121,93576,110375,105827,312086,132966,57247,510842,65955,18585216000,2800608000,3032835000,2931174000,8775852000,4356675000,1911329000,15276611000,2481994000
Massachusetts,"Professional, Scientific, and Technical Services",2012,101718,68927,13520,7346,89793,6876,2174,98843,2875,107345,68945,13530,7495,89970,7385,2505,99860,7485,1277379,92019,87172,94779,289152,229125,195408,723587,542749,126998377000,6920241000,5811549000,7181354000,19950599000,22549695000,18883002000,61979991000,64521226000
Massachusetts,Real Estate and Rental and Leasing,2012,24877,18093,2930,1493,22516,1190,514,24220,657,31740,18155,3105,1685,22945,1890,1610,26445,5295,203329,26750,18011,18283,63819,38337,37871,146561,49726,12335787000,1430894000,884408000,968624000,3320715000,2298705000,2083997000,7970690000,3977308000
Massachusetts,Retail Trade,2012,81561,47178,16484,8304,71966,5584,1535,79085,2476,122170,47345,16995,9170,73510,8365,5300,87175,34995,1707085,74264,100634,96140,271905,168899,102877,575680,711708,46950885000,2486090000,2838780000,3147745000,8565864000,7061879000,4381063000,20864493000,18078592000
Massachusetts,Total,2012,138386,80356,24198,14493,119047,12917,3401,135365,3021,171279,80445,24481,15147,120073,16019,8844,144936,26343,3043759,136720,158783,193393,488896,478514,436824,1404234,1639525,173520982000,6495516000,6570573000,8510528000,21576617000,24473706000,23380857000,69431180000,104089802000
Massachusetts,Transportation and Warehousing,2012,15751,8140,2330,1589,12059,1659,867,14585,1166,17900,8140,2335,1595,12070,1800,1055,14925,2975,376440,10755,13486,19827,46634,52220,62257,168105,193668,15922390000,500178000,522076000,743002000,1827888000,1931600000,2164989000,6204108000,8976289000
Massachusetts,Utilities,2012,485,170,50,10,230,75,50,355,130,1365,170,50,10,230,75,85,390,975,38118,88,219,0,421,1941,0,5616,1404,4104745000,10438000,12276000,0,32270000,360556000,0,726878000,3306751000
Massachusetts,Wholesale Trade,2012,35345,16480,5580,4112,26172,4648,1840,32660,2685,40250,16495,5610,4265,26370,5220,2340,33930,6320,646056,27495,33795,51244,117893,147365,104104,384799,232686,50940050000,1887173000,2211012000,3465222000,7645712000,10372383000,7922937000,26732346000,22508376000
Michigan,Accommodation and Food Services,2012,74743,28195,14480,14682,57357,14989,1279,73625,1118,97450,28235,14535,14845,57615,18045,5550,81210,16240,1695103,44650,96787,201218,342759,538575,194124,1078564,604934,25117025000,1078240000,1103361000,2383014000,4565790000,7313893000,2478626000,14419133000,10672074000
Michigan,Administrative and Support and Waste Management and Remediation Services,2012,49205,30494,6377,4145,41016,4468,1806,47290,1915,56310,30520,6415,4215,41150,4835,2340,48325,7985,1542514,37474,41573,54994,138094,172987,287958,604772,922476,47227128000,2072529000,1344068000,1855694000,5294580000,5891337000,9396006000,20759992000,26000446000
Michigan,"Agriculture, Forestry, Fishing and Hunting",2012,2659,1935,380,150,2465,134,30,2629,30,2665,1935,380,150,2465,135,30,2630,35,16194,3074,2298,1738,7278,3653,1486,14772,751,589213000,107953000,71240000,68606000,252228000,129759000,51144000,509747000,56268000
Michigan,"Arts, Entertainment, and Recreation",2012,16300,9515,2335,2039,13889,1870,330,16089,211,16925,9530,2350,2065,13945,2025,425,16395,530,219737,11676,14456,27014,55007,67914,37147,168669,21628,7055918000,647124000,352452000,484093000,1509338000,1364367000,3139259000,6226579000,360052000
Michigan,Construction,2012,89953,65235,12965,6429,84629,4371,563,89563,390,90645,65235,12965,6430,84630,4530,750,89910,735,569310,93617,84089,84891,265330,152458,76144,499985,44969,32448355000,4338167000,3615968000,4394033000,12432250000,9320241000,5140421000,27171420000,3978456000
Michigan,Educational Services,2012,10468,5080,1645,1410,8135,1535,431,10101,367,11615,5080,1645,1465,8190,1715,705,10610,1005,361265,7633,10797,18362,37222,63298,61635,165840,193682,9788874000,218529000,202695000,379810000,807415000,1556803000,2082317000,4524694000,5206218000
Michigan,Finance and Insurance,2012,34967,22915,5022,2205,30142,2277,919,33338,1629,67800,22930,5120,2585,30635,5745,4805,41185,26615,745606,35811,31176,27764,100302,84087,98089,290700,418338,48143741000,1732675000,1500456000,1719239000,5000110000,4619052000,5743979000,15661923000,30691221000
Michigan,Health Care and Social Assistance,2012,104081,47308,26489,14763,88560,10198,3362,102120,1961,131695,47345,26625,15315,89285,14820,12255,116360,15335,2913662,87449,176399,193478,461440,388422,512353,1369307,1527666,128313320000,4198093000,7082479000,8539265000,19851646000,16763227000,17257267000,54056758000,73343021000
Michigan,Information,2012,8679,4020,1285,875,6180,972,400,7552,1127,16265,4020,1290,910,6220,1160,625,8005,8260,327419,5272,7632,9865,25102,31972,29438,96143,225658,23146972000,311063000,325706000,448969000,1119684000,1754475000,1458157000,4830739000,18162789000
Michigan,Management of Companies and Enterprises,2012,5258,315,65,130,510,1040,1602,3152,2106,7805,315,65,135,515,1065,1705,3285,4520,544825,0,39,890,1542,12360,48108,62105,482627,55014800000,244000,37725000,93490000,314460000,760230000,3258738000,4339600000,50667651000
Michigan,Manufacturing,2012,58782,20205,10333,8959,39497,11620,4184,55301,3481,62410,20220,10350,9015,39585,12190,5255,57030,5380,2427939,33436,63375,116141,223157,445892,497341,1220880,1095791,134957249000,1545707000,2676108000,5278707000,9806229000,22578303000,25273249000,59957182000,68341370000
Michigan,"Mining, Quarrying, and Oil and Gas Extraction",2012,1721,860,250,189,1299,190,71,1560,161,1895,860,250,205,1315,205,100,1620,275,26351,973,1600,2306,5454,4914,3819,15102,10714,1761315000,79401000,88663000,160498000,337350000,349313000,215142000,987171000,730304000
Michigan,Other,2012,171,167,3,0,170,1,0,171,0,171,167,3,0,170,1,0,171,0,0,0,0,0,0,0,0,0,0,4502000,4389000,105000,0,4494000,0,0,4502000,0
Michigan,Other Services (except Public Administration),2012,105502,63925,23785,10298,98008,6002,827,104837,665,114015,63980,23960,10955,98895,8345,2275,109515,4500,764669,124490,152374,133306,413652,200554,69686,694980,46672,19785264000,2869374000,3409243000,3067299000,9367375000,5233387000,2208235000,17250359000,1728634000
Michigan,"Professional, Scientific, and Technical Services",2012,100350,68690,14003,7521,90214,5951,1803,97968,2382,108340,68710,14080,7750,90540,7360,3150,101050,7290,1150905,97925,90831,98104,291902,205392,161791,668029,466357,75721612000,5207425000,4657150000,5649593000,15539144000,13645533000,10738939000,40339514000,35051662000
Michigan,Real Estate and Rental and Leasing,2012,29613,21025,3930,1967,26922,1455,582,28959,654,37970,21065,4035,2220,27320,2750,2095,32165,5805,238425,31065,24411,24035,80525,43990,42238,168829,59866,9467842000,1086186000,769962000,831763000,2715745000,1788154000,1369210000,5965588000,2891038000
Michigan,Retail Trade,2012,113952,67137,22795,11245,101177,8376,1876,111429,2523,174505,67215,23235,12605,103055,13890,8570,125515,48990,2202165,110129,142518,139692,386190,293624,156472,901486,1198951,53334870000,2838865000,3205652000,3583366000,9727305000,9405156000,5103547000,24822880000,27375816000
Michigan,Total,2012,172118,99326,31296,18756,149378,15954,3721,169053,3065,217440,99418,31587,19738,150743,21714,11314,183771,33669,3468089,167319,205825,251102,624246,602846,528809,1755901,1712188,152248431000,6356286000,6790713000,8867116000,22014115000,23570402000,22708681000,68293198000,83955233000
Michigan,Transportation and Warehousing,2012,24433,14825,3048,2053,19926,2208,869,23003,1430,28475,14845,3060,2105,20010,2440,1220,23670,4805,440257,17019,18616,25732,65562,70897,57143,201159,191010,19046233000,763909000,710161000,954639000,2466509000,2911985000,2503469000,8182529000,8914806000
Michigan,Utilities,2012,526,195,60,35,290,50,51,391,135,1945,200,70,50,320,65,170,555,1390,4121,172,83,0,170,2122,5084,8617,2853,7717634000,12703000,12845000,0,45667000,144755000,912845000,1151766000,1297134000
Michigan,Wholesale Trade,2012,48117,23987,7434,5373,36794,5775,2455,45024,3093,57615,24015,7490,5670,37175,7245,4545,48965,8650,792204,29775,46535,66557,155106,182055,146376,502115,269939,49105055000,2213154000,2484613000,3832937000,8587757000,10697017000,8707230000,28820130000,19401960000
Minnesota,Accommodation and Food Services,2012,42382,14383,7563,8893,30839,9597,1012,41448,934,56575,14410,7585,9010,31005,11255,2960,45220,11355,1103230,20592,51201,121946,196124,351600,130594,682209,411605,16865490000,627945000,579461000,1392105000,2605460000,4961644000,1898559000,9519946000,7262980000
Minnesota,Administrative and Support and Waste Management and Remediation Services,2012,32528,21055,4135,2580,27770,2541,865,31176,1352,36300,21060,4145,2640,27845,2825,1115,31785,4515,792361,25003,25681,33130,87703,93320,101429,292925,485560,27462486000,1454802000,901960000,1178485000,3564212000,3473384000,2756852000,10261883000,16640520000
Minnesota,"Agriculture, Forestry, Fishing and Hunting",2012,2410,1580,455,200,2235,120,20,2375,35,2450,1580,455,200,2235,125,30,2390,60,12591,1888,2774,1978,7484,3539,0,12002,237,458922000,80902000,93043000,63254000,247737000,153130000,9306000,428410000,12299000
Minnesota,"Arts, Entertainment, and Recreation",2012,12943,7915,1967,1220,11102,1381,275,12758,185,13665,7920,1970,1235,11125,1520,345,12990,675,207199,7380,11548,13309,37055,47588,36800,128087,34009,6045834000,349201000,240864000,213869000,847085000,836737000,1097555000,3302313000,971653000
Minnesota,Construction,2012,79326,60565,9919,4935,75419,3021,497,78937,389,79870,60570,9920,4935,75425,3140,620,79185,685,474774,79630,63113,64819,210372,112021,54690,382542,72554,29729557000,3944970000,3018625000,3730330000,10706645000,7683741000,3991405000,22659419000,5795897000
Minnesota,Educational Services,2012,8778,4130,1095,1110,6335,1852,285,8472,306,9495,4135,1095,1120,6350,2025,370,8745,750,349850,4954,7163,14707,28417,75975,44040,153144,196569,9311395000,221594000,155623000,307441000,688971000,1955736000,1433631000,4209754000,5148445000
Minnesota,Finance and Insurance,2012,30260,20390,3606,1760,25756,1999,796,28551,1709,46670,20405,3740,2230,26375,4655,3430,34460,12210,716424,29192,21764,21455,74640,69698,62147,213115,485068,59454167000,1521661000,1202151000,1475771000,4231256000,4608947000,4122284000,13326038000,44666293000
Minnesota,Health Care and Social Assistance,2012,51011,22730,9414,6698,38842,7168,3290,49300,1711,75390,22745,9510,7135,39390,10460,11370,61220,14170,2194294,35428,62920,89705,191153,290596,501864,991786,1169455,88432524000,1597862000,2420206000,3139064000,7185194000,10048548000,14826465000,32250203000,53967317000
Minnesota,Information,2012,8308,3870,1175,955,6000,920,403,7323,985,12995,3870,1175,965,6010,1205,825,8040,4955,271148,5326,7219,11915,26492,29483,31171,101990,134636,19121518000,282449000,300866000,561527000,1172833000,1771071000,1888603000,5727517000,12959427000
Minnesota,Management of Companies and Enterprises,2012,3980,175,70,125,370,700,1226,2296,1684,5860,185,70,125,380,740,1300,2420,3440,665220,8,284,531,993,9100,39440,49660,615535,57989105000,15292000,30411000,27733000,81670000,503385000,3163610000,3749635000,54226025000
Minnesota,Manufacturing,2012,34461,12980,5760,4547,23287,6380,2279,31946,2515,36640,12980,5760,4590,23330,6610,2900,32840,3800,1380939,18292,31905,54112,115414,243497,246396,652174,618560,74544897000,908798000,1365793000,2410814000,4932928000,12097645000,12834419000,32183032000,36747598000
Minnesota,"Mining, Quarrying, and Oil and Gas Extraction",2012,691,375,110,65,550,40,36,626,65,805,375,110,70,555,45,45,645,160,27017,313,650,534,1694,645,936,5031,21968,2561604000,43724000,41258000,66666000,185755000,51917000,66325000,403279000,2117545000
Minnesota,Other,2012,98,93,3,2,98,0,0,98,0,98,93,3,2,98,0,0,98,0,108,0,19,0,108,0,0,108,0,2133000,1502000,271000,0,2133000,0,0,2133000,0
Minnesota,Other Services (except Public Administration),2012,70269,41702,14499,7903,64104,4889,699,69692,577,76245,41745,14665,8335,64745,6475,1965,73185,3060,563874,75844,93075,103747,276070,160641,60511,502237,40010,14041045000,1831758000,2050407000,2323248000,6230644000,3894769000,1866430000,12143247000,1415837000
Minnesota,"Professional, Scientific, and Technical Services",2012,78139,57370,8845,4932,71147,3924,1310,76381,1758,82140,57380,8880,5120,71380,4655,1650,77685,4455,663639,62580,56796,62710,195271,130227,103907,433749,213488,47393390000,4036725000,2968361000,3628534000,10680207000,9709867000,7907015000,28601846000,18266927000
Minnesota,Real Estate and Rental and Leasing,2012,25367,19735,2355,1023,23113,1089,571,24773,594,30905,19755,2385,1155,23295,2050,1770,27115,3790,173446,22667,14789,12645,52421,35351,32074,120877,37386,7241222000,929638000,535465000,455305000,1942154000,1219271000,1091058000,4462608000,2526101000
Minnesota,Retail Trade,2012,62812,31209,13598,8222,53029,5833,1575,60437,2375,96260,31280,13850,9000,54130,9465,6080,69675,26585,1352485,54270,84893,102052,244522,197822,112789,584527,687786,33832119000,1384052000,1837973000,2524584000,5797332000,5829202000,3576815000,15607272000,16959204000
Minnesota,Total,2012,117124,70075,18396,12065,100536,11129,2835,114500,2624,145776,70137,18597,12731,101465,14970,8240,124675,21101,2480643,107920,121081,161228,390229,422819,373861,1186909,1293734,116324440000,4307137000,4106107000,5530633000,13943877000,16448552000,15772560000,46164989000,70159451000
Minnesota,Transportation and Warehousing,2012,20940,12770,2430,1820,17020,1941,766,19727,1213,23150,12770,2460,1845,17075,2070,1090,20235,2915,340706,10535,15307,22200,55258,65064,54620,181890,143424,13486902000,639316000,575872000,791198000,2057443000,2210604000,2110190000,6537470000,6498511000
Minnesota,Utilities,2012,643,120,50,75,245,180,71,496,147,1595,120,50,75,245,225,125,595,1000,649,0,165,925,1323,6219,5180,13437,132,63740000,3315000,10068000,65295000,88493000,436529000,393168000,957447000,10350000
Minnesota,Wholesale Trade,2012,35079,16915,5094,3697,25706,4528,2012,32246,2833,41380,16935,5145,3860,25940,5305,3210,34455,6925,611917,23820,32143,40963,103830,142971,94427,361535,218376,41789660000,1475506000,1938123000,2587910000,6174063000,9011903000,6033137000,21892395000,17025266000
Mississippi,Accommodation and Food Services,2012,18692,6490,3780,3778,14048,3460,502,18010,682,25800,6495,3780,3850,14125,3985,1800,19910,5890,581054,10471,25624,51573,88281,120868,61969,274045,306348,8956355000,215042000,295925000,613233000,1127015000,1518079000,741658000,3425130000,5524597000
Mississippi,Administrative and Support and Waste Management and Remediation Services,2012,9819,5305,1620,964,7889,806,355,9050,769,11170,5305,1620,980,7905,905,455,9265,1905,238263,8473,9954,11925,31480,27465,33183,96051,132495,6042752000,241984000,254176000,300855000,812841000,737773000,676897000,2361140000,3503565000
Mississippi,"Agriculture, Forestry, Fishing and Hunting",2012,3408,1805,980,385,3170,160,35,3365,43,3475,1805,980,385,3170,160,55,3385,90,23867,2588,6339,4542,14496,4868,0,22580,463,839295000,129027000,205404000,140732000,488231000,208051000,0,756405000,31930000
Mississippi,"Arts, Entertainment, and Recreation",2012,3155,1815,420,425,2660,370,70,3100,55,3305,1815,425,430,2670,395,170,3235,70,37873,2659,2235,5120,10883,12551,1740,32366,0,679329000,86672000,40376000,82059000,214115000,220079000,15142000,585789000,0
Mississippi,Construction,2012,19452,11880,3535,1960,17375,1660,230,19265,187,19660,11880,3535,1960,17375,1680,280,19335,325,202276,19522,22461,24964,69467,58964,27902,163612,23079,8419312000,634227000,668892000,892824000,2218408000,2499201000,1291983000,6332921000,1375206000
Mississippi,Educational Services,2012,2421,930,375,280,1585,541,160,2286,135,2975,930,375,280,1585,560,320,2465,510,89479,1044,2210,3295,7629,22566,18287,49457,38828,2022195000,29278000,52827000,45299000,142646000,497362000,512635000,1190022000,808652000
Mississippi,Finance and Insurance,2012,11351,7515,1395,591,9501,652,376,10529,822,23390,7530,1530,1155,10215,2185,2950,15350,8040,163771,13385,7623,6345,30368,21620,26779,82004,76967,7986352000,484734000,311323000,306313000,1143142000,1067462000,1224399000,3538269000,4406160000
Mississippi,Health Care and Social Assistance,2012,24694,10795,6010,3700,20505,2454,936,23895,799,30980,10795,6015,3860,20670,3230,2625,26525,4455,793175,20045,38960,48212,108996,92844,123378,330043,425827,34126656000,1018033000,1485306000,1991366000,4512214000,3483384000,4108479000,12235495000,21325342000
Mississippi,Information,2012,1962,735,365,225,1325,191,125,1641,321,4495,735,365,230,1330,285,230,1845,2650,54365,1090,2080,2095,6096,4966,2491,17259,36655,2407596000,39441000,60380000,62958000,175797000,170021000,106150000,612178000,1778963000
Mississippi,Management of Companies and Enterprises,2012,1266,50,21,75,146,216,381,743,523,1630,50,30,75,155,220,405,780,850,39075,0,0,190,348,1967,8495,10855,28214,2803030000,205000,0,10634000,25774000,93818000,552975000,674405000,2128099000
Mississippi,Manufacturing,2012,10251,3170,1505,1360,6035,1841,888,8764,1487,11215,3170,1505,1365,6040,1880,1120,9040,2175,559304,4261,7384,14021,30765,56736,65185,175066,339389,22448636000,168071000,216463000,453053000,960840000,2114115000,2232348000,6118361000,14447511000
Mississippi,"Mining, Quarrying, and Oil and Gas Extraction",2012,1795,1004,220,150,1374,164,85,1623,172,1945,1005,220,150,1375,170,120,1665,280,31398,1065,1285,1581,4308,5758,6497,17933,9560,2332832000,74908000,61634000,76948000,217482000,476012000,419210000,1211428000,900406000
Mississippi,Other,2012,53,51,1,1,53,0,0,53,0,53,51,1,1,53,0,0,53,0,0,0,0,0,0,0,0,0,0,1046000,813000,0,0,1046000,0,0,1046000,0
Mississippi,Other Services (except Public Administration),2012,30304,19235,6430,2545,28210,1516,248,29974,330,32035,19240,6480,2675,28395,1895,705,30995,1040,190786,38255,41089,32781,113890,48135,11781,180394,7969,4250523000,795569000,796879000,697991000,2313226000,1061337000,296896000,3809671000,354446000
Mississippi,"Professional, Scientific, and Technical Services",2012,21668,14655,3257,1540,19452,1197,347,20996,672,23780,14665,3285,1610,19560,1775,515,21850,1930,150150,21852,20361,17780,64424,34666,16623,118880,26377,7234623000,898755000,813897000,822503000,2598700000,1734266000,1084624000,5580154000,1588534000
Mississippi,Real Estate and Rental and Leasing,2012,9216,6925,1058,338,8321,363,208,8892,324,11765,6930,1060,440,8430,565,590,9585,2180,48730,8636,5923,3024,21052,7250,5235,36934,9185,1632168000,298105000,167603000,108142000,597173000,260692000,198309000,1185247000,395110000
Mississippi,Retail Trade,2012,37173,20190,7982,3983,32155,2868,582,35605,1568,57930,20215,8200,4390,32805,4440,2635,39880,18050,604162,36464,50639,49346,141027,91929,38172,281306,292389,13859040000,789410000,1149204000,1241951000,3205616000,2816952000,959467000,7192983000,6291674000
Mississippi,Total,2012,44734,24610,8456,4860,37926,4035,1105,43066,1668,58644,24630,8565,5240,38435,5492,3385,47312,11332,895804,45466,55416,64137,165019,145492,119805,430316,465488,30897159000,1328962000,1497462000,1861214000,4687638000,4647467000,4051295000,13386400000,17510759000
Mississippi,Transportation and Warehousing,2012,8768,4430,1400,835,6665,826,334,7825,943,10190,4430,1405,835,6670,895,480,8045,2145,157301,6868,8648,9235,26349,23245,12376,66952,71594,6449247000,246162000,265403000,312726000,847839000,852490000,508927000,2450833000,3237617000
Mississippi,Utilities,2012,1832,1160,375,60,1595,95,70,1760,72,2965,1160,375,85,1620,170,260,2050,915,42638,2676,2172,768,5745,5278,8886,20830,0,3082610000,58667000,59916000,31388000,159290000,288690000,536453000,1011079000,0
Mississippi,Wholesale Trade,2012,11498,4740,1610,1325,7675,1595,756,10026,1472,14250,4740,1635,1440,7815,2065,1210,11090,3160,164899,6346,9510,13825,32343,37861,24829,108581,47553,7724286000,313293000,371674000,662266000,1417949000,1714975000,1205040000,4819904000,2498942000
Missouri,Accommodation and Food Services,2012,44721,16265,7695,8351,32311,9977,1248,43536,1185,62395,16280,7710,8485,32475,11800,4815,49090,13305,1179004,25899,51306,114382,192373,358205,173963,726928,450084,17251116000,567143000,583161000,1389152000,2546908000,4774867000,2440796000,9789283000,7449130000
Missouri,Administrative and Support and Waste Management and Remediation Services,2012,32638,19865,4783,2908,27556,2588,888,31032,1606,36225,19885,4790,2925,27600,2765,1175,31540,4685,733162,27454,29903,36703,99691,90425,97355,301955,424474,22372256000,911766000,849620000,1144217000,2941228000,3147205000,2680611000,9023191000,13098718000
Missouri,"Agriculture, Forestry, Fishing and Hunting",2012,1285,930,170,70,1170,55,25,1250,35,1305,930,170,70,1170,60,25,1255,50,8542,1539,997,585,3337,1493,948,6217,507,379655000,39201000,36185000,13234000,94543000,41902000,27056000,174280000,20301000
Missouri,"Arts, Entertainment, and Recreation",2012,9810,5580,1355,1182,8117,1212,241,9570,240,10435,5585,1360,1205,8150,1340,360,9850,585,184317,7407,8091,15287,32790,43856,17606,105547,60389,6689910000,300041000,147070000,275953000,741178000,849111000,671334000,2750383000,1429772000
Missouri,Construction,2012,64886,42645,11365,5669,59679,4113,654,64446,440,65465,42650,11365,5675,59690,4215,860,64765,700,528990,69022,73577,75518,221305,142732,68672,441090,64704,26870705000,2357456000,2627448000,3389091000,8383750000,7994067000,4429903000,21255140000,4666238000
Missouri,Educational Services,2012,7023,2985,1000,965,4950,1380,370,6700,323,7925,2985,1000,995,4980,1460,480,6920,1005,377029,1286,6244,12765,24796,57318,62296,147589,219967,13426483000,121929000,112950000,253156000,495438000,1396786000,1949532000,3880737000,9400944000
Missouri,Finance and Insurance,2012,28811,19565,3200,1335,24100,2046,858,27004,1807,54760,19600,3320,1730,24650,6030,4520,35200,19560,602834,33163,19351,16422,70296,72287,72375,226526,348051,40074713000,1307149000,863180000,870334000,3077399000,3762546000,4621477000,11928888000,27047664000
Missouri,Health Care and Social Assistance,2012,73954,42515,12303,7815,62633,6934,2519,72086,1868,94170,42530,12380,8150,63060,9245,7930,80235,13935,1979935,47189,81713,102345,238967,292033,342872,890315,1072513,78683344000,2328416000,3219569000,4136053000,9678931000,9860387000,9983971000,29726938000,48120482000
Missouri,Information,2012,6244,2775,890,733,4398,722,325,5445,799,11900,2775,890,780,4445,950,595,5990,5910,265676,4125,5230,8102,19297,21225,21251,66078,196523,17317186000,164101000,206331000,334052000,722039000,1058987000,1036255000,2939408000,14055631000
Missouri,Management of Companies and Enterprises,2012,4046,190,70,141,401,786,1195,2382,1664,5825,190,70,145,405,795,1265,2465,3360,356540,10,0,775,1261,8028,31513,40935,315360,32529240000,25796000,40636000,50630000,131361000,493680000,2149380000,2778430000,29741296000
Missouri,Manufacturing,2012,28605,10710,4865,4165,19740,4762,1827,26329,2276,30485,10710,4870,4185,19765,5055,2195,27015,3470,1076939,16902,28499,48742,103397,160526,164347,478922,516978,50029053000,610714000,934316000,1875361000,3639805000,6960143000,7605815000,20369382000,25444225000
Missouri,"Mining, Quarrying, and Oil and Gas Extraction",2012,847,315,155,105,575,102,75,752,95,1380,315,155,105,575,205,255,1035,345,14525,358,839,1346,2790,0,2748,8342,6041,753402000,29094000,38196000,55898000,125285000,0,134009000,392191000,347939000
Missouri,Other,2012,905,896,9,0,905,0,0,905,0,905,896,9,0,905,0,0,905,0,0,0,0,0,0,0,0,0,0,5320000,4957000,0,0,5320000,0,0,5320000,0
Missouri,Other Services (except Public Administration),2012,71810,44930,14600,6533,66063,4420,676,71159,651,77580,44965,14730,6910,66605,5710,2110,74425,3155,548341,84750,92707,84725,264983,152590,47189,478150,44887,13915427000,1887060000,2113558000,2009953000,6032638000,3930415000,1300717000,11552455000,1761470000
Missouri,"Professional, Scientific, and Technical Services",2012,61301,40985,9130,4785,54900,3470,1184,59554,1747,66400,41020,9140,4975,55135,4360,1835,61330,5070,678745,62572,58176,60642,183850,109024,81461,379994,271268,43281340000,2753575000,2591472000,3078666000,8464250000,7147655000,5573785000,21408528000,19826233000
Missouri,Real Estate and Rental and Leasing,2012,24544,18482,2469,1168,22119,1114,550,23783,761,30460,18555,2525,1265,22345,1775,1480,25600,4860,166945,26856,14895,14463,58014,30335,27933,121412,35841,6657672000,825013000,520946000,503061000,1858008000,1279799000,1044003000,4508760000,2085594000
Missouri,Retail Trade,2012,65292,34519,12873,7798,55190,6005,1452,62647,2645,106980,34585,13160,8885,56630,10185,5180,71995,34985,1359994,57623,80524,97620,241478,195006,87531,547883,759860,33510054000,1419048000,1851670000,2471148000,5803826000,6278368000,3218800000,15679795000,17280544000
Missouri,Total,2012,113678,66843,18822,11784,97449,10732,2657,110838,2840,146604,66925,19019,12476,98420,14821,7956,121197,25407,2320239,112484,123309,157267,393060,397933,318470,1109463,1210776,95330830000,3559152000,3799038000,5098325000,12456515000,14161056000,12433463000,39051034000,56279796000
Missouri,Transportation and Warehousing,2012,19833,11605,2620,1768,15993,1731,699,18423,1410,22775,11605,2625,1780,16010,1910,1045,18965,3810,384552,17603,16047,22739,58280,50839,41967,160122,174590,14904459000,581696000,532753000,785644000,1923171000,1881481000,1665329000,5679827000,7563326000
Missouri,Utilities,2012,561,165,50,30,245,185,44,474,87,1810,165,50,30,245,290,245,780,1030,83571,231,280,141,838,9506,4421,14511,51747,7147617000,7304000,8449000,13769000,31808000,619083000,316003000,1008515000,4536572000
Missouri,Wholesale Trade,2012,32735,14802,4665,3860,23327,4732,1976,30035,2700,40220,14815,4740,4085,23640,5955,3410,33005,7215,597117,22479,29141,46853,104415,135638,87073,348309,221664,30995153000,1302544000,1473287000,2352778000,5267121000,7418889000,4785104000,18129830000,11432153000
Montana,Accommodation and Food Services,2012,15641,5962,3420,3015,12397,2799,239,15435,206,17390,5970,3440,3080,12490,3260,720,16470,920,224788,9419,22964,40757,73463,94854,27292,196237,14765,3314468000,238165000,287047000,527452000,1061728000,1376267000,415962000,2866788000,353758000
Montana,Administrative and Support and Waste Management and Remediation Services,2012,8002,5605,1070,535,7210,370,113,7693,309,8445,5610,1070,560,7240,475,140,7855,590,73850,6339,6512,6128,20615,12180,7082,42994,6159,2049432000,255714000,165423000,162724000,621095000,341447000,159826000,1211899000,162606000
Montana,"Agriculture, Forestry, Fishing and Hunting",2012,1855,1550,170,70,1790,25,20,1835,20,1880,1550,170,70,1790,25,35,1850,30,4948,1598,777,811,3272,871,0,4303,0,212631000,77255000,29592000,32485000,149162000,30112000,0,197733000,846000
Montana,"Arts, Entertainment, and Recreation",2012,4951,2990,875,595,4460,357,94,4911,40,5580,2990,875,635,4500,470,130,5100,480,46020,3327,5613,7139,17357,12144,10920,42136,0,724502000,121333000,91956000,110556000,330114000,181920000,122498000,657127000,0
Montana,Construction,2012,24167,19060,3030,1145,23235,690,113,24038,129,24275,19060,3030,1145,23235,710,120,24065,210,104497,23499,18224,14341,61523,22607,8613,98052,3773,5003725000,984160000,707568000,645282000,2359585000,1375507000,580835000,4588124000,248460000
Montana,Educational Services,2012,1700,905,260,220,1385,195,75,1655,45,1750,905,260,220,1385,195,120,1700,50,29194,1074,1333,2598,5939,6393,2422,20197,2256,612656000,27950000,33791000,37753000,103112000,137393000,64471000,427753000,40192000
Montana,Finance and Insurance,2012,6263,4205,700,362,5267,359,134,5760,503,9860,4205,710,435,5350,955,655,6960,2900,78794,6220,3956,3271,14727,11258,7590,37198,22352,3899340000,240690000,161921000,159004000,585859000,486162000,410859000,1646904000,2119867000
Montana,Health Care and Social Assistance,2012,15031,7985,3105,1608,12698,1216,700,14614,417,17585,7985,3105,1675,12765,1585,1960,16310,1275,321639,13088,20059,19655,53795,45226,84418,185928,116720,12390364000,520627000,647005000,782770000,1980295000,1492353000,2772341000,6331427000,5133291000
Montana,Information,2012,1954,905,305,210,1420,138,117,1675,279,3005,905,305,215,1425,190,430,2045,960,41185,960,1541,2303,5473,2060,7574,18943,21948,1764929000,36686000,47586000,74967000,173591000,77261000,368058000,799387000,980825000
Montana,Management of Companies and Enterprises,2012,570,55,0,35,90,105,160,355,215,650,55,0,35,90,105,165,360,290,16219,0,0,88,120,109,6743,7598,8631,999782000,2150000,0,6764000,8914000,21930000,373452000,412740000,587458000
Montana,Manufacturing,2012,6084,3215,1090,745,5050,617,193,5860,224,6200,3215,1090,745,5050,665,210,5925,275,65033,3563,5078,6256,17877,13365,7720,49481,7850,2796560000,139399000,159615000,230406000,602219000,470206000,312050000,1753900000,680519000
Montana,"Mining, Quarrying, and Oil and Gas Extraction",2012,1814,1060,220,145,1425,105,80,1610,204,1935,1060,220,145,1425,105,90,1620,315,29554,826,954,1500,3689,3087,6058,13944,9034,2391329000,93249000,62257000,89139000,261044000,225827000,479098000,979750000,891102000
Montana,Other,2012,38,37,1,0,38,0,0,38,0,38,37,1,0,38,0,0,38,0,30,24,0,0,30,0,0,30,0,399000,367000,0,0,399000,0,0,399000,0
Montana,Other Services (except Public Administration),2012,14924,9910,2910,1267,14087,602,80,14769,155,15605,9910,2915,1315,14140,850,115,15105,500,75532,17260,18290,15856,52609,16080,1369,72723,739,1859733000,424225000,426448000,385602000,1255282000,391425000,67445000,1776759000,33348000
Montana,"Professional, Scientific, and Technical Services",2012,16982,12490,2185,1012,15687,629,219,16535,447,17920,12490,2200,1030,15720,930,445,17095,825,87801,13558,12722,12351,42558,14131,10217,73299,11326,4148270000,713422000,546706000,610695000,1893100000,812215000,590884000,3502590000,568978000
Montana,Real Estate and Rental and Leasing,2012,7952,6605,635,328,7568,185,67,7820,132,8700,6615,670,435,7720,325,130,8175,525,26656,7435,3369,3549,15598,3911,924,23575,2107,812936000,233266000,93085000,97661000,450261000,93296000,42448000,677046000,105336000
Montana,Retail Trade,2012,18540,9510,4061,2187,15758,1591,373,17722,818,24125,9520,4145,2495,16160,2255,1225,19640,4485,260958,14933,25110,24430,69244,43621,18789,145757,96154,6413406000,419131000,602921000,682250000,1748895000,1306357000,588081000,3861322000,2174595000
Montana,Total,2012,31370,19938,5148,2860,27946,2109,504,30559,811,36241,19949,5193,3054,28196,2937,1517,32650,3591,343842,31268,33879,37844,102991,72707,56685,232383,111459,11885907000,1003240000,921906000,1093783000,3018929000,2219815000,2053957000,7292701000,4593206000
Montana,Transportation and Warehousing,2012,6570,4439,870,405,5714,384,135,6233,337,7385,4440,870,405,5715,415,255,6385,1000,53786,4592,4994,4145,16030,10219,3941,36043,10807,2163835000,224140000,157938000,190475000,598140000,434346000,162577000,1369098000,451956000
Montana,Utilities,2012,421,195,20,50,265,85,20,370,51,1025,200,20,65,285,110,45,440,585,13317,20,86,618,892,2073,0,4571,3848,1067433000,10151000,3340000,38080000,59137000,150090000,0,316579000,336650000
Montana,Wholesale Trade,2012,6103,2875,848,531,4254,765,310,5329,774,7700,2875,865,565,4305,1060,595,5960,1740,67914,2175,4015,5309,13324,17707,6227,45058,17539,3235505000,161936000,200644000,221758000,663427000,739860000,330405000,1978773000,1004725000
Nebraska,Accommodation and Food Services,2012,16748,6175,3259,3185,12619,3133,453,16205,543,21690,6175,3280,3240,12695,3890,1920,18505,3185,348574,9877,21451,43431,75574,108162,52201,236770,111086,4411770000,173270000,205238000,469813000,852478000,1340444000,694286000,2897147000,1503473000
Nebraska,Administrative and Support and Waste Management and Remediation Services,2012,11762,7295,1750,1015,10060,720,321,11101,661,12890,7295,1750,1020,10065,790,410,11265,1625,229165,9201,10702,12352,35402,22762,31932,95094,114359,7262155000,324621000,284042000,354671000,996104000,761351000,815406000,2706486000,4021329000
Nebraska,"Agriculture, Forestry, Fishing and Hunting",2012,860,655,80,45,780,30,20,830,30,900,655,80,45,780,30,30,840,60,5047,744,346,418,1730,514,198,2348,2600,274587000,41366000,20421000,23864000,87037000,20065000,6748000,129936000,140820000
Nebraska,"Arts, Entertainment, and Recreation",2012,4013,2340,600,375,3315,480,85,3880,133,4205,2340,600,380,3320,520,105,3945,260,62934,3002,3609,4280,11334,17959,9570,42847,14602,976966000,85500000,60131000,70094000,237448000,299267000,146081000,728446000,170090000
Nebraska,Construction,2012,29023,19755,4845,2377,26977,1614,214,28805,218,29250,19755,4845,2380,26980,1645,300,28925,325,189604,30606,30647,30786,93725,58774,13291,172691,8008,8482469000,1016186000,1067792000,1284684000,3397251000,2969039000,799528000,7454969000,570886000
Nebraska,Educational Services,2012,2378,990,350,320,1660,505,115,2280,98,2630,990,350,320,1660,595,245,2500,130,99929,1504,1612,3939,7948,21367,11083,43333,54827,2654228000,33546000,25101000,58396000,127044000,435739000,262507000,920872000,1684540000
Nebraska,Finance and Insurance,2012,12863,8480,1556,744,10780,810,330,11920,943,21155,8480,1630,1005,11115,2190,1715,15020,6135,261821,13653,9182,7970,32281,24915,23790,85403,163644,16539793000,494219000,399214000,410756000,1366606000,1290847000,1283493000,4160332000,11919402000
Nebraska,Health Care and Social Assistance,2012,21670,10280,4270,2675,17225,2750,981,20956,714,27025,10295,4280,2780,17355,3780,2590,23725,3300,602430,13332,27111,33998,81214,102970,114452,305393,259084,24179022000,808439000,1154874000,1402921000,3425132000,4152643000,3998023000,11695217000,10312478000
Nebraska,Information,2012,2858,1048,395,359,1802,391,191,2384,474,4710,1050,395,360,1805,505,290,2600,2110,96445,1071,2014,4031,8569,12272,3524,30947,38920,5809601000,50967000,82684000,153155000,301689000,689557000,163363000,1451583000,3433287000
Nebraska,Management of Companies and Enterprises,2012,1390,85,30,71,186,266,390,842,548,1735,85,30,80,195,275,405,875,860,90690,0,0,180,0,3225,11076,14855,75794,7551490000,7004000,7298000,27181000,47452000,170810000,671161000,895270000,6652302000
Nebraska,Manufacturing,2012,8602,3215,1420,1062,5697,1326,698,7721,881,9245,3215,1420,1095,5730,1420,805,7955,1290,400835,3851,6717,9234,23690,42116,48614,134477,214052,17062396000,158040000,214014000,358825000,854321000,1723033000,2210265000,5719761000,8831667000
Nebraska,"Mining, Quarrying, and Oil and Gas Extraction",2012,567,320,80,65,465,45,22,532,35,610,320,80,65,465,45,25,535,75,4259,189,406,251,1126,604,0,3193,240,245177000,20498000,15783000,18862000,62447000,33342000,0,178102000,13415000
Nebraska,Other,2012,46,46,0,0,46,0,0,46,0,46,46,0,0,46,0,0,46,0,0,0,0,0,0,0,0,0,0,440000,440000,0,0,440000,0,0,440000,0
Nebraska,Other Services (except Public Administration),2012,26456,17250,4915,2235,24400,1446,314,26160,296,28560,17260,4970,2340,24570,2075,965,27610,950,174634,29834,30511,28622,91146,46334,17335,160865,9060,4193175000,699949000,670337000,647807000,2044836000,1112157000,413745000,3742277000,379058000
Nebraska,"Professional, Scientific, and Technical Services",2012,20757,13745,3080,1567,18392,1191,369,19952,805,22250,13745,3085,1630,18460,1475,625,20560,1690,257714,17141,18462,17462,54038,33763,23843,124368,129606,13367443000,795046000,825478000,868780000,2626942000,1991186000,1535756000,6498220000,6495776000
Nebraska,Real Estate and Rental and Leasing,2012,8715,6710,760,365,7835,296,231,8362,353,9985,6710,770,415,7895,375,590,8860,1125,48768,2673,4163,3668,14402,6709,8977,33386,8784,1864770000,270818000,129674000,108593000,557576000,244355000,354058000,1335978000,453259000
Nebraska,Retail Trade,2012,25036,11864,5480,3165,20509,2367,721,23597,1439,36475,11880,5585,3485,20950,3620,2395,26965,9510,465695,17758,33705,38550,95684,70685,34889,215286,212204,11435888000,483822000,717728000,914882000,2150414000,2136180000,1305353000,5890693000,5186621000
Nebraska,Total,2012,42029,24393,7147,4256,35796,3788,997,40581,1448,52294,24406,7221,4549,36176,5312,3210,44698,7596,818289,40758,46736,56473,143967,136430,110753,391150,427139,31736125000,1238410000,1358504000,1749675000,4346589000,4733842000,4211720000,13292151000,18443974000
Nebraska,Transportation and Warehousing,2012,10506,7025,1289,655,8969,588,293,9850,656,11435,7025,1290,660,8975,630,425,10030,1405,164897,9930,7805,7427,26015,17273,16002,64966,72629,6406241000,313544000,252453000,273000000,847426000,706416000,665099000,2383449000,3357562000
Nebraska,Utilities,2012,162,50,10,5,65,25,10,100,62,590,50,10,5,65,30,15,110,480,617,0,0,0,128,475,0,766,148,48131000,2032000,0,0,10163000,28075000,0,47105000,30127000
Nebraska,Wholesale Trade,2012,11616,4474,1635,1303,7412,1951,910,10273,1343,15900,4475,1655,1440,7570,2670,2195,12435,3465,196335,5770,8971,13608,31101,48344,34017,122361,62603,10125531000,275706000,378404000,659506000,1400992000,2313690000,1815343000,5857288000,3937708000
Nevada,Accommodation and Food Services,2012,20132,6785,4078,3858,14721,3615,763,19099,1033,29315,6840,4105,3995,14940,4570,2330,21840,7475,1491167,10012,26219,50426,88099,134125,117123,341527,1138086,43330217000,427094000,417588000,789955000,1649536000,2462919000,2447757000,6574297000,36505570000
Nevada,Administrative and Support and Waste Management and Remediation Services,2012,18257,10445,2491,1775,14711,1773,664,17148,1109,20075,10445,2495,1810,14750,1905,765,17420,2655,442304,13021,15254,21078,55027,56544,57486,181024,240929,13626362000,630301000,496863000,691128000,1875230000,1949391000,1566839000,5733373000,7519400000
Nevada,"Agriculture, Forestry, Fishing and Hunting",2012,265,225,15,10,250,10,5,265,0,265,225,15,10,250,10,5,265,0,1275,234,0,0,430,0,0,1275,0,44127000,9779000,0,0,31747000,0,0,44127000,0
Nevada,"Arts, Entertainment, and Recreation",2012,5787,3588,550,490,4628,757,222,5607,180,6545,3595,550,495,4640,805,640,6085,460,125311,2136,3383,6096,13080,31676,34042,85407,29795,3478730000,485753000,117504000,190525000,829026000,798330000,787663000,2560224000,655185000
Nevada,Construction,2012,22425,12715,3920,2575,19210,2222,492,21924,501,22705,12715,3920,2590,19225,2255,540,22020,685,229728,19612,24811,32352,79326,79264,31282,197156,29477,11895006000,923825000,1026394000,1469686000,3443209000,3751307000,1849582000,9335494000,2318515000
Nevada,Educational Services,2012,3038,1625,395,315,2335,385,130,2850,188,3310,1625,395,315,2335,430,160,2925,385,54009,1509,2037,3862,8866,12522,11643,35386,12693,1737270000,89914000,52960000,82408000,237897000,384893000,356342000,1103539000,426552000
Nevada,Finance and Insurance,2012,12780,8585,1203,506,10294,648,533,11475,1305,20605,8610,1255,575,10440,1020,1260,12720,7885,165934,9914,6689,5294,24693,10255,8612,47997,106970,9384696000,633208000,311014000,305421000,1299160000,700705000,464079000,2676798000,6621638000
Nevada,Health Care and Social Assistance,2012,27244,14470,5810,3325,23605,2198,601,26404,840,31560,14505,5825,3480,23810,3025,1600,28435,3125,508793,23010,37295,42984,105950,78149,69612,262193,232892,24642082000,1838345000,1604254000,1963113000,5427887000,3334842000,2722143000,11832326000,12381728000
Nevada,Information,2012,4204,2510,480,305,3295,240,135,3670,534,5900,2510,480,305,3295,270,180,3745,2155,74819,1759,2117,2785,8624,5848,3634,23878,46503,4429824000,191806000,111716000,186838000,544268000,333502000,151543000,1313969000,3057724000
Nevada,Management of Companies and Enterprises,2012,2159,515,50,55,620,281,424,1325,834,2630,515,55,60,630,295,505,1430,1200,77664,0,0,216,1092,2707,8981,12909,64755,6796814000,38184000,15255000,12389000,70348000,209841000,755785000,1035974000,5760840000
Nevada,Manufacturing,2012,8304,3475,1380,1065,5920,1218,526,7664,640,8560,3475,1380,1065,5920,1240,575,7735,825,160410,3412,6461,9738,23725,29227,25437,96501,38627,8872070000,185038000,259293000,386031000,984419000,1285772000,1298370000,4242991000,2984668000
Nevada,"Mining, Quarrying, and Oil and Gas Extraction",2012,1153,580,100,113,793,149,85,1027,126,1240,580,100,115,795,150,95,1040,200,73207,554,217,1133,2299,4387,6331,14717,49836,6214267000,55345000,39197000,94911000,211225000,354511000,576689000,1673748000,4219162000
Nevada,Other,2012,52,48,3,1,52,0,0,52,0,52,48,3,1,52,0,0,52,0,0,0,17,0,0,0,0,0,0,1859000,1519000,265000,0,1859000,0,0,1859000,0
Nevada,Other Services (except Public Administration),2012,18773,11700,3490,1595,16785,1212,358,18355,418,21070,11700,3510,1775,16985,1680,735,19400,1670,158674,17935,20993,18970,62677,38997,19494,126787,14859,4456324000,574977000,595765000,537989000,1736064000,1084723000,498657000,3506097000,653969000
Nevada,"Professional, Scientific, and Technical Services",2012,38112,27950,4105,2310,34365,1957,725,37047,1065,40830,27960,4115,2350,34425,2275,905,37605,3225,244925,32948,25434,28244,90031,54717,18908,174110,55139,14631902000,2367505000,1358911000,1601535000,5371305000,3578890000,1333997000,10643045000,3965484000
Nevada,Real Estate and Rental and Leasing,2012,15834,11830,1643,672,14145,671,418,15234,600,18995,11845,1690,740,14275,830,885,15990,3005,108935,15513,10341,7995,35030,16579,16686,70942,30630,4252167000,615568000,319876000,287626000,1258984000,670529000,625527000,2688369000,1311755000
Nevada,Retail Trade,2012,24337,11919,4625,2795,19339,1830,871,22040,2297,40725,11985,4720,3145,19850,2700,2135,24685,16040,596153,14726,25647,30925,77818,53777,33168,181347,368587,16614321000,564349000,722762000,828157000,2243276000,1714868000,1398787000,5622730000,10137489000
Nevada,Total,2012,47408,27715,7317,4659,39691,4150,1483,45324,2084,59417,27763,7389,4911,40063,5184,3009,48256,11161,1014570,42718,48023,61234,151975,141263,121207,414445,600125,40126669000,2151422000,1670335000,2166245000,5988002000,5402441000,4517323000,15907766000,24218903000
Nevada,Transportation and Warehousing,2012,6125,3040,645,527,4212,562,419,5193,932,7005,3045,645,545,4235,590,480,5305,1700,187412,3147,2982,5217,12601,12324,25568,56725,112137,6581715000,164489000,124408000,199856000,525185000,508615000,1022628000,2280326000,3745595000
Nevada,Utilities,2012,254,90,25,10,125,50,33,208,46,605,90,25,15,130,100,55,285,320,1338,8,0,0,194,0,542,1660,609,124779000,3886000,2366000,0,13120000,0,53356000,192202000,64253000
Nevada,Wholesale Trade,2012,13302,6310,1650,1111,9071,1590,1025,11686,1616,14885,6310,1650,1165,9125,1770,1195,12090,2795,154031,7365,8456,11517,31080,30949,15845,87173,48454,9186529000,490762000,442144000,597466000,1626403000,1835542000,867589000,4658153000,3006164000
New Hampshire,Accommodation and Food Services,2012,14804,5695,2910,2958,11563,2592,298,14453,351,17930,5710,2920,2990,11620,3030,1080,15730,2200,259669,7853,19505,40263,67941,89438,28672,187679,58225,4553626000,303170000,303786000,599477000,1220969000,1543931000,476988000,3287863000,984156000
New Hampshire,Administrative and Support and Waste Management and Remediation Services,2012,10233,6515,1445,790,8750,690,222,9662,571,11015,6515,1450,795,8760,785,255,9800,1215,183761,8715,7784,9267,28879,22789,17588,74145,89805,7387823000,406146000,325501000,369563000,1148041000,941867000,770303000,3020749000,4128139000
New Hampshire,"Agriculture, Forestry, Fishing and Hunting",2012,685,500,120,40,660,20,0,680,5,690,500,120,40,660,25,0,685,5,2463,511,611,406,1790,264,0,2288,0,110268000,27893000,24398000,19090000,75228000,9516000,0,107910000,0
New Hampshire,"Arts, Entertainment, and Recreation",2012,3453,1945,485,370,2800,460,92,3352,101,3670,1945,485,370,2800,500,150,3450,220,63241,2191,2293,4579,10461,14613,10415,38458,18345,1255920000,292227000,69707000,96752000,484077000,327612000,114234000,966882000,159332000
New Hampshire,Construction,2012,19041,13830,2575,1390,17795,1008,150,18953,88,19140,13830,2575,1390,17795,1030,200,19025,115,111296,19288,16015,17435,56735,33693,9703,106441,2716,6027359000,921259000,735797000,934702000,2638699000,2011708000,681709000,5727799000,177211000
New Hampshire,Educational Services,2012,2711,1200,470,341,2011,440,130,2581,130,2920,1200,475,400,2075,480,150,2705,215,111061,1697,2898,3250,9508,14958,17294,45553,57067,4202094000,57912000,64538000,81613000,223191000,405062000,657759000,1382294000,2643262000
New Hampshire,Finance and Insurance,2012,5208,2850,600,264,3714,450,314,4478,730,9510,2850,620,310,3780,775,1395,5950,3560,103896,3946,3288,2672,11100,11809,18674,41907,52910,7607463000,284785000,204315000,180331000,686434000,927349000,1038295000,2985804000,4267288000
New Hampshire,Health Care and Social Assistance,2012,13716,5570,3335,1883,10788,1590,697,13075,641,17910,5570,3340,1985,10895,2090,1580,14565,3345,414757,10570,20873,22833,57259,53346,85256,203268,203938,19305810000,427971000,891589000,1205643000,2592094000,2407645000,3037413000,8152750000,10625033000
New Hampshire,Information,2012,2384,940,345,255,1540,299,147,1986,398,3925,955,345,255,1555,365,220,2140,1785,50211,1052,1817,2074,5679,8070,11256,27926,14044,4838962000,87819000,115287000,143902000,386400000,536614000,635890000,1753578000,1205554000
New Hampshire,Management of Companies and Enterprises,2012,777,60,20,30,110,86,185,381,396,1035,60,20,30,110,90,190,390,645,38040,110,0,172,408,905,5050,6445,31595,3037430000,9020000,0,7122000,38435000,74235000,332235000,444905000,2592525000
New Hampshire,Manufacturing,2012,8942,3475,1455,1185,6115,1642,485,8242,700,9270,3475,1455,1200,6130,1675,555,8360,910,250832,4274,6411,11444,26501,52772,26801,128828,94482,14681371000,233977000,331495000,583461000,1305125000,2701558000,1560735000,6637487000,6533795000
New Hampshire,"Mining, Quarrying, and Oil and Gas Extraction",2012,192,120,10,30,160,5,15,180,12,215,120,10,30,160,5,25,190,25,940,185,0,0,163,0,0,838,0,62862000,9415000,0,7119000,37159000,0,0,52602000,0
New Hampshire,Other,2012,22,20,2,0,22,0,0,22,0,22,20,2,0,22,0,0,22,0,0,0,0,0,0,0,0,0,0,436000,392000,0,0,436000,0,0,436000,0
New Hampshire,Other Services (except Public Administration),2012,16940,10620,3795,1415,15830,663,177,16670,270,18015,10630,3815,1450,15895,935,345,17175,840,103823,18999,24336,17108,62567,18280,5019,91221,6449,2919537000,551842000,601739000,454697000,1632744000,558940000,194001000,2561093000,198275000
New Hampshire,"Professional, Scientific, and Technical Services",2012,18235,12115,2565,1490,16170,1075,335,17580,655,19210,12115,2575,1555,16245,1270,435,17950,1260,146222,16596,15816,18474,54263,29658,13533,103412,40604,8674949000,1121324000,970882000,1265821000,3393937000,2074074000,1245748000,7030698000,1564218000
New Hampshire,Real Estate and Rental and Leasing,2012,5792,4090,715,368,5173,257,142,5572,220,6645,4105,755,410,5270,475,195,5940,705,33412,5217,4041,4117,14673,5790,5787,27881,3704,1499837000,263916000,145863000,167398000,593705000,297075000,314256000,1257679000,193536000
New Hampshire,Retail Trade,2012,20331,9855,4289,2281,16425,1891,541,18857,1474,30800,9870,4350,2515,16735,2590,1535,20860,9940,404223,13813,24846,24221,68290,48217,27263,161919,166082,11540259000,501985000,719841000,784105000,2074061000,2112254000,1328990000,5748788000,3569905000
New Hampshire,Total,2012,30522,17051,5403,3209,25663,2836,784,29283,1239,37213,17076,5445,3364,25885,3537,1864,31286,5927,548985,29749,35567,42436,107752,98404,77879,284035,264950,24055321000,1238275000,1297772000,1640586000,4176633000,4172932000,3446528000,11796093000,12259228000
New Hampshire,Transportation and Warehousing,2012,3699,1935,650,329,2914,313,130,3357,342,4085,1935,650,330,2915,335,160,3410,675,61300,1488,3200,3303,10803,7129,4230,31843,12696,2251799000,122477000,126759000,120335000,392384000,296627000,139315000,1201724000,570332000
New Hampshire,Utilities,2012,226,85,15,10,110,10,41,161,65,595,85,15,10,110,10,175,295,300,11379,152,78,0,430,0,1898,2350,9062,1033258000,9901000,2265000,0,21550000,0,150611000,179288000,866712000
New Hampshire,Wholesale Trade,2012,8475,3790,1239,752,5781,1106,522,7409,1066,9375,3810,1240,755,5805,1220,675,7700,1675,109077,5274,5873,7670,22040,24675,13583,70401,31218,7790257000,403866000,437579000,567597000,1520922000,1540661000,767895000,4395547000,2853666000
New Jersey,Accommodation and Food Services,2012,87042,45898,16098,12139,74135,11095,922,86152,890,100445,45930,16130,12210,74270,11960,2275,88505,11940,1457380,77534,105720,165413,348833,410485,110159,871040,582391,27989986000,2051479000,1696711000,2540369000,6294239000,6783631000,1952214000,15039851000,12881579000
New Jersey,Administrative and Support and Waste Management and Remediation Services,2012,61400,39630,8100,5197,52927,4946,1575,59448,1952,68150,39635,8105,5235,52975,5140,2020,60135,8015,1407373,52736,52338,68344,178117,188518,218217,593611,804716,52160350000,3137251000,1994877000,2916433000,8230102000,7639135000,7357375000,23436071000,28208538000
New Jersey,"Agriculture, Forestry, Fishing and Hunting",2012,1130,800,180,80,1060,45,15,1120,10,1130,800,180,80,1060,45,15,1120,10,1790,220,960,900,2870,850,0,4891,0,214810000,34947000,31672000,30841000,108389000,33983000,0,173274000,0
New Jersey,"Arts, Entertainment, and Recreation",2012,16154,9400,1855,1940,13195,2202,525,15922,232,17255,9405,1855,1970,13230,2240,725,16195,1060,272008,10760,11612,25411,49966,89881,73214,221962,45116,8092162000,742135000,314412000,529294000,1620344000,2003768000,3355236000,7157767000,704784000
New Jersey,Construction,2012,100096,72194,14160,7450,93804,5221,591,99616,480,100575,72195,14160,7465,93820,5255,655,99730,845,654395,114752,90550,99421,306515,193209,77363,583585,62062,40621765000,4885245000,4294675000,5717920000,14900990000,13011354000,6501804000,34884640000,5021315000
New Jersey,Educational Services,2012,16531,7615,2885,2120,12620,2930,608,16158,373,17750,7615,2885,2145,12645,3175,800,16620,1130,485238,12023,18981,28307,60094,122532,86034,275143,188650,16879459000,346735000,387257000,608672000,1350292000,3643317000,3482322000,8816258000,7460264000
New Jersey,Finance and Insurance,2012,31502,19628,4355,2042,26025,2304,1144,29473,2029,60770,19675,4445,2385,26505,4130,4145,34780,25990,953893,27421,27227,24421,84098,75739,80490,246314,708138,98472234000,2005649000,1902696000,2213297000,6154062000,6705641000,6421146000,19785919000,78769213000
New Jersey,Health Care and Social Assistance,2012,111516,54036,26010,14471,94517,11879,3154,109550,1966,134620,54135,26180,15230,95545,15570,9405,120520,14100,2726691,110600,169373,189943,472150,435097,462057,1376125,1290946,125223180000,5184331000,7423312000,9371344000,21989501000,19757647000,16786484000,59012301000,64079542000
New Jersey,Information,2012,10331,5539,1210,870,7619,1209,460,9288,1043,18015,5540,1210,870,7620,1380,565,9565,8450,427357,5711,7590,10766,26826,38322,36287,104539,304637,39480437000,520696000,479773000,757834000,1970605000,2853989000,3349924000,8396462000,29617526000
New Jersey,Management of Companies and Enterprises,2012,4655,345,130,120,595,626,996,2217,2438,6970,345,130,125,600,640,1050,2290,4680,659650,516,685,845,2055,9691,37045,48791,609432,79662644000,41867000,116720000,62575000,221162000,856892000,3225025000,4303079000,75151593000
New Jersey,Manufacturing,2012,37738,14369,6520,5375,26264,7094,2299,35657,2081,38860,14370,6525,5395,26290,7270,2555,36115,2745,1094946,23482,37665,64038,136568,256241,251530,695918,338081,68476283000,1115570000,1655945000,3105841000,6214487000,13396887000,14059239000,36077599000,28145260000
New Jersey,"Mining, Quarrying, and Oil and Gas Extraction",2012,329,115,50,40,205,46,26,277,52,385,115,50,40,205,55,30,290,95,4167,77,69,237,399,949,56,3256,1167,293763000,9399000,3897000,21422000,44257000,58575000,2956000,247789000,73828000
New Jersey,Other,2012,151,144,4,2,150,1,0,151,0,151,144,4,2,150,1,0,151,0,175,101,23,0,146,0,0,175,0,3679000,3023000,344000,0,3652000,0,0,3679000,0
New Jersey,Other Services (except Public Administration),2012,111142,74660,19516,9690,103866,5732,823,110421,721,115395,74700,19580,9960,104240,6410,1505,112155,3240,746063,138249,125391,126889,393339,199461,67227,670294,53851,21428790000,3416026000,3152167000,3573165000,10152155000,5418778000,2302669000,18341995000,2476178000
New Jersey,"Professional, Scientific, and Technical Services",2012,140006,99445,16968,9931,126344,8377,2641,137362,2644,147310,99475,16975,10100,126550,9210,3400,139160,8150,1558394,149799,109442,129083,392417,283566,230525,915000,607415,126485100000,8592920000,6366737000,8826208000,23829658000,22691886000,18142614000,65167295000,60110561000
New Jersey,Real Estate and Rental and Leasing,2012,35511,25345,4753,2359,32457,1733,528,34718,793,43465,25390,4885,2620,32895,2395,990,36280,7185,267422,41217,30240,29407,103553,53916,27059,186975,69607,14808737000,1643105000,1298401000,1437415000,4397886000,2856236000,1588756000,8947056000,4872487000
New Jersey,Retail Trade,2012,113148,73087,19523,9550,102160,6629,1628,110417,2731,158870,73250,19945,10300,103495,8525,4160,116180,42690,2129466,105011,113732,112075,340083,204229,104412,686250,1187215,62424759000,3319153000,3236970000,3447692000,9955081000,8473311000,5757024000,24521027000,30833377000
New Jersey,Total,2012,192704,119296,31440,18621,169357,16299,3842,189498,3206,228289,119417,31675,19285,170377,19127,7996,197500,30789,3440470,204038,205665,247650,657353,603324,475050,1735727,1704743,189910527000,8547812000,7986882000,10650834000,27185528000,28150120000,24334191000,79669839000,110240688000
New Jersey,Transportation and Warehousing,2012,31529,18190,4107,2895,25192,3212,1389,29793,1736,35100,18190,4110,2980,25280,3495,1840,30615,4485,707505,26735,26207,36035,92674,113775,116076,331053,355577,32074438000,1059955000,1055523000,1417283000,3596404000,4487225000,4689708000,13157439000,17815422000
New Jersey,Utilities,2012,537,195,90,25,310,65,17,392,145,2060,195,95,25,315,75,50,440,1620,91436,0,450,160,860,2177,0,4785,81388,10046031000,12543000,32371000,23930000,85783000,232619000,0,459113000,9113412000
New Jersey,Wholesale Trade,2012,67661,35390,10852,7173,53415,7966,2915,64296,3365,73565,35405,10910,7280,53595,8660,3795,66050,7515,1271307,57608,68616,92117,226278,265228,222599,729837,525449,106542537000,3697941000,4183133000,6002695000,14008170000,17228577000,15294006000,47627335000,58121984000
New Mexico,Accommodation and Food Services,2012,15259,5095,2815,2960,10870,3221,557,14648,611,20820,5120,2840,3005,10965,3870,2015,16850,3970,394925,7417,18875,41089,68413,117892,74328,261970,131557,6008057000,205103000,248383000,540021000,997328000,1787808000,1134394000,3937817000,2031232000
New Mexico,Administrative and Support and Waste Management and Remediation Services,2012,8396,4690,1380,710,6780,648,188,7616,780,9285,4690,1380,730,6800,730,265,7795,1490,159817,6457,8824,8083,25512,19562,20278,70831,88196,4893317000,219325000,238560000,238059000,732051000,606301000,442074000,1981478000,2700870000
New Mexico,"Agriculture, Forestry, Fishing and Hunting",2012,481,350,70,45,465,6,5,476,5,495,350,75,45,470,15,5,490,5,1614,297,172,209,1196,0,0,1404,0,65634000,16690000,12346000,9416000,56313000,0,0,62149000,0
New Mexico,"Arts, Entertainment, and Recreation",2012,3112,1865,415,305,2585,345,95,3025,87,3275,1865,430,305,2600,405,135,3140,135,63525,1754,2213,2851,8414,12334,11106,36465,20369,1403830000,79103000,52900000,63033000,219585000,207279000,304483000,820563000,432553000
New Mexico,Construction,2012,21616,13517,3635,2210,19362,1784,282,21428,188,21760,13520,3640,2210,19370,1805,345,21520,240,183233,20318,23585,29679,76034,61216,28079,173428,4481,7563355000,692842000,749246000,1131615000,2584853000,2708206000,1400138000,7010490000,296345000
New Mexico,Educational Services,2012,2943,1535,390,370,2295,405,140,2840,103,3050,1535,390,370,2295,410,165,2870,180,46128,2119,2543,4612,9851,14168,12533,39102,2522,1339253000,75355000,49194000,94135000,227069000,375979000,458488000,1175054000,110463000
New Mexico,Finance and Insurance,2012,7526,4795,905,310,6010,460,283,6753,773,13550,4810,935,400,6145,1150,1495,8790,4760,103560,8354,5386,3406,17624,13474,22362,53850,36059,5594130000,309251000,229543000,131579000,685200000,673332000,1102633000,2545979000,2862071000
New Mexico,Health Care and Social Assistance,2012,20326,9490,4260,2584,16334,2339,850,19523,803,24885,9490,4285,2650,16425,3135,2025,21585,3300,572861,15029,28207,33313,78994,86673,109928,282975,277198,22895909000,748592000,1105782000,1378661000,3291823000,3005428000,3457516000,9959274000,12419745000
New Mexico,Information,2012,2328,1190,242,205,1637,208,115,1960,368,3795,1190,245,210,1645,270,300,2215,1580,57206,1172,1038,2103,5407,5473,6629,18992,30347,2568468000,74680000,37444000,78179000,214989000,236865000,265593000,761481000,1733643000
New Mexico,Management of Companies and Enterprises,2012,885,30,40,30,100,170,250,520,365,1210,30,40,30,100,170,265,535,675,31748,0,0,128,272,1600,5249,7463,24285,1905104000,3123000,1235000,6102000,21140000,87463000,332651000,441289000,1463815000
New Mexico,Manufacturing,2012,6854,3260,1305,865,5430,749,255,6434,420,7005,3260,1305,870,5435,770,295,6500,505,110671,4056,5857,7875,21075,15661,6739,58588,30068,5578543000,161936000,202919000,302757000,772366000,662401000,390738000,2485370000,1808580000
New Mexico,"Mining, Quarrying, and Oil and Gas Extraction",2012,3164,1285,400,384,2069,581,150,2800,364,3630,1285,405,390,2080,615,165,2860,770,85409,888,2663,4849,9867,21167,12675,45832,38664,6400892000,139214000,134947000,273701000,551024000,1408951000,884308000,3036960000,3287714000
New Mexico,Other,2012,25,24,1,0,25,0,0,25,0,25,24,1,0,25,0,0,25,0,0,0,0,0,0,0,0,0,0,581000,498000,0,0,581000,0,0,581000,0
New Mexico,Other Services (except Public Administration),2012,19322,11660,3965,1900,17525,1270,187,18982,340,20635,11660,3970,1995,17625,1620,530,19775,860,133255,21214,25011,24599,72316,39430,6443,122882,4892,3401788000,532219000,617493000,600404000,1772745000,941219000,190063000,3044384000,190551000
New Mexico,"Professional, Scientific, and Technical Services",2012,21770,14665,2977,1646,19288,1147,472,20907,863,23430,14665,2990,1680,19335,1355,595,21285,2145,173615,20093,18144,20352,61792,30667,19390,116507,55486,10473159000,1130477000,881172000,1052113000,3106076000,1874218000,1366120000,6582098000,3985067000
New Mexico,Real Estate and Rental and Leasing,2012,9214,6960,1027,370,8357,347,147,8851,363,11615,6995,1050,420,8465,595,835,9895,1720,44408,8332,6240,3579,20791,7993,151,33005,8440,1792200000,313994000,182685000,140944000,659891000,407273000,36079000,1214063000,553499000
New Mexico,Retail Trade,2012,20984,10692,3893,2407,16992,1857,568,19417,1567,32975,10715,3970,2585,17270,3000,1725,21995,10980,381504,16660,23540,27568,73917,53162,29292,169564,187966,10023928000,485059000,596483000,724715000,1853362000,1665017000,1079027000,4799739000,4549661000
New Mexico,Total,2012,35018,19637,5931,3734,29302,3289,898,33489,1529,43882,19665,5994,3895,29554,4371,2412,36337,7545,594853,33952,39181,49400,122533,115020,91309,328862,265991,22106840000,1150974000,1198180000,1595627000,3944781000,3891088000,3380094000,11215963000,10890877000
New Mexico,Transportation and Warehousing,2012,5893,3380,690,535,4605,469,240,5314,579,6930,3380,690,545,4615,495,310,5420,1510,76617,4391,2921,5620,15017,13575,9088,40733,16498,3179168000,172264000,119663000,248377000,564692000,492416000,416166000,1566053000,910025000
New Mexico,Utilities,2012,753,460,95,30,585,70,15,670,83,1170,460,95,30,585,130,30,745,425,18515,946,526,318,1898,3002,0,5840,2372,1443731000,20061000,14252000,15885000,54697000,172413000,0,278155000,211218000
New Mexico,Wholesale Trade,2012,8237,3179,1219,941,5339,1127,446,6912,1325,9770,3185,1230,1005,5420,1315,560,7295,2475,101970,3946,6043,8817,22468,20427,6196,55818,39181,4923324000,245461000,290265000,392421000,995072000,941390000,287682000,2440037000,2201199000
New York,Accommodation and Food Services,2012,218788,112348,41430,31347,185125,29273,2940,217338,1450,248395,112380,41470,31570,185420,32235,7970,225625,22770,3359562,197457,273105,426674,899776,1068504,450340,2420945,802672,72094807000,4711910000,4364144000,7256974000,16339950000,21899634000,10533385000,48827280000,23233595000
New York,Administrative and Support and Waste Management and Remediation Services,2012,118438,79097,15160,8977,103234,9142,3300,115676,2762,128560,79100,15210,9060,103370,9640,4215,117225,11335,2641574,106184,97543,118766,326560,352311,492174,1175815,1437813,124735534000,5252239000,3984460000,5228429000,14476645000,15265964000,17717645000,47599678000,75639938000
New York,"Agriculture, Forestry, Fishing and Hunting",2012,3005,2345,355,175,2875,90,20,2985,20,3010,2345,355,175,2875,95,20,2990,20,15201,1945,2155,2094,7750,2768,0,14044,463,490623000,101933000,66246000,70069000,243658000,86685000,0,449228000,16203000
New York,"Arts, Entertainment, and Recreation",2012,54508,37420,6155,4365,47940,4833,1130,53903,605,58285,37425,6175,4410,48010,5060,1555,54625,3660,788894,36586,39948,58811,143394,190564,161156,503353,275842,35806040000,5948242000,1939776000,2049315000,9945146000,6281524000,5823841000,22331240000,13208863000
New York,Construction,2012,223870,161525,30663,17144,209332,12411,1571,223314,556,225120,161525,30670,17160,209355,12605,1820,223780,1340,1512165,234532,200258,229840,670610,455030,232902,1365135,135137,92882145000,9738605000,8833176000,12390070000,30965835000,30030710000,19112554000,80515580000,11196938000
New York,Educational Services,2012,35567,17075,4690,4217,25982,6727,1827,34536,1031,39050,17075,4730,4310,26115,7225,2630,35970,3080,1986210,24302,30737,57647,114445,277717,297271,689914,1263575,78986765000,968785000,722650000,1555216000,3247500000,9941107000,11753410000,24962250000,53079388000
New York,Finance and Insurance,2012,80539,50755,12065,5539,68359,6160,2810,77329,3210,141845,50810,12360,6425,69595,9080,8880,87555,54290,2610220,82360,75081,69488,232684,212887,282896,737296,1856422,496657192000,7690650000,7095302000,9437416000,24407858000,40983860000,64916048000,131441780000,362809906000
New York,Health Care and Social Assistance,2012,229025,125940,45450,23961,195351,19679,8556,223586,5439,283715,126075,45765,24990,196830,26850,25575,249255,34460,7156846,223305,297609,317740,850051,751357,1371626,2977964,4165955,328653066000,11912584000,13103223000,14751984000,39815513000,33372805000,48126919000,121429445000,206869125000
New York,Information,2012,37934,22641,4640,3397,30678,3816,1347,35841,2093,55465,22650,4655,3455,30760,4315,1815,36890,18575,1314001,29282,29600,44120,105224,131275,128894,373419,914536,124694062000,2358949000,1694093000,2411895000,6583195000,9108026000,11090192000,27243683000,96259910000
New York,Management of Companies and Enterprises,2012,9135,921,200,270,1391,1635,2452,5478,3657,14545,930,215,285,1430,1665,2590,5685,8860,912390,1208,975,2074,4499,22828,96008,123350,789017,119085985000,153450000,146239000,176534000,500197000,2323511000,8392430000,11218010000,107864464000
New York,Manufacturing,2012,80198,35640,13870,11080,60590,13029,3677,77296,2902,82640,35640,13880,11145,60665,13430,4265,78360,4280,2080425,59272,85329,143886,300895,491769,429231,1287570,653922,107592416000,2349070000,3059052000,5698163000,11403789000,21889390000,20875416000,56881458000,43324287000
New York,"Mining, Quarrying, and Oil and Gas Extraction",2012,1333,665,205,150,1020,113,95,1228,105,1585,665,205,150,1020,155,160,1335,250,21065,919,1233,1384,4236,2257,4565,14543,0,1350484000,54529000,51360000,82448000,211909000,153451000,275769000,919248000,0
New York,Other,2012,496,481,13,2,496,0,0,496,0,496,481,13,2,496,0,0,496,0,0,0,83,0,0,0,0,0,0,17570000,14669000,1309000,0,17570000,0,0,17570000,0
New York,Other Services (except Public Administration),2012,262914,182990,43800,20673,247463,12570,1824,261857,1057,276690,183125,43995,21180,248300,14665,4255,267220,9470,1810608,314940,285954,272386,891756,428286,236213,1564711,188046,60505070000,8295564000,7999727000,8440476000,24741220000,14891953000,10400963000,50504725000,7273737000
New York,"Professional, Scientific, and Technical Services",2012,281721,205970,33727,18986,258683,15090,4101,277874,3847,297450,206015,33840,19375,259230,16960,6120,282310,15140,2911273,276793,218469,246624,772965,505847,406676,1697493,1162892,249504110000,18235565000,13159307000,17326734000,48737745000,39847025000,36210560000,125455040000,121690821000
New York,Real Estate and Rental and Leasing,2012,144291,111962,16537,7870,136369,5558,1269,143196,1095,159335,112055,16745,8500,137300,7975,4310,149585,9750,812744,121985,107746,101483,383125,181716,100978,668592,114687,44660810000,6557811000,4736611000,4951190000,16257585000,10410749000,6403762000,33282011000,10228693000
New York,Retail Trade,2012,292767,199715,47837,22419,269971,16523,2893,289387,3380,388055,199970,48485,24415,272870,22015,10215,305100,82955,4388551,279885,294957,278745,906898,560040,252052,1765856,2337935,118951039000,9079210000,8586590000,8591054000,26266895000,19791768000,9076421000,55911537000,59795749000
New York,Total,2012,450189,295452,69156,39811,404419,33977,7457,445853,4336,527001,295664,69647,41312,406623,41115,19189,466927,60074,7556521,486234,451716,530431,1468381,1268670,1121681,3858732,3697789,451846838000,20671998000,17815035000,22831332000,61318365000,63271582000,63677328000,188267275000,263579563000
New York,Transportation and Warehousing,2012,55263,34497,7182,4871,46550,5057,1766,53373,1890,61850,34500,7195,4935,46630,5640,2755,55025,6825,1144359,43300,45448,59662,156765,174385,146342,510169,622575,48111315000,1718242000,1672183000,2291293000,5733322000,7160760000,5485116000,19534790000,28207872000
New York,Utilities,2012,993,390,105,128,623,102,73,798,195,3110,390,105,140,635,160,320,1115,1995,205649,445,423,1465,2746,3060,3510,10202,183183,19231984000,72656000,32001000,100848000,223421000,294998000,392978000,1002632000,17226066000
New York,Wholesale Trade,2012,151006,93166,22013,14405,129584,13821,4004,147409,3597,163820,93240,22115,14870,130225,15805,6475,152505,11315,1797453,152756,141688,186879,485859,465974,339029,1304830,427256,120735941000,7858235000,7509971000,10718973000,26079397000,30056460000,23226855000,79955410000,36930057000
North Carolina,Accommodation and Food Services,2012,70142,24760,13619,14866,53245,14151,1410,68806,1336,97480,24785,13675,15165,53625,16990,5545,76160,21320,1736356,39104,92249,202868,335000,497663,197567,1033180,710061,25287948000,1077540000,1205351000,2684344000,4970815000,7007124000,2793092000,14805565000,10276655000
North Carolina,Administrative and Support and Waste Management and Remediation Services,2012,51109,30870,8105,4287,43262,4386,1442,49090,2019,58790,30910,8130,4340,43380,5080,1975,50435,8355,1324737,48195,52574,57067,161942,156933,172740,502817,818924,39921892000,1665606000,1502398000,1728783000,4932855000,5049317000,5424628000,15700323000,24011447000
North Carolina,"Agriculture, Forestry, Fishing and Hunting",2012,3933,2395,890,450,3735,100,40,3875,58,3950,2395,890,460,3745,100,45,3890,60,24090,3748,5654,5531,15683,2132,3419,22134,1456,837241000,130764000,184235000,211922000,539566000,70645000,119839000,758257000,48686000
North Carolina,"Arts, Entertainment, and Recreation",2012,16521,9675,2314,1760,13749,2071,415,16235,286,17565,9690,2335,1780,13805,2215,665,16685,880,280538,13139,14787,23116,52030,80562,55161,192626,76800,7674879000,578950000,379183000,462870000,1427125000,1626254000,1500616000,4673943000,2726032000
North Carolina,Construction,2012,103560,70060,16335,9084,95479,6455,912,102846,714,105050,70060,16345,9115,95520,6660,1180,103360,1690,812145,112871,106390,120820,341365,233634,104866,683810,118758,33531345000,3507835000,3368161000,4457945000,11335845000,9702112000,5013222000,26252330000,6664549000
North Carolina,Educational Services,2012,12027,6335,1675,1450,9460,1755,491,11706,321,12785,6335,1685,1460,9480,1820,670,11970,815,455480,8248,11119,19102,39155,69851,76428,191149,250004,16950314000,306800000,185116000,397245000,900066000,1812512000,2402705000,5357422000,11135386000
North Carolina,Finance and Insurance,2012,32123,22057,4124,1674,27855,1557,802,30214,1909,65890,22115,4250,2200,28565,4065,3945,36575,29315,817353,32491,23802,20617,80075,49013,54539,190803,571198,63626095000,1657718000,1290896000,1339590000,4319145000,3246529000,3725052000,11609877000,51179842000
North Carolina,Health Care and Social Assistance,2012,87170,36998,20685,12998,70681,11557,2955,85193,1977,115015,37055,20805,13490,71350,15695,9565,96610,18405,2707118,62567,137756,171286,377062,442446,421603,1248334,1404271,113355024000,3040394000,5601319000,6808908000,15461659000,15435637000,14525148000,45640183000,66710206000
North Carolina,Information,2012,9012,4820,1145,735,6700,849,400,7949,1063,17555,4820,1150,765,6735,1145,920,8800,8755,373455,5935,6974,8921,24406,27287,31923,87237,263201,24424165000,329423000,269165000,513999000,1139042000,1568771000,2268381000,5103591000,19192403000
North Carolina,Management of Companies and Enterprises,2012,5029,225,115,160,500,1015,1354,2869,2160,8740,225,115,160,500,1045,1465,3010,5730,399358,0,372,694,1470,13990,42823,58283,341075,38235580000,0,31990000,46495000,132020000,791000000,2545857000,3468877000,34766703000
North Carolina,Manufacturing,2012,41082,15335,6560,5133,27028,7286,2744,37058,4024,44805,15345,6570,5150,27065,7520,3500,38085,6720,1912098,22748,38666,62643,133955,272043,273016,726123,1093800,86487726000,979709000,1274552000,2251268000,4773390000,10615600000,11131179000,28413840000,53645822000
North Carolina,"Mining, Quarrying, and Oil and Gas Extraction",2012,626,280,90,60,430,70,57,557,69,1070,280,90,60,430,90,100,620,450,13286,342,0,679,1692,1574,1806,6132,6217,692675000,18986000,17490000,28044000,82055000,69139000,97386000,281127000,354964000
North Carolina,Other,2012,149,144,2,3,149,0,0,149,0,149,144,2,3,149,0,0,149,0,0,0,0,39,0,0,0,0,0,2784000,2429000,0,233000,2784000,0,0,2784000,0
North Carolina,Other Services (except Public Administration),2012,104675,67207,21273,8957,97437,5688,820,103945,730,112630,67265,21450,9345,98060,7630,2485,108175,4455,729007,123920,136332,116274,380595,196586,68046,655674,53108,17713960000,2819075000,3007266000,2805313000,8644560000,4713058000,1730074000,15334551000,1780733000
North Carolina,"Professional, Scientific, and Technical Services",2012,105690,76325,12843,6993,96161,5123,1862,103146,2544,114630,76340,12885,7265,96490,6435,2920,105845,8785,967076,108318,83187,90122,285994,158910,114702,572783,375312,64246824000,5219648000,3911375000,4622308000,13785740000,9795742000,8223368000,32458329000,30991296000
North Carolina,Real Estate and Rental and Leasing,2012,37357,29413,3488,1456,34357,1395,768,36520,837,50160,29445,3600,1665,34710,2395,4255,41360,8800,222369,30655,20779,17415,77849,39387,37576,160444,62978,9507240000,1448486000,758177000,667871000,2895206000,1580434000,1597829000,6226268000,3243168000
North Carolina,Retail Trade,2012,101187,59405,20076,9850,89331,7499,1597,98427,2760,171350,59555,20590,11575,91720,13875,7890,113485,57865,2030997,106699,126516,123733,354752,245308,117603,747105,1199927,48488640000,2548334000,3051505000,3357566000,8981583000,7940799000,4160563000,21350948000,25924720000
North Carolina,Total,2012,167077,99073,28613,17259,144945,15071,3590,163606,3471,217404,99193,28971,18287,146451,20402,10603,177456,39948,3352151,165815,187859,229744,583418,550787,421792,1555997,1796154,137928718000,5659736000,5799107000,7356425000,18815268000,18663030000,16452620000,53930918000,83997800000
North Carolina,Transportation and Warehousing,2012,23019,13900,2889,1846,18635,1787,906,21328,1691,26975,13900,2925,1910,18735,1995,1235,21965,5010,469618,20535,17590,22765,62790,55387,42667,167737,241754,18552920000,693069000,553591000,783358000,2062350000,2009042000,1726891000,5983740000,10352021000
North Carolina,Utilities,2012,777,295,115,55,465,125,95,685,92,2445,295,115,55,465,200,240,905,1540,65806,304,680,630,1735,6252,8826,17732,0,6026798000,15267000,27729000,23010000,67280000,381006000,626384000,1147879000,0
North Carolina,Wholesale Trade,2012,48237,24396,7106,5088,36590,5577,2606,44773,3464,59390,24430,7240,5460,37130,7055,4415,48600,10790,819695,36295,42992,60821,149382,158838,130743,454023,339815,49474170000,2042025000,2141156000,3041117000,7349106000,8262338000,7270808000,23476484000,25004307000
North Dakota,Accommodation and Food Services,2012,8391,3010,1565,1492,6067,1826,292,8185,206,9680,3015,1565,1525,6105,2080,680,8865,815,171625,4670,10154,20582,35702,63448,37945,138853,29647,2548899000,120879000,109860000,248778000,487104000,892651000,641716000,2044439000,478401000
North Dakota,Administrative and Support and Waste Management and Remediation Services,2012,4559,2650,740,404,3794,332,87,4213,346,4975,2650,740,425,3815,360,165,4340,635,58410,3274,4245,4643,13046,7570,8227,35996,19494,2009359000,141564000,134724000,154638000,460213000,326681000,218952000,1229008000,651552000
North Dakota,"Agriculture, Forestry, Fishing and Hunting",2012,625,500,60,40,600,10,5,615,10,630,500,60,40,600,10,5,615,15,2325,563,370,0,1396,0,0,1763,0,104498000,33833000,16176000,0,69443000,0,0,81423000,0
North Dakota,"Arts, Entertainment, and Recreation",2012,1930,1150,280,223,1653,193,52,1898,32,2140,1150,280,245,1675,265,165,2105,35,22820,1155,1459,2105,5137,6028,5674,18326,0,346051000,43910000,23237000,40462000,129929000,80608000,51299000,274652000,0
North Dakota,Construction,2012,14449,9460,2525,1194,13179,1010,147,14336,113,14610,9460,2525,1200,13185,1080,185,14450,160,107891,12489,15586,15229,46055,35079,11538,98796,4701,6282524000,649146000,703170000,827208000,2200102000,2236007000,783717000,5570389000,498262000
North Dakota,Educational Services,2012,730,280,80,95,455,160,60,675,55,760,280,85,95,460,170,60,690,70,21532,8,186,1209,1645,6372,5823,14330,0,472161000,9912000,5369000,12275000,31257000,133718000,150625000,315788000,0
North Dakota,Finance and Insurance,2012,5542,3790,500,315,4605,378,142,5125,417,8810,3790,540,500,4830,1160,995,6985,1825,77728,5316,2746,3851,12380,10568,12808,38343,35639,4171061000,240430000,115359000,184221000,565406000,546384000,674146000,1919499000,2124425000
North Dakota,Health Care and Social Assistance,2012,7711,3335,1540,1098,5973,943,475,7391,320,9270,3335,1545,1150,6030,1190,1085,8305,965,283904,4552,9612,13136,28669,35152,53348,125641,139711,12357313000,216315000,380712000,430730000,1087222000,1066398000,1617679000,4072426000,6888357000
North Dakota,Information,2012,1176,365,210,135,710,190,84,984,192,1770,365,210,160,735,275,115,1125,645,32442,285,930,978,2777,6947,3591,14647,12350,1970965000,18683000,24439000,41665000,106730000,376459000,182876000,750906000,693252000
North Dakota,Management of Companies and Enterprises,2012,470,40,15,25,80,95,80,255,215,525,40,15,25,80,95,85,260,265,24405,40,0,0,188,734,1420,2374,21923,1639665000,17515000,0,0,27308000,34168000,97976000,162935000,1472737000
North Dakota,Manufacturing,2012,3445,1315,605,430,2350,551,261,3162,283,3730,1315,605,430,2350,600,325,3275,455,84658,1267,1904,3680,8414,12185,12325,41861,18753,3774474000,61267000,94529000,136193000,365680000,534553000,536411000,1739405000,913105000
North Dakota,"Mining, Quarrying, and Oil and Gas Extraction",2012,2071,860,235,220,1315,315,105,1735,336,2390,860,235,220,1315,315,125,1755,635,95997,991,1465,2867,5655,12404,9944,29355,64693,9537919000,119019000,121787000,251944000,504360000,1082930000,930540000,2636530000,6760865000
North Dakota,Other,2012,22,21,0,1,22,0,0,22,0,22,21,0,1,22,0,0,22,0,0,0,0,0,0,0,0,0,0,450000,419000,0,0,450000,0,0,450000,0
North Dakota,Other Services (except Public Administration),2012,11770,7612,2365,961,10938,597,45,11580,190,12260,7615,2385,1015,11015,820,60,11895,365,64247,12612,13959,11729,39556,16818,258,60041,2060,1599223000,312581000,367845000,292716000,1004729000,389530000,7725000,1455282000,76614000
North Dakota,"Professional, Scientific, and Technical Services",2012,8013,5160,1155,670,6985,501,210,7696,317,8580,5160,1155,680,6995,755,300,8050,530,63892,5813,6815,7576,22063,12801,6142,44937,14312,4105499000,349653000,333580000,384147000,1103651000,932732000,582135000,2780927000,1128804000
North Dakota,Real Estate and Rental and Leasing,2012,4127,3100,325,265,3690,163,112,3965,162,4555,3100,330,275,3705,210,300,4215,340,22669,2744,1665,2755,8387,3146,3881,16985,4077,1221959000,161068000,58266000,111826000,366933000,201773000,115916000,811478000,358534000
North Dakota,Retail Trade,2012,11755,4705,2615,1689,9009,1467,416,10892,863,15955,4710,2660,1870,9240,2135,1325,12700,3255,222289,6832,15409,19436,45167,41133,27900,121719,80450,5863776000,231257000,438162000,596250000,1304289000,1339098000,878429000,3730986000,1665624000
North Dakota,Total,2012,19520,10836,3326,2084,16246,1942,523,18711,809,23551,10842,3358,2245,16445,2751,1447,20643,2908,331278,17336,21789,27783,66908,70026,57315,194249,137029,14705136000,665018000,723000000,995000000,2383018000,2825049000,2327132000,7535199000,7169937000
North Dakota,Transportation and Warehousing,2012,7508,4850,1025,579,6454,460,206,7120,388,8250,4860,1025,585,6470,510,355,7335,915,86941,5842,6011,6277,19886,16024,6496,51059,30029,4859374000,370983000,260970000,339444000,988540000,985940000,279230000,2620161000,1967024000
North Dakota,Utilities,2012,221,50,5,10,65,80,15,160,61,635,50,5,10,65,140,45,250,385,11311,40,0,0,0,3226,0,5144,0,947776000,4157000,0,0,10055000,251629000,0,407371000,0
North Dakota,Wholesale Trade,2012,5691,1850,794,655,3299,1067,473,4839,852,8120,1850,825,770,3445,1585,860,5890,2230,104295,2302,4182,5915,14128,25933,13139,60295,34865,6059414000,130347000,222274000,371597000,801461000,1499047000,868720000,3538287000,2115632000
Ohio,Accommodation and Food Services,2012,83490,30199,16635,16384,63218,16855,1910,81983,1507,116980,30215,16655,16640,63510,20555,8995,93060,23920,2148205,48897,111388,224211,384508,620951,293949,1303310,826438,28699399000,1026340000,1279333000,2652848000,4960305000,8074794000,3652488000,16730010000,11673581000
Ohio,Administrative and Support and Waste Management and Remediation Services,2012,56144,32770,8520,5565,46855,5122,1853,53830,2314,65620,32790,8520,5610,46920,5590,2435,54945,10675,1800485,46355,56144,72586,177266,194295,265800,643615,1155240,51489654000,1888261000,1699384000,2389687000,6000822000,6040736000,6857621000,19032941000,32454159000
Ohio,"Agriculture, Forestry, Fishing and Hunting",2012,1345,995,155,75,1225,75,15,1315,30,1360,995,155,75,1225,75,15,1315,45,6358,1470,258,324,3363,1725,0,5444,790,203969000,44734000,19114000,14962000,97252000,56084000,0,163770000,33912000
Ohio,"Arts, Entertainment, and Recreation",2012,17919,9835,2805,2182,14822,2304,473,17599,320,19210,9835,2820,2220,14875,2460,710,18045,1165,300212,13596,17818,28381,61337,83551,60845,214613,79837,9632606000,562459000,395745000,511823000,1493796000,1732733000,1862018000,6574961000,2937251000
Ohio,Construction,2012,97281,63635,16250,9220,89105,6600,920,96625,656,98630,63635,16250,9245,89130,6905,1255,97290,1340,831007,100358,105672,123256,332000,238699,121850,698762,112140,43685024000,4094882000,4236150000,5758741000,14115825000,13106509000,7645251000,35263144000,7308432000
Ohio,Educational Services,2012,13280,5260,2230,1797,9287,2851,658,12796,484,15250,5280,2245,1860,9385,3330,1065,13780,1470,591615,8160,14633,23432,47813,118620,95261,264172,314321,15694000000,256801000,280419000,509119000,1048546000,3101820000,2950383000,7174884000,8061659000
Ohio,Finance and Insurance,2012,42263,27992,6025,2479,36496,2686,951,40133,2130,88215,28060,6270,3050,37380,6285,4365,48030,40185,1219509,47862,37850,30741,117237,92193,73657,291814,916806,81900433000,1988073000,1845289000,1847647000,5738678000,5756490000,4296678000,16012116000,65366670000
Ohio,Health Care and Social Assistance,2012,102580,40632,24659,15427,80718,13914,5044,99676,2904,141535,40725,24870,16305,81900,20505,15800,118205,23330,4041647,82010,162646,205486,451278,555143,750772,1767347,2268989,168726483000,3489083000,6333671000,8644247000,18496940000,20805705000,21592851000,61241633000,107467572000
Ohio,Information,2012,8764,3765,1249,985,5999,1228,434,7661,1103,19440,3770,1260,1015,6045,1430,1070,8545,10895,407015,4941,7607,12185,26604,41940,40396,111605,297131,25426039000,271596000,279904000,670225000,1250377000,2182553000,2126090000,5644038000,19851258000
Ohio,Management of Companies and Enterprises,2012,6638,400,145,210,755,1115,2032,3902,2736,10610,400,155,210,765,1135,2120,4020,6590,779520,537,44,1155,2212,13339,61888,77439,702026,69056605000,80909000,36612000,78685000,197105000,746765000,4230610000,5175035000,63881406000
Ohio,Manufacturing,2012,67330,20780,11809,10048,42637,14162,5249,62048,5282,72445,20780,11815,10140,42735,14810,6530,64075,8370,3019236,36759,73625,129592,249380,539989,597137,1444288,1462909,160722799000,1430169000,2627452000,5389119000,9709145000,24724082000,29434461000,66513373000,88731006000
Ohio,"Mining, Quarrying, and Oil and Gas Extraction",2012,2957,1455,565,354,2374,260,105,2739,218,3690,1455,570,355,2380,325,230,2935,755,47763,2486,3515,4447,10681,7383,5282,24302,19711,2893821000,107215000,156498000,219380000,495538000,409527000,304748000,1216421000,1461168000
Ohio,Other,2012,153,145,4,4,153,0,0,153,0,153,145,4,4,153,0,0,153,0,0,0,0,54,0,0,0,0,0,3215000,2618000,0,346000,3215000,0,0,3215000,0
Ohio,Other Services (except Public Administration),2012,124426,72350,28430,13494,114274,8062,1188,123524,902,139140,72435,28710,14285,115430,10980,3280,129690,9450,1005755,146108,185271,174905,507019,269064,99257,883926,92150,24364106000,3114712000,3859875000,3916676000,10904110000,6598566000,2863189000,20513740000,3072709000
Ohio,"Professional, Scientific, and Technical Services",2012,109824,72555,15928,9454,97937,7044,2305,107286,2538,119970,72580,15945,9815,98340,8450,3570,110360,9610,1161355,111024,103682,123936,343394,231572,181218,765503,377801,72165519000,5144669000,4825067000,6400034000,16407735000,14352037000,12272105000,43432352000,28286373000
Ohio,Real Estate and Rental and Leasing,2012,34527,24345,4477,2129,30951,1752,930,33633,894,48485,24435,4625,2490,31550,3235,3730,38515,9970,293647,37996,27473,27312,94854,49409,41400,191590,86165,12644159000,1312009000,935989000,1006728000,3267938000,2000242000,1928285000,7575158000,4497944000
Ohio,Retail Trade,2012,104604,55976,22383,11817,90176,9263,2217,101656,2948,183320,56100,23015,13530,92645,15225,8615,116485,66835,2735981,85315,141616,151478,390254,320818,183432,922712,1674049,69204150000,2353418000,3103221000,3706990000,9179390000,9883271000,6056035000,25510053000,40395088000
Ohio,Total,2012,186870,100957,35075,22215,158247,19998,4817,183062,3808,250842,101096,35481,23549,160126,27021,14454,201601,49241,4548143,178820,231043,297543,707406,755493,661046,2123945,2424198,191069504000,6118883000,7225048000,10113780000,23457711000,27820726000,25976113000,77254550000,113814954000
Ohio,Transportation and Warehousing,2012,29103,15455,4010,3179,22644,2949,1252,26845,2258,34980,15455,4035,3255,22745,3450,1820,28015,6965,752464,23051,25183,40917,90773,98026,70135,268442,381009,30417242000,906987000,873819000,1489208000,3310469000,3704712000,2739348000,10116088000,17177977000
Ohio,Utilities,2012,843,250,110,80,440,232,38,710,133,3190,250,110,85,445,330,75,850,2340,13851,347,66,1035,2135,9005,2916,13371,0,1283208000,16213000,32323000,63713000,116334000,579261000,192713000,1027498000,0
Ohio,Wholesale Trade,2012,57021,25519,9226,7063,41808,7865,3359,53032,3989,71375,25560,9360,7540,42460,10030,6590,59080,12295,1094993,42740,59501,88976,197474,242770,203124,664293,409106,61588618000,2329410000,3076691000,4744159000,10200174000,13146658000,11423949000,35488919000,25249737000
Oklahoma,Accommodation and Food Services,2012,26142,9735,4750,4770,19255,5402,670,25327,815,36775,9745,4755,4855,19355,6585,2810,28750,8025,680974,16156,32142,65459,114675,195055,90192,402844,260269,9368173000,318961000,355759000,777078000,1454210000,2607184000,1171440000,5285830000,3808662000
Oklahoma,Administrative and Support and Waste Management and Remediation Services,2012,19940,11715,3195,1770,16680,1429,651,18760,1180,22115,11720,3210,1780,16710,1580,960,19250,2865,464587,17112,18736,22709,60191,52011,73286,194963,229593,14995151000,611124000,539673000,700740000,1917906000,1726906000,1856068000,5759526000,8223983000
Oklahoma,"Agriculture, Forestry, Fishing and Hunting",2012,766,530,95,90,715,15,16,746,20,775,530,95,90,715,15,25,755,20,4013,547,444,980,2308,0,0,3648,0,156798000,24343000,17100000,32299000,79697000,0,0,135361000,0
Oklahoma,"Arts, Entertainment, and Recreation",2012,4804,2700,595,545,3840,630,225,4695,109,5240,2705,595,555,3855,705,325,4885,355,124579,2911,3355,6872,14129,25005,31013,74932,876,3302902000,161969000,68962000,101541000,345528000,468205000,794986000,1787130000,14384000
Oklahoma,Construction,2012,39183,24810,6820,4065,35695,2715,462,38872,311,39530,24810,6820,4065,35695,2755,555,39005,525,324620,39677,44149,53217,139419,95307,50843,292400,28617,15279320000,1377995000,1435090000,2060019000,4886755000,4335701000,2874910000,12422145000,2669317000
Oklahoma,Educational Services,2012,3395,1695,460,460,2615,420,184,3219,176,3605,1695,460,465,2620,430,245,3295,310,104221,2036,2521,5312,11173,14774,23459,51414,49974,2843205000,58980000,52825000,103645000,221569000,386903000,637522000,1302861000,1453429000
Oklahoma,Finance and Insurance,2012,20094,13900,2270,984,17154,1391,477,19022,1072,33770,13920,2305,1390,17615,3945,2675,24235,9535,278027,21846,13407,11482,49413,48364,45028,150186,123076,15051537000,887155000,548425000,625147000,2141030000,2310811000,2066539000,6942282000,7862738000
Oklahoma,Health Care and Social Assistance,2012,42250,20873,9345,4715,34933,4757,1447,41137,1113,53275,20890,9360,4825,35075,6375,5445,46895,6380,1061728,34598,60788,61699,161215,197935,192198,559409,478794,42640248000,2084889000,2493063000,2283879000,6873325000,6325834000,6129905000,19481627000,22564324000
Oklahoma,Information,2012,3950,1755,570,469,2794,422,220,3436,514,7390,1760,575,530,2865,530,505,3900,3490,139000,1914,3142,4583,12669,11777,9748,40411,94022,6773117000,103361000,110680000,204952000,474970000,549129000,520482000,1750403000,4816683000
Oklahoma,Management of Companies and Enterprises,2012,2165,120,65,80,265,395,650,1310,855,2785,120,70,80,270,395,710,1375,1410,158399,6,235,26,56,3697,16529,21585,135822,15952895000,51905000,13520000,2204000,96781000,204975000,1059897000,1384415000,14573847000
Oklahoma,Manufacturing,2012,16850,6035,2930,2359,11324,2919,1010,15253,1597,18075,6035,2930,2380,11345,3055,1200,15600,2475,592340,8432,14799,25979,55226,97774,84501,268908,282814,28368844000,381129000,552052000,1062859000,2163094000,4432433000,4113575000,12011161000,14393225000
Oklahoma,"Mining, Quarrying, and Oil and Gas Extraction",2012,14034,8975,1885,1104,11964,1150,359,13473,561,15660,8975,1885,1105,11965,1225,475,13665,1995,277594,8608,11959,14403,40564,42041,41559,124603,152545,23638347000,746329000,635164000,851521000,2238396000,3009819000,2914598000,8241159000,15394068000
Oklahoma,Other,2012,61,57,4,0,61,0,0,61,0,61,57,4,0,61,0,0,61,0,0,0,26,0,0,0,0,0,0,1407000,747000,660000,0,1407000,0,0,1407000,0
Oklahoma,Other Services (except Public Administration),2012,41518,26268,8243,3687,38198,2504,395,41097,421,44550,26345,8285,3855,38485,3380,1180,43045,1505,308900,47669,52362,46453,150286,87135,35012,284268,14198,7355224000,1068178000,1151200000,1142502000,3378480000,2035000000,926016000,6580821000,571661000
Oklahoma,"Professional, Scientific, and Technical Services",2012,44379,31627,6135,2950,40712,1970,691,43373,1006,47445,31640,6145,3060,40845,2340,1685,44870,2575,362227,33230,39181,37173,127698,63007,44125,246848,105992,20989494000,2114047000,1614429000,1896230000,5668475000,3738324000,3355012000,13218375000,7294100000
Oklahoma,Real Estate and Rental and Leasing,2012,16322,12296,1668,837,14801,689,279,15769,553,19875,12315,1700,965,14980,1065,765,16810,3065,108783,14499,10424,9854,39146,20331,10663,74814,22523,4684121000,585987000,366283000,349464000,1315016000,802769000,507753000,2922562000,1372112000
Oklahoma,Retail Trade,2012,41864,21733,9388,4640,35761,3364,827,39952,1912,65295,21800,9670,5100,36570,5380,2870,44820,20475,741817,34658,60033,56823,159994,110093,46707,332480,386525,18531735000,952367000,1373402000,1487999000,3850656000,3653532000,1673508000,9641616000,8540867000
Oklahoma,Total,2012,72041,41923,12545,7310,61778,6485,1703,69966,2075,90954,41984,12668,7719,62371,8876,5081,76328,14626,1305183,72174,82100,97424,251698,242451,199583,693732,611451,53518174000,2554521000,2536540000,3200169000,8291230000,8632061000,8051894000,24975185000,28542989000
Oklahoma,Transportation and Warehousing,2012,11320,6450,1303,1077,8830,956,516,10302,1018,13235,6450,1310,1115,8875,1000,865,10740,2495,186999,8002,7231,12490,31174,28567,22214,84870,78968,8379904000,329561000,244171000,486356000,1090779000,1233937000,1115766000,3531166000,4133138000
Oklahoma,Utilities,2012,701,270,80,30,380,140,65,585,116,1740,270,80,30,380,185,170,735,1005,32859,438,510,271,1159,7430,2160,12875,2160,2778011000,13506000,23940000,26440000,65635000,445002000,166800000,805661000,213877000
Oklahoma,Wholesale Trade,2012,18790,7905,3008,2184,13097,2580,1183,16860,1930,23330,7910,3070,2350,13330,3435,1940,18705,4625,286853,11521,17065,25177,59241,65789,37591,181021,92986,16042735000,633187000,852047000,1266441000,2833952000,3329919000,2379548000,9295483000,6007744000
Oregon,Accommodation and Food Services,2012,42490,14745,10213,9517,34475,6594,810,41879,611,53135,14755,10275,9870,34900,8690,3415,47005,6130,733193,24427,66701,129125,219602,215680,99262,538785,185061,12530830000,516575000,902645000,1877028000,3304425000,3602493000,1674077000,8596519000,3731601000
Oregon,Administrative and Support and Waste Management and Remediation Services,2012,23865,14890,3502,2007,20399,1861,590,22850,1015,26595,14900,3520,2065,20485,2060,860,23405,3190,410016,21098,20626,24990,70492,65100,54604,207853,195970,12253410000,703001000,593439000,746373000,2079003000,2172741000,1395346000,6084214000,6005229000
Oregon,"Agriculture, Forestry, Fishing and Hunting",2012,6346,4250,715,645,5610,590,100,6300,46,6490,4250,715,645,5610,630,145,6385,105,56820,5784,4666,9239,20004,20960,6741,53917,2563,2270361000,298911000,196974000,363018000,866840000,787931000,235561000,2078783000,168572000
Oregon,"Arts, Entertainment, and Recreation",2012,7787,4540,1065,920,6525,970,168,7663,124,8255,4540,1075,920,6535,1135,285,7955,300,121143,4528,6298,11554,24625,34299,23683,89144,16485,2934077000,204777000,134407000,234543000,589640000,592367000,695893000,1996768000,326571000
Oregon,Construction,2012,54470,40095,7545,3585,51225,2522,343,54090,380,55000,40095,7545,3600,51240,2700,435,54375,625,329015,58245,47877,47316,155041,81931,28669,275261,34408,16770025000,2050751000,1755933000,2043743000,5854051000,4460535000,2078064000,12858879000,2962957000
Oregon,Educational Services,2012,6612,3180,1060,840,5080,1065,260,6405,207,7345,3180,1065,870,5115,1295,615,7025,320,174303,4288,6846,10773,22244,37928,31123,95689,75022,4225555000,126394000,129445000,216403000,482890000,888390000,748990000,2224920000,1812367000
Oregon,Finance and Insurance,2012,16500,11080,2004,689,13773,818,621,15212,1288,29475,11090,2050,800,13940,1695,2440,18075,11400,276600,17697,11698,7533,38326,24791,18804,98472,157161,17883689000,732259000,538413000,470756000,1786625000,1661081000,1999182000,5948555000,11176485000
Oregon,Health Care and Social Assistance,2012,49568,26630,10545,5563,42738,4207,1547,48492,1076,62745,26645,10605,5810,43060,6425,5755,55240,7505,1060452,39144,68759,72756,189122,163901,171516,532003,493520,48717728000,1968403000,2590730000,2903325000,7479860000,6159063000,5809393000,19659349000,27558608000
Oregon,Information,2012,6416,3295,846,625,4766,629,297,5692,724,9750,3295,860,665,4820,675,650,6145,3605,170864,3712,4759,7348,17536,20102,21658,67486,95457,10850928000,208487000,214643000,341616000,781185000,1257852000,1463040000,3936735000,6792789000
Oregon,Management of Companies and Enterprises,2012,2565,155,75,85,315,597,786,1698,867,3380,155,75,85,315,620,850,1785,1595,206362,0,268,0,788,6163,28749,35782,170064,18704774000,39786000,16628000,15324000,78255000,354011000,2038103000,2470369000,16234405000
Oregon,Manufacturing,2012,25220,10700,4450,3390,18540,3905,1239,23684,1536,26445,10700,4465,3400,18565,4085,1485,24135,2310,677660,15102,24278,38691,86870,131716,95007,366428,234245,34336594000,601264000,888043000,1504919000,3235814000,5878145000,4665822000,15992982000,14329340000
Oregon,"Mining, Quarrying, and Oil and Gas Extraction",2012,596,285,100,75,460,70,10,540,56,715,285,100,75,460,75,10,545,170,6297,319,644,635,1806,1570,0,3851,983,348972000,18438000,24830000,27191000,77711000,80545000,0,187336000,109492000
Oregon,Other,2012,96,89,5,1,95,0,0,95,1,96,89,5,1,95,0,0,95,1,0,77,30,0,119,0,0,119,0,5738000,1499000,221000,0,1903000,0,0,1903000,0
Oregon,Other Services (except Public Administration),2012,44069,28115,8657,4082,40854,2369,377,43600,469,48255,28130,8700,4360,41190,3195,2290,46675,1580,306431,49463,56361,51579,161152,78648,25071,272080,17573,8032784000,1243354000,1294452000,1315552000,3873395000,2058960000,791727000,6963933000,756367000
Oregon,"Professional, Scientific, and Technical Services",2012,55805,39900,7275,3780,50955,2632,844,54431,1374,58685,39905,7280,3900,51085,3140,1015,55240,3445,434876,56941,45917,46941,151081,79066,43877,282845,98521,30150709000,2665107000,2095514000,2501081000,7282268000,5020504000,2829763000,15459058000,9277992000
Oregon,Real Estate and Rental and Leasing,2012,22808,17517,2492,1000,21009,921,338,22268,540,27800,17530,2610,1170,21310,2295,1005,24610,3190,123094,25299,15464,12156,53750,27274,15834,101083,17828,4373529000,767974000,488211000,370707000,1644155000,1001381000,540158000,3343279000,924046000
Oregon,Retail Trade,2012,46823,24039,10188,5524,39751,3939,1125,44815,2008,69700,24110,10375,6310,40795,6940,4625,52360,17340,913067,38290,63777,65593,172067,120494,74098,390055,483493,24129493000,1001178000,1452596000,1745958000,4248262000,3697330000,2304113000,10548813000,12740043000
Oregon,Total,2012,87717,52471,15127,9099,76697,7137,1763,85597,2120,107549,52513,15281,9651,77445,10094,5781,93320,14229,1363523,86750,99272,120576,306598,254986,195548,757132,606391,58477866000,2908044000,2978592000,3823315000,9709951000,9522922000,7961547000,27194420000,31283446000
Oregon,Transportation and Warehousing,2012,13073,7475,1790,1199,10464,1042,550,12056,1017,14970,7475,1800,1265,10540,1190,730,12460,2510,240751,6882,9458,13988,36922,32161,22220,97194,104424,10243600000,371923000,379103000,516427000,1302917000,1367789000,964630000,3871961000,4939999000
Oregon,Utilities,2012,655,360,60,30,450,100,26,576,79,1450,360,60,35,455,155,35,645,805,18597,647,319,353,1365,4110,0,5874,15081,2234421000,16328000,7344000,26588000,52131000,350822000,14833000,437895000,1916926000
Oregon,Wholesale Trade,2012,22692,10715,3154,2282,16151,2920,1441,20512,2180,27075,10720,3205,2405,16330,3470,2260,22060,5015,373690,14800,18612,25883,65564,73807,49493,205411,150213,24538750000,825768000,926232000,1345171000,3193905000,4194633000,2889677000,11059620000,13134894000
Pennsylvania,Accommodation and Food Services,2012,111444,50425,22110,17993,90528,17709,1887,110124,1320,138335,50445,22150,18160,90755,20185,6280,117220,21115,2117850,88028,147474,243947,479633,640461,265153,1386594,700149,33017565000,1727235000,1811205000,3018457000,6557710000,8988218000,3577836000,19146390000,13840500000
Pennsylvania,Administrative and Support and Waste Management and Remediation Services,2012,65280,38630,10110,6410,55150,5723,2069,62942,2338,75010,38630,10140,6515,55285,6285,3105,64675,10335,1507898,57645,65511,85063,211062,216889,259935,696446,800657,49269419000,2309375000,2158878000,3022994000,7505855000,7422389000,7812635000,23050454000,26043910000
Pennsylvania,"Agriculture, Forestry, Fishing and Hunting",2012,2430,1835,315,140,2290,100,25,2415,15,2430,1835,315,140,2290,100,25,2415,15,12527,1846,1841,1556,6503,2679,877,12381,58,413128000,83118000,45558000,49845000,185105000,105508000,34080000,395248000,3576000
Pennsylvania,"Arts, Entertainment, and Recreation",2012,20893,11217,3325,2425,16967,2925,594,20486,407,22220,11220,3330,2465,17015,3115,870,21000,1220,450441,13750,21659,31827,69703,116951,79700,275617,153052,13781307000,586002000,451750000,594662000,1651989000,2239156000,3107342000,7303176000,5928244000
Pennsylvania,Construction,2012,129532,86740,20620,11791,119151,8436,1248,128835,697,130695,86740,20620,11830,119190,8600,1520,129310,1385,1109155,143318,133901,157833,436370,305133,169938,916885,177749,59061560000,5308685000,5453700000,7540695000,18303080000,17638505000,11259260000,47474065000,10889610000
Pennsylvania,Educational Services,2012,16235,6705,2420,2020,11145,3481,878,15504,731,18305,6705,2430,2075,11210,3845,1465,16520,1785,1293752,9492,15551,27648,54813,155803,124536,347642,944166,48614732000,382743000,350332000,655644000,1391548000,4777821000,4566147000,11100102000,37469973000
Pennsylvania,Finance and Insurance,2012,46437,29189,7483,3005,39677,2978,1383,44038,2399,89230,29380,7750,3480,40610,6040,6925,53575,35655,1278185,53295,46057,38693,140406,99281,116167,365234,879581,98032373000,2605656000,2530977000,2725154000,7949856000,7459325000,8349657000,24560290000,70015268000
Pennsylvania,Health Care and Social Assistance,2012,125315,54059,28277,17744,100080,15695,5704,121479,3836,182890,54160,28575,18795,101530,23835,19990,145355,37535,4840172,109117,186226,238607,535385,590940,853947,1985095,2851611,202114629000,4182619000,7316299000,9601756000,21105295000,23077363000,27083298000,71446420000,130535069000
Pennsylvania,Information,2012,12880,5745,1940,1655,9340,1672,565,11577,1303,24925,5745,1945,1720,9410,2045,995,12450,12475,566454,8335,11861,20661,43527,57015,45836,154700,407706,43080848000,458254000,479533000,940956000,1920242000,3249620000,2887653000,8461985000,34374030000
Pennsylvania,Management of Companies and Enterprises,2012,7024,270,86,210,566,1226,2145,3937,3087,11540,270,100,210,580,1245,2310,4135,7405,857001,311,426,1317,2240,17103,71888,91231,765770,84440786000,69978000,39425000,124633000,261494000,1039894000,5446026000,6751880000,77693372000
Pennsylvania,Manufacturing,2012,65682,21943,11034,9881,42858,13404,4542,60804,4878,69975,21990,11040,9925,42955,14020,5575,62550,7425,2625472,37247,68269,127171,242906,505888,487574,1308119,1147644,134926398000,1528458000,2507203000,5185848000,9595187000,23439661000,23915819000,60141834000,66270878000
Pennsylvania,"Mining, Quarrying, and Oil and Gas Extraction",2012,4440,1920,720,480,3120,655,276,4051,389,5745,1920,720,480,3120,740,440,4300,1445,166056,3404,4588,6768,14762,23230,25704,64716,86326,12510059000,165335000,212943000,327468000,707035000,1250426000,1730004000,3741077000,7602590000
Pennsylvania,Other,2012,124,123,1,0,124,0,0,124,0,124,123,1,0,124,0,0,124,0,0,0,0,0,0,0,0,0,0,2344000,2315000,0,0,2344000,0,0,2344000,0
Pennsylvania,Other Services (except Public Administration),2012,166914,104165,36230,15178,155573,9186,1209,165968,946,178685,104210,36480,15735,156425,11365,3685,171475,7210,1197030,205663,232225,195651,636851,316182,102516,1070431,106323,30255042000,4530755000,4954175000,4518869000,14013443000,8151579000,3706340000,26154707000,3621901000
Pennsylvania,"Professional, Scientific, and Technical Services",2012,135250,89865,18827,11419,120111,9331,2677,132119,3131,146830,89880,18920,11765,120565,11405,4035,136005,10825,1567454,139272,122515,148107,412261,314465,225021,960358,578157,113620277000,7315256000,6394676000,9123670000,22902730000,22490721000,18361307000,64067125000,48465369000
Pennsylvania,Real Estate and Rental and Leasing,2012,34285,22910,4905,2478,30293,2129,816,33238,1047,46215,22960,5150,2900,31010,3015,2675,36700,9515,291344,34488,30925,31042,100004,65732,40776,210975,69474,13540371000,1432805000,1209347000,1314318000,3961195000,3274718000,1798760000,9270495000,4174273000
Pennsylvania,Retail Trade,2012,133895,73048,27652,14750,115450,12175,2970,130595,3300,220230,73170,28265,16470,117905,18505,10425,146835,73395,3096570,111549,167470,183244,479482,421009,282754,1199649,1597967,75016210000,3102337000,3964793000,4753201000,11790732000,13585170000,8398572000,34359286000,36683310000
Pennsylvania,Total,2012,229428,129198,42188,25603,196989,23027,5366,225382,4046,296872,129348,42658,26874,198880,29931,15652,244463,52409,5169196,230799,277092,342866,850757,865202,729064,2445023,2724173,231749663000,8018434000,8965611000,12215464000,29199509000,34033335000,30969261000,94202105000,137547558000
Pennsylvania,Transportation and Warehousing,2012,34745,18120,4762,3690,26572,4411,1405,32388,2357,41050,18120,4770,3755,26645,4910,1875,33430,7620,965969,26140,30442,47806,108723,151209,108164,373472,492957,36678907000,952342000,919529000,1570322000,3493997000,5077401000,3652484000,12416547000,20276355000
Pennsylvania,Utilities,2012,1061,370,140,80,590,185,50,825,236,3945,370,140,80,590,250,135,975,2970,97137,611,530,910,2575,6774,1290,11941,80621,11555742000,25312000,30393000,46849000,118670000,477314000,109773000,864773000,8236805000
Pennsylvania,Wholesale Trade,2012,62085,28354,10320,7540,46214,8344,3481,58039,4046,75485,28375,10445,7870,46690,10150,5930,62770,12715,1231360,46511,66653,96804,216315,259327,211133,702976,492045,78395987000,2742377000,3487966000,5272984000,11537955000,14749063000,11466518000,38528354000,38954729000
Rhode Island,Accommodation and Food Services,2012,12779,5365,2210,2365,9940,2300,182,12422,357,14855,5375,2210,2395,9980,2565,490,13035,1820,206817,7680,14535,32218,55246,79593,20949,155834,51395,3525750000,280362000,193425000,448817000,933724000,1274322000,335194000,2549384000,984747000
Rhode Island,Administrative and Support and Waste Management and Remediation Services,2012,7865,5185,950,475,6610,585,225,7420,445,8275,5185,955,475,6615,605,245,7465,810,100826,4017,5623,4925,15806,19430,22366,64166,30795,3093825000,319975000,191511000,202576000,737126000,589016000,507884000,1998726000,942499000
Rhode Island,"Agriculture, Forestry, Fishing and Hunting",2012,210,180,10,15,205,5,0,210,0,210,180,10,15,205,5,0,210,0,523,43,0,0,359,0,0,523,0,29273000,9079000,0,0,23163000,0,0,29273000,0
Rhode Island,"Arts, Entertainment, and Recreation",2012,2452,1320,415,295,2030,287,65,2382,70,2680,1320,415,300,2035,295,175,2505,175,36857,1174,2233,3259,7494,9025,4769,24144,0,1052910000,73032000,93531000,105501000,287149000,215270000,92004000,670406000,131383000
Rhode Island,Construction,2012,14655,11210,1835,835,13880,620,90,14590,65,14670,11210,1835,835,13880,620,90,14590,80,75296,15533,10779,10421,38757,19741,7839,70643,0,4315854000,727856000,477294000,552324000,1836875000,1196742000,509412000,3844829000,0
Rhode Island,Educational Services,2012,1936,960,220,210,1390,310,131,1831,105,2060,960,225,250,1435,340,155,1930,130,132843,1375,827,2622,5554,12031,12125,30522,97145,4686243000,45538000,21139000,61794000,140110000,384258000,478717000,1030706000,3437047000
Rhode Island,Finance and Insurance,2012,4075,2215,535,230,2980,250,235,3465,610,6630,2215,535,240,2990,370,695,4055,2575,88696,3071,3036,2419,8146,7153,13107,31188,43033,7713241000,195248000,198629000,191050000,622403000,595235000,946111000,2524643000,3677751000
Rhode Island,Health Care and Social Assistance,2012,12411,5060,2875,1694,9629,1454,791,11874,537,16225,5065,2895,1765,9725,2085,2465,14275,1950,413644,9181,18660,21551,51707,59846,96311,217992,183176,17498640000,426781000,810295000,967480000,2228564000,2520759000,3507757000,8473233000,8707759000
Rhode Island,Information,2012,1343,535,230,125,890,150,75,1115,228,2120,535,230,125,890,210,80,1180,940,33168,436,996,820,2135,4779,933,11479,17357,2106536000,34184000,62294000,47195000,148957000,223157000,54343000,529883000,1263166000
Rhode Island,Management of Companies and Enterprises,2012,592,25,15,20,60,80,146,286,306,920,25,15,20,60,85,170,315,605,61170,6,48,105,168,1804,4557,6600,54350,5478700000,2861000,3188000,6235000,10760000,193152000,240385000,448575000,5018570000
Rhode Island,Manufacturing,2012,7447,2990,1304,1096,5390,1381,371,7142,305,7555,2990,1305,1115,5410,1415,405,7230,325,156948,3390,6729,11456,25232,42176,22102,113396,24462,7998480000,174846000,259795000,452267000,1009607000,1873198000,1088692000,5072881000,1628139000
Rhode Island,"Mining, Quarrying, and Oil and Gas Extraction",2012,85,40,15,20,75,5,0,80,5,90,40,15,20,75,5,0,80,10,594,0,63,0,381,0,0,489,0,34894000,2429000,4584000,13405000,22605000,0,0,28189000,0
Rhode Island,Other,2012,27,26,0,1,27,0,0,27,0,27,26,0,1,27,0,0,27,0,41,29,0,0,41,0,0,41,0,570000,550000,0,0,570000,0,0,570000,0
Rhode Island,Other Services (except Public Administration),2012,13716,8785,2815,1156,12756,635,100,13491,225,14455,8785,2820,1170,12775,910,110,13795,660,84677,15262,17365,13693,48580,20231,1339,75761,6288,2429260000,438438000,446753000,414797000,1316746000,654835000,55721000,2191953000,162268000
Rhode Island,"Professional, Scientific, and Technical Services",2012,14432,9870,1975,980,12825,807,250,13882,550,15040,9870,1980,985,12835,850,260,13945,1095,107526,13569,11557,11235,38916,20892,10685,75135,24664,6704629000,740560000,643126000,717140000,2179151000,1400436000,882327000,4746151000,1646406000
Rhode Island,Real Estate and Rental and Leasing,2012,4372,3090,480,280,3850,206,93,4149,223,5125,3090,495,320,3905,275,230,4410,715,25535,3605,2224,2945,10620,5090,1564,18576,4829,1137502000,193294000,104132000,136792000,472892000,188657000,62450000,779084000,281249000
Rhode Island,Retail Trade,2012,14335,8050,2584,1349,11983,791,349,13123,1212,18940,8070,2660,1455,12185,960,720,13865,5075,222650,10845,14512,14231,43958,17569,10041,81692,83191,5791393000,356465000,406491000,435334000,1249039000,703714000,494991000,2673269000,2009764000
Rhode Island,Total,2012,24022,13918,3963,2388,20269,2158,585,23012,1010,28034,13927,3995,2468,20390,2576,1331,24297,3737,402977,23318,25899,31808,81025,77677,62934,221636,181341,17286685000,902542000,912089000,1161011000,2975642000,3039831000,2665931000,8681404000,8605281000
Rhode Island,Transportation and Warehousing,2012,2881,1730,340,220,2290,242,85,2617,264,3075,1730,340,225,2295,255,90,2640,435,43320,1674,1761,1836,6702,5493,2104,18572,10604,1501000000,95309000,61245000,65631000,254624000,223321000,72195000,679888000,564048000
Rhode Island,Utilities,2012,99,40,5,20,65,0,0,65,34,200,40,5,20,65,0,0,65,135,3078,0,0,0,271,0,0,271,2126,288754000,1134000,0,23969000,27498000,0,0,27498000,192656000
Rhode Island,Wholesale Trade,2012,6491,2815,1030,600,4445,967,265,5677,814,6910,2820,1030,605,4455,1030,275,5760,1150,88115,4132,5147,6072,17348,21654,7030,56068,22634,5371439000,232727000,292857000,386985000,979034000,1297236000,452618000,3284151000,1539349000
South Carolina,Accommodation and Food Services,2012,36474,12920,7030,7137,27087,7342,1069,35498,976,49255,12930,7065,7240,27235,8440,4165,39840,9415,923170,19809,47154,96527,164639,270116,145776,582164,314569,13583945000,458322000,576892000,1277828000,2317060000,3890414000,1990653000,8222549000,5339686000
South Carolina,Administrative and Support and Waste Management and Remediation Services,2012,24314,14465,3745,2104,20314,1993,781,23088,1226,27445,14470,3760,2135,20365,2105,1055,23525,3920,746777,21452,23443,25534,75157,70553,99261,259040,464118,22003431000,687318000,673407000,741332000,2189364000,2136851000,2417713000,7153503000,12981588000
South Carolina,"Agriculture, Forestry, Fishing and Hunting",2012,2490,1215,680,340,2235,170,45,2450,40,2510,1215,680,340,2235,170,55,2460,50,19741,2136,4481,3996,10867,4331,1582,18209,373,735368000,78423000,158317000,146234000,396056000,166956000,58900000,646866000,26601000
South Carolina,"Arts, Entertainment, and Recreation",2012,7002,3690,920,873,5483,1116,263,6862,140,7670,3715,935,890,5540,1230,530,7300,370,119171,4349,5547,11437,22915,42636,25798,100978,13369,2235625000,178805000,107814000,192012000,491790000,807433000,438763000,1931374000,210099000
South Carolina,Construction,2012,42770,27684,7535,4090,39309,2785,320,42414,356,43355,27690,7535,4100,39325,2855,460,42640,715,325973,45131,49513,53438,150355,98502,29348,285690,24461,12965673000,1422540000,1599305000,1971858000,5031705000,4136490000,1510666000,10945620000,1280324000
South Carolina,Educational Services,2012,5226,2598,795,693,4086,770,170,5026,200,5600,2600,795,730,4125,800,275,5200,400,152464,3342,4845,8949,18342,30441,28948,80364,70379,3632323000,96902000,83871000,160691000,348868000,728243000,870352000,2009338000,1570157000
South Carolina,Finance and Insurance,2012,16178,10255,2363,990,13608,843,457,14908,1270,36125,10290,2515,1350,14155,2620,2920,19695,16430,304722,15622,14195,11462,43751,27489,31002,105959,188623,17385290000,764775000,554774000,590748000,1930158000,1396607000,1562548000,5098454000,12019386000
South Carolina,Health Care and Social Assistance,2012,38048,16495,9355,5368,31218,4405,1230,36853,1195,48985,16535,9415,5640,31590,5805,3520,40915,8070,1058624,30137,60807,70937,163866,164193,143063,487724,565752,44270655000,1515472000,2353012000,2824892000,6694448000,6536762000,4521545000,17920219000,26094195000
South Carolina,Information,2012,3522,1705,395,270,2370,340,197,2907,615,6965,1705,395,290,2390,455,370,3215,3750,141416,1996,1526,2905,6941,9226,4781,30642,110743,7909967000,98520000,72682000,116578000,315247000,513747000,613516000,1631073000,6248496000
South Carolina,Management of Companies and Enterprises,2012,2115,130,25,65,220,352,609,1181,934,3050,130,25,65,220,360,655,1235,1815,112443,22,106,364,680,3118,15904,19778,92466,9654924000,22137000,10097000,15412000,51453000,181527000,973316000,1212424000,8412410000
South Carolina,Manufacturing,2012,17871,6130,2645,2255,11030,2907,1484,15421,2450,19335,6135,2645,2255,11035,3085,1730,15850,3485,921105,8606,13988,25280,53952,96455,129369,316514,534376,44926679000,360356000,506234000,994877000,2026721000,4084987000,5902459000,13480228000,27487014000
South Carolina,"Mining, Quarrying, and Oil and Gas Extraction",2012,290,125,15,35,175,30,25,230,60,400,125,15,35,175,30,25,230,170,5211,139,0,336,716,413,692,2559,2389,293721000,9605000,2717000,15208000,37097000,20902000,36426000,150706000,124538000
South Carolina,Other,2012,88,85,2,1,88,0,0,88,0,88,85,2,1,88,0,0,88,0,70,50,0,0,70,0,0,70,0,1308000,1126000,0,0,1308000,0,0,1308000,0
South Carolina,Other Services (except Public Administration),2012,52220,31800,11716,4640,48156,3119,422,51697,523,55600,31800,11795,4795,48390,4000,1005,53395,2205,388923,60079,74773,60482,197808,108962,33044,347467,26117,9251513000,1297686000,1580947000,1374213000,4282341000,2454874000,799824000,7628786000,1002316000
South Carolina,"Professional, Scientific, and Technical Services",2012,44789,31560,6025,3075,40660,2049,815,43524,1265,48645,31560,6050,3190,40800,2700,1370,44870,3775,393938,45294,37553,39113,124523,60893,47105,240507,143386,23567057000,2103656000,1648570000,1901119000,5675297000,3881664000,3246842000,13066737000,10249328000
South Carolina,Real Estate and Rental and Leasing,2012,18447,14180,1652,767,16599,731,474,17804,643,23325,14195,1740,865,16800,1275,1375,19450,3875,111353,19605,9449,8754,39006,21003,19424,81956,26326,4179112000,697686000,339286000,326468000,1382885000,703409000,710983000,2838187000,1158958000
South Carolina,Retail Trade,2012,52796,31009,10445,4872,46326,3455,947,50728,2068,87970,31145,10745,5700,47590,5905,3785,57280,30690,1031212,54932,63188,52200,171972,111426,53232,355531,615500,23370869000,1280599000,1494745000,1552868000,4436793000,3616760000,1583063000,9866861000,12701930000
South Carolina,Total,2012,77617,44392,13957,8044,66393,6940,1905,75238,2379,101228,44464,14154,8534,67152,9187,5270,81609,19619,1548516,77069,91442,106934,275445,250495,202830,728770,819746,56665721000,2463336000,2634115000,3242425000,8339876000,8149340000,7046467000,23535683000,33130038000
South Carolina,Transportation and Warehousing,2012,10695,5897,1355,745,7997,849,610,9456,1239,12540,5900,1365,760,8025,950,810,9785,2755,241677,8274,8529,8463,27093,20813,20905,76187,139932,9440637000,300750000,263252000,272702000,879197000,792425000,846581000,2708153000,5674634000
South Carolina,Utilities,2012,458,135,50,35,220,110,75,405,53,1670,135,50,35,220,150,185,555,1115,50139,265,278,327,886,4884,6904,12898,740,3860654000,7178000,10748000,14954000,33548000,260742000,417222000,720377000,58901000
South Carolina,Wholesale Trade,2012,20577,9597,3195,2152,14944,2463,1214,18621,1956,25255,9620,3235,2250,15105,3000,2060,20165,5090,308198,13858,18476,23631,62720,59770,44099,179556,96145,16143483000,753313000,874183000,1150429000,2881173000,3048051000,2254513000,8660123000,6055351000
South Dakota,Accommodation and Food Services,2012,10138,4050,1780,1874,7704,1871,329,9904,234,11795,4050,1825,1900,7775,2210,840,10825,970,188980,5777,11590,25876,43203,65382,36702,146535,40621,2701895000,156177000,129056000,298340000,588020000,885015000,580613000,2072815000,628657000
South Dakota,Administrative and Support and Waste Management and Remediation Services,2012,5099,3275,802,355,4432,228,125,4785,314,5360,3275,805,375,4455,255,145,4855,505,51220,4294,4412,3640,14302,7274,6910,30950,15701,1654974000,177316000,119133000,84225000,412255000,189946000,177026000,1000439000,494531000
South Dakota,"Agriculture, Forestry, Fishing and Hunting",2012,710,580,65,35,680,15,10,705,5,710,580,65,35,680,15,10,705,5,1413,514,360,292,1444,0,0,1383,0,86677000,34126000,9889000,12022000,59932000,0,0,85917000,0
South Dakota,"Arts, Entertainment, and Recreation",2012,3153,1855,580,340,2775,268,60,3103,50,3330,1855,580,355,2790,315,165,3270,60,27515,1946,3430,3535,10288,9360,2326,24459,387,468565000,75515000,56052000,59410000,208974000,166867000,33753000,446982000,11841000
South Dakota,Construction,2012,15601,10885,2640,1170,14695,734,102,15531,70,15710,10885,2640,1175,14700,740,155,15595,115,87773,17140,16521,13899,49488,24453,6193,84058,2621,3871049000,649642000,615517000,587192000,1894905000,1281569000,306004000,3658549000,136936000
South Dakota,Educational Services,2012,1073,445,170,130,745,175,90,1010,63,1120,445,170,135,750,180,90,1020,100,38222,542,827,1321,3427,6257,14481,24179,12090,894167000,14254000,15159000,18900000,56151000,132152000,399666000,626128000,265073000
South Dakota,Finance and Insurance,2012,6169,3995,700,395,5090,363,184,5637,532,9890,4000,730,605,5335,870,1065,7270,2620,127954,6147,3737,4581,15395,9542,12814,41160,71986,5793180000,243041000,164581000,210365000,638270000,504473000,698126000,1945163000,3417170000
South Dakota,Health Care and Social Assistance,2012,9062,4085,1780,1220,7085,1104,578,8767,295,11430,4090,1790,1250,7130,1775,1590,10495,935,302788,6322,11756,13136,34153,42538,63811,145933,147077,12150261000,284461000,368269000,592719000,1275779000,1580141000,2277781000,5219209000,6565437000
South Dakota,Information,2012,1444,570,230,140,940,183,107,1230,214,2210,570,240,140,950,290,330,1570,640,28254,860,1253,964,3556,5012,3749,15540,6366,1275795000,23418000,33427000,36482000,106243000,200205000,131236000,611228000,419391000
South Dakota,Management of Companies and Enterprises,2012,637,5,10,10,25,130,251,406,231,740,5,10,10,25,130,275,430,310,25326,0,0,0,120,922,4537,5835,19546,2006226000,0,0,0,3268000,75397000,287937000,380980000,1624862000
South Dakota,Manufacturing,2012,4779,1845,800,555,3200,799,316,4315,464,5120,1845,800,560,3205,835,445,4485,635,166643,1949,3460,4075,12270,23623,19878,72939,69353,6880041000,90307000,116814000,173684000,448424000,983164000,754425000,2861585000,2967668000
South Dakota,"Mining, Quarrying, and Oil and Gas Extraction",2012,280,115,45,15,175,42,19,236,44,325,115,45,15,175,45,40,260,65,3880,70,213,0,308,815,700,2626,0,228349000,8698000,9632000,0,26022000,34902000,50484000,158411000,21274000
South Dakota,Other,2012,24,24,0,0,24,0,0,24,0,24,24,0,0,24,0,0,24,0,13,13,0,0,13,0,0,13,0,407000,407000,0,0,407000,0,0,407000,0
South Dakota,Other Services (except Public Administration),2012,13093,8595,2610,1075,12280,600,98,12978,115,13650,8595,2625,1115,12335,910,120,13365,285,72025,15015,15710,12728,45645,17412,1370,66137,246,1549708000,337123000,345289000,285775000,992622000,390279000,28400000,1456463000,37392000
South Dakota,"Professional, Scientific, and Technical Services",2012,8698,5685,1365,775,7825,400,131,8356,342,9135,5685,1380,810,7875,525,165,8565,570,53732,8675,8504,8943,27067,9390,0,43480,9139,2413580000,333173000,326221000,373245000,1071844000,475026000,122650000,1817519000,517209000
South Dakota,Real Estate and Rental and Leasing,2012,4149,3110,448,215,3773,148,85,4006,143,4810,3110,460,230,3800,230,455,4485,325,17641,398,2505,2415,9212,2770,850,15557,1540,533879000,111051000,73350000,80453000,278413000,92316000,56856000,446795000,70901000
South Dakota,Retail Trade,2012,14743,6474,3339,2182,11995,1395,473,13863,880,19405,6505,3360,2365,12230,2060,1655,15945,3460,223258,8407,20064,26776,60093,38341,18178,130783,78538,5285686000,287977000,440326000,643578000,1427614000,1090128000,429253000,3410332000,1580537000
South Dakota,Total,2012,21522,12262,3768,2298,18328,1863,541,20732,790,25773,12273,3816,2443,18532,2661,1715,22908,2865,336526,20800,24615,30031,75446,65999,57787,199232,137294,11768782000,643512000,667659000,882296000,2193467000,2136682000,2020980000,6351129000,5417653000
South Dakota,Transportation and Warehousing,2012,5334,3490,715,434,4639,302,139,5080,254,5770,3490,715,450,4655,345,200,5200,570,43619,3127,4068,4680,14709,8311,2269,27884,12211,1755035000,175106000,143220000,164258000,516551000,319683000,91865000,1069017000,537381000
South Dakota,Utilities,2012,358,60,60,60,180,100,10,290,68,790,60,60,60,180,175,50,405,385,9630,0,0,855,1401,2872,0,5566,96,665800000,1929000,17971000,47520000,68971000,179166000,0,338991000,23852000
South Dakota,Wholesale Trade,2012,5644,2085,770,594,3449,1016,452,4917,727,7445,2085,780,630,3495,1400,780,5675,1770,85170,2489,3739,5234,14007,24630,14455,59595,17185,4109546000,133155000,161552000,254389000,601179000,1051319000,805068000,2792625000,1056593000
Tennessee,Accommodation and Food Services,2012,40815,14378,7470,7989,29837,8677,1064,39578,1237,60055,14390,7495,8255,30140,10665,4475,45280,14775,1184196,21840,50222,108480,182064,308853,146363,638212,534939,17680192000,572200000,644964000,1444647000,2663895000,4491489000,2045018000,9221378000,8283942000
Tennessee,Administrative and Support and Waste Management and Remediation Services,2012,27147,14390,4340,2808,21538,2772,1013,25323,1824,32845,14400,4375,2885,21660,3020,1440,26120,6725,1057878,23224,25758,35894,88054,106113,128298,333689,710249,31757974000,907080000,932659000,1145087000,3054521000,3816327000,3585973000,10701489000,20617105000
Tennessee,"Agriculture, Forestry, Fishing and Hunting",2012,1195,835,210,65,1110,45,25,1180,15,1210,835,215,65,1115,45,25,1185,25,6921,1303,1228,766,3571,1130,0,5483,0,251010000,46714000,42861000,27957000,124694000,32686000,29318000,238881000,0
Tennessee,"Arts, Entertainment, and Recreation",2012,11141,6305,1875,1290,9470,1183,257,10910,231,11700,6305,1885,1295,9485,1255,355,11095,605,151364,7158,11929,15373,37108,43161,23901,110943,34036,6073608000,582462000,408407000,755952000,1877629000,1455218000,948047000,4822774000,711673000
Tennessee,Construction,2012,45790,27145,8120,5339,40604,4189,569,45362,428,46575,27145,8120,5340,40605,4285,775,45665,910,474160,46628,52613,71048,172665,153194,62046,394705,74571,21553470000,1628225000,1831200000,2908404000,6368375000,7659468000,3247203000,17577090000,3683459000
Tennessee,Educational Services,2012,5902,2465,965,760,4190,961,425,5576,326,6335,2465,965,795,4225,1040,470,5735,600,278180,1046,6254,9809,21152,39970,66223,134638,137387,9280099000,132299000,147190000,205765000,491580000,1104432000,2166708000,4021879000,5012400000
Tennessee,Finance and Insurance,2012,22530,13960,3000,1276,18236,1650,948,20834,1696,48765,13970,3295,1700,18965,5210,5535,29710,19055,528898,22568,17898,15871,60085,58035,66862,193130,306811,34991988000,1124092000,855099000,1062227000,3078562000,4559594000,3889130000,12441116000,21911256000
Tennessee,Health Care and Social Assistance,2012,55987,24198,13761,8018,45977,6136,2113,54226,1761,75495,24240,13805,8520,46565,8310,6460,61335,14160,1927725,48237,89983,103512,244569,231026,298732,780435,1102127,85448091000,2344150000,3537713000,4457001000,10428870000,10472735000,11292330000,32416830000,52215460000
Tennessee,Information,2012,7116,3405,1100,701,5206,710,323,6239,877,12225,3410,1100,730,5240,805,615,6660,5565,212054,4367,5721,6713,18528,21004,14163,60066,128793,11719113000,263157000,245699000,330803000,888716000,1134160000,737147000,3039637000,8359257000
Tennessee,Management of Companies and Enterprises,2012,3715,130,55,85,270,670,1001,1941,1774,7080,130,55,85,270,670,1020,1960,5120,366725,179,35,289,695,5658,31698,38350,328374,38881565000,17305000,37220000,32975000,88756000,576125000,2412116000,3086430000,35794850000
Tennessee,Manufacturing,2012,27150,9220,4465,3350,17035,4819,2205,24059,3091,29165,9240,4475,3370,17085,5045,2615,24745,4420,1305189,14368,25128,38041,84589,161779,173947,476251,726768,62519469000,585529000,896987000,1524471000,3205296000,6922086000,7727327000,19850887000,37488159000
Tennessee,"Mining, Quarrying, and Oil and Gas Extraction",2012,647,225,100,70,395,89,45,529,118,1035,225,100,70,395,95,105,595,440,7936,88,584,215,1556,1994,1071,6457,0,571046000,14998000,23056000,23432000,72204000,127074000,87760000,379033000,0
Tennessee,Other,2012,87,84,3,0,87,0,0,87,0,87,84,3,0,87,0,0,87,0,73,55,18,0,73,0,0,73,0,1530000,1343000,187000,0,1530000,0,0,1530000,0
Tennessee,Other Services (except Public Administration),2012,64606,39665,13100,6090,58855,4457,680,63992,614,69955,39675,13125,6510,59310,5915,1315,66540,3415,537521,75283,83589,78581,240129,160344,60141,465673,53628,13389780000,1677747000,1859953000,1973152000,5532818000,3802583000,1359815000,10790852000,2108835000
Tennessee,"Professional, Scientific, and Technical Services",2012,49708,32725,7090,4133,43948,3134,1065,48147,1561,54415,32730,7110,4300,44140,3845,1510,49495,4920,492205,53408,45470,53103,155177,94648,70192,326529,155670,29792925000,2533556000,2094957000,2826829000,7516062000,5810455000,4472952000,18048708000,11230020000
Tennessee,Real Estate and Rental and Leasing,2012,19045,13165,2491,1163,16819,998,538,18355,690,26990,13215,2565,1300,17080,1650,2120,20850,6140,150708,18067,15075,13579,50644,28144,20162,102740,40236,6211400000,710521000,529853000,600254000,1861655000,1254390000,836243000,4039810000,2040842000
Tennessee,Retail Trade,2012,68860,39378,13559,6866,59803,5340,1203,66346,2514,112975,39520,13900,7810,61230,8410,4465,74105,38870,1422601,69243,87663,85687,248166,173587,86596,517512,842033,35352594000,1617199000,2036699000,2428982000,6102103000,6071457000,3198856000,15584856000,19071274000
Tennessee,Total,2012,96348,52050,17735,10920,80705,9889,2706,93300,3048,130592,52127,17950,11638,81715,13386,7490,102591,28001,2344047,94655,116634,144821,356110,360102,307316,1023528,1320519,96087992000,3302329000,3680320000,5051421000,12034070000,13863890000,12330287000,38228247000,57859745000
Tennessee,Transportation and Warehousing,2012,15540,7140,2552,1700,11392,1549,812,13753,1787,20360,7140,2565,1725,11430,1700,1075,14205,6155,506583,10863,16332,20860,49823,48889,46148,151410,340709,20058846000,411295000,542725000,705641000,1687411000,1877401000,1999308000,5866628000,13456437000
Tennessee,Utilities,2012,292,50,20,5,75,100,50,225,67,715,50,20,5,75,205,225,505,210,15362,9,0,0,120,4990,6616,12139,2715,959880000,2485000,0,0,7292000,290552000,435110000,756461000,182742000
Tennessee,Wholesale Trade,2012,27682,11115,4533,3266,18914,3918,1915,24747,2935,34630,11130,4565,3430,19125,4760,2850,26735,7895,553166,16506,27184,38125,89463,107673,78173,292925,242168,31809735000,976650000,1402995000,2104450000,4583917000,5977538000,4668152000,15863378000,15254273000
Texas,Accommodation and Food Services,2012,166708,61295,32358,31187,124840,35886,3779,164505,2203,243715,61365,32595,31790,125750,43310,17715,186775,56940,4811963,100998,215911,421918,739265,1318711,607056,2667195,2114802,77326055000,2645060000,2861920000,5693330000,11200800000,19713366000,9114961000,40074340000,37246401000
Texas,Administrative and Support and Waste Management and Remediation Services,2012,109823,61485,17030,10772,89287,11979,4507,105773,4050,130755,61500,17130,10990,89620,13045,6085,108750,22005,4602075,99380,111600,142407,359269,466547,679191,1519940,3042889,162828395000,4810995000,4035651000,5330908000,14186175000,17463665000,21719278000,53560330000,107912176000
Texas,"Agriculture, Forestry, Fishing and Hunting",2012,5025,3445,920,305,4670,220,90,4980,45,5275,3445,920,305,4670,230,290,5190,85,32614,4928,5884,3920,14824,6834,5601,28574,3928,1149848000,212612000,209568000,149881000,583272000,237660000,135540000,1005168000,138936000
Texas,"Arts, Entertainment, and Recreation",2012,28245,15680,4355,3681,23716,3325,733,27774,471,31645,15685,4370,3780,23835,3695,1140,28670,2975,588757,21398,28108,49067,102075,127046,99342,343718,217517,16608796000,1003511000,594910000,1002773000,2604616000,2502287000,4318467000,9758246000,6489392000
Texas,Construction,2012,188533,111118,33768,20330,165216,18386,3344,186946,1587,192720,111125,33785,20365,165275,18960,4505,188740,3980,2759915,190010,222855,274021,687570,710405,499402,1903865,846027,140722645000,8056260000,8336205000,11604760000,27997225000,33392655000,27016570000,88684555000,51450691000
Texas,Educational Services,2012,27592,13523,4405,3645,21573,4245,1081,26899,693,31040,13540,4410,3720,21670,4755,1915,28340,2700,844856,19983,28867,47358,98956,172178,148270,426902,401726,28860325000,724115000,599972000,1013501000,2343325000,4755259000,5134393000,12443180000,15670117000
Texas,Finance and Insurance,2012,97076,66422,13276,5274,84972,5956,2741,93669,3407,197645,66585,13710,6655,86950,13850,13890,114690,82955,2387383,98425,82184,66590,266220,211726,269370,757840,1594790,167648951000,5692581000,4306143000,4621372000,14691452000,16161486000,17945317000,49775265000,115712581000
Texas,Health Care and Social Assistance,2012,252366,121759,58960,34768,215487,26553,6913,248953,3413,308305,121830,59150,35900,216880,34785,18320,269985,38320,6673044,213986,389883,463682,1074513,1028319,1120657,3232459,3401378,278249780000,15002296000,16727239000,18468698000,50206857000,37516967000,35389292000,123420117000,154217471000
Texas,Information,2012,22962,11885,3065,2328,17278,2634,1094,21006,1956,44825,11910,3075,2365,17350,3170,2105,22625,22200,1085737,16923,19767,30092,69331,92961,89093,261075,814931,79668303000,1134747000,945859000,1628286000,3733821000,5941643000,6192521000,16126746000,63218987000
Texas,Management of Companies and Enterprises,2012,12678,976,320,415,1711,2393,3459,7563,5115,21960,980,320,415,1715,2480,3730,7925,14035,1397355,1187,1543,2776,5614,32240,114765,152630,1244646,178236640000,274985000,134050000,200140000,609175000,2511185000,10439810000,13561270000,164665184000
Texas,Manufacturing,2012,90280,34080,15615,12748,62443,16042,5536,84021,6259,98885,34090,15635,12835,62560,16705,6845,86110,12775,3737289,55060,96125,164722,333862,617449,624001,1647418,1947538,214306921000,2801939000,3629643000,6921600000,13736855000,29360210000,30761537000,77016582000,128241131000
Texas,"Mining, Quarrying, and Oil and Gas Extraction",2012,35169,20178,4648,3499,28325,4417,1308,34050,1119,41770,20190,4665,3540,28395,4700,2015,35110,6660,1105310,31627,30235,47037,109206,169964,174904,456277,646432,107637870000,2696398000,2019964000,3449056000,8179582000,13575771000,15809577000,37677699000,69957552000
Texas,Other,2012,514,491,18,4,513,1,0,514,0,514,491,18,4,513,1,0,514,0,0,0,113,46,0,0,0,0,0,12899000,11331000,1030000,494000,12855000,0,0,12899000,0
Texas,Other Services (except Public Administration),2012,220150,131255,44901,23502,199658,16464,2502,218624,1526,244260,131360,45140,24795,201295,21820,5775,228890,15370,2111932,246974,292340,308076,849919,596399,277253,1726565,342500,59691940000,6251615000,7095930000,7604591000,20960266000,14710558000,7794085000,43543640000,14712727000
Texas,"Professional, Scientific, and Technical Services",2012,286496,204193,36836,19974,261003,16614,4434,282051,4445,312180,204265,37010,20535,261810,20035,7890,289735,22445,3132550,285952,240946,262100,814515,572243,421119,1812580,1256049,243885490000,18503910000,13156061000,15956043000,47634910000,42355477000,32886014000,123187510000,117215597000
Texas,Real Estate and Rental and Leasing,2012,95847,71258,11387,5257,87902,4513,1812,94227,1620,130640,71370,11620,5895,88885,7660,7900,104445,26195,839301,108729,72436,64820,247337,147991,137107,543273,276750,40429881000,4303080000,2695826000,2855753000,9872220000,7216233000,6597837000,24163875000,15864158000
Texas,Retail Trade,2012,222957,132137,44821,22748,199706,15643,3947,219296,3661,392165,132555,46300,25815,204670,27125,16965,248760,143405,5213094,220189,283748,282817,778778,538021,396017,1789030,3210054,134714310000,6371855000,6964936000,7976303000,21458531000,18639600000,16593349000,57077812000,75894670000
Texas,Total,2012,404116,233246,71809,44075,349130,40127,9336,398593,5523,537839,233561,72691,46523,352775,53019,27068,432862,104977,9350829,402130,472250,588862,1463242,1515910,1296716,4275868,5074961,446679425000,17969021000,16947367000,21842707000,56759095000,61408584000,58543401000,176711080000,269968345000
Texas,Transportation and Warehousing,2012,66377,36422,10453,6449,53324,6503,2749,62576,3801,85270,36440,10530,6585,53555,7465,5315,66335,18935,1689100,55625,66962,83592,208610,211714,210091,653116,1029178,83629808000,2473745000,2600724000,3501036000,8621557000,9943885000,10419339000,29911780000,53568382000
Texas,Utilities,2012,4964,2635,930,355,3920,478,232,4630,334,9960,2640,930,365,3935,590,670,5195,4765,249446,5443,5642,4321,15728,20356,32270,69497,151323,22284067000,231031000,271248000,323924000,852833000,1346764000,2264856000,4637153000,17553110000
Texas,Wholesale Trade,2012,128195,64374,21678,14636,100688,15623,5874,122185,6010,163610,64475,22070,15945,102490,20710,12270,135470,28140,2419530,108752,139447,186561,440134,487525,395192,1330173,1030057,159877055000,6276350000,7300052000,10363096000,23981280000,28230304000,23711915000,76231819000,80707567000
United States,Accommodation and Food Services,2012,2480944,1006168,494871,464897,1965936,459110,44264,2469310,11634,3313785,1008185,496695,472650,1977530,548185,203260,2728975,584810,59926370,1693603,3307768,6335973,11341870,16823670,7725666,35891620,22560156,1017823985000,41474095000,44593050000,87389980000,173457165000,262033440000,124266137000,559768700000,457965828000
United States,Administrative and Support and Waste Management and Remediation Services,2012,1640319,1053215,242229,145958,1441402,137397,40503,1619302,21017,1937325,1053895,243190,149310,1446395,156720,70535,1673650,263675,49331480,1590039,1589960,1964025,5165330,5465990,6947772,17579275,31601313,1751963505000,64644865000,51934115000,68152745000,184731725000,194349840000,217351243000,596442445000,1147682603000
United States,"Agriculture, Forestry, Fishing and Hunting",2012,106822,74246,17350,8170,99766,5449,1112,106327,495,110230,74260,17375,8205,99840,5825,2400,108065,2165,805385,110331,112841,106956,331260,194741,156944,685775,108369,29546740000,4326530000,3981226000,3971360000,12280505000,7501665000,4876046000,24752455000,4225589000
United States,"Arts, Entertainment, and Recreation",2012,576026,362136,75791,57344,495271,62976,13365,571612,4414,625410,362380,76210,58550,497140,69295,23395,589830,35580,10286450,416374,497705,773815,1746660,2533785,2226585,6507030,3733335,330055270000,43287285000,13666960000,18173970000,75128215000,56322670000,86794855000,218245740000,110042303000
United States,Construction,2012,3208440,2203347,495797,274928,2974072,202999,25220,3202291,6149,3264510,2203420,495955,275565,2974940,211080,38665,3224685,39825,26304710,3445600,3237745,3671175,10354520,7554715,3990865,21900100,4385482,1376009110000,131558475000,126364740000,168358490000,426281705000,405740345000,245857790000,1077879840000,298004746000
United States,Educational Services,2012,423418,209021,65711,53545,328277,70664,17399,416340,7078,479360,209185,66065,55250,330500,80175,30180,440855,38505,17385235,323117,439355,729135,1494835,2961940,3010030,7466805,9900647,602287360000,10704740000,9496530000,16094290000,36295560000,85375750000,105023465000,226694775000,375379916000
United States,Finance and Insurance,2012,1184786,849300,163321,67754,1080375,69233,22071,1171679,13107,2372550,851295,169455,85655,1106405,174755,178110,1459270,913280,29898305,1406841,1032660,890072,3413068,2735045,3382418,9536176,20289621,2608782855000,72122981000,58495759000,66790094000,197425770000,227174750000,288995604000,714278178000,1893620797000
United States,Health Care and Social Assistance,2012,3249850,1640040,731127,410472,2781639,322598,104162,3208399,41451,4169415,1642145,735740,431575,2809460,461370,344980,3615810,553605,91787593,2976029,4840568,5456285,13315860,12626425,16310286,42255690,49468832,4073412250000,155302904000,198590619000,230034648000,583983784000,504300390000,555174290000,1643521535000,2424828765000
United States,Information,2012,358823,214243,50807,36812,301862,38733,10750,351345,7478,675925,214580,51325,38545,304450,51305,31370,387125,288800,14954008,312212,334774,494873,1145290,1494938,1665298,4309000,10654533,1276514930000,22954110000,16719495000,26539310000,66212915000,96432349000,122445713000,285392175000,987434323000
United States,Management of Companies and Enterprises,2012,134929,13094,3438,5103,21635,30040,44826,96501,38428,261235,13155,3540,5235,21930,31175,49790,102895,158340,15186495,16460,16516,30520,63535,370310,1497885,1931730,13254765,1580013505000,5942920000,1569643000,2369020000,9883340000,25945765000,111916910000,147746015000,1432267490000
United States,Manufacturing,2012,1313494,534683,238124,193087,965894,240494,69218,1275606,37888,1486105,534965,238470,194570,968005,256905,104725,1329635,156470,55889893,991966,1583677,2631129,5217645,9695341,10493530,25434455,30284992,2989902733000,39896789000,56833131000,105411514000,203856332000,441134666000,510957656000,1157457870000,1827224299000
United States,"Mining, Quarrying, and Oil and Gas Extraction",2012,111772,63447,16288,12165,91900,13560,3929,109389,2383,144545,63500,16425,12465,92390,15910,8360,116660,27885,3631296,101301,107755,164037,373736,512287,578295,1468723,2160005,305992853000,7005141000,6064458000,10428527000,23519831000,36018766000,45473370000,105163934000,200672553000
United States,Other,2012,7104,6856,182,56,7094,9,0,7103,1,7104,6856,182,56,7094,9,0,7103,1,0,0,1126,674,0,238,0,0,0,157537000,125496000,17506000,9160000,152162000,1540000,0,153702000,0
United States,Other Services (except Public Administration),2012,3338047,2134102,667155,311600,3112857,195508,22232,3330597,7450,3654995,2135775,672025,327680,3135480,262260,81335,3479075,175920,26250135,4020701,4332290,4100640,12455245,6991375,3087824,22540670,3445403,747931160000,97391045000,104200560000,107785985000,309377590000,194961515000,106579573000,611086795000,135492593000
United States,"Professional, Scientific, and Technical Services",2012,3872031,2854767,495746,269542,3620055,194629,36735,3851419,20612,4295910,2856085,498525,282540,3637150,260545,102710,4000405,295505,40080905,3865181,3235910,3584560,11070605,7218625,5547040,23836270,16021400,2974870740000,232414960000,172408525000,218145745000,622969230000,530406155000,435995915000,1589371300000,1378896086000
United States,Real Estate and Rental and Leasing,2012,1355800,1061960,151640,69288,1282888,51777,13749,1348414,7386,1748880,1064275,156575,79575,1300425,94535,91315,1486275,262605,9405603,1542603,972025,898440,3410246,1800775,1491848,6721510,2712810,442854020000,59033695000,36217415000,37477085000,132728195000,84191785000,71328936000,288536665000,149878914000
United States,Retail Trade,2012,3275173,1962993,667000,346743,2976736,240572,42790,3260098,15075,5319210,1967985,684260,393005,3045250,401230,233865,3680345,1638865,69807697,3425433,4343807,4506176,12417268,8670495,5315753,26532933,41189767,1852146628000,89520495000,103573937000,119141092000,312237330000,284728002000,189020763000,785984659000,1047947459000
United States,Total,2012,5726160,3543991,992716,593641,5130348,494170,83423,5707941,18219,7431808,3549102,1005042,630811,5184955,687272,360207,6232434,1199374,115938468,5906506,6527943,7974340,20408789,19387249,16266855,56062893,59875575,5414255995000,237897059000,224438258000,290990699000,753326016000,783571581000,730638284000,2267535881000,3146720114000
United States,Transportation and Warehousing,2012,848138,537498,122120,79835,739453,73331,20429,833213,14925,1072460,537945,123325,82835,744105,91700,51910,887715,184745,21147902,805542,802854,1059820,2679306,2695662,2456657,7838616,11889049,923492464000,29483399000,27773002000,38765355000,96028866000,107654575000,102715702000,306627337000,556965095000
United States,Utilities,2012,30362,15365,4920,2512,22797,4567,1638,29002,1360,89165,15480,4990,2820,23290,7335,6850,37475,51690,3204480,29363,31604,33153,94481,202925,258926,557744,2645236,295216555000,1155080000,1345822000,1971189000,4474922000,14597311000,19661141000,38837257000,256191843000
United States,Wholesale Trade,2012,1593413,900444,269047,181495,1350986,177763,43458,1572207,21206,2102505,902720,274155,197745,1374620,256010,147280,1777910,324595,28881215,1524038,1769240,2408355,5702875,6380110,5117967,17202580,11509323,1850445570000,78961085000,88212795000,127764495000,294938375000,358755355000,305096361000,958888145000,888547097000
Utah,Accommodation and Food Services,2012,18563,5980,3620,3953,13553,3946,500,17999,564,25695,6030,3635,4010,13675,4845,2035,20555,5140,477497,8258,23648,54058,87098,137077,68877,295513,177876,7000466000,266601000,275447000,637326000,1188782000,1859057000,1033739000,4115802000,2886398000
Utah,Administrative and Support and Waste Management and Remediation Services,2012,18530,11960,2295,1500,15755,1245,515,17515,1015,20040,11960,2300,1505,15765,1295,575,17635,2405,575547,13763,14024,18767,49700,43840,50530,153539,408543,17510578000,718416000,388133000,603495000,1757689000,1422307000,1613910000,5085587000,11845116000
Utah,"Agriculture, Forestry, Fishing and Hunting",2012,375,265,65,20,350,15,5,370,5,385,265,65,20,350,15,5,370,15,1307,271,300,0,781,0,0,927,0,76022000,11353000,10398000,0,31266000,0,0,54955000,0
Utah,"Arts, Entertainment, and Recreation",2012,4477,2750,615,355,3720,500,139,4359,118,4680,2750,615,355,3720,525,195,4440,240,102185,1508,3620,3934,10527,17792,17217,52111,40206,1938534000,113535000,77873000,64003000,264849000,310483000,545920000,1236939000,508762000
Utah,Construction,2012,40761,28905,5660,3133,37698,2372,354,40424,337,40985,28905,5665,3140,37710,2420,390,40520,465,295590,40127,36638,39690,122895,85757,38727,260390,28195,13487335000,1484661000,1252137000,1630520000,4384625000,3940287000,2172166000,11213890000,1797224000
Utah,Educational Services,2012,4763,2445,670,595,3710,755,155,4620,143,5050,2450,670,595,3715,795,165,4675,375,126885,2373,3860,7813,14862,29989,17195,65660,1360,3424611000,106466000,67131000,151873000,343727000,837468000,504713000,1759937000,1476190000
Utah,Finance and Insurance,2012,15933,11397,1570,725,13692,753,300,14745,1188,24625,11410,1605,855,13870,1550,1290,16710,7915,258934,14205,9170,7363,32642,22431,22923,85665,158114,16134600000,683124000,399797000,445742000,1558315000,1698637000,1680111000,5471926000,10342201000
Utah,Health Care and Social Assistance,2012,31102,16815,6800,3785,27400,2434,663,30497,605,36500,16840,6815,3855,27510,3285,2055,32850,3650,623583,19435,45467,46796,120525,90475,81423,309464,196672,25336557000,1606404000,1392218000,1413551000,4441720000,3095298000,2566032000,10662577000,9174866000
Utah,Information,2012,4971,2480,500,390,3370,606,297,4273,698,6880,2480,500,410,3390,635,400,4425,2455,151042,1240,2604,3610,10042,18614,24247,57446,79751,9583666000,167551000,116034000,175536000,498110000,1105182000,1846442000,3560174000,5326738000
Utah,Management of Companies and Enterprises,2012,1791,275,20,40,335,305,410,1050,741,2370,275,20,40,335,305,420,1060,1310,114299,293,103,0,570,3620,13462,17819,96480,9181727000,15863000,8747000,10336000,35315000,214432000,855332000,1117212000,8064515000
Utah,Manufacturing,2012,15380,5930,2860,2179,10969,2441,726,14136,1244,15845,5930,2865,2185,10980,2520,785,14285,1560,455527,6352,15042,22090,50670,80065,45478,208365,167967,23254864000,306094000,513996000,812434000,1874564000,3417085000,2292544000,8795766000,9563526000
Utah,"Mining, Quarrying, and Oil and Gas Extraction",2012,2322,1195,250,270,1715,220,100,2035,287,2480,1195,250,270,1715,230,100,2045,435,51648,1628,1327,3341,6857,6695,3542,18596,32515,3981797000,111056000,57973000,201595000,400245000,410529000,258395000,1221714000,2754542000
Utah,Other,2012,36,35,0,1,36,0,0,36,0,36,35,0,1,36,0,0,36,0,50,37,0,0,50,0,0,50,0,618000,477000,0,0,618000,0,0,618000,0
Utah,Other Services (except Public Administration),2012,20892,13290,3940,1920,19150,1125,218,20493,399,23335,13320,3945,2030,19295,2015,555,21865,1470,229809,21687,23788,20875,71801,33020,7508,115533,48452,7637992000,582020000,623537000,623948000,1873457000,816198000,275679000,3190528000,1991620000
Utah,"Professional, Scientific, and Technical Services",2012,43184,31855,4595,2450,38900,2300,796,41996,1188,45390,31855,4630,2490,38975,2715,995,42685,2705,366119,29184,28769,30522,98114,74865,65063,250089,79775,19705310000,1824864000,1217935000,1581580000,4655694000,4906272000,3816929000,13830775000,5444533000
Utah,Real Estate and Rental and Leasing,2012,19748,16213,1625,648,18486,603,217,19306,442,22295,16285,1640,710,18635,1025,415,20075,2220,91617,11040,9374,7542,35730,16551,4350,63047,10277,3366899000,628867000,289678000,280339000,1222958000,647786000,201991000,2228324000,495644000
Utah,Retail Trade,2012,29868,15175,5702,3869,24746,2627,685,28058,1810,45265,15215,5845,4200,25260,4125,2575,31960,13305,651991,20156,34488,45971,109199,84017,51334,256243,349938,16800706000,658852000,837720000,1094451000,2652328000,2372840000,1774033000,6979774000,9132203000
Utah,Total,2012,58560,36099,8819,5608,50526,4848,1261,56635,1925,70454,36153,8901,5826,50880,6322,2969,60171,10283,1070986,53037,58048,74116,185201,177717,141361,504279,566707,43317548000,2047068000,1731039000,2316043000,6094150000,6617431000,5972044000,18683625000,24633923000
Utah,Transportation and Warehousing,2012,9930,5895,1175,847,7917,827,351,9095,835,10885,5895,1175,860,7930,865,400,9195,1690,226369,2210,7180,10252,24456,24444,22226,79204,126800,9830121000,276567000,259049000,390791000,953341000,997530000,831653000,2927181000,6128571000
Utah,Utilities,2012,421,245,50,30,325,32,20,377,44,1105,245,50,30,325,85,30,440,665,685,328,341,390,1059,1167,0,5134,0,23412000,9869000,11616000,14645000,36972000,82254000,0,412749000,0
Utah,Wholesale Trade,2012,15999,7270,2195,1530,10995,2061,1047,14103,1896,18280,7285,2215,1565,11065,2360,1460,14885,3395,247778,6972,11928,15974,41538,54181,34566,148853,93688,14453648000,490700000,552783000,851654000,1995033000,2769930000,1967201000,7235845000,6569221000
Vermont,Accommodation and Food Services,2012,8496,3575,1525,1660,6760,1384,136,8280,216,9575,3575,1525,1675,6775,1695,325,8795,780,149636,5486,9864,22824,38533,44597,13759,97521,51901,2479811000,147470000,143398000,354267000,651345000,786203000,267130000,1720925000,753403000
Vermont,Administrative and Support and Waste Management and Remediation Services,2012,5090,3580,645,275,4500,270,45,4815,275,5285,3580,645,285,4510,310,45,4865,420,33144,4712,3417,2620,11606,6432,1203,22495,8230,1044503000,205631000,104216000,85356000,445558000,208640000,19452000,738898000,225635000
Vermont,"Agriculture, Forestry, Fishing and Hunting",2012,690,590,60,25,675,5,10,690,0,690,590,60,25,675,5,10,690,0,1600,253,314,100,1489,0,0,1600,0,58545000,27252000,8248000,3248000,45206000,0,0,58545000,0
Vermont,"Arts, Entertainment, and Recreation",2012,2194,1445,315,200,1960,165,44,2169,25,2270,1445,325,200,1970,180,90,2240,30,31925,1629,1675,2148,6448,3965,4288,17130,9167,555909000,89016000,44256000,64207000,216182000,101005000,56051000,420845000,84526000
Vermont,Construction,2012,13425,10120,1920,740,12780,520,70,13370,55,13445,10120,1920,745,12785,530,75,13390,55,62878,14954,11921,8431,37023,14588,2855,59758,193,3000371000,605806000,501524000,424464000,1561475000,812384000,181098000,2818179000,8397000
Vermont,Educational Services,2012,1725,865,265,150,1280,265,120,1665,60,1810,865,265,150,1280,295,170,1745,65,73753,1152,1268,1804,4633,9770,22513,37756,35713,2084004000,45604000,39549000,38013000,130183000,258082000,727815000,1155904000,919532000
Vermont,Finance and Insurance,2012,2643,1460,275,170,1905,180,117,2202,441,4940,1470,290,255,2015,545,735,3295,1645,46312,2272,1235,1566,5160,3889,7084,19771,6793,2636045000,125174000,83720000,103263000,346774000,294604000,429998000,1310256000,1375370000
Vermont,Health Care and Social Assistance,2012,8700,3940,1855,1170,6965,1032,407,8404,296,10515,3945,1855,1175,6975,1400,1045,9420,1095,220484,6085,10181,12157,33443,37473,42579,118935,90355,8910779000,326713000,426770000,474544000,1268510000,1127752000,1505749000,4005524000,4538230000
Vermont,Information,2012,1826,780,330,195,1305,227,95,1627,199,2440,780,330,195,1305,305,120,1730,710,22920,963,1514,2167,5553,6235,1418,15577,4416,1113257000,37487000,49941000,74462000,184978000,246964000,76153000,775305000,369117000
Vermont,Management of Companies and Enterprises,2012,385,20,10,30,60,75,90,225,160,445,20,10,30,60,85,95,240,205,12478,0,0,119,165,848,3507,4788,7682,773626000,0,0,7619000,16495000,69068000,183275000,287916000,485036000
Vermont,Manufacturing,2012,4857,2165,825,600,3590,721,318,4629,228,5055,2165,825,605,3595,750,420,4765,290,94447,1853,3283,4872,12790,20281,14254,63343,18919,4724462000,99024000,123885000,192451000,474540000,974119000,705285000,2937842000,1055340000
Vermont,"Mining, Quarrying, and Oil and Gas Extraction",2012,216,130,35,10,175,20,5,200,16,250,130,35,10,175,35,15,225,25,1384,177,0,0,358,246,0,880,0,113187000,11284000,678000,0,31871000,12204000,0,64399000,0
Vermont,Other,2012,18,18,0,0,18,0,0,18,0,18,18,0,0,18,0,0,18,0,0,0,0,0,0,0,0,0,0,523000,523000,0,0,523000,0,0,523000,0
Vermont,Other Services (except Public Administration),2012,9683,6510,2020,670,9200,290,78,9568,115,10115,6515,2045,725,9285,495,150,9930,185,43677,10763,12035,8021,31519,5261,165,42789,398,1190399000,320228000,293977000,210383000,838384000,186084000,15566000,1156700000,15120000
Vermont,"Professional, Scientific, and Technical Services",2012,10340,7260,1485,705,9450,445,128,10023,317,10645,7260,1485,730,9475,555,155,10185,460,82270,8775,8898,8285,28610,13113,3139,50194,31240,3632765000,503428000,458239000,473794000,1487703000,903293000,240540000,2963327000,630621000
Vermont,Real Estate and Rental and Leasing,2012,3336,2500,365,175,3040,138,28,3206,130,3690,2500,365,215,3080,235,60,3375,315,13781,3332,1921,1959,7872,2932,470,11669,1082,504058000,128262000,74615000,61035000,271217000,111782000,17839000,417732000,52341000
Vermont,Retail Trade,2012,13067,5830,3006,1759,10595,1240,338,12173,894,17675,5835,3045,1910,10790,2060,1540,14390,3285,184262,7436,17295,18152,47814,29891,21200,105699,35485,4849186000,265065000,441203000,519041000,1286133000,1072058000,618118000,3266519000,774312000
Vermont,Total,2012,18216,10755,3144,1792,15691,1476,365,17532,684,21161,10760,3166,1894,15820,2075,1097,18992,2169,265460,18187,20516,23532,62235,51646,42406,156287,109173,9540625000,639800000,645913000,743803000,2029516000,1895972000,1709690000,5635178000,3905447000
Vermont,Transportation and Warehousing,2012,2213,1330,265,176,1771,207,68,2046,167,2410,1330,265,185,1780,220,95,2095,315,24764,1570,1377,1737,5173,4836,1030,14458,4147,895080000,61504000,47909000,58761000,184090000,195234000,43280000,540860000,166710000
Vermont,Utilities,2012,137,35,10,10,55,20,20,95,42,330,35,10,10,55,25,55,135,195,952,0,0,0,173,342,590,1887,0,749222000,1735000,0,0,11383000,25263000,48108000,157659000,0
Vermont,Wholesale Trade,2012,3732,1550,525,330,2405,527,243,3175,557,4130,1550,530,345,2425,650,285,3360,770,46964,1406,2174,2480,8590,10973,5064,33731,7585,2668235000,94032000,110694000,111512000,386313000,561428000,279802000,1731888000,639149000
Virginia,Accommodation and Food Services,2012,61146,22810,12026,12363,47199,11206,1348,59753,1393,84125,22845,12090,12530,47465,12950,5445,65860,18265,1540446,35850,79589,165903,285041,392912,188618,867935,678344,24966960000,955070000,1181046000,2342954000,4480664000,6169873000,2760874000,13424194000,11275670000
Virginia,Administrative and Support and Waste Management and Remediation Services,2012,45060,25785,6840,4170,36795,4491,1736,43022,2038,52380,25800,6855,4195,36850,4885,2830,44565,7815,1220335,39456,44083,54238,142096,163891,209353,525040,688694,48930921000,1373765000,1465813000,1934511000,4861405000,5963735000,7723458000,18766476000,29848673000
Virginia,"Agriculture, Forestry, Fishing and Hunting",2012,3345,2320,660,195,3175,110,25,3310,35,3360,2320,660,195,3175,110,40,3325,35,18235,3032,3801,2224,10268,1894,302,14494,0,874980000,123850000,122224000,70029000,325084000,91181000,9105000,498891000,0
Virginia,"Arts, Entertainment, and Recreation",2012,12543,7310,1615,1325,10250,1650,324,12224,319,13705,7310,1615,1330,10255,1885,450,12590,1115,232765,8792,10367,17670,39017,65493,38431,150331,72939,5309499000,371373000,215508000,332599000,941392000,1231857000,908475000,3294363000,1385688000
Virginia,Construction,2012,94847,62544,15115,8605,86264,6887,1041,94192,655,96110,62545,15115,8620,86280,7035,1275,94590,1520,841445,104447,99426,115269,320170,253880,123870,702540,123255,40643095000,3522044000,3602248000,4933199000,12061815000,12314415000,6866499000,31540245000,8108059000
Virginia,Educational Services,2012,13002,6605,1775,1710,10090,1978,521,12589,413,14105,6605,1775,1755,10135,2125,675,12935,1170,369955,10187,11415,23023,45236,77632,79579,203570,158535,12318740000,395308000,267863000,540960000,1215520000,2435812000,2930846000,6646510000,5624880000
Virginia,Finance and Insurance,2012,28237,18648,3705,1435,23788,1668,1019,26475,1762,56305,18695,3835,1800,24330,3565,4825,32720,23585,731092,30746,22775,17957,74467,51370,63127,200754,514581,55489620000,1580401000,1250824000,1393333000,4248797000,4113808000,4813904000,13735903000,39192078000
Virginia,Health Care and Social Assistance,2012,72152,31935,16923,10778,59636,8683,2025,70344,1808,93755,31985,17025,11440,60450,12395,6685,79530,14225,2013322,59488,112549,142074,316141,333643,296053,955991,1002624,91149449000,3026033000,4969900000,6486190000,14491963000,14033547000,11844991000,40815767000,47891829000
Virginia,Information,2012,9976,4495,1230,1005,6730,1271,617,8618,1358,19235,4500,1230,1030,6760,1550,945,9255,9980,472330,5464,6533,13153,27133,43550,47737,128872,330890,38984071000,392842000,423684000,789580000,1634931000,3192468000,3843296000,9378506000,28602286000
Virginia,Management of Companies and Enterprises,2012,4133,240,75,100,415,690,1190,2295,1838,6415,240,75,100,415,705,1260,2380,4035,318465,375,40,560,1250,7180,35651,44085,274378,32291115000,21910000,27840000,31240000,80990000,516085000,2750423000,3348005000,28942262000
Virginia,Manufacturing,2012,23740,8975,4205,2986,16166,3870,1546,21582,2158,25420,8975,4205,3000,16180,4130,1935,22245,3175,948020,13596,24402,35666,80279,129908,136033,385101,482770,48311054000,550926000,876514000,1338669000,2979062000,5564290000,6246025000,16595389000,26612366000
Virginia,"Mining, Quarrying, and Oil and Gas Extraction",2012,984,285,115,145,545,181,112,838,146,1440,285,115,145,545,200,210,955,485,45960,271,497,1223,2322,5491,3695,13632,29762,3055740000,23710000,29634000,65254000,161179000,309040000,187350000,715746000,2169555000
Virginia,Other,2012,137,134,0,3,137,0,0,137,0,137,134,0,3,137,0,0,137,0,0,0,0,0,0,0,0,0,0,2637000,2545000,0,0,2637000,0,0,2637000,0
Virginia,Other Services (except Public Administration),2012,98086,59411,20253,9904,89568,6758,907,97233,853,106190,59445,20385,10315,90145,8280,2520,100945,5245,809405,111530,131639,130143,377122,232075,83168,702931,82290,27570220000,2872325000,3434855000,3990627000,10314065000,8396327000,4331856000,23261561000,3140805000
Virginia,"Professional, Scientific, and Technical Services",2012,126073,86131,14768,9360,110259,9374,3308,122941,3132,146690,86145,14825,9645,110615,11030,4865,126510,20180,2105044,93036,95288,123273,343007,327786,342867,1028348,1062014,183289226000,8038590000,6218829000,8935495000,23269602000,27477298000,30552539000,81614143000,100675813000
Virginia,Real Estate and Rental and Leasing,2012,31637,23503,3284,1722,28509,1358,842,30709,928,43765,23540,3455,1995,28990,2580,3475,35045,8720,244232,34508,20329,20902,76772,39429,44859,165037,69099,12099522000,1354768000,803721000,915447000,3088533000,2063537000,2177706000,7428241000,4300326000
Virginia,Retail Trade,2012,79959,43442,16185,9277,68904,6194,1818,76916,3043,137345,43565,16605,10310,70480,9710,5440,85630,51715,1936563,71573,102797,115265,299758,198636,121783,637989,1191309,49958180000,1996024000,2440055000,2923352000,7403549000,6478618000,5109366000,19200819000,29535856000
Virginia,Total,2012,147929,86170,25105,15956,127231,13896,3493,144620,3309,192730,86263,25376,16759,128398,17993,9470,155861,36869,3089241,147511,165254,212064,524829,506279,422276,1453384,1635857,150556416000,5715412000,5899168000,8109920000,19724500000,22009900000,21451337000,63185737000,87370679000
Virginia,Transportation and Warehousing,2012,20602,11550,2827,1860,16237,1918,844,18999,1603,23965,11555,2835,1920,16310,2145,1175,19630,4335,398205,15172,17211,22089,59117,58279,43680,167628,190247,16858798000,564200000,558922000,801450000,1969669000,2419176000,1749433000,6370083000,8356966000
Virginia,Utilities,2012,477,135,45,15,195,65,58,318,159,1595,135,45,15,195,95,190,480,1115,36777,205,245,0,529,1870,7275,9931,7244,4351307000,9353000,8845000,0,24858000,144411000,532548000,741665000,2844089000
Virginia,Wholesale Trade,2012,29461,14135,4056,3294,21485,3667,1713,26865,2596,37060,14155,4135,3440,21730,4590,3110,29430,7630,505377,20101,25028,40646,90638,100461,82441,292093,189764,30104137000,1204440000,1283392000,2163165000,4744992000,5138416000,5292848000,15972214000,12851709000
Washington,Accommodation and Food Services,2012,64945,26060,14832,12760,53652,9422,1066,64140,805,82030,26130,14895,13130,54155,12030,4680,70865,11165,1154878,43605,95190,168802,308189,317475,146030,770187,354992,21976840000,964475000,1392136000,2782593000,5147675000,6000675000,2784877000,13951088000,7403432000
Washington,Administrative and Support and Waste Management and Remediation Services,2012,40799,26270,6200,3290,35760,2813,750,39323,1476,45465,26270,6230,3365,35865,3045,1130,40040,5425,653344,36856,39684,42569,121575,96552,72333,306901,326020,27155083000,1292473000,1251612000,1490874000,4079286000,3706613000,2908437000,11396975000,15539386000
Washington,"Agriculture, Forestry, Fishing and Hunting",2012,6897,5195,660,425,6280,410,130,6820,77,7000,5195,660,425,6280,425,155,6860,140,60238,4763,3806,5452,14142,15226,19035,51078,3833,2782601000,402402000,159140000,253214000,825119000,648104000,766333000,2315385000,275202000
Washington,"Arts, Entertainment, and Recreation",2012,12765,7130,1975,1255,10360,1670,524,12554,211,13695,7135,1975,1270,10380,1745,740,12865,830,295078,6960,12268,16202,37604,66231,80291,189736,90938,8160729000,347895000,284242000,345720000,997852000,1248406000,2084436000,4403145000,2498490000
Washington,Construction,2012,96210,70100,13040,6980,90120,4865,664,95649,561,96955,70100,13040,6980,90120,5030,835,95985,970,631895,101192,84476,92261,279635,173095,75972,536122,77194,36406095000,3982385000,3547447000,4834783000,12396580000,10445517000,5499501000,28848291000,6270109000
Washington,Educational Services,2012,12194,6235,2085,1610,9930,1570,368,11868,326,12990,6235,2100,1625,9960,1845,535,12340,650,258753,9279,13552,21439,45029,60851,38675,150988,105828,7058469000,297787000,309875000,459773000,1070997000,1537976000,1280498000,4112809000,2892919000
Washington,Finance and Insurance,2012,25089,17157,3005,1215,21377,1241,814,23432,1657,49375,17190,3085,1355,21630,2655,3775,28060,21315,464731,28558,17304,14572,61384,39168,63136,172573,275084,34529558000,1450877000,947051000,1183103000,3674040000,2840992000,4096361000,11235537000,22740346000
Washington,Health Care and Social Assistance,2012,82041,42930,19085,9559,71574,6633,2275,80482,1559,99115,42960,19190,10060,72210,9690,6700,88600,10515,1856454,74729,125946,123246,328051,247760,311595,894671,942937,88550068000,3074117000,4833275000,4799788000,12699449000,9530094000,12552933000,35130692000,52783830000
Washington,Information,2012,10221,4875,1462,1105,7442,1165,526,9133,1088,15990,4875,1475,1145,7495,1305,655,9455,6535,549204,4885,8218,13872,30332,39361,35892,116369,216628,73915859000,374395000,447108000,819151000,1961741000,2772915000,3927911000,10085899000,22772661000
Washington,Management of Companies and Enterprises,2012,3716,315,110,140,565,746,1011,2322,1394,5075,315,110,140,565,760,1090,2415,2660,338754,342,484,845,1713,8323,31941,42386,296368,38420455000,70186000,50419000,90857000,214947000,592906000,2141640000,2949493000,35466679000
Washington,Manufacturing,2012,33542,14800,5785,4247,24832,4977,1773,31582,1960,35000,14800,5790,4300,24890,5090,2090,32070,2930,966679,21437,33360,49358,114644,176186,166131,502447,324876,53910856000,991814000,1280327000,2106595000,4616491000,8270464000,9066888000,24053620000,20773342000
Washington,"Mining, Quarrying, and Oil and Gas Extraction",2012,748,340,130,65,535,75,54,664,84,925,340,130,70,540,95,105,740,185,9437,131,740,491,1992,1807,636,5166,2983,696455000,30172000,32992000,21953000,100183000,124699000,71370000,369434000,230395000
Washington,Other,2012,193,185,7,1,193,0,0,193,0,193,185,7,1,193,0,0,193,0,0,0,0,0,0,0,0,0,0,4676000,3086000,990000,0,4676000,0,0,4676000,0
Washington,Other Services (except Public Administration),2012,75266,47730,15240,6889,69859,4119,674,74652,614,82890,47805,15310,7295,70410,5755,2220,78385,4505,538617,84639,96836,87112,273329,130679,50603,465484,42662,15907055000,2205173000,2485878000,2336489000,7048580000,3742095000,1513669000,12596152000,1827873000
Washington,"Professional, Scientific, and Technical Services",2012,94289,67315,11470,6506,85291,5122,1780,92193,2096,100510,67315,11500,6650,85465,5910,2540,93915,6595,845315,90643,74460,85563,256567,168329,133177,565855,250106,62728021000,5335319000,4126121000,5262500000,14768222000,13933944000,10000004000,39025593000,21732026000
Washington,Real Estate and Rental and Leasing,2012,37310,28877,4086,1678,34641,1390,601,36632,678,49045,28970,4210,1955,35135,2555,2585,40275,8770,224845,39591,25373,21021,86709,39678,31347,163397,52354,9746770000,1412669000,853667000,966844000,3240991000,1781343000,1312679000,6507600000,2978681000
Washington,Retail Trade,2012,72444,39079,15152,8416,62647,5981,1512,70140,2304,107950,39165,15500,9610,64275,9470,5670,79415,28535,1486884,55674,94717,106174,268018,203737,108748,594755,785324,43159782000,1811050000,2353546000,2941570000,7215970000,7093316000,4486515000,19014129000,22723313000
Washington,Total,2012,143147,87337,24516,14286,126139,11285,2918,140342,2805,175553,87440,24758,15093,127291,15161,8191,150643,24910,2361697,142019,160460,189080,491559,405052,333616,1230227,1131470,122692282000,5370762000,5451237000,6990124000,17812123000,17219666000,16348621000,51380410000,71311872000
Washington,Transportation and Warehousing,2012,21026,11925,2709,1826,16460,1858,1032,19350,1676,24350,11940,2755,1895,16590,2150,1550,20290,4060,413274,15783,16801,21869,57442,53319,39010,160990,244995,20480515000,685606000,644267000,890650000,2266121000,2190425000,1814187000,6725858000,13476872000
Washington,Utilities,2012,983,605,115,65,785,72,33,890,93,1520,605,115,70,790,120,70,980,540,2901,1216,604,797,2790,1014,0,4585,61,243110000,26543000,25440000,43633000,105801000,184744000,0,271577000,45901000
Washington,Wholesale Trade,2012,38176,18905,5603,3889,28397,4722,2181,35300,2876,46920,18930,5685,4120,28735,6130,3830,38695,8225,619814,27862,33620,47821,115198,138064,99595,370001,219928,38426519000,1647432000,1870037000,2623856000,6196925000,7772743000,5872736000,20591069000,16629682000
West Virginia,Accommodation and Food Services,2012,13231,4825,2610,2516,9951,2338,477,12766,465,18130,4835,2615,2585,10035,3090,1930,15055,3075,303178,8250,17009,34344,60497,85338,52268,199676,96844,4055762000,151492000,205384000,414286000,773322000,1103287000,645613000,2556408000,1336796000
West Virginia,Administrative and Support and Waste Management and Remediation Services,2012,6445,3405,1080,600,5085,590,216,5891,554,7215,3405,1080,600,5085,640,280,6005,1210,159935,4733,5528,7366,19263,19686,30393,73094,77836,4455856000,180412000,180627000,203825000,592447000,615680000,912384000,2354238000,1831001000
West Virginia,"Agriculture, Forestry, Fishing and Hunting",2012,1120,890,170,30,1090,20,5,1115,5,1120,890,170,30,1090,20,5,1115,5,3804,1511,975,0,2939,805,0,3764,0,108699000,36839000,18727000,2278000,69359000,34490000,0,105214000,0
West Virginia,"Arts, Entertainment, and Recreation",2012,3398,1630,775,480,2885,345,79,3309,89,3830,1630,785,555,2970,480,265,3715,115,58109,2317,4619,6028,13736,9300,5904,32440,25130,1255374000,66887000,66061000,105271000,248153000,166972000,52216000,513371000,726773000
West Virginia,Construction,2012,16653,10765,2840,1660,15265,1030,202,16497,156,16765,10765,2840,1660,15265,1050,240,16555,210,125692,17131,17724,21327,57936,35840,13749,112890,6211,5708821000,513924000,541214000,819342000,1892725000,1834062000,932208000,4931112000,377286000
West Virginia,Educational Services,2012,1283,545,240,140,925,223,80,1228,55,1335,545,240,140,925,235,110,1270,65,45840,803,1540,1637,4184,6390,16305,31576,8190,1400259000,20819000,18013000,30383000,70817000,133106000,351003000,666662000,293456000
West Virginia,Finance and Insurance,2012,5805,3445,835,345,4625,448,158,5231,574,10815,3445,875,465,4785,1265,720,6770,4045,84183,6899,4889,4137,16213,15384,8732,43493,15364,3808456000,217085000,168121000,188757000,594991000,630346000,325283000,1639475000,2033639000
West Virginia,Health Care and Social Assistance,2012,17618,6735,4515,2453,13703,2218,974,16895,723,24805,6735,4525,2545,13805,3280,2780,19865,4940,654037,13681,29058,31173,75731,84585,121903,288000,342459,24686981000,508264000,994245000,1219221000,2742137000,2737999000,3512970000,9195771000,15043153000
West Virginia,Information,2012,1400,475,170,205,850,143,88,1081,319,3320,475,170,205,850,200,200,1250,2070,50176,445,851,1808,3819,3534,1165,11427,31508,2411119000,20468000,17165000,60274000,108344000,122848000,41264000,383955000,1875021000
West Virginia,Management of Companies and Enterprises,2012,786,45,5,30,80,170,255,505,281,1130,45,5,30,80,170,260,510,620,23552,0,0,23,284,2316,4589,7322,16225,1516592000,13106000,0,778000,31668000,117564000,447403000,613397000,903187000
West Virginia,Manufacturing,2012,5833,1805,1020,863,3688,1076,448,5212,621,6240,1805,1025,865,3695,1165,550,5410,830,182212,1983,4625,8286,18897,30788,19795,85289,76460,9562127000,66966000,144021000,279866000,578284000,1161861000,927636000,3411161000,5037181000
West Virginia,"Mining, Quarrying, and Oil and Gas Extraction",2012,2581,985,375,310,1670,416,218,2304,277,3340,985,375,310,1670,435,270,2375,965,182469,940,1547,3700,8128,13954,25210,49268,116869,13474250000,74076000,111662000,182731000,383189000,803438000,1759873000,3055532000,9111325000
West Virginia,Other,2012,23,21,2,0,23,0,0,23,0,23,21,2,0,23,0,0,23,0,28,0,0,0,28,0,0,28,0,402000,227000,0,0,402000,0,0,402000,0
West Virginia,Other Services (except Public Administration),2012,20905,13190,4415,1876,19481,937,193,20611,294,22345,13200,4435,1950,19585,1285,255,21125,1220,126317,24258,27661,23885,77551,27128,2996,115612,7000,2939898000,487104000,516077000,544229000,1564740000,643348000,97964000,2555619000,291816000
West Virginia,"Professional, Scientific, and Technical Services",2012,13368,7980,2240,1210,11430,907,386,12723,645,14920,7995,2250,1270,11515,1165,595,13275,1645,120322,13190,14015,14874,43631,28848,12183,93308,22772,5674438000,512103000,527988000,640169000,1717015000,1469242000,569710000,4151105000,1483261000
West Virginia,Real Estate and Rental and Leasing,2012,5700,4050,770,310,5130,192,101,5423,277,6985,4075,775,340,5190,275,310,5775,1210,26465,6815,4351,3200,15200,3228,533,21288,5010,1014046000,182132000,140189000,88135000,453434000,123671000,34490000,762470000,223284000
West Virginia,Retail Trade,2012,19012,8708,4143,2483,15334,2003,420,17757,1255,32000,8735,4210,2800,15745,3080,1635,20460,11540,352746,13745,24443,27281,73623,60181,23916,162560,159214,8098869000,332822000,577501000,724708000,1650928000,1819963000,668305000,4234177000,3736661000
West Virginia,Total,2012,28613,14935,5599,3326,23860,2747,779,27386,1227,37906,14957,5650,3536,24143,3940,2271,30354,7552,579583,28420,36590,44000,109010,100202,88376,297588,281995,21204523000,760530000,954882000,1276587000,2991999000,3225087000,3100763000,9317849000,11886674000
West Virginia,Transportation and Warehousing,2012,5371,2939,835,485,4259,534,164,4957,414,6170,2940,835,485,4260,575,200,5035,1135,63132,4514,4784,5611,16033,14851,2508,36855,12013,2355156000,156650000,153022000,194311000,527876000,543126000,98766000,1249934000,575193000
West Virginia,Utilities,2012,302,105,20,55,180,25,20,225,77,1100,105,20,65,190,75,120,385,715,1524,195,0,56,847,488,1144,2211,0,72051000,5449000,1326000,1459000,23282000,20679000,90520000,135984000,0
West Virginia,Wholesale Trade,2012,6236,2070,984,710,3764,975,419,5158,1078,7850,2070,1010,780,3860,1215,630,5705,2145,93797,2581,5095,7234,16456,19242,11869,52823,29133,4603385000,154517000,202756000,277999000,702833000,872949000,593749000,2486517000,1580764000
Wisconsin,Accommodation and Food Services,2012,57931,23633,11245,10711,45589,10468,1044,57101,830,70850,23720,11255,10870,45845,12470,3785,62100,8750,1097189,39925,75797,146492,262762,370704,137610,772044,296048,14389675000,804405000,807751000,1581098000,3198500000,4626840000,1862382000,9692935000,4584194000
Wisconsin,Administrative and Support and Waste Management and Remediation Services,2012,28726,17610,4097,2603,24310,2222,858,27390,1336,33755,17610,4105,2640,24355,2445,1350,28150,5605,688415,24438,25722,33297,86062,82785,108371,282270,388500,19414476000,922445000,766086000,1029209000,2753138000,2598917000,2427558000,8031003000,10637436000
Wisconsin,"Agriculture, Forestry, Fishing and Hunting",2012,2720,2135,350,120,2605,65,25,2695,25,2740,2135,350,120,2605,65,30,2700,40,14257,3095,2182,1367,6734,414,0,11682,210,584541000,91121000,65993000,50089000,210194000,41762000,0,477971000,4845000
Wisconsin,"Arts, Entertainment, and Recreation",2012,12693,7055,1937,1592,10584,1621,312,12517,176,13285,7055,1955,1600,10610,1800,515,12925,360,207304,9307,12149,20818,44138,61417,44042,153985,31647,5288426000,337076000,240825000,326245000,926626000,1034103000,975036000,3429994000,580084000
Wisconsin,Construction,2012,66791,47950,10148,4735,62833,3193,454,66480,311,67520,47950,10160,4770,62880,3365,625,66870,650,445005,72546,65486,61147,201226,108249,53962,373447,55637,26947430000,3097389000,2903853000,3400155000,9431460000,6688471000,3956250000,20720155000,4690104000
Wisconsin,Educational Services,2012,7152,2975,1225,1000,5200,1420,203,6823,329,7645,2975,1225,1020,5220,1520,265,7005,640,278571,4202,7740,13538,26198,53712,26006,108613,164209,8641743000,133708000,141216000,240569000,522257000,1257059000,715607000,2542432000,5927600000
Wisconsin,Finance and Insurance,2012,23687,15460,2755,1224,19439,2027,779,22245,1442,46015,15465,2825,1510,19800,5185,4350,29335,16680,695934,23595,15842,14274,57523,71597,76799,209499,467315,45591751000,1070019000,771247000,817239000,2706466000,3876259000,4212073000,10990154000,34225759000
Wisconsin,Health Care and Social Assistance,2012,50866,21742,10545,7603,39890,6720,2433,49043,1823,73155,21865,10665,8125,40655,10455,7715,58825,14330,1910684,38688,68932,102152,208849,253216,356390,826866,1068791,81639786000,2139413000,2616909000,3844567000,8617392000,9909744000,10115810000,28799103000,52102072000
Wisconsin,Information,2012,5515,2175,780,735,3690,776,290,4756,759,11375,2175,795,770,3740,1120,520,5380,5995,264827,2377,4040,9738,18253,24027,24490,68867,192375,14523166000,155709000,185920000,409581000,777100000,1085149000,1238919000,3221426000,11066536000
Wisconsin,Management of Companies and Enterprises,2012,3545,220,30,145,395,690,1069,2154,1391,5030,220,30,145,395,695,1160,2250,2780,351246,2,164,827,1197,7425,33783,42431,308815,31501540000,54470000,16196000,57791000,129178000,423480000,2195457000,2759175000,28735017000
Wisconsin,Manufacturing,2012,41058,12865,6465,5834,25164,9033,3664,37861,3197,44885,12880,6480,5865,25225,9615,4655,39495,5390,2056126,20001,38406,72384,140221,355600,446338,993724,955977,103667776000,885865000,1493927000,3023442000,5653500000,16206430000,22021825000,46135252000,51876610000
Wisconsin,"Mining, Quarrying, and Oil and Gas Extraction",2012,713,315,105,85,505,90,33,628,85,815,315,105,95,515,110,60,685,130,10903,428,639,962,2167,1612,0,6061,4106,767711000,34570000,45447000,58374000,146912000,142889000,0,501669000,247775000
Wisconsin,Other,2012,216,213,2,1,216,0,0,216,0,216,213,2,1,216,0,0,216,0,0,0,0,0,0,0,0,0,0,2048000,1976000,0,0,2048000,0,0,2048000,0
Wisconsin,Other Services (except Public Administration),2012,68432,39960,15377,7419,62756,4501,606,67863,569,73625,39980,15525,7750,63255,6150,1330,70735,2890,537286,74405,99207,95402,272949,151707,40304,476047,51897,12887837000,1743290000,2115233000,2005899000,5899748000,3740679000,1131110000,11206608000,1518600000
Wisconsin,"Professional, Scientific, and Technical Services",2012,52412,34200,7771,4461,46432,3595,969,50996,1416,56650,34225,7825,4650,46700,4630,1505,52835,3815,540515,47671,49224,56368,159639,113040,74370,356454,135820,30037071000,2310583000,2253819000,2776775000,7375568000,6634514000,5492842000,19972158000,9589209000
Wisconsin,Real Estate and Rental and Leasing,2012,18260,13260,2220,1116,16596,811,436,17843,417,22355,13275,2315,1280,16870,1240,2095,20205,2150,118021,18574,13281,13597,47604,26236,20730,100170,14386,4211841000,638755000,444021000,475357000,1587250000,929767000,796108000,3496210000,632108000
Wisconsin,Retail Trade,2012,62862,30599,13560,8019,52178,6738,1617,60533,2329,96785,30680,13920,8980,53580,10745,5985,70310,26475,1376524,49295,87203,100478,245053,228449,129681,620938,594467,32450720000,1344148000,1916700000,2485265000,5780216000,6443562000,3562116000,16004709000,14435908000
Wisconsin,Total,2012,108389,59862,19221,12518,91601,11564,2730,105895,2494,138246,59971,19437,13242,92650,15937,8156,116743,21503,2388855,101646,126432,168011,396089,436134,377923,1210146,1178709,99665591000,3550665000,3828564000,5302243000,12681472000,15610070000,15166871000,43458413000,56207178000
Wisconsin,Transportation and Warehousing,2012,23340,13470,3150,2337,18957,2352,698,22007,1333,26215,13475,3165,2375,19015,2645,1130,22790,3425,462193,16928,19551,29484,69940,77751,60491,215532,238287,18058950000,760521000,722579000,1079345000,2596090000,2940823000,2085649000,7801896000,9889670000
Wisconsin,Utilities,2012,389,80,15,40,135,115,15,265,124,1635,140,15,55,210,160,25,395,1240,64956,124,0,485,686,3534,0,5148,59381,5978320000,6999000,0,27882000,37782000,383561000,0,478939000,5377279000
Wisconsin,Wholesale Trade,2012,29216,12628,4440,3431,20499,4302,2058,26859,2357,35815,12650,4460,3585,20695,5270,3680,29645,6170,563638,18996,27769,42242,93764,131041,116784,360125,173398,32216361000,1082945000,1378606000,2235838000,4786639000,7000928000,6207856000,18848401000,11081757000
Wyoming,Accommodation and Food Services,2012,7911,3010,1545,1540,6095,1344,270,7709,202,9010,3010,1555,1565,6130,1635,715,8480,530,134867,3810,9861,20350,35236,45643,32131,113111,7094,2420540000,131587000,139047000,301401000,577250000,744573000,546042000,1875640000,375842000
Wyoming,Administrative and Support and Waste Management and Remediation Services,2012,4613,3130,645,398,4173,185,35,4393,220,4790,3130,650,410,4190,205,40,4435,355,30034,4220,3728,4468,13401,3972,276,18867,8963,923016000,172233000,108647000,139442000,448275000,124426000,6915000,631919000,212529000
Wyoming,"Agriculture, Forestry, Fishing and Hunting",2012,490,420,50,5,475,10,0,485,5,490,420,50,5,475,10,0,485,5,947,158,216,0,748,0,0,1072,0,31701000,13402000,6714000,0,25087000,0,0,30669000,0
Wyoming,"Arts, Entertainment, and Recreation",2012,2120,1515,225,195,1935,150,30,2115,5,2140,1515,225,195,1935,160,40,2135,5,16737,1190,953,2308,5795,4514,754,12789,0,353171000,68869000,23425000,34318000,142420000,97103000,30845000,302468000,0
Wyoming,Construction,2012,13193,8920,2135,1195,12250,709,105,13064,129,13285,8920,2135,1195,12250,760,130,13140,145,88726,13100,12901,15116,43618,22362,5805,77064,2085,4420130000,567458000,529969000,739510000,1855700000,1402506000,344652000,3875290000,293096000
Wyoming,Educational Services,2012,858,495,105,135,735,40,48,823,35,900,495,105,135,735,40,90,865,35,8577,582,515,1276,2677,1325,3250,7677,0,224673000,19458000,7878000,20556000,55210000,26315000,103861000,200493000,0
Wyoming,Finance and Insurance,2012,3270,2150,340,165,2655,251,59,2965,305,5185,2150,350,210,2710,790,190,3690,1495,32248,2212,1698,1573,6075,9024,1735,18920,5369,1626754000,117673000,65876000,60783000,267558000,445026000,103831000,946375000,638086000
Wyoming,Health Care and Social Assistance,2012,8600,4370,1750,1135,7255,800,259,8314,286,9515,4375,1750,1155,7280,1170,510,8960,555,153442,7516,11053,14537,34174,27438,29752,99059,49782,6635989000,461012000,422828000,567471000,1471727000,1107016000,1141267000,3933709000,2596499000
Wyoming,Information,2012,1076,400,150,125,675,198,75,948,128,1610,400,160,130,690,265,155,1110,500,18279,272,574,782,2807,5215,1742,12101,5499,753114000,17345000,14103000,25055000,96313000,153148000,110339000,411300000,297971000
Wyoming,Management of Companies and Enterprises,2012,371,65,5,25,95,65,75,235,136,425,65,5,25,95,65,80,240,185,4460,0,0,0,0,544,1045,1787,2673,444505000,2939000,0,3340000,7844000,28927000,120085000,155945000,288560000
Wyoming,Manufacturing,2012,2623,1335,445,235,2015,260,102,2377,246,2765,1335,445,250,2030,275,110,2415,350,35080,1275,1332,1362,5889,3636,2152,17120,12855,2232852000,60717000,58161000,73176000,229468000,223892000,116407000,879895000,1053376000
Wyoming,"Mining, Quarrying, and Oil and Gas Extraction",2012,3623,1640,625,380,2645,364,148,3157,466,4250,1640,625,380,2645,365,210,3220,1030,141704,2826,3415,4834,11636,11939,12888,39406,100747,11288662000,164624000,184891000,296621000,676428000,825923000,824870000,2613188000,8611745000
Wyoming,Other,2012,33,30,2,1,33,0,0,33,0,33,30,2,1,33,0,0,33,0,40,0,0,0,40,0,0,40,0,1178000,409000,0,0,1178000,0,0,1178000,0
Wyoming,Other Services (except Public Administration),2012,8821,5695,1850,725,8270,290,90,8650,171,9165,5695,1850,785,8330,395,105,8830,335,41863,10118,11465,7706,30861,3888,24,38872,704,1293082000,290757000,310019000,237601000,866610000,176940000,4700000,1125582000,36087000
Wyoming,"Professional, Scientific, and Technical Services",2012,10437,7655,1250,705,9610,372,162,10144,293,10800,7660,1250,740,9650,470,200,10320,480,44676,10191,7184,8704,26831,8918,2355,41491,1918,2432616000,557283000,345401000,450303000,1376135000,519625000,152288000,2241310000,143498000
Wyoming,Real Estate and Rental and Leasing,2012,4758,3770,360,235,4365,125,65,4555,203,5380,3770,370,235,4375,200,295,4870,510,20803,4488,1745,2289,10172,2274,213,14617,5788,1024439000,177193000,69505000,92837000,358420000,112947000,33111000,562603000,456680000
Wyoming,Retail Trade,2012,10210,4860,2205,1264,8329,825,338,9492,718,13415,4860,2250,1410,8520,1140,870,10530,2885,122178,7554,13746,14580,37173,20014,8893,72027,38669,3368903000,216573000,317065000,415795000,982843000,730889000,342159000,2135855000,971846000
Wyoming,Total,2012,17804,10661,2954,1813,15428,1273,381,17082,722,20635,10664,2979,1916,15559,1768,878,18205,2430,214241,17530,19283,23751,60564,42041,30907,133512,80729,9589138000,675362000,617869000,820939000,2114170000,1670604000,1275999000,5060773000,4528365000
Wyoming,Transportation and Warehousing,2012,4123,2470,635,340,3445,265,97,3807,316,5020,2470,635,340,3445,290,190,3925,1095,39457,3375,3937,3727,11968,6860,4217,24662,11433,2254868000,136550000,163308000,189706000,517594000,343563000,199080000,1144520000,983785000
Wyoming,Utilities,2012,262,85,20,20,125,40,15,180,82,700,85,20,30,135,75,50,260,440,21,0,0,0,170,1373,0,2687,0,2878000,0,2010000,0,9745000,93745000,0,181348000,0
Wyoming,Wholesale Trade,2012,3218,1175,444,348,1967,413,254,2634,584,4165,1175,455,380,2010,530,410,2950,1215,38527,1479,2029,2964,7160,4936,3679,20734,16648,2326096000,102964000,111181000,139430000,408434000,333035000,231706000,1117287000,1113527000
